Winamax Poker - HOLD-UP "Colorado" - HandId: #19116069-655176-1701676279 - Holdem no limit (0.01€/0.02€) - 2023/12/04 07:51:19 UTC
Table: 'Colorado' 6-max (real money) Seat #6 is the button
Seat 1: nonoleboucan (2€)
Seat 2: Fried Berg (0.50€)
Seat 3: Phil_TezAsS_ (2€)
Seat 4: mel0581 (0.53€)
Seat 5: St. Germain (2.34€)
Seat 6: Piexxxe10 (1.41€)
*** ANTE/BLINDS ***
nonoleboucan posts small blind 0.01€
Fried Berg posts big blind 0.02€
Dealt to Fried Berg [Qs 9h]
*** PRE-FLOP *** 
Phil_TezAsS_ folds
mel0581 folds
St. Germain raises 0.03€ to 0.05€
Piexxxe10 calls 0.05€
nonoleboucan folds
Fried Berg folds
*** FLOP *** [8h Qd 8c]
St. Germain checks
Piexxxe10 checks
*** TURN *** [8h Qd 8c][6d]
St. Germain bets 0.08€
Piexxxe10 folds
St. Germain collected 0.20€ from pot
*** SUMMARY ***
Total pot 0.20€ | Rake 0.01€
Board: [8h Qd 8c 6d]
Seat 5: St. Germain won 0.20€


Winamax Poker - HOLD-UP "Colorado" - HandId: #19116069-655186-1701676290 - Holdem no limit (0.01€/0.02€) - 2023/12/04 07:51:30 UTC
Table: 'Colorado' 6-max (real money) Seat #6 is the button
Seat 1: Fried Berg (0.48€)
Seat 2: jdeepenslip (2.50€)
Seat 3: mel0581 (0.54€)
Seat 4: jjakpour (2.36€)
Seat 5: 18GranDDuC18 (2.08€)
Seat 6: Hydramist (2.12€)
*** ANTE/BLINDS ***
Fried Berg posts small blind 0.01€
jdeepenslip posts big blind 0.02€
Dealt to Fried Berg [8d Js]
*** PRE-FLOP *** 
mel0581 folds
jjakpour calls 0.02€
18GranDDuC18 folds
Hydramist raises 0.06€ to 0.08€
Fried Berg folds
jdeepenslip calls 0.06€
jjakpour calls 0.06€
*** FLOP *** [Jc 3h Ad]
jdeepenslip checks
jjakpour checks
Hydramist bets 0.09€
jdeepenslip folds
jjakpour folds
Hydramist collected 0.31€ from pot
*** SUMMARY ***
Total pot 0.31€ | Rake 0.03€
Board: [Jc 3h Ad]
Seat 6: Hydramist (button) won 0.31€


Winamax Poker - HOLD-UP "Colorado" - HandId: #19116069-655190-1701676295 - Holdem no limit (0.01€/0.02€) - 2023/12/04 07:51:35 UTC
Table: 'Colorado' 6-max (real money) Seat #6 is the button
Seat 1: fabrice8551 (2.11€)
Seat 2: Emasand11 (0.97€)
Seat 3: Fried Berg (0.47€)
Seat 4: On100Fish (2.04€)
Seat 5: nonoleboucan (2.26€)
Seat 6: sim. (2.24€)
*** ANTE/BLINDS ***
fabrice8551 posts small blind 0.01€
Emasand11 posts big blind 0.02€
Dealt to Fried Berg [Th 3s]
*** PRE-FLOP *** 
Fried Berg folds
On100Fish folds
nonoleboucan raises 0.04€ to 0.06€
sim. folds
fabrice8551 folds
Emasand11 calls 0.04€
*** FLOP *** [3h 5h 6h]
Emasand11 checks
nonoleboucan bets 0.05€
Emasand11 calls 0.05€
*** TURN *** [3h 5h 6h][5c]
Emasand11 checks
nonoleboucan bets 0.13€
Emasand11 calls 0.13€
*** RIVER *** [3h 5h 6h 5c][As]
Emasand11 checks
nonoleboucan checks
*** SHOW DOWN ***
Emasand11 shows [Jh Qs] (One pair : 5)
nonoleboucan shows [Ks Kh] (Two pairs : Kings and 5)
nonoleboucan collected 0.44€ from pot
*** SUMMARY ***
Total pot 0.44€ | Rake 0.05€
Board: [3h 5h 6h 5c As]
Seat 2: Emasand11 (big blind) showed [Jh Qs] and lost with One pair : 5
Seat 5: nonoleboucan showed [Ks Kh] and won 0.44€ with Two pairs : Kings and 5


Winamax Poker - HOLD-UP "Colorado" - HandId: #19116069-655193-1701676297 - Holdem no limit (0.01€/0.02€) - 2023/12/04 07:51:37 UTC
Table: 'Colorado' 6-max (real money) Seat #6 is the button
Seat 1: EpxGrds (2.08€)
Seat 2: 18GranDDuC18 (2.08€)
Seat 3: LilRun (2.06€)
Seat 4: Fried Berg (0.47€)
Seat 5: Redemption90 (1.89€)
Seat 6: In_The_Mood (2€)
*** ANTE/BLINDS ***
EpxGrds posts small blind 0.01€
18GranDDuC18 posts big blind 0.02€
Dealt to Fried Berg [Jc Ks]
*** PRE-FLOP *** 
LilRun raises 0.03€ to 0.05€
Fried Berg calls 0.05€
Redemption90 folds
In_The_Mood folds
EpxGrds folds
18GranDDuC18 calls 0.03€
*** FLOP *** [7d Jd 4c]
18GranDDuC18 checks
LilRun bets 0.06€
Fried Berg calls 0.06€
18GranDDuC18 calls 0.06€
*** TURN *** [7d Jd 4c][Ad]
18GranDDuC18 checks
LilRun checks
Fried Berg bets 0.12€
18GranDDuC18 calls 0.12€
LilRun folds
*** RIVER *** [7d Jd 4c Ad][2c]
18GranDDuC18 checks
Fried Berg bets 0.24€ and is all-in
18GranDDuC18 calls 0.24€
*** SHOW DOWN ***
Fried Berg shows [Jc Ks] (One pair : Jacks)
18GranDDuC18 shows [7s 7c] (Trips of 7)
18GranDDuC18 collected 0.95€ from pot
*** SUMMARY ***
Total pot 0.95€ | Rake 0.11€
Board: [7d Jd 4c Ad 2c]
Seat 2: 18GranDDuC18 (big blind) showed [7s 7c] and won 0.95€ with Trips of 7
Seat 4: Fried Berg showed [Jc Ks] and lost with One pair : Jacks


Winamax Poker - HOLD-UP "Colorado" - HandId: #19116069-655236-1701676361 - Holdem no limit (0.01€/0.02€) - 2023/12/04 07:52:41 UTC
Table: 'Colorado' 6-max (real money) Seat #6 is the button
Seat 1: Suaterna207 (2€)
Seat 2: fabrice8551 (1.84€)
Seat 3: pasquale202a (1.32€)
Seat 4: Matofs (2.07€)
Seat 5: Fried Berg (0.50€)
Seat 6: sopra61 (1.81€)
*** ANTE/BLINDS ***
Suaterna207 posts small blind 0.01€
fabrice8551 posts big blind 0.02€
Dealt to Fried Berg [2c 9h]
*** PRE-FLOP *** 
pasquale202a raises 0.03€ to 0.05€
Matofs folds
Fried Berg folds
sopra61 folds
Suaterna207 folds
fabrice8551 folds
pasquale202a collected 0.08€ from pot
*** SUMMARY ***
Total pot 0.08€ | No rake
Seat 3: pasquale202a won 0.08€


Winamax Poker - HOLD-UP "Colorado" - HandId: #19116069-655243-1701676371 - Holdem no limit (0.01€/0.02€) - 2023/12/04 07:52:51 UTC
Table: 'Colorado' 6-max (real money) Seat #6 is the button
Seat 1: LilRun (1.93€)
Seat 2: TimToBey (2.63€)
Seat 3: Phil_TezAsS_ (2€)
Seat 4: Redemption90 (6.21€)
Seat 5: On100Fish (2.29€)
Seat 6: Fried Berg (0.50€)
*** ANTE/BLINDS ***
LilRun posts small blind 0.01€
TimToBey posts big blind 0.02€
Dealt to Fried Berg [6s 5c]
*** PRE-FLOP *** 
Phil_TezAsS_ folds
Redemption90 raises 0.03€ to 0.05€
On100Fish folds
Fried Berg folds
LilRun folds
TimToBey calls 0.03€
*** FLOP *** [5d Kh 5h]
TimToBey checks
Redemption90 checks
*** TURN *** [5d Kh 5h][Kc]
TimToBey bets 0.07€
Redemption90 calls 0.07€
*** RIVER *** [5d Kh 5h Kc][Ts]
TimToBey bets 0.16€
Redemption90 folds
TimToBey collected 0.38€ from pot
*** SUMMARY ***
Total pot 0.38€ | Rake 0.03€
Board: [5d Kh 5h Kc Ts]
Seat 2: TimToBey (big blind) won 0.38€


Winamax Poker - HOLD-UP "Colorado" - HandId: #19116069-655261-1701676391 - Holdem no limit (0.01€/0.02€) - 2023/12/04 07:53:11 UTC
Table: 'Colorado' 6-max (real money) Seat #6 is the button
Seat 1: Fried Berg (0.50€)
Seat 2: jdeepenslip (2.45€)
Seat 3: Suaterna207 (2€)
Seat 4: Emasand11 (0.75€)
Seat 5: hello7585 (2.07€)
Seat 6: Hagreed (0.71€)
*** ANTE/BLINDS ***
Fried Berg posts small blind 0.01€
jdeepenslip posts big blind 0.02€
Dealt to Fried Berg [Qd 5s]
*** PRE-FLOP *** 
Suaterna207 raises 0.04€ to 0.06€
Emasand11 folds
hello7585 folds
Hagreed folds
Fried Berg folds
jdeepenslip folds
Suaterna207 collected 0.09€ from pot
*** SUMMARY ***
Total pot 0.09€ | No rake
Seat 3: Suaterna207 won 0.09€


Winamax Poker - HOLD-UP "Colorado" - HandId: #19116069-655276-1701676406 - Holdem no limit (0.01€/0.02€) - 2023/12/04 07:53:26 UTC
Table: 'Colorado' 6-max (real money) Seat #6 is the button
Seat 1: 18GranDDuC18 (2.41€)
Seat 2: Fried Berg (0.49€)
Seat 3: mel0581 (0.25€)
Seat 4: pie38_x (3.42€)
Seat 5: In_The_Mood (2.67€)
Seat 6: magnumbenji (0.19€)
*** ANTE/BLINDS ***
18GranDDuC18 posts small blind 0.01€
Fried Berg posts big blind 0.02€
Dealt to Fried Berg [Td 8h]
*** PRE-FLOP *** 
mel0581 folds
pie38_x folds
In_The_Mood folds
magnumbenji folds
18GranDDuC18 raises 0.04€ to 0.06€
Fried Berg folds
18GranDDuC18 collected 0.08€ from pot
*** SUMMARY ***
Total pot 0.08€ | No rake
Seat 1: 18GranDDuC18 (small blind) won 0.08€


Winamax Poker - HOLD-UP "Colorado" - HandId: #19116069-655291-1701676417 - Holdem no limit (0.01€/0.02€) - 2023/12/04 07:53:37 UTC
Table: 'Colorado' 6-max (real money) Seat #6 is the button
Seat 1: Phil_TezAsS_ (2.02€)
Seat 2: Ga31k (2.12€)
Seat 3: Fried Berg (0.47€)
Seat 4: SashaTDouss (2.12€)
Seat 5: Suaterna207 (2.03€)
Seat 6: AllDiamond (2.17€)
*** ANTE/BLINDS ***
Phil_TezAsS_ posts small blind 0.01€
Ga31k posts big blind 0.02€
Dealt to Fried Berg [Kc 6s]
*** PRE-FLOP *** 
Fried Berg folds
SashaTDouss raises 0.04€ to 0.06€
Suaterna207 folds
AllDiamond folds
Phil_TezAsS_ calls 0.05€
Ga31k calls 0.04€
*** FLOP *** [8s Tc Ad]
Phil_TezAsS_ bets 0.09€
Ga31k folds
SashaTDouss calls 0.09€
*** TURN *** [8s Tc Ad][4h]
Phil_TezAsS_ bets 0.18€
SashaTDouss folds
Phil_TezAsS_ collected 0.50€ from pot
*** SUMMARY ***
Total pot 0.50€ | Rake 0.04€
Board: [8s Tc Ad 4h]
Seat 1: Phil_TezAsS_ (small blind) won 0.50€


Winamax Poker - HOLD-UP "Colorado" - HandId: #19116069-655296-1701676423 - Holdem no limit (0.01€/0.02€) - 2023/12/04 07:53:43 UTC
Table: 'Colorado' 6-max (real money) Seat #6 is the button
Seat 1: jdeepenslip (2€)
Seat 2: pasquale202a (1.54€)
Seat 3: hello7585 (1.87€)
Seat 4: Emasand11 (0.90€)
Seat 5: L INCONNU (0.70€)
Seat 6: Fried Berg (0.47€)
*** ANTE/BLINDS ***
jdeepenslip posts small blind 0.01€
pasquale202a posts big blind 0.02€
Dealt to Fried Berg [Td 8c]
*** PRE-FLOP *** 
hello7585 folds
Emasand11 folds
L INCONNU calls 0.02€
Fried Berg folds
jdeepenslip folds
pasquale202a checks
*** FLOP *** [5c 5h 6c]
pasquale202a checks
L INCONNU checks
*** TURN *** [5c 5h 6c][Jc]
pasquale202a checks
L INCONNU bets 0.68€ and is all-in
pasquale202a folds
L INCONNU collected 0.72€ from pot
*** SUMMARY ***
Total pot 0.72€ | Rake 0.01€
Board: [5c 5h 6c Jc]
Seat 5: L INCONNU won 0.72€


Winamax Poker - HOLD-UP "Colorado" - HandId: #19116069-655299-1701676426 - Holdem no limit (0.01€/0.02€) - 2023/12/04 07:53:46 UTC
Table: 'Colorado' 6-max (real money) Seat #6 is the button
Seat 1: X3a26J23i54 (0.50€)
Seat 2: Suaterna207 (2.03€)
Seat 3: hello7585 (1.87€)
Seat 4: Keniata (0.53€)
Seat 5: Saatho. (1.05€)
Seat 6: Fried Berg (0.47€)
*** ANTE/BLINDS ***
X3a26J23i54 posts small blind 0.01€
Suaterna207 posts big blind 0.02€
Dealt to Fried Berg [8s Qd]
*** PRE-FLOP *** 
hello7585 folds
Keniata folds
Saatho. raises 0.04€ to 0.06€
Fried Berg folds
X3a26J23i54 calls 0.05€
Suaterna207 folds
*** FLOP *** [5s 5c 2d]
X3a26J23i54 bets 0.14€
Saatho. calls 0.14€
*** TURN *** [5s 5c 2d][2c]
X3a26J23i54 bets 0.30€ and is all-in
Saatho. calls 0.30€
*** RIVER *** [5s 5c 2d 2c][2h]
*** SHOW DOWN ***
X3a26J23i54 shows [Ts Qh] (Full of 2 and 5)
Saatho. shows [Td Ah] (Full of 2 and 5)
Saatho. collected 0.46€ from pot
X3a26J23i54 collected 0.46€ from pot
*** SUMMARY ***
Total pot 0.92€ | Rake 0.10€
Board: [5s 5c 2d 2c 2h]
Seat 1: X3a26J23i54 (small blind) showed [Ts Qh] and won 0.46€ with Full of 2 and 5
Seat 5: Saatho. showed [Td Ah] and won 0.46€ with Full of 2 and 5


Winamax Poker - HOLD-UP "Colorado" - HandId: #19116069-655303-1701676433 - Holdem no limit (0.01€/0.02€) - 2023/12/04 07:53:53 UTC
Table: 'Colorado' 6-max (real money) Seat #6 is the button
Seat 1: fabrice8551 (1.79€)
Seat 2: LilRun (1.83€)
Seat 3: Matofs (2.25€)
Seat 4: Fried Berg (0.47€)
Seat 5: Hydramist (2.20€)
Seat 6: In_The_Mood (2.64€)
*** ANTE/BLINDS ***
fabrice8551 posts small blind 0.01€
LilRun posts big blind 0.02€
Dealt to Fried Berg [8c Qc]
*** PRE-FLOP *** 
Matofs folds
Fried Berg folds
Hydramist raises 0.03€ to 0.05€
In_The_Mood calls 0.05€
fabrice8551 calls 0.04€
LilRun folds
*** FLOP *** [4d 3c 9s]
fabrice8551 checks
Hydramist bets 0.07€
In_The_Mood calls 0.07€
fabrice8551 folds
*** TURN *** [4d 3c 9s][Qd]
Hydramist checks
In_The_Mood bets 0.23€
Hydramist folds
In_The_Mood collected 0.51€ from pot
*** SUMMARY ***
Total pot 0.51€ | Rake 0.03€
Board: [4d 3c 9s Qd]
Seat 6: In_The_Mood (button) won 0.51€


Winamax Poker - HOLD-UP "Colorado" - HandId: #19116069-655307-1701676442 - Holdem no limit (0.01€/0.02€) - 2023/12/04 07:54:02 UTC
Table: 'Colorado' 6-max (real money) Seat #6 is the button
Seat 1: Ga31k (2.06€)
Seat 2: mel0581 (0.34€)
Seat 3: jdeepenslip (2€)
Seat 4: nonoleboucan (2.50€)
Seat 5: Fried Berg (0.47€)
Seat 6: Matofs (2.25€)
*** ANTE/BLINDS ***
Ga31k posts small blind 0.01€
mel0581 posts big blind 0.02€
Dealt to Fried Berg [Qh As]
*** PRE-FLOP *** 
jdeepenslip folds
nonoleboucan folds
Fried Berg raises 0.02€ to 0.04€
Matofs folds
Ga31k folds
mel0581 calls 0.02€
*** FLOP *** [4c 8s 5c]
mel0581 checks
Fried Berg bets 0.04€
mel0581 folds
Fried Berg collected 0.12€ from pot
*** SUMMARY ***
Total pot 0.12€ | Rake 0.01€
Board: [4c 8s 5c]
Seat 5: Fried Berg won 0.12€


Winamax Poker - HOLD-UP "Colorado" - HandId: #19116069-655326-1701676474 - Holdem no limit (0.01€/0.02€) - 2023/12/04 07:54:34 UTC
Table: 'Colorado' 6-max (real money) Seat #6 is the button
Seat 1: jdeepenslip (2€)
Seat 2: Fried Berg (0.51€)
Seat 3: Le nouche 71 (0.47€)
Seat 4: Suaterna207 (2€)
Seat 5: mel0581 (0.30€)
Seat 6: L INCONNU (0.72€)
*** ANTE/BLINDS ***
jdeepenslip posts small blind 0.01€
Fried Berg posts big blind 0.02€
Dealt to Fried Berg [3d Ks]
*** PRE-FLOP *** 
Le nouche 71 folds
Suaterna207 folds
mel0581 calls 0.02€
L INCONNU folds
jdeepenslip folds
Fried Berg checks
*** FLOP *** [Js 7d 7s]
Fried Berg checks
mel0581 checks
*** TURN *** [Js 7d 7s][Ah]
Fried Berg checks
mel0581 bets 0.03€
Fried Berg folds
mel0581 collected 0.07€ from pot
*** SUMMARY ***
Total pot 0.07€ | Rake 0.01€
Board: [Js 7d 7s Ah]
Seat 5: mel0581 won 0.07€


Winamax Poker - HOLD-UP "Colorado" - HandId: #19116069-655351-1701676511 - Holdem no limit (0.01€/0.02€) - 2023/12/04 07:55:11 UTC
Table: 'Colorado' 6-max (real money) Seat #6 is the button
Seat 1: Asticoco934 (0.73€)
Seat 2: TimToBey (2€)
Seat 3: Fried Berg (0.49€)
Seat 4: jjakpour (2.14€)
Seat 5: jdeepenslip (2€)
Seat 6: Suaterna207 (2.01€)
Hold-up to Pot: total 0.10€
*** ANTE/BLINDS ***
Asticoco934 posts small blind 0.01€
TimToBey posts big blind 0.02€
Dealt to Fried Berg [8d 6s]
*** PRE-FLOP *** 
Fried Berg folds
jjakpour folds
jdeepenslip folds
Suaterna207 folds
Asticoco934 calls 0.01€
TimToBey raises 0.05€ to 0.07€
Asticoco934 calls 0.05€
*** FLOP *** [5h 9s 3d]
Asticoco934 bets 0.08€
TimToBey raises 0.24€ to 0.32€
Asticoco934 folds
TimToBey collected 0.61€ from pot
*** SUMMARY ***
Total pot 0.61€ | Rake 0.03€
Board: [5h 9s 3d]
Seat 2: TimToBey (big blind) won 0.61€


Winamax Poker - HOLD-UP "Colorado" - HandId: #19116069-655357-1701676517 - Holdem no limit (0.01€/0.02€) - 2023/12/04 07:55:17 UTC
Table: 'Colorado' 6-max (real money) Seat #6 is the button
Seat 1: LufaS (0.50€)
Seat 2: Ga31k (2.22€)
Seat 3: EpxGrds (2.20€)
Seat 4: Fried Berg (0.49€)
Seat 5: St. Germain (1.76€)
Seat 6: vicieux59 (2.01€)
*** ANTE/BLINDS ***
LufaS posts small blind 0.01€
Ga31k posts big blind 0.02€
Dealt to Fried Berg [7h 4h]
*** PRE-FLOP *** 
EpxGrds raises 0.03€ to 0.05€
Fried Berg folds
St. Germain folds
vicieux59 folds
LufaS folds
Ga31k folds
EpxGrds collected 0.08€ from pot
*** SUMMARY ***
Total pot 0.08€ | No rake
Seat 3: EpxGrds won 0.08€


Winamax Poker - HOLD-UP "Colorado" - HandId: #19116069-655359-1701676521 - Holdem no limit (0.01€/0.02€) - 2023/12/04 07:55:21 UTC
Table: 'Colorado' 6-max (real money) Seat #6 is the button
Seat 1: Fried Berg (0.49€)
Seat 2: On100Fish (2.47€)
Seat 3: LufaS (0.49€)
Seat 4: nonoleboucan (2.58€)
Seat 5: vicieux59 (2.01€)
Seat 6: jdeepenslip (2€)
*** ANTE/BLINDS ***
Fried Berg posts small blind 0.01€
On100Fish posts big blind 0.02€
Dealt to Fried Berg [Kd 2d]
*** PRE-FLOP *** 
LufaS folds
nonoleboucan raises 0.03€ to 0.05€
vicieux59 folds
jdeepenslip folds
Fried Berg folds
On100Fish folds
nonoleboucan collected 0.08€ from pot
*** SUMMARY ***
Total pot 0.08€ | No rake
Seat 4: nonoleboucan won 0.08€


Winamax Poker - HOLD-UP "Colorado" - HandId: #19116069-655367-1701676533 - Holdem no limit (0.01€/0.02€) - 2023/12/04 07:55:33 UTC
Table: 'Colorado' 6-max (real money) Seat #6 is the button
Seat 1: Suaterna207 (2.01€)
Seat 2: Hydramist (2.10€)
Seat 3: fabrice8551 (1.34€)
Seat 4: LilRun (2€)
Seat 5: Fried Berg (0.48€)
Seat 6: Phil_TezAsS_ (2.07€)
*** ANTE/BLINDS ***
Suaterna207 posts small blind 0.01€
Hydramist posts big blind 0.02€
Dealt to Fried Berg [Ks 2d]
*** PRE-FLOP *** 
fabrice8551 folds
LilRun folds
Fried Berg folds
Phil_TezAsS_ folds
Suaterna207 folds
Hydramist collected 0.03€ from pot
*** SUMMARY ***
Total pot 0.03€ | No rake
Seat 2: Hydramist (big blind) won 0.03€


Winamax Poker - HOLD-UP "Colorado" - HandId: #19116069-655369-1701676539 - Holdem no limit (0.01€/0.02€) - 2023/12/04 07:55:39 UTC
Table: 'Colorado' 6-max (real money) Seat #6 is the button
Seat 1: Fried Berg (0.48€)
Seat 2: Suaterna207 (2€)
Seat 3: VR_King14 (0.54€)
Seat 4: Redemption90 (2.31€)
Seat 5: LilRun (2€)
Seat 6: X3a26J23i54 (0.37€)
*** ANTE/BLINDS ***
Fried Berg posts small blind 0.01€
Suaterna207 posts big blind 0.02€
Dealt to Fried Berg [Ah Kd]
*** PRE-FLOP *** 
VR_King14 folds
Redemption90 folds
LilRun raises 0.03€ to 0.05€
X3a26J23i54 folds
Fried Berg calls 0.04€
Suaterna207 calls 0.03€
*** FLOP *** [3s 6h Ts]
Fried Berg bets 0.12€
Suaterna207 folds
LilRun raises 0.21€ to 0.33€
Fried Berg calls 0.21€
*** TURN *** [3s 6h Ts][5d]
Fried Berg checks
LilRun bets 0.28€
Fried Berg calls 0.10€ and is all-in
*** RIVER *** [3s 6h Ts 5d][9s]
*** SHOW DOWN ***
Fried Berg shows [Ah Kd] (High card : Ace)
LilRun shows [Jc Jd] (One pair : Jacks)
LilRun collected 1.09€ from pot
*** SUMMARY ***
Total pot 1.09€ | Rake 0.10€
Board: [3s 6h Ts 5d 9s]
Seat 1: Fried Berg (small blind) showed [Ah Kd] and lost with High card : Ace
Seat 5: LilRun showed [Jc Jd] and won 1.09€ with One pair : Jacks


Winamax Poker - HOLD-UP "Colorado" - HandId: #19116069-655453-1701676651 - Holdem no limit (0.01€/0.02€) - 2023/12/04 07:57:31 UTC
Table: 'Colorado' 6-max (real money) Seat #6 is the button
Seat 1: sheep47 (2.24€)
Seat 2: Fried Berg (0.50€)
Seat 3: Redemption90 (2.31€)
Seat 4: gsxr72220 (1.93€)
Seat 5: jdeepenslip (2.50€)
Seat 6: Suaterna207 (2€)
Hold-up to Pot: total 0.10€
*** ANTE/BLINDS ***
sheep47 posts small blind 0.01€
Fried Berg posts big blind 0.02€
Dealt to Fried Berg [4c Qc]
*** PRE-FLOP *** 
Redemption90 folds
gsxr72220 raises 0.15€ to 0.17€
jdeepenslip folds
Suaterna207 folds
sheep47 folds
Fried Berg folds
gsxr72220 collected 0.30€ from pot
*** SUMMARY ***
Total pot 0.30€ | No rake
Seat 4: gsxr72220 won 0.30€


Winamax Poker - HOLD-UP "Colorado" - HandId: #19116069-655458-1701676657 - Holdem no limit (0.01€/0.02€) - 2023/12/04 07:57:37 UTC
Table: 'Colorado' 6-max (real money) Seat #6 is the button
Seat 1: Hydramist (2.07€)
Seat 2: nonoleboucan (3.16€)
Seat 3: Fried Berg (0.48€)
Seat 4: Saatho. (1.01€)
Seat 5: Matofs (2.05€)
Seat 6: pasquale202a (4.55€)
*** ANTE/BLINDS ***
Hydramist posts small blind 0.01€
nonoleboucan posts big blind 0.02€
Dealt to Fried Berg [Qd 2h]
*** PRE-FLOP *** 
Fried Berg folds
Saatho. folds
Matofs folds
pasquale202a folds
Hydramist calls 0.01€
nonoleboucan checks
*** FLOP *** [9d 8d Tc]
Hydramist checks
nonoleboucan checks
*** TURN *** [9d 8d Tc][4s]
Hydramist checks
nonoleboucan bets 0.03€
Hydramist folds
nonoleboucan collected 0.07€ from pot
*** SUMMARY ***
Total pot 0.07€ | No rake
Board: [9d 8d Tc 4s]
Seat 2: nonoleboucan (big blind) won 0.07€


Winamax Poker - HOLD-UP "Colorado" - HandId: #19116069-655461-1701676663 - Holdem no limit (0.01€/0.02€) - 2023/12/04 07:57:43 UTC
Table: 'Colorado' 6-max (real money) Seat #6 is the button
Seat 1: Phil_TezAsS_ (3.04€)
Seat 2: jdeepenslip (2€)
Seat 3: Clemence75 (2.02€)
Seat 4: hello7585 (2.42€)
Seat 5: Fried Berg (0.48€)
Seat 6: Suaterna207 (2€)
*** ANTE/BLINDS ***
Phil_TezAsS_ posts small blind 0.01€
jdeepenslip posts big blind 0.02€
Dealt to Fried Berg [Ts Js]
*** PRE-FLOP *** 
Clemence75 folds
hello7585 folds
Fried Berg raises 0.02€ to 0.04€
Suaterna207 folds
Phil_TezAsS_ folds
jdeepenslip folds
Fried Berg collected 0.07€ from pot
*** SUMMARY ***
Total pot 0.07€ | No rake
Seat 5: Fried Berg won 0.07€


Winamax Poker - HOLD-UP "Colorado" - HandId: #19116069-655478-1701676685 - Holdem no limit (0.01€/0.02€) - 2023/12/04 07:58:05 UTC
Table: 'Colorado' 6-max (real money) Seat #6 is the button
Seat 1: Suaterna207 (2.09€)
Seat 2: St. Germain (2.09€)
Seat 3: L INCONNU (0.89€)
Seat 4: Fried Berg (0.51€)
Seat 5: In_The_Mood (2€)
Seat 6: Matofs (2.20€)
*** ANTE/BLINDS ***
Suaterna207 posts small blind 0.01€
St. Germain posts big blind 0.02€
Dealt to Fried Berg [4h Ks]
*** PRE-FLOP *** 
L INCONNU calls 0.02€
Fried Berg folds
In_The_Mood folds
Matofs folds
Suaterna207 calls 0.01€
St. Germain checks
*** FLOP *** [Qd 4d 5s]
Suaterna207 checks
St. Germain checks
L INCONNU checks
*** TURN *** [Qd 4d 5s][6h]
Suaterna207 checks
St. Germain bets 0.04€
L INCONNU folds
Suaterna207 folds
St. Germain collected 0.09€ from pot
*** SUMMARY ***
Total pot 0.09€ | Rake 0.01€
Board: [Qd 4d 5s 6h]
Seat 2: St. Germain (big blind) won 0.09€


Winamax Poker - HOLD-UP "Colorado" - HandId: #19116069-655483-1701676694 - Holdem no limit (0.01€/0.02€) - 2023/12/04 07:58:14 UTC
Table: 'Colorado' 6-max (real money) Seat #6 is the button
Seat 1: Matofs (2€)
Seat 2: Sebidu57 (4.46€)
Seat 3: Saatho. (0.98€)
Seat 4: EpxGrds (2.35€)
Seat 5: A1pha_B1oCkk (0.37€)
Seat 6: Fried Berg (0.51€)
*** ANTE/BLINDS ***
Matofs posts small blind 0.01€
Sebidu57 posts big blind 0.02€
Dealt to Fried Berg [Ks 4h]
*** PRE-FLOP *** 
Saatho. raises 0.04€ to 0.06€
EpxGrds folds
A1pha_B1oCkk folds
Fried Berg folds
Matofs folds
Sebidu57 calls 0.04€
*** FLOP *** [Qs 5s 2s]
Sebidu57 bets 0.05€
Saatho. calls 0.05€
*** TURN *** [Qs 5s 2s][Jh]
Sebidu57 bets 0.08€
Saatho. calls 0.08€
*** RIVER *** [Qs 5s 2s Jh][5c]
Sebidu57 bets 0.02€
Saatho. raises 0.21€ to 0.23€
Sebidu57 calls 0.21€
*** SHOW DOWN ***
Sebidu57 shows [Qc 8h] (Two pairs : Queens and 5)
Saatho. shows [Jc Qd] (Two pairs : Queens and Jacks)
Saatho. collected 0.76€ from pot
*** SUMMARY ***
Total pot 0.76€ | Rake 0.09€
Board: [Qs 5s 2s Jh 5c]
Seat 2: Sebidu57 (big blind) showed [Qc 8h] and lost with Two pairs : Queens and 5
Seat 3: Saatho. showed [Jc Qd] and won 0.76€ with Two pairs : Queens and Jacks


Winamax Poker - HOLD-UP "Colorado" - HandId: #19116069-655486-1701676700 - Holdem no limit (0.01€/0.02€) - 2023/12/04 07:58:20 UTC
Table: 'Colorado' 6-max (real money) Seat #6 is the button
Seat 1: EpxGrds (2.35€)
Seat 2: Redemption90 (2€)
Seat 3: Clemence75 (3.85€)
Seat 4: A1pha_B1oCkk (0.37€)
Seat 5: hello7585 (2.25€)
Seat 6: Fried Berg (0.51€)
*** ANTE/BLINDS ***
EpxGrds posts small blind 0.01€
Redemption90 posts big blind 0.02€
Dealt to Fried Berg [9s Td]
*** PRE-FLOP *** 
Clemence75 folds
A1pha_B1oCkk folds
hello7585 folds
Fried Berg folds
EpxGrds folds
Redemption90 collected 0.03€ from pot
*** SUMMARY ***
Total pot 0.03€ | No rake
Seat 2: Redemption90 (big blind) won 0.03€


Winamax Poker - HOLD-UP "Colorado" - HandId: #19116069-655492-1701676707 - Holdem no limit (0.01€/0.02€) - 2023/12/04 07:58:27 UTC
Table: 'Colorado' 6-max (real money) Seat #6 is the button
Seat 1: Fried Berg (0.51€)
Seat 2: vicieux59 (0.50€)
Seat 3: jdeepenslip (3.24€)
Seat 4: 18GranDDuC18 (3.24€)
Seat 5: Clemence75 (2.40€)
Seat 6: Hydramist (2.05€)
Hold-up to Pot: total 0.10€
*** ANTE/BLINDS ***
Fried Berg posts small blind 0.01€
vicieux59 posts big blind 0.02€
Dealt to Fried Berg [4c Js]
*** PRE-FLOP *** 
jdeepenslip folds
18GranDDuC18 folds
Clemence75 folds
Hydramist raises 0.08€ to 0.10€
Fried Berg folds
vicieux59 folds
Hydramist collected 0.23€ from pot
*** SUMMARY ***
Total pot 0.23€ | No rake
Seat 6: Hydramist (button) won 0.23€


Winamax Poker - HOLD-UP "Colorado" - HandId: #19116069-655496-1701676713 - Holdem no limit (0.01€/0.02€) - 2023/12/04 07:58:33 UTC
Table: 'Colorado' 6-max (real money) Seat #6 is the button
Seat 1: hello7585 (3.82€)
Seat 2: Zz8crackS (0.52€)
Seat 3: Fried Berg (0.50€)
Seat 4: jdeepenslip (3.24€)
Seat 5: Matofs (2€)
Seat 6: Piexxxe10 (2.47€)
*** ANTE/BLINDS ***
hello7585 posts small blind 0.01€
Zz8crackS posts big blind 0.02€
Dealt to Fried Berg [Td 6d]
*** PRE-FLOP *** 
Fried Berg folds
jdeepenslip folds
Matofs folds
Piexxxe10 folds
hello7585 folds
Zz8crackS collected 0.03€ from pot
*** SUMMARY ***
Total pot 0.03€ | No rake
Seat 2: Zz8crackS (big blind) won 0.03€


Winamax Poker - HOLD-UP "Colorado" - HandId: #19116069-655502-1701676719 - Holdem no limit (0.01€/0.02€) - 2023/12/04 07:58:39 UTC
Table: 'Colorado' 6-max (real money) Seat #6 is the button
Seat 1: pasquale202a (1.98€)
Seat 2: Fried Berg (0.50€)
Seat 3: On100Fish (3.74€)
Seat 4: jdeepenslip (3.24€)
Seat 5: Mali 1969 (0.59€)
Seat 6: Ga31k (2.57€)
*** ANTE/BLINDS ***
pasquale202a posts small blind 0.01€
Fried Berg posts big blind 0.02€
Dealt to Fried Berg [Td 4s]
*** PRE-FLOP *** 
On100Fish folds
jdeepenslip folds
Mali 1969 folds
Ga31k folds
pasquale202a folds
Fried Berg collected 0.03€ from pot
*** SUMMARY ***
Total pot 0.03€ | No rake
Seat 2: Fried Berg (big blind) won 0.03€


Winamax Poker - HOLD-UP "Colorado" - HandId: #19116069-655513-1701676734 - Holdem no limit (0.01€/0.02€) - 2023/12/04 07:58:54 UTC
Table: 'Colorado' 6-max (real money) Seat #6 is the button
Seat 1: Matofs (2.18€)
Seat 2: hello7585 (3.81€)
Seat 3: In_The_Mood (2€)
Seat 4: vicieux59 (0.47€)
Seat 5: Fried Berg (0.51€)
Seat 6: EpxGrds (2.32€)
*** ANTE/BLINDS ***
Matofs posts small blind 0.01€
hello7585 posts big blind 0.02€
Dealt to Fried Berg [2h 4h]
*** PRE-FLOP *** 
In_The_Mood folds
vicieux59 folds
Fried Berg folds
EpxGrds folds
Matofs raises 0.03€ to 0.05€
hello7585 folds
Matofs collected 0.07€ from pot
*** SUMMARY ***
Total pot 0.07€ | No rake
Seat 1: Matofs (small blind) won 0.07€


Winamax Poker - HOLD-UP "Colorado" - HandId: #19116069-655516-1701676737 - Holdem no limit (0.01€/0.02€) - 2023/12/04 07:58:57 UTC
Table: 'Colorado' 6-max (real money) Seat #6 is the button
Seat 1: Ga31k (2€)
Seat 2: On100Fish (2.51€)
Seat 3: Hydramist (2€)
Seat 4: In_The_Mood (2€)
Seat 5: Cantinooo (0.97€)
Seat 6: Fried Berg (0.51€)
*** ANTE/BLINDS ***
Ga31k posts small blind 0.01€
On100Fish posts big blind 0.02€
Dealt to Fried Berg [9d Js]
*** PRE-FLOP *** 
Hydramist folds
In_The_Mood raises 0.04€ to 0.06€
Cantinooo calls 0.06€
Fried Berg folds
Ga31k raises 0.24€ to 0.30€
On100Fish folds
In_The_Mood calls 0.24€
Cantinooo folds
*** FLOP *** [Kh 4s 3c]
Ga31k bets 0.22€
In_The_Mood folds
Ga31k collected 0.83€ from pot
*** SUMMARY ***
Total pot 0.83€ | Rake 0.07€
Board: [Kh 4s 3c]
Seat 1: Ga31k (small blind) won 0.83€


Winamax Poker - HOLD-UP "Colorado" - HandId: #19116069-655519-1701676741 - Holdem no limit (0.01€/0.02€) - 2023/12/04 07:59:01 UTC
Table: 'Colorado' 6-max (real money) Seat #6 is the button
Seat 1: St. Germain (2.12€)
Seat 2: Hydramist (2€)
Seat 3: Fried Berg (0.51€)
Seat 4: Saatho. (1.35€)
Seat 5: Mayl2019 (1.44€)
Seat 6: vicieux59 (0.47€)
*** ANTE/BLINDS ***
St. Germain posts small blind 0.01€
Hydramist posts big blind 0.02€
Dealt to Fried Berg [Jd 5h]
*** PRE-FLOP *** 
Fried Berg folds
Saatho. folds
Mayl2019 folds
vicieux59 raises 0.05€ to 0.07€
St. Germain calls 0.06€
Hydramist folds
*** FLOP *** [Ad 2s 4s]
St. Germain checks
vicieux59 bets 0.16€
St. Germain folds
vicieux59 collected 0.30€ from pot
*** SUMMARY ***
Total pot 0.30€ | Rake 0.02€
Board: [Ad 2s 4s]
Seat 6: vicieux59 (button) won 0.30€


Winamax Poker - HOLD-UP "Colorado" - HandId: #19116069-655524-1701676748 - Holdem no limit (0.01€/0.02€) - 2023/12/04 07:59:08 UTC
Table: 'Colorado' 6-max (real money) Seat #6 is the button
Seat 1: hello7585 (3.79€)
Seat 2: nda94 (0.50€)
Seat 3: 18GranDDuC18 (3.23€)
Seat 4: Fried Berg (0.51€)
Seat 5: Saatho. (1.35€)
Seat 6: On100Fish (2€)
*** ANTE/BLINDS ***
hello7585 posts small blind 0.01€
nda94 posts big blind 0.02€
Dealt to Fried Berg [8h 8d]
*** PRE-FLOP *** 
18GranDDuC18 folds
Fried Berg raises 0.02€ to 0.04€
Saatho. folds
On100Fish calls 0.04€
hello7585 calls 0.03€
nda94 calls 0.02€
*** FLOP *** [7h 3s 2d]
hello7585 checks
nda94 checks
Fried Berg bets 0.12€
On100Fish folds
hello7585 folds
nda94 folds
Fried Berg collected 0.26€ from pot
*** SUMMARY ***
Total pot 0.26€ | Rake 0.02€
Board: [7h 3s 2d]
Seat 4: Fried Berg won 0.26€


Winamax Poker - HOLD-UP "Colorado" - HandId: #19116069-655553-1701676788 - Holdem no limit (0.01€/0.02€) - 2023/12/04 07:59:48 UTC
Table: 'Colorado' 6-max (real money) Seat #6 is the button
Seat 1: Ga31k (2.53€)
Seat 2: Fried Berg (0.61€)
Seat 3: hello7585 (2.47€)
Seat 4: EpxGrds (2.31€)
Seat 5: Hydramist (2.25€)
Seat 6: Redemption90 (2.39€)
*** ANTE/BLINDS ***
Ga31k posts small blind 0.01€
Fried Berg posts big blind 0.02€
Dealt to Fried Berg [3d Kd]
*** PRE-FLOP *** 
hello7585 folds
EpxGrds folds
Hydramist folds
Redemption90 folds
Ga31k raises 0.04€ to 0.06€
Fried Berg folds
Ga31k collected 0.08€ from pot
*** SUMMARY ***
Total pot 0.08€ | No rake
Seat 1: Ga31k (small blind) won 0.08€


Winamax Poker - HOLD-UP "Colorado" - HandId: #19116069-655613-1701676890 - Holdem no limit (0.01€/0.02€) - 2023/12/04 08:01:30 UTC
Table: 'Colorado' 6-max (real money) Seat #6 is the button
Seat 1: Fried Berg (0.59€)
Seat 2: L INCONNU (0.47€)
Seat 3: Killim (0.81€)
Seat 4: On100Fish (3.65€)
Seat 5: pasquale202a (1.86€)
Seat 6: St. Germain (2.88€)
*** ANTE/BLINDS ***
Fried Berg posts small blind 0.01€
L INCONNU posts big blind 0.02€
Dealt to Fried Berg [4s Jc]
*** PRE-FLOP *** 
Killim folds
On100Fish folds
pasquale202a folds
St. Germain raises 0.03€ to 0.05€
Fried Berg folds
L INCONNU folds
St. Germain collected 0.08€ from pot
*** SUMMARY ***
Total pot 0.08€ | No rake
Seat 6: St. Germain (button) won 0.08€


Winamax Poker - HOLD-UP "Colorado" - HandId: #19116069-655617-1701676894 - Holdem no limit (0.01€/0.02€) - 2023/12/04 08:01:34 UTC
Table: 'Colorado' 6-max (real money) Seat #6 is the button
Seat 1: vicieux59 (0.53€)
Seat 2: Killim (0.81€)
Seat 3: Fried Berg (0.58€)
Seat 4: Clemence75 (2.40€)
Seat 5: hello7585 (3.76€)
Seat 6: Redemption90 (4.66€)
*** ANTE/BLINDS ***
vicieux59 posts small blind 0.01€
Killim posts big blind 0.02€
Dealt to Fried Berg [9d 3s]
*** PRE-FLOP *** 
Fried Berg folds
Clemence75 folds
hello7585 folds
Redemption90 folds
vicieux59 folds
Killim collected 0.03€ from pot
*** SUMMARY ***
Total pot 0.03€ | No rake
Seat 2: Killim (big blind) won 0.03€


Winamax Poker - HOLD-UP "Colorado" - HandId: #19116069-655620-1701676898 - Holdem no limit (0.01€/0.02€) - 2023/12/04 08:01:38 UTC
Table: 'Colorado' 6-max (real money) Seat #6 is the button
Seat 1: pie38_x (6.05€)
Seat 2: nda94 (0.34€)
Seat 3: 48centaure (1.38€)
Seat 4: Fried Berg (0.58€)
Seat 5: vicieux59 (0.52€)
Seat 6: Ga31k (2.55€)
*** ANTE/BLINDS ***
pie38_x posts small blind 0.01€
nda94 posts big blind 0.02€
Dealt to Fried Berg [Kd 6d]
*** PRE-FLOP *** 
48centaure raises 0.04€ to 0.06€
Fried Berg folds
vicieux59 folds
Ga31k folds
pie38_x folds
nda94 calls 0.04€
*** FLOP *** [Jh 9c 3h]
nda94 checks
48centaure bets 0.13€
nda94 folds
48centaure collected 0.25€ from pot
*** SUMMARY ***
Total pot 0.25€ | Rake 0.01€
Board: [Jh 9c 3h]
Seat 3: 48centaure won 0.25€


Winamax Poker - HOLD-UP "Colorado" - HandId: #19116069-655624-1701676907 - Holdem no limit (0.01€/0.02€) - 2023/12/04 08:01:47 UTC
Table: 'Colorado' 6-max (real money) Seat #6 is the button
Seat 1: Hydramist (2.07€)
Seat 2: pasquale202a (1.60€)
Seat 3: pie38_x (6.02€)
Seat 4: Sebidu57 (3.98€)
Seat 5: Fried Berg (0.58€)
Seat 6: Justo_170382 (0.77€)
*** ANTE/BLINDS ***
Hydramist posts small blind 0.01€
pasquale202a posts big blind 0.02€
Dealt to Fried Berg [5h Qd]
*** PRE-FLOP *** 
pie38_x folds
Sebidu57 folds
Fried Berg folds
Justo_170382 folds
Hydramist folds
pasquale202a collected 0.03€ from pot
*** SUMMARY ***
Total pot 0.03€ | No rake
Seat 2: pasquale202a (big blind) won 0.03€


Winamax Poker - HOLD-UP "Colorado" - HandId: #19116069-655625-1701676909 - Holdem no limit (0.01€/0.02€) - 2023/12/04 08:01:49 UTC
Table: 'Colorado' 6-max (real money) Seat #6 is the button
Seat 1: Fried Berg (0.58€)
Seat 2: jdeepenslip (2.91€)
Seat 3: nonoleboucan (2.27€)
Seat 4: Ga31k (2.55€)
Seat 5: pie38_x (6.02€)
Seat 6: Justo_170382 (0.77€)
*** ANTE/BLINDS ***
Fried Berg posts small blind 0.01€
jdeepenslip posts big blind 0.02€
Dealt to Fried Berg [Kh 9h]
*** PRE-FLOP *** 
nonoleboucan folds
Ga31k folds
pie38_x folds
Justo_170382 folds
Fried Berg raises 0.02€ to 0.04€
jdeepenslip calls 0.02€
*** FLOP *** [Kd 2c 7c]
Fried Berg bets 0.08€
jdeepenslip folds
Fried Berg collected 0.15€ from pot
*** SUMMARY ***
Total pot 0.15€ | Rake 0.01€
Board: [Kd 2c 7c]
Seat 1: Fried Berg (small blind) won 0.15€


Winamax Poker - HOLD-UP "Colorado" - HandId: #19116069-655645-1701676933 - Holdem no limit (0.01€/0.02€) - 2023/12/04 08:02:13 UTC
Table: 'Colorado' 6-max (real money) Seat #6 is the button
Seat 1: On100Fish (2.42€)
Seat 2: Clemence75 (2.40€)
Seat 3: Hydramist (2.04€)
Seat 4: Fried Berg (0.61€)
Seat 5: Redemption90 (2.22€)
Seat 6: VR_King14 (0.89€)
*** ANTE/BLINDS ***
On100Fish posts small blind 0.01€
Clemence75 posts big blind 0.02€
Dealt to Fried Berg [Qd 3d]
*** PRE-FLOP *** 
Hydramist folds
Fried Berg folds
Redemption90 raises 0.03€ to 0.05€
VR_King14 folds
On100Fish calls 0.04€
Clemence75 folds
*** FLOP *** [8c 5s Kc]
On100Fish checks
Redemption90 bets 0.04€
On100Fish calls 0.04€
*** TURN *** [8c 5s Kc][4c]
On100Fish checks
Redemption90 bets 0.13€
On100Fish folds
Redemption90 collected 0.31€ from pot
*** SUMMARY ***
Total pot 0.31€ | Rake 0.02€
Board: [8c 5s Kc 4c]
Seat 5: Redemption90 won 0.31€


Winamax Poker - HOLD-UP "Colorado" - HandId: #19116069-655653-1701676941 - Holdem no limit (0.01€/0.02€) - 2023/12/04 08:02:21 UTC
Table: 'Colorado' 6-max (real money) Seat #6 is the button
Seat 1: VR_King14 (0.89€)
Seat 2: Fried Berg (0.61€)
Seat 3: Piexxxe10 (3.15€)
Seat 4: pasquale202a (1.60€)
Seat 5: Killim (0.87€)
Seat 6: DigBick99 (2€)
*** ANTE/BLINDS ***
VR_King14 posts small blind 0.01€
Fried Berg posts big blind 0.02€
Dealt to Fried Berg [Kc Th]
*** PRE-FLOP *** 
Piexxxe10 raises 0.03€ to 0.05€
pasquale202a calls 0.05€
Killim folds
DigBick99 raises 0.18€ to 0.23€
VR_King14 folds
Fried Berg folds
Piexxxe10 folds
pasquale202a calls 0.18€
*** FLOP *** [6h Jd 6s]
pasquale202a checks
DigBick99 bets 0.18€
pasquale202a calls 0.18€
*** TURN *** [6h Jd 6s][4c]
pasquale202a checks
DigBick99 bets 0.30€
pasquale202a folds
DigBick99 collected 1.11€ from pot
*** SUMMARY ***
Total pot 1.11€ | Rake 0.09€
Board: [6h Jd 6s 4c]
Seat 6: DigBick99 (button) won 1.11€


Winamax Poker - HOLD-UP "Colorado" - HandId: #19116069-655667-1701676965 - Holdem no limit (0.01€/0.02€) - 2023/12/04 08:02:45 UTC
Table: 'Colorado' 6-max (real money) Seat #6 is the button
Seat 1: Hydramist (2€)
Seat 2: Sebidu57 (3.88€)
Seat 3: 48centaure (1.53€)
Seat 4: Mali 1969 (0.31€)
Seat 5: Fried Berg (0.59€)
Seat 6: caarloosgb (1.83€)
*** ANTE/BLINDS ***
Hydramist posts small blind 0.01€
Sebidu57 posts big blind 0.02€
Dealt to Fried Berg [2c 7h]
*** PRE-FLOP *** 
48centaure raises 0.05€ to 0.07€
Mali 1969 folds
Fried Berg folds
caarloosgb calls 0.07€
Hydramist folds
Sebidu57 folds
*** FLOP *** [7d Js Qc]
48centaure bets 0.17€
caarloosgb folds
48centaure collected 0.32€ from pot
*** SUMMARY ***
Total pot 0.32€ | Rake 0.02€
Board: [7d Js Qc]
Seat 3: 48centaure won 0.32€


Winamax Poker - HOLD-UP "Colorado" - HandId: #19116069-655672-1701676972 - Holdem no limit (0.01€/0.02€) - 2023/12/04 08:02:52 UTC
Table: 'Colorado' 6-max (real money) Seat #6 is the button
Seat 1: Saatho. (0.75€)
Seat 2: jdeepenslip (2.33€)
Seat 3: Piexxxe10 (3.10€)
Seat 4: Matofs (2.35€)
Seat 5: Ga31k (2.46€)
Seat 6: Fried Berg (0.59€)
*** ANTE/BLINDS ***
Saatho. posts small blind 0.01€
jdeepenslip posts big blind 0.02€
Dealt to Fried Berg [9c 7h]
*** PRE-FLOP *** 
Piexxxe10 folds
Matofs folds
Ga31k folds
Fried Berg folds
Saatho. folds
jdeepenslip collected 0.03€ from pot
*** SUMMARY ***
Total pot 0.03€ | No rake
Seat 2: jdeepenslip (big blind) won 0.03€


Winamax Poker - HOLD-UP "Colorado" - HandId: #19116069-655675-1701676977 - Holdem no limit (0.01€/0.02€) - 2023/12/04 08:02:57 UTC
Table: 'Colorado' 6-max (real money) Seat #6 is the button
Seat 1: Clemence75 (2.38€)
Seat 2: Hydramist (2€)
Seat 3: sheep47 (1.95€)
Seat 4: St. Germain (2.98€)
Seat 5: Fried Berg (0.59€)
Seat 6: Matofs (2.35€)
*** ANTE/BLINDS ***
Clemence75 posts small blind 0.01€
Hydramist posts big blind 0.02€
Dealt to Fried Berg [Qd 2d]
*** PRE-FLOP *** 
sheep47 calls 0.02€
St. Germain folds
Fried Berg folds
Matofs calls 0.02€
Clemence75 folds
Hydramist checks
*** FLOP *** [7d 7c 3c]
Hydramist bets 0.04€
sheep47 folds
Matofs folds
Hydramist collected 0.10€ from pot
*** SUMMARY ***
Total pot 0.10€ | Rake 0.01€
Board: [7d 7c 3c]
Seat 2: Hydramist (big blind) won 0.10€


Winamax Poker - HOLD-UP "Colorado" - HandId: #19116069-655679-1701676982 - Holdem no limit (0.01€/0.02€) - 2023/12/04 08:03:02 UTC
Table: 'Colorado' 6-max (real money) Seat #6 is the button
Seat 1: Fried Berg (0.59€)
Seat 2: Clemence75 (2.37€)
Seat 3: In_The_Mood (2€)
Seat 4: hello7585 (3.71€)
Seat 5: pie38_x (6.27€)
Seat 6: St. Germain (2.98€)
*** ANTE/BLINDS ***
Fried Berg posts small blind 0.01€
Clemence75 posts big blind 0.02€
Dealt to Fried Berg [5d Kh]
*** PRE-FLOP *** 
In_The_Mood raises 0.04€ to 0.06€
hello7585 folds
pie38_x folds
St. Germain folds
Fried Berg folds
Clemence75 folds
In_The_Mood collected 0.09€ from pot
*** SUMMARY ***
Total pot 0.09€ | No rake
Seat 3: In_The_Mood won 0.09€


Winamax Poker - HOLD-UP "Colorado" - HandId: #19116069-655682-1701676986 - Holdem no limit (0.01€/0.02€) - 2023/12/04 08:03:06 UTC
Table: 'Colorado' 6-max (real money) Seat #6 is the button
Seat 1: Ga31k (2.46€)
Seat 2: Fried Berg (0.58€)
Seat 3: VR_King14 (0.93€)
Seat 4: jdeepenslip (3.19€)
Seat 5: hello7585 (2.70€)
Seat 6: nonoleboucan (2.35€)
*** ANTE/BLINDS ***
Ga31k posts small blind 0.01€
Fried Berg posts big blind 0.02€
Dealt to Fried Berg [9d Tc]
*** PRE-FLOP *** 
VR_King14 folds
jdeepenslip folds
hello7585 folds
nonoleboucan raises 0.03€ to 0.05€
Ga31k folds
Fried Berg folds
nonoleboucan collected 0.08€ from pot
*** SUMMARY ***
Total pot 0.08€ | No rake
Seat 6: nonoleboucan (button) won 0.08€


Winamax Poker - HOLD-UP "Colorado" - HandId: #19116069-655690-1701676998 - Holdem no limit (0.01€/0.02€) - 2023/12/04 08:03:18 UTC
Table: 'Colorado' 6-max (real money) Seat #6 is the button
Seat 1: TimToBey (2.48€)
Seat 2: hello7585 (2.70€)
Seat 3: Fried Berg (0.56€)
Seat 4: On100Fish (2.33€)
Seat 5: jdeepenslip (2.94€)
Seat 6: St. Germain (2.14€)
*** ANTE/BLINDS ***
TimToBey posts small blind 0.01€
hello7585 posts big blind 0.02€
Dealt to Fried Berg [7c 8s]
*** PRE-FLOP *** 
Fried Berg folds
On100Fish folds
jdeepenslip folds
St. Germain raises 0.03€ to 0.05€
TimToBey folds
hello7585 folds
St. Germain collected 0.08€ from pot
*** SUMMARY ***
Total pot 0.08€ | No rake
Seat 6: St. Germain (button) won 0.08€


Winamax Poker - HOLD-UP "Colorado" - HandId: #19116069-655694-1701677001 - Holdem no limit (0.01€/0.02€) - 2023/12/04 08:03:21 UTC
Table: 'Colorado' 6-max (real money) Seat #6 is the button
Seat 1: Matofs (2€)
Seat 2: Ga31k (2.45€)
Seat 3: VR_King14 (0.93€)
Seat 4: Fried Berg (0.56€)
Seat 5: Lovemyboot (0.58€)
Seat 6: Clemence75 (2.03€)
*** ANTE/BLINDS ***
Matofs posts small blind 0.01€
Ga31k posts big blind 0.02€
Dealt to Fried Berg [4h Qs]
*** PRE-FLOP *** 
VR_King14 folds
Fried Berg folds
Lovemyboot folds
Clemence75 raises 0.04€ to 0.06€
Matofs folds
Ga31k folds
Clemence75 collected 0.09€ from pot
*** SUMMARY ***
Total pot 0.09€ | No rake
Seat 6: Clemence75 (button) won 0.09€


Winamax Poker - HOLD-UP "Colorado" - HandId: #19116069-655698-1701677006 - Holdem no limit (0.01€/0.02€) - 2023/12/04 08:03:26 UTC
Table: 'Colorado' 6-max (real money) Seat #6 is the button
Seat 1: VR_King14 (0.93€)
Seat 2: On100Fish (2.33€)
Seat 3: Halmosthard (1.97€)
Seat 4: Redemption90 (2.31€)
Seat 5: Justo_170382 (0.84€)
Seat 6: Fried Berg (0.56€)
Hold-up to Pot: total 0.20€
*** ANTE/BLINDS ***
VR_King14 posts small blind 0.01€
On100Fish posts big blind 0.02€
Dealt to Fried Berg [As 7h]
*** PRE-FLOP *** 
Halmosthard folds
Redemption90 folds
Justo_170382 raises 0.04€ to 0.06€
Fried Berg raises 0.50€ to 0.56€ and is all-in
VR_King14 folds
On100Fish folds
Justo_170382 folds
Fried Berg collected 0.85€ from pot
*** SUMMARY ***
Total pot 0.85€ | No rake
Seat 6: Fried Berg (button) won 0.85€


Winamax Poker - HOLD-UP "Colorado" - HandId: #19116069-655727-1701677047 - Holdem no limit (0.01€/0.02€) - 2023/12/04 08:04:07 UTC
Table: 'Colorado' 6-max (real money) Seat #6 is the button
Seat 1: Fried Berg (0.85€)
Seat 2: Matofs (2.56€)
Seat 3: stevebalboni (1.97€)
Seat 4: pasquale202a (1.01€)
Seat 5: Redemption90 (4.96€)
Seat 6: Clemence75 (2€)
*** ANTE/BLINDS ***
Fried Berg posts small blind 0.01€
Matofs posts big blind 0.02€
Dealt to Fried Berg [4s 5c]
*** PRE-FLOP *** 
stevebalboni folds
pasquale202a folds
Redemption90 folds
Clemence75 raises 0.04€ to 0.06€
Fried Berg folds
Matofs raises 0.13€ to 0.19€
Clemence75 folds
Matofs collected 0.26€ from pot
*** SUMMARY ***
Total pot 0.26€ | No rake
Seat 2: Matofs (big blind) won 0.26€


Winamax Poker - HOLD-UP "Colorado" - HandId: #19116069-655736-1701677058 - Holdem no limit (0.01€/0.02€) - 2023/12/04 08:04:18 UTC
Table: 'Colorado' 6-max (real money) Seat #6 is the button
Seat 1: fabrice8551 (1.65€)
Seat 2: Fried Berg (0.84€)
Seat 3: pasquale202a (1.01€)
Seat 4: LilRun (1.97€)
Seat 5: stevebalboni (1.97€)
Seat 6: Sebidu57 (4.02€)
*** ANTE/BLINDS ***
fabrice8551 posts small blind 0.01€
Fried Berg posts big blind 0.02€
Dealt to Fried Berg [Td 2s]
*** PRE-FLOP *** 
pasquale202a folds
LilRun folds
stevebalboni folds
Sebidu57 folds
fabrice8551 raises 0.04€ to 0.06€
Fried Berg folds
fabrice8551 collected 0.08€ from pot
*** SUMMARY ***
Total pot 0.08€ | No rake
Seat 1: fabrice8551 (small blind) won 0.08€


Winamax Poker - HOLD-UP "Colorado" - HandId: #19116069-655747-1701677073 - Holdem no limit (0.01€/0.02€) - 2023/12/04 08:04:33 UTC
Table: 'Colorado' 6-max (real money) Seat #6 is the button
Seat 1: LilRun (1.97€)
Seat 2: Stephane0497 (1.72€)
Seat 3: Fried Berg (0.82€)
Seat 4: Piexxxe10 (2.66€)
Seat 5: Hydramist (2.03€)
Seat 6: vicieux59 (1.01€)
*** ANTE/BLINDS ***
LilRun posts small blind 0.01€
Stephane0497 posts big blind 0.02€
Dealt to Fried Berg [3h Ks]
*** PRE-FLOP *** 
Fried Berg folds
Piexxxe10 folds
Hydramist folds
vicieux59 folds
LilRun folds
Stephane0497 collected 0.03€ from pot
*** SUMMARY ***
Total pot 0.03€ | No rake
Seat 2: Stephane0497 (big blind) won 0.03€


Winamax Poker - HOLD-UP "Colorado" - HandId: #19116069-655749-1701677075 - Holdem no limit (0.01€/0.02€) - 2023/12/04 08:04:35 UTC
Table: 'Colorado' 6-max (real money) Seat #6 is the button
Seat 1: nonoleboucan (2.33€)
Seat 2: LilRun (1.96€)
Seat 3: tout- DTC (1.97€)
Seat 4: Fried Berg (0.82€)
Seat 5: hello7585 (3.76€)
Seat 6: vicieux59 (1.01€)
*** ANTE/BLINDS ***
nonoleboucan posts small blind 0.01€
LilRun posts big blind 0.02€
Dealt to Fried Berg [Js 3c]
*** PRE-FLOP *** 
tout- DTC calls 0.02€
Fried Berg folds
hello7585 folds
vicieux59 folds
nonoleboucan folds
LilRun checks
*** FLOP *** [Kh 8h Kc]
LilRun checks
tout- DTC checks
*** TURN *** [Kh 8h Kc][Ad]
LilRun checks
tout- DTC checks
*** RIVER *** [Kh 8h Kc Ad][8s]
LilRun bets 0.02€
tout- DTC calls 0.02€
*** SHOW DOWN ***
tout- DTC shows [As Jd] (Two pairs : Aces and Kings)
LilRun shows [Kd 8d] (Full of Kings and 8)
LilRun collected 0.08€ from pot
*** SUMMARY ***
Total pot 0.08€ | Rake 0.01€
Board: [Kh 8h Kc Ad 8s]
Seat 2: LilRun (big blind) showed [Kd 8d] and won 0.08€ with Full of Kings and 8
Seat 3: tout- DTC showed [As Jd] and lost with Two pairs : Aces and Kings


Winamax Poker - HOLD-UP "Colorado" - HandId: #19116069-655754-1701677080 - Holdem no limit (0.01€/0.02€) - 2023/12/04 08:04:40 UTC
Table: 'Colorado' 6-max (real money) Seat #6 is the button
Seat 1: vicieux59 (1.01€)
Seat 2: TheRealWill (2€)
Seat 3: Hydramist (2.03€)
Seat 4: Clemence75 (2.40€)
Seat 5: DigBick99 (2€)
Seat 6: Fried Berg (0.82€)
*** ANTE/BLINDS ***
vicieux59 posts small blind 0.01€
TheRealWill posts big blind 0.02€
Dealt to Fried Berg [6d Kd]
*** PRE-FLOP *** 
Hydramist folds
Clemence75 folds
DigBick99 folds
Fried Berg raises 0.02€ to 0.04€
vicieux59 folds
TheRealWill folds
Fried Berg collected 0.07€ from pot
*** SUMMARY ***
Total pot 0.07€ | No rake
Seat 6: Fried Berg (button) won 0.07€


Winamax Poker - HOLD-UP "Colorado" - HandId: #19116069-655763-1701677093 - Holdem no limit (0.01€/0.02€) - 2023/12/04 08:04:53 UTC
Table: 'Colorado' 6-max (real money) Seat #6 is the button
Seat 1: Redemption90 (2.37€)
Seat 2: St. Germain (3.27€)
Seat 3: On100Fish (3.57€)
Seat 4: jdeepenslip (3.20€)
Seat 5: Fried Berg (0.85€)
Seat 6: Hydramist (2€)
*** ANTE/BLINDS ***
Redemption90 posts small blind 0.01€
St. Germain posts big blind 0.02€
Dealt to Fried Berg [Td 5s]
*** PRE-FLOP *** 
On100Fish folds
jdeepenslip folds
Fried Berg folds
Hydramist raises 0.03€ to 0.05€
Redemption90 folds
St. Germain folds
Hydramist collected 0.08€ from pot
*** SUMMARY ***
Total pot 0.08€ | No rake
Seat 6: Hydramist (button) won 0.08€


Winamax Poker - HOLD-UP "Colorado" - HandId: #19116069-655769-1701677099 - Holdem no limit (0.01€/0.02€) - 2023/12/04 08:04:59 UTC
Table: 'Colorado' 6-max (real money) Seat #6 is the button
Seat 1: Clemence75 (2€)
Seat 2: Fried Berg (0.85€)
Seat 3: hello7585 (3.76€)
Seat 4: TheRealWill (2€)
Seat 5: On100Fish (3.57€)
Seat 6: pasquale202a (1.07€)
*** ANTE/BLINDS ***
Clemence75 posts small blind 0.01€
Fried Berg posts big blind 0.02€
Dealt to Fried Berg [8s Ad]
*** PRE-FLOP *** 
hello7585 folds
TheRealWill folds
On100Fish folds
pasquale202a raises 0.03€ to 0.05€
Clemence75 folds
Fried Berg calls 0.03€
*** FLOP *** [9d Td 6h]
Fried Berg checks
pasquale202a checks
*** TURN *** [9d Td 6h][Ah]
Fried Berg checks
pasquale202a checks
*** RIVER *** [9d Td 6h Ah][Qc]
Fried Berg bets 0.06€
pasquale202a folds
Fried Berg collected 0.16€ from pot
*** SUMMARY ***
Total pot 0.16€ | Rake 0.01€
Board: [9d Td 6h Ah Qc]
Seat 2: Fried Berg (big blind) won 0.16€


Winamax Poker - HOLD-UP "Colorado" - HandId: #19116069-655838-1701677181 - Holdem no limit (0.01€/0.02€) - 2023/12/04 08:06:21 UTC
Table: 'Colorado' 6-max (real money) Seat #6 is the button
Seat 1: 48centaure (2.71€)
Seat 2: On100Fish (2.20€)
Seat 3: pasquale202a (1.71€)
Seat 4: liseau5312 (1.40€)
Seat 5: Fried Berg (0.90€)
Seat 6: Redemption90 (4.85€)
*** ANTE/BLINDS ***
48centaure posts small blind 0.01€
On100Fish posts big blind 0.02€
Dealt to Fried Berg [Tc 8d]
*** PRE-FLOP *** 
pasquale202a raises 0.04€ to 0.06€
liseau5312 calls 0.06€
Fried Berg folds
Redemption90 folds
48centaure raises 0.20€ to 0.26€
On100Fish folds
pasquale202a calls 0.20€
liseau5312 calls 0.20€
*** FLOP *** [Kd Ah 5s]
48centaure bets 2.45€ and is all-in
pasquale202a folds
liseau5312 folds
48centaure collected 3.17€ from pot
*** SUMMARY ***
Total pot 3.17€ | Rake 0.08€
Board: [Kd Ah 5s]
Seat 1: 48centaure (small blind) won 3.17€


Winamax Poker - HOLD-UP "Colorado" - HandId: #19116069-655848-1701677194 - Holdem no limit (0.01€/0.02€) - 2023/12/04 08:06:34 UTC
Table: 'Colorado' 6-max (real money) Seat #6 is the button
Seat 1: SashaTDouss (2.13€)
Seat 2: fabrice8551 (2.52€)
Seat 3: Fried Berg (0.90€)
Seat 4: jdeepenslip (2.73€)
Seat 5: TheRealWill (2€)
Seat 6: Le nouche 71 (0.44€)
*** ANTE/BLINDS ***
SashaTDouss posts small blind 0.01€
fabrice8551 posts big blind 0.02€
Dealt to Fried Berg [Qh 4c]
*** PRE-FLOP *** 
Fried Berg folds
jdeepenslip folds
TheRealWill raises 0.04€ to 0.06€
Le nouche 71 folds
SashaTDouss folds
fabrice8551 folds
TheRealWill collected 0.09€ from pot
*** SUMMARY ***
Total pot 0.09€ | No rake
Seat 5: TheRealWill won 0.09€


Winamax Poker - HOLD-UP "Colorado" - HandId: #19116069-655850-1701677199 - Holdem no limit (0.01€/0.02€) - 2023/12/04 08:06:39 UTC
Table: 'Colorado' 6-max (real money) Seat #6 is the button
Seat 1: Fried Berg (0.90€)
Seat 2: Thequeen1205 (1.97€)
Seat 3: Redemption90 (4.85€)
Seat 4: badou29 (2€)
Seat 5: tout- DTC (2.34€)
Seat 6: TimToBey (3.67€)
*** ANTE/BLINDS ***
Fried Berg posts small blind 0.01€
Thequeen1205 posts big blind 0.02€
Dealt to Fried Berg [6s 8s]
*** PRE-FLOP *** 
Redemption90 folds
badou29 raises 0.03€ to 0.05€
tout- DTC folds
TimToBey raises 0.13€ to 0.18€
Fried Berg folds
Thequeen1205 folds
badou29 calls 0.13€
*** FLOP *** [7s Ah 6h]
badou29 checks
TimToBey bets 0.13€
badou29 folds
TimToBey collected 0.48€ from pot
*** SUMMARY ***
Total pot 0.48€ | Rake 0.04€
Board: [7s Ah 6h]
Seat 6: TimToBey (button) won 0.48€


Winamax Poker - HOLD-UP "Colorado" - HandId: #19116069-655869-1701677227 - Holdem no limit (0.01€/0.02€) - 2023/12/04 08:07:07 UTC
Table: 'Colorado' 6-max (real money) Seat #6 is the button
Seat 1: Melielvir (2.01€)
Seat 2: DigBick99 (2€)
Seat 3: Thequeen1205 (2€)
Seat 4: Fried Berg (0.89€)
Seat 5: Clemence75 (2.09€)
Seat 6: fabrice8551 (2.49€)
*** ANTE/BLINDS ***
Melielvir posts small blind 0.01€
DigBick99 posts big blind 0.02€
Dealt to Fried Berg [Ah 6s]
*** PRE-FLOP *** 
Thequeen1205 folds
Fried Berg folds
Clemence75 raises 0.04€ to 0.06€
fabrice8551 folds
Melielvir calls 0.05€
DigBick99 folds
*** FLOP *** [3c Ks Qc]
Melielvir checks
Clemence75 bets 0.05€
Melielvir calls 0.05€
*** TURN *** [3c Ks Qc][9c]
Melielvir checks
Clemence75 bets 0.16€
Melielvir calls 0.16€
*** RIVER *** [3c Ks Qc 9c][9s]
Melielvir checks
Clemence75 checks
*** SHOW DOWN ***
Clemence75 shows [Qd Ac] (Two pairs : Queens and 9)
Melielvir shows [Kc Js] (Two pairs : Kings and 9)
Melielvir collected 0.50€ from pot
*** SUMMARY ***
Total pot 0.50€ | Rake 0.06€
Board: [3c Ks Qc 9c 9s]
Seat 1: Melielvir (small blind) showed [Kc Js] and won 0.50€ with Two pairs : Kings and 9
Seat 5: Clemence75 showed [Qd Ac] and lost with Two pairs : Queens and 9


Winamax Poker - HOLD-UP "Colorado" - HandId: #19116069-655878-1701677241 - Holdem no limit (0.01€/0.02€) - 2023/12/04 08:07:21 UTC
Table: 'Colorado' 6-max (real money) Seat #6 is the button
Seat 1: nonoleboucan (2.01€)
Seat 2: Sebidu57 (3.97€)
Seat 3: mixtep (2€)
Seat 4: Fried Berg (0.89€)
Seat 5: vicieux59 (1.45€)
Seat 6: VR_King14 (1.01€)
*** ANTE/BLINDS ***
nonoleboucan posts small blind 0.01€
Sebidu57 posts big blind 0.02€
Dealt to Fried Berg [6d 8h]
*** PRE-FLOP *** 
mixtep raises 0.04€ to 0.06€
Fried Berg folds
vicieux59 folds
VR_King14 folds
nonoleboucan calls 0.05€
Sebidu57 folds
*** FLOP *** [2d Qs Jh]
nonoleboucan bets 0.09€
mixtep calls 0.09€
*** TURN *** [2d Qs Jh][5h]
nonoleboucan bets 0.21€
mixtep calls 0.21€
*** RIVER *** [2d Qs Jh 5h][6h]
nonoleboucan bets 0.68€
mixtep folds
nonoleboucan collected 1.35€ from pot
*** SUMMARY ***
Total pot 1.35€ | Rake 0.07€
Board: [2d Qs Jh 5h 6h]
Seat 1: nonoleboucan (small blind) won 1.35€


Winamax Poker - HOLD-UP "Colorado" - HandId: #19116069-655882-1701677245 - Holdem no limit (0.01€/0.02€) - 2023/12/04 08:07:25 UTC
Table: 'Colorado' 6-max (real money) Seat #6 is the button
Seat 1: Thequeen1205 (2€)
Seat 2: On100Fish (2€)
Seat 3: jdeepenslip (3.15€)
Seat 4: Sebidu57 (3.95€)
Seat 5: Fried Berg (0.89€)
Seat 6: VR_King14 (1.01€)
*** ANTE/BLINDS ***
Thequeen1205 posts small blind 0.01€
On100Fish posts big blind 0.02€
Dealt to Fried Berg [3s Jh]
*** PRE-FLOP *** 
jdeepenslip raises 0.03€ to 0.05€
Sebidu57 calls 0.05€
Fried Berg folds
VR_King14 calls 0.05€
Thequeen1205 folds
On100Fish folds
*** FLOP *** [Ac Th Jd]
jdeepenslip checks
Sebidu57 checks
VR_King14 bets 0.06€
jdeepenslip folds
Sebidu57 folds
VR_King14 collected 0.22€ from pot
*** SUMMARY ***
Total pot 0.22€ | Rake 0.02€
Board: [Ac Th Jd]
Seat 6: VR_King14 (button) won 0.22€


Winamax Poker - HOLD-UP "Colorado" - HandId: #19116069-655885-1701677253 - Holdem no limit (0.01€/0.02€) - 2023/12/04 08:07:33 UTC
Table: 'Colorado' 6-max (real money) Seat #6 is the button
Seat 1: On100Fish (2€)
Seat 2: loox7 (0.50€)
Seat 3: fabrice8551 (2.49€)
Seat 4: badou29 (2€)
Seat 5: Thequeen1205 (2€)
Seat 6: Fried Berg (0.89€)
*** ANTE/BLINDS ***
On100Fish posts small blind 0.01€
loox7 posts big blind 0.02€
Dealt to Fried Berg [4s 3h]
*** PRE-FLOP *** 
fabrice8551 folds
badou29 folds
Thequeen1205 folds
Fried Berg folds
On100Fish calls 0.01€
loox7 checks
*** FLOP *** [3s 6c As]
On100Fish bets 0.04€
loox7 folds
On100Fish collected 0.08€ from pot
*** SUMMARY ***
Total pot 0.08€ | No rake
Board: [3s 6c As]
Seat 1: On100Fish (small blind) won 0.08€


Winamax Poker - HOLD-UP "Colorado" - HandId: #19116069-655886-1701677255 - Holdem no limit (0.01€/0.02€) - 2023/12/04 08:07:35 UTC
Table: 'Colorado' 6-max (real money) Seat #6 is the button
Seat 1: Fried Berg (0.89€)
Seat 2: NBChasseur52 (2.10€)
Seat 3: Matofs (2.21€)
Seat 4: TimToBey (2.47€)
Seat 5: fabrice8551 (2.49€)
Seat 6: pasquale202a (1.45€)
*** ANTE/BLINDS ***
Fried Berg posts small blind 0.01€
NBChasseur52 posts big blind 0.02€
Dealt to Fried Berg [4c 5h]
*** PRE-FLOP *** 
Matofs folds
TimToBey folds
fabrice8551 folds
pasquale202a raises 0.03€ to 0.05€
Fried Berg folds
NBChasseur52 calls 0.03€
*** FLOP *** [2s 9c Qd]
NBChasseur52 bets 0.11€
pasquale202a folds
NBChasseur52 collected 0.21€ from pot
*** SUMMARY ***
Total pot 0.21€ | Rake 0.01€
Board: [2s 9c Qd]
Seat 2: NBChasseur52 (big blind) won 0.21€


Winamax Poker - HOLD-UP "Colorado" - HandId: #19116069-655889-1701677259 - Holdem no limit (0.01€/0.02€) - 2023/12/04 08:07:39 UTC
Table: 'Colorado' 6-max (real money) Seat #6 is the button
Seat 1: DigBick99 (2€)
Seat 2: Fried Berg (0.88€)
Seat 3: Asticoco934 (1.57€)
Seat 4: Matofs (2.21€)
Seat 5: badou29 (2€)
Seat 6: Thequeen1205 (2€)
*** ANTE/BLINDS ***
DigBick99 posts small blind 0.01€
Fried Berg posts big blind 0.02€
Dealt to Fried Berg [6c Js]
*** PRE-FLOP *** 
Asticoco934 calls 0.02€
Matofs folds
badou29 calls 0.02€
Thequeen1205 folds
DigBick99 calls 0.01€
Fried Berg checks
*** FLOP *** [3c Kc 4s]
DigBick99 checks
Fried Berg checks
Asticoco934 checks
badou29 bets 0.04€
DigBick99 folds
Fried Berg folds
Asticoco934 calls 0.04€
*** TURN *** [3c Kc 4s][As]
Asticoco934 checks
badou29 checks
*** RIVER *** [3c Kc 4s As][Qc]
Asticoco934 checks
badou29 bets 0.08€
Asticoco934 folds
badou29 collected 0.22€ from pot
*** SUMMARY ***
Total pot 0.22€ | Rake 0.02€
Board: [3c Kc 4s As Qc]
Seat 5: badou29 won 0.22€


Winamax Poker - HOLD-UP "Colorado" - HandId: #19116069-655912-1701677288 - Holdem no limit (0.01€/0.02€) - 2023/12/04 08:08:08 UTC
Table: 'Colorado' 6-max (real money) Seat #6 is the button
Seat 1: Matofs (3.08€)
Seat 2: Killim (1.15€)
Seat 3: Fried Berg (0.86€)
Seat 4: TheRealWill (2.06€)
Seat 5: Hydramist (3.12€)
Seat 6: Redemption90 (4.90€)
*** ANTE/BLINDS ***
Matofs posts small blind 0.01€
Killim posts big blind 0.02€
Dealt to Fried Berg [3h Js]
*** PRE-FLOP *** 
Fried Berg folds
TheRealWill folds
Hydramist folds
Redemption90 raises 0.03€ to 0.05€
Matofs calls 0.04€
Killim folds
*** FLOP *** [7s 3s Ah]
Matofs checks
Redemption90 bets 0.08€
Matofs folds
Redemption90 collected 0.19€ from pot
*** SUMMARY ***
Total pot 0.19€ | Rake 0.01€
Board: [7s 3s Ah]
Seat 6: Redemption90 (button) won 0.19€


Winamax Poker - HOLD-UP "Colorado" - HandId: #19116069-655914-1701677290 - Holdem no limit (0.01€/0.02€) - 2023/12/04 08:08:10 UTC
Table: 'Colorado' 6-max (real money) Seat #6 is the button
Seat 1: St. Germain (2.46€)
Seat 2: LoOooOliV13 (0.43€)
Seat 3: pasquale202a (1.40€)
Seat 4: On100Fish (2.01€)
Seat 5: DigBick99 (2.11€)
Seat 6: Fried Berg (0.86€)
*** ANTE/BLINDS ***
St. Germain posts small blind 0.01€
LoOooOliV13 posts big blind 0.02€
Dealt to Fried Berg [7d 4s]
*** PRE-FLOP *** 
pasquale202a raises 0.03€ to 0.05€
On100Fish folds
DigBick99 folds
Fried Berg folds
St. Germain folds
LoOooOliV13 calls 0.03€
*** FLOP *** [9h 9s 6c]
LoOooOliV13 checks
pasquale202a checks
*** TURN *** [9h 9s 6c][Ac]
LoOooOliV13 bets 0.07€
pasquale202a calls 0.07€
*** RIVER *** [9h 9s 6c Ac][Qc]
LoOooOliV13 bets 0.16€
pasquale202a folds
LoOooOliV13 collected 0.38€ from pot
*** SUMMARY ***
Total pot 0.38€ | Rake 0.03€
Board: [9h 9s 6c Ac Qc]
Seat 2: LoOooOliV13 (big blind) won 0.38€


Winamax Poker - HOLD-UP "Colorado" - HandId: #19116069-655916-1701677292 - Holdem no limit (0.01€/0.02€) - 2023/12/04 08:08:12 UTC
Table: 'Colorado' 6-max (real money) Seat #6 is the button
Seat 1: fabrice8551 (2.47€)
Seat 2: -KEMS 14- (0.48€)
Seat 3: Thequeen1205 (2€)
Seat 4: Fried Berg (0.86€)
Seat 5: TheRealWill (2.06€)
Seat 6: VR_King14 (1.09€)
*** ANTE/BLINDS ***
fabrice8551 posts small blind 0.01€
-KEMS 14- posts big blind 0.02€
Dealt to Fried Berg [5d 2d]
*** PRE-FLOP *** 
Thequeen1205 folds
Fried Berg folds
TheRealWill folds
VR_King14 calls 0.02€
fabrice8551 folds
-KEMS 14- checks
*** FLOP *** [8d As Ah]
-KEMS 14- checks
VR_King14 bets 0.03€
-KEMS 14- folds
VR_King14 collected 0.07€ from pot
*** SUMMARY ***
Total pot 0.07€ | Rake 0.01€
Board: [8d As Ah]
Seat 6: VR_King14 (button) won 0.07€


Winamax Poker - HOLD-UP "Colorado" - HandId: #19116069-655918-1701677296 - Holdem no limit (0.01€/0.02€) - 2023/12/04 08:08:16 UTC
Table: 'Colorado' 6-max (real money) Seat #6 is the button
Seat 1: On100Fish (2.97€)
Seat 2: TQMISTL (0.50€)
Seat 3: Fried Berg (0.86€)
Seat 4: Hydramist (3.12€)
Seat 5: jdeepenslip (2.72€)
Seat 6: Thequeen1205 (2€)
*** ANTE/BLINDS ***
On100Fish posts small blind 0.01€
TQMISTL posts big blind 0.02€
Dealt to Fried Berg [Jc Td]
*** PRE-FLOP *** 
Fried Berg folds
Hydramist folds
jdeepenslip folds
Thequeen1205 raises 0.03€ to 0.05€
On100Fish folds
TQMISTL raises 0.03€ to 0.08€
Thequeen1205 calls 0.03€
*** FLOP *** [Jh 8s 2s]
TQMISTL bets 0.06€
Thequeen1205 calls 0.06€
*** TURN *** [Jh 8s 2s][Ah]
TQMISTL bets 0.10€
Thequeen1205 folds
TQMISTL collected 0.36€ from pot
*** SUMMARY ***
Total pot 0.36€ | Rake 0.03€
Board: [Jh 8s 2s Ah]
Seat 2: TQMISTL (big blind) won 0.36€


Winamax Poker - HOLD-UP "Colorado" - HandId: #19116069-655925-1701677305 - Holdem no limit (0.01€/0.02€) - 2023/12/04 08:08:25 UTC
Table: 'Colorado' 6-max (real money) Seat #6 is the button
Seat 1: Justo_170382 (0.77€)
Seat 2: Fried Berg (0.86€)
Seat 3: On100Fish (2.96€)
Seat 4: Killim (1.13€)
Seat 5: Clemence75 (2.01€)
Seat 6: Halmosthard (1.95€)
*** ANTE/BLINDS ***
Justo_170382 posts small blind 0.01€
Fried Berg posts big blind 0.02€
Dealt to Fried Berg [Ks 3d]
*** PRE-FLOP *** 
On100Fish folds
Killim folds
Clemence75 folds
Halmosthard calls 0.02€
Justo_170382 calls 0.01€
Fried Berg checks
*** FLOP *** [5c Ac Jc]
Justo_170382 bets 0.04€
Fried Berg folds
Halmosthard calls 0.04€
*** TURN *** [5c Ac Jc][7h]
Justo_170382 bets 0.14€
Halmosthard folds
Justo_170382 collected 0.27€ from pot
*** SUMMARY ***
Total pot 0.27€ | Rake 0.01€
Board: [5c Ac Jc 7h]
Seat 1: Justo_170382 (small blind) won 0.27€


Winamax Poker - HOLD-UP "Colorado" - HandId: #19116069-655937-1701677318 - Holdem no limit (0.01€/0.02€) - 2023/12/04 08:08:38 UTC
Table: 'Colorado' 6-max (real money) Seat #6 is the button
Seat 1: Fried Berg (0.84€)
Seat 2: fabrice8551 (1.31€)
Seat 3: vicieux59 (1.40€)
Seat 4: -KEMS 14- (0.45€)
Seat 5: Hydramist (2.25€)
Seat 6: SashaTDouss (2€)
*** ANTE/BLINDS ***
Fried Berg posts small blind 0.01€
fabrice8551 posts big blind 0.02€
Dealt to Fried Berg [3s 9d]
*** PRE-FLOP *** 
vicieux59 folds
-KEMS 14- folds
Hydramist folds
SashaTDouss folds
Fried Berg folds
fabrice8551 collected 0.03€ from pot
*** SUMMARY ***
Total pot 0.03€ | No rake
Seat 2: fabrice8551 (big blind) won 0.03€


Winamax Poker - HOLD-UP "Colorado" - HandId: #19116069-655945-1701677325 - Holdem no limit (0.01€/0.02€) - 2023/12/04 08:08:45 UTC
Table: 'Colorado' 6-max (real money) Seat #6 is the button
Seat 1: Melielvir (2.25€)
Seat 2: TimToBey (2.41€)
Seat 3: stevebalboni (1.89€)
Seat 4: aaasticot (0.47€)
Seat 5: mixtep (2€)
Seat 6: Fried Berg (0.83€)
*** ANTE/BLINDS ***
Melielvir posts small blind 0.01€
TimToBey posts big blind 0.02€
Dealt to Fried Berg [Jh 7s]
*** PRE-FLOP *** 
stevebalboni folds
aaasticot raises 0.02€ to 0.04€
mixtep folds
Fried Berg folds
Melielvir folds
TimToBey folds
aaasticot collected 0.07€ from pot
*** SUMMARY ***
Total pot 0.07€ | No rake
Seat 4: aaasticot won 0.07€


Winamax Poker - HOLD-UP "Colorado" - HandId: #19116069-655950-1701677329 - Holdem no limit (0.01€/0.02€) - 2023/12/04 08:08:49 UTC
Table: 'Colorado' 6-max (real money) Seat #6 is the button
Seat 1: VR_King14 (1.09€)
Seat 2: Clemence75 (2.19€)
Seat 3: On100Fish (3.42€)
Seat 4: St. Germain (3.29€)
Seat 5: Fried Berg (0.83€)
Seat 6: Redemption90 (2.15€)
*** ANTE/BLINDS ***
VR_King14 posts small blind 0.01€
Clemence75 posts big blind 0.02€
Dealt to Fried Berg [8c Qs]
*** PRE-FLOP *** 
On100Fish folds
St. Germain folds
Fried Berg folds
Redemption90 raises 0.03€ to 0.05€
VR_King14 calls 0.04€
Clemence75 folds
*** FLOP *** [9h 3d 5d]
VR_King14 checks
Redemption90 bets 0.04€
VR_King14 folds
Redemption90 collected 0.15€ from pot
*** SUMMARY ***
Total pot 0.15€ | Rake 0.01€
Board: [9h 3d 5d]
Seat 6: Redemption90 (button) won 0.15€


Winamax Poker - HOLD-UP "Colorado" - HandId: #19116069-655956-1701677334 - Holdem no limit (0.01€/0.02€) - 2023/12/04 08:08:54 UTC
Table: 'Colorado' 6-max (real money) Seat #6 is the button
Seat 1: jdeepenslip (3.04€)
Seat 2: Fried Berg (0.83€)
Seat 3: Melielvir (2.24€)
Seat 4: mixtep (2€)
Seat 5: aaasticot (0.50€)
Seat 6: loox7 (0.68€)
*** ANTE/BLINDS ***
jdeepenslip posts small blind 0.01€
Fried Berg posts big blind 0.02€
Dealt to Fried Berg [8d 6c]
*** PRE-FLOP *** 
Melielvir folds
mixtep folds
aaasticot folds
loox7 folds
jdeepenslip folds
Fried Berg collected 0.03€ from pot
*** SUMMARY ***
Total pot 0.03€ | No rake
Seat 2: Fried Berg (big blind) won 0.03€


Winamax Poker - HOLD-UP "Colorado" - HandId: #19116069-655962-1701677344 - Holdem no limit (0.01€/0.02€) - 2023/12/04 08:09:04 UTC
Table: 'Colorado' 6-max (real money) Seat #6 is the button
Seat 1: vicieux59 (1.38€)
Seat 2: pasquale202a (1.27€)
Seat 3: Thequeen1205 (2€)
Seat 4: On100Fish (2.97€)
Seat 5: Fried Berg (0.84€)
Seat 6: Hydramist (3.12€)
*** ANTE/BLINDS ***
vicieux59 posts small blind 0.01€
pasquale202a posts big blind 0.02€
Dealt to Fried Berg [Ad 4h]
*** PRE-FLOP *** 
Thequeen1205 folds
On100Fish folds
Fried Berg calls 0.02€
Hydramist folds
vicieux59 calls 0.01€
pasquale202a checks
*** FLOP *** [3c Jh 2s]
vicieux59 checks
pasquale202a bets 0.06€
Fried Berg folds
vicieux59 folds
pasquale202a collected 0.11€ from pot
*** SUMMARY ***
Total pot 0.11€ | Rake 0.01€
Board: [3c Jh 2s]
Seat 2: pasquale202a (big blind) won 0.11€


Winamax Poker - HOLD-UP "Colorado" - HandId: #19116069-655998-1701677397 - Holdem no limit (0.01€/0.02€) - 2023/12/04 08:09:57 UTC
Table: 'Colorado' 6-max (real money) Seat #6 is the button
Seat 1: Obelix44 (0.71€)
Seat 2: Killim (1.57€)
Seat 3: rigolodlazac (2.09€)
Seat 4: Suaterna207 (2€)
Seat 5: Piexxxe10 (1.93€)
Seat 6: Fried Berg (0.82€)
*** ANTE/BLINDS ***
Obelix44 posts small blind 0.01€
Killim posts big blind 0.02€
Dealt to Fried Berg [Tc 6d]
*** PRE-FLOP *** 
rigolodlazac folds
Suaterna207 folds
Piexxxe10 folds
Fried Berg folds
Obelix44 calls 0.01€
Killim checks
*** FLOP *** [8d 4c 6c]
Obelix44 checks
Killim checks
*** TURN *** [8d 4c 6c][Qd]
Obelix44 checks
Killim checks
*** RIVER *** [8d 4c 6c Qd][Jc]
Obelix44 bets 0.04€
Killim folds
Obelix44 collected 0.08€ from pot
*** SUMMARY ***
Total pot 0.08€ | No rake
Board: [8d 4c 6c Qd Jc]
Seat 1: Obelix44 (small blind) won 0.08€


Winamax Poker - HOLD-UP "Colorado" - HandId: #19116069-656000-1701677403 - Holdem no limit (0.01€/0.02€) - 2023/12/04 08:10:03 UTC
Table: 'Colorado' 6-max (real money) Seat #6 is the button
Seat 1: Fried Berg (0.82€)
Seat 2: Piexxxe10 (1.93€)
Seat 3: Suaterna207 (2€)
Seat 4: Clemence75 (2€)
Seat 5: rigolodlazac (2.09€)
Seat 6: LilRun (1.91€)
*** ANTE/BLINDS ***
Fried Berg posts small blind 0.01€
Piexxxe10 posts big blind 0.02€
Dealt to Fried Berg [4h 4d]
*** PRE-FLOP *** 
Suaterna207 folds
Clemence75 folds
rigolodlazac folds
LilRun folds
Fried Berg calls 0.01€
Piexxxe10 checks
*** FLOP *** [Ks 3d 8d]
Fried Berg bets 0.08€
Piexxxe10 folds
Fried Berg collected 0.12€ from pot
*** SUMMARY ***
Total pot 0.12€ | No rake
Board: [Ks 3d 8d]
Seat 1: Fried Berg (small blind) won 0.12€


Winamax Poker - HOLD-UP "Colorado" - HandId: #19116069-656015-1701677423 - Holdem no limit (0.01€/0.02€) - 2023/12/04 08:10:23 UTC
Table: 'Colorado' 6-max (real money) Seat #6 is the button
Seat 1: El tiki tiki (1.48€)
Seat 2: On100Fish (3.42€)
Seat 3: fabrice8551 (1.21€)
Seat 4: Fried Berg (0.84€)
Seat 5: pasquale202a (1.40€)
Seat 6: mixtep (2€)
*** ANTE/BLINDS ***
El tiki tiki posts small blind 0.01€
On100Fish posts big blind 0.02€
Dealt to Fried Berg [2d Td]
*** PRE-FLOP *** 
fabrice8551 folds
Fried Berg folds
pasquale202a folds
mixtep folds
El tiki tiki folds
On100Fish collected 0.03€ from pot
*** SUMMARY ***
Total pot 0.03€ | No rake
Seat 2: On100Fish (big blind) won 0.03€


Winamax Poker - HOLD-UP "Colorado" - HandId: #19116069-656018-1701677426 - Holdem no limit (0.01€/0.02€) - 2023/12/04 08:10:26 UTC
Table: 'Colorado' 6-max (real money) Seat #6 is the button
Seat 1: jdeepenslip (2.09€)
Seat 2: fabrice8551 (1.21€)
Seat 3: Thequeen1205 (2.19€)
Seat 4: nonoleboucan (2.20€)
Seat 5: Fried Berg (0.84€)
Seat 6: Hydramist (2.94€)
*** ANTE/BLINDS ***
jdeepenslip posts small blind 0.01€
fabrice8551 posts big blind 0.02€
Dealt to Fried Berg [Ac 2h]
*** PRE-FLOP *** 
Thequeen1205 folds
nonoleboucan folds
Fried Berg folds
Hydramist folds
jdeepenslip folds
fabrice8551 collected 0.03€ from pot
*** SUMMARY ***
Total pot 0.03€ | No rake
Seat 2: fabrice8551 (big blind) won 0.03€


Winamax Poker - HOLD-UP "Colorado" - HandId: #19116069-656025-1701677438 - Holdem no limit (0.01€/0.02€) - 2023/12/04 08:10:38 UTC
Table: 'Colorado' 6-max (real money) Seat #6 is the button
Seat 1: DigBick99 (2.55€)
Seat 2: jdeepenslip (3.93€)
Seat 3: Killim (1.54€)
Seat 4: LilRun (1.88€)
Seat 5: TimToBey (4.24€)
Seat 6: Fried Berg (0.84€)
*** ANTE/BLINDS ***
DigBick99 posts small blind 0.01€
jdeepenslip posts big blind 0.02€
Dealt to Fried Berg [Ts 4h]
*** PRE-FLOP *** 
Killim folds
LilRun folds
TimToBey folds
Fried Berg folds
DigBick99 folds
jdeepenslip collected 0.03€ from pot
*** SUMMARY ***
Total pot 0.03€ | No rake
Seat 2: jdeepenslip (big blind) won 0.03€


Winamax Poker - HOLD-UP "Colorado" - HandId: #19116069-656026-1701677442 - Holdem no limit (0.01€/0.02€) - 2023/12/04 08:10:42 UTC
Table: 'Colorado' 6-max (real money) Seat #6 is the button
Seat 1: Fried Berg (0.84€)
Seat 2: Matofs (2.88€)
Seat 3: Clemence75 (2€)
Seat 4: nonoleboucan (2.20€)
Seat 5: Killim (1.54€)
Seat 6: liseau5312 (0.35€)
*** ANTE/BLINDS ***
Fried Berg posts small blind 0.01€
Matofs posts big blind 0.02€
Dealt to Fried Berg [4c 8c]
*** PRE-FLOP *** 
Clemence75 folds
nonoleboucan folds
Killim folds
liseau5312 folds
Fried Berg folds
Matofs collected 0.03€ from pot
*** SUMMARY ***
Total pot 0.03€ | No rake
Seat 2: Matofs (big blind) won 0.03€


Winamax Poker - HOLD-UP "Colorado" - HandId: #19116069-656029-1701677446 - Holdem no limit (0.01€/0.02€) - 2023/12/04 08:10:46 UTC
Table: 'Colorado' 6-max (real money) Seat #6 is the button
Seat 1: St. Germain (3.30€)
Seat 2: Fried Berg (0.83€)
Seat 3: Killim (1.54€)
Seat 4: pasquale202a (1.40€)
Seat 5: LilRun (1.88€)
Seat 6: Halmosthard (1.87€)
*** ANTE/BLINDS ***
St. Germain posts small blind 0.01€
Fried Berg posts big blind 0.02€
Dealt to Fried Berg [Jc 2s]
*** PRE-FLOP *** 
Killim folds
pasquale202a folds
LilRun raises 0.03€ to 0.05€
Halmosthard folds
St. Germain folds
Fried Berg folds
LilRun collected 0.08€ from pot
*** SUMMARY ***
Total pot 0.08€ | No rake
Seat 5: LilRun won 0.08€


Winamax Poker - HOLD-UP "Colorado" - HandId: #19116069-656036-1701677454 - Holdem no limit (0.01€/0.02€) - 2023/12/04 08:10:54 UTC
Table: 'Colorado' 6-max (real money) Seat #6 is the button
Seat 1: stevebalboni (1.81€)
Seat 2: Killim (1.54€)
Seat 3: Fried Berg (0.81€)
Seat 4: Clemence75 (2.14€)
Seat 5: Matofs (2.89€)
Seat 6: jdeepenslip (2.72€)
*** ANTE/BLINDS ***
stevebalboni posts small blind 0.01€
Killim posts big blind 0.02€
Dealt to Fried Berg [9s 9c]
*** PRE-FLOP *** 
Fried Berg raises 0.02€ to 0.04€
Clemence75 folds
Matofs folds
jdeepenslip folds
stevebalboni folds
Killim calls 0.02€
*** FLOP *** [7d Jc 5c]
Killim checks
Fried Berg bets 0.06€
Killim calls 0.06€
*** TURN *** [7d Jc 5c][Qd]
Killim checks
Fried Berg checks
*** RIVER *** [7d Jc 5c Qd][8c]
Killim checks
Fried Berg checks
*** SHOW DOWN ***
Fried Berg shows [9s 9c] (One pair : 9)
Killim shows [6c Js] (One pair : Jacks)
Killim collected 0.19€ from pot
*** SUMMARY ***
Total pot 0.19€ | Rake 0.02€
Board: [7d Jc 5c Qd 8c]
Seat 2: Killim (big blind) showed [6c Js] and won 0.19€ with One pair : Jacks
Seat 3: Fried Berg showed [9s 9c] and lost with One pair : 9


Winamax Poker - HOLD-UP "Colorado" - HandId: #19116069-656079-1701677499 - Holdem no limit (0.01€/0.02€) - 2023/12/04 08:11:39 UTC
Table: 'Colorado' 6-max (real money) Seat #6 is the button
Seat 1: Killim (1.63€)
Seat 2: loox7 (0.75€)
Seat 3: Fried Berg (0.71€)
Seat 4: Hydramist (2.20€)
Seat 5: Clemence75 (2.35€)
Seat 6: Thequeen1205 (2€)
*** ANTE/BLINDS ***
Killim posts small blind 0.01€
loox7 posts big blind 0.02€
Dealt to Fried Berg [Ac Kd]
*** PRE-FLOP *** 
Fried Berg raises 0.02€ to 0.04€
Hydramist folds
Clemence75 folds
Thequeen1205 folds
Killim folds
loox7 folds
Fried Berg collected 0.07€ from pot
*** SUMMARY ***
Total pot 0.07€ | No rake
Seat 3: Fried Berg won 0.07€


Winamax Poker - HOLD-UP "Colorado" - HandId: #19116069-656086-1701677508 - Holdem no limit (0.01€/0.02€) - 2023/12/04 08:11:48 UTC
Table: 'Colorado' 6-max (real money) Seat #6 is the button
Seat 1: Halmosthard (1.82€)
Seat 2: nonoleboucan (3.26€)
Seat 3: On100Fish (3.45€)
Seat 4: nda94 (0.69€)
Seat 5: El tiki tiki (0.50€)
Seat 6: Fried Berg (0.74€)
*** ANTE/BLINDS ***
Halmosthard posts small blind 0.01€
nonoleboucan posts big blind 0.02€
Dealt to Fried Berg [Td Ts]
*** PRE-FLOP *** 
On100Fish folds
nda94 folds
El tiki tiki folds
Fried Berg raises 0.02€ to 0.04€
Halmosthard folds
nonoleboucan folds
Fried Berg collected 0.07€ from pot
*** SUMMARY ***
Total pot 0.07€ | No rake
Seat 6: Fried Berg (button) won 0.07€


Winamax Poker - HOLD-UP "Colorado" - HandId: #19116069-656177-1701677620 - Holdem no limit (0.01€/0.02€) - 2023/12/04 08:13:40 UTC
Table: 'Colorado' 6-max (real money) Seat #6 is the button
Seat 1: Amazigh 78 (2.16€)
Seat 2: DuroDePelar (2€)
Seat 3: Suaterna207 (2€)
Seat 4: Fried Berg (0.77€)
Seat 5: stevebalboni (2.01€)
Seat 6: Melielvir (2.17€)
Hold-up to Pot: total 0.10€
*** ANTE/BLINDS ***
Amazigh 78 posts small blind 0.01€
DuroDePelar posts big blind 0.02€
Dealt to Fried Berg [5s 7s]
*** PRE-FLOP *** 
Suaterna207 folds
Fried Berg folds
stevebalboni raises 0.04€ to 0.06€
Melielvir folds
Amazigh 78 calls 0.05€
DuroDePelar calls 0.04€
*** FLOP *** [Qd Kh Td]
Amazigh 78 checks
DuroDePelar checks
stevebalboni bets 0.13€
Amazigh 78 folds
DuroDePelar calls 0.13€
*** TURN *** [Qd Kh Td][Ts]
DuroDePelar checks
stevebalboni bets 0.27€
DuroDePelar calls 0.27€
*** RIVER *** [Qd Kh Td Ts][Ac]
DuroDePelar bets 1.54€ and is all-in
stevebalboni raises 0.01€ to 1.55€ and is all-in
*** SHOW DOWN ***
DuroDePelar shows [4s Js] (Straight Ace high)
stevebalboni shows [Tc Kc] (Full of Tens and Kings)
stevebalboni collected 3.76€ from pot
*** SUMMARY ***
Total pot 3.76€ | Rake 0.41€
Board: [Qd Kh Td Ts Ac]
Seat 2: DuroDePelar (big blind) showed [4s Js] and lost with Straight Ace high
Seat 5: stevebalboni showed [Tc Kc] and won 3.76€ with Full of Tens and Kings


Winamax Poker - HOLD-UP "Colorado" - HandId: #19116069-656184-1701677627 - Holdem no limit (0.01€/0.02€) - 2023/12/04 08:13:47 UTC
Table: 'Colorado' 6-max (real money) Seat #6 is the button
Seat 1: On100Fish (1.85€)
Seat 2: Suaterna207 (2€)
Seat 3: jdeepenslip (2€)
Seat 4: liseau5312 (0.39€)
Seat 5: 48centaure (3.43€)
Seat 6: Fried Berg (0.77€)
*** ANTE/BLINDS ***
On100Fish posts small blind 0.01€
Suaterna207 posts big blind 0.02€
Dealt to Fried Berg [2h Tc]
*** PRE-FLOP *** 
jdeepenslip folds
liseau5312 calls 0.02€
48centaure raises 0.07€ to 0.09€
Fried Berg folds
On100Fish folds
Suaterna207 folds
liseau5312 calls 0.07€
*** FLOP *** [9h Kd 8s]
liseau5312 checks
48centaure bets 0.21€
liseau5312 raises 0.09€ to 0.30€ and is all-in
48centaure calls 0.09€
*** TURN *** [9h Kd 8s][3h]
*** RIVER *** [9h Kd 8s 3h][3c]
*** SHOW DOWN ***
liseau5312 shows [4h 4c] (Two pairs : 4 and 3)
48centaure shows [Qh Qc] (Two pairs : Queens and 3)
48centaure collected 0.73€ from pot
*** SUMMARY ***
Total pot 0.73€ | Rake 0.08€
Board: [9h Kd 8s 3h 3c]
Seat 4: liseau5312 showed [4h 4c] and lost with Two pairs : 4 and 3
Seat 5: 48centaure showed [Qh Qc] and won 0.73€ with Two pairs : Queens and 3


Winamax Poker - HOLD-UP "Colorado" - HandId: #19116069-656186-1701677629 - Holdem no limit (0.01€/0.02€) - 2023/12/04 08:13:49 UTC
Table: 'Colorado' 6-max (real money) Seat #6 is the button
Seat 1: SashaTDouss (2.14€)
Seat 2: Fried Berg (0.77€)
Seat 3: TimToBey (4.25€)
Seat 4: DigBick99 (2.11€)
Seat 5: Clemence75 (2.02€)
Seat 6: nonoleboucan (2€)
*** ANTE/BLINDS ***
SashaTDouss posts small blind 0.01€
Fried Berg posts big blind 0.02€
Dealt to Fried Berg [Jh Ks]
*** PRE-FLOP *** 
TimToBey folds
DigBick99 folds
Clemence75 folds
nonoleboucan raises 0.03€ to 0.05€
SashaTDouss folds
Fried Berg raises 0.10€ to 0.15€
nonoleboucan folds
Fried Berg collected 0.21€ from pot
*** SUMMARY ***
Total pot 0.21€ | No rake
Seat 2: Fried Berg (big blind) won 0.21€


Winamax Poker - HOLD-UP "Colorado" - HandId: #19116069-656206-1701677656 - Holdem no limit (0.01€/0.02€) - 2023/12/04 08:14:16 UTC
Table: 'Colorado' 6-max (real money) Seat #6 is the button
Seat 1: Fried Berg (0.83€)
Seat 2: liseau5312 (2€)
Seat 3: VR_King14 (0.77€)
Seat 4: pasquale202a (1.27€)
Seat 5: On100Fish (3.06€)
Seat 6: Amazigh 78 (2.10€)
*** ANTE/BLINDS ***
Fried Berg posts small blind 0.01€
liseau5312 posts big blind 0.02€
Dealt to Fried Berg [Jh Qs]
*** PRE-FLOP *** 
VR_King14 folds
pasquale202a folds
On100Fish folds
Amazigh 78 folds
Fried Berg raises 0.02€ to 0.04€
liseau5312 folds
Fried Berg collected 0.06€ from pot
*** SUMMARY ***
Total pot 0.06€ | No rake
Seat 1: Fried Berg (small blind) won 0.06€


Winamax Poker - HOLD-UP "Colorado" - HandId: #19116069-656215-1701677671 - Holdem no limit (0.01€/0.02€) - 2023/12/04 08:14:31 UTC
Table: 'Colorado' 6-max (real money) Seat #6 is the button
Seat 1: jdeepenslip (5.19€)
Seat 2: DigBick99 (2.34€)
Seat 3: Fried Berg (0.85€)
Seat 4: fabrice8551 (0.83€)
Seat 5: TimToBey (4.22€)
Seat 6: Melielvir (2.11€)
*** ANTE/BLINDS ***
jdeepenslip posts small blind 0.01€
DigBick99 posts big blind 0.02€
Dealt to Fried Berg [2h 4s]
*** PRE-FLOP *** 
Fried Berg folds
fabrice8551 folds
TimToBey folds
Melielvir folds
jdeepenslip raises 0.04€ to 0.06€
DigBick99 folds
jdeepenslip collected 0.08€ from pot
*** SUMMARY ***
Total pot 0.08€ | No rake
Seat 1: jdeepenslip (small blind) won 0.08€


Winamax Poker - HOLD-UP "Colorado" - HandId: #19116069-656217-1701677673 - Holdem no limit (0.01€/0.02€) - 2023/12/04 08:14:33 UTC
Table: 'Colorado' 6-max (real money) Seat #6 is the button
Seat 1: billoss (0.54€)
Seat 2: Matofs (2.94€)
Seat 3: nonoleboucan (2€)
Seat 4: Thequeen1205 (2.14€)
Seat 5: Fried Berg (0.85€)
Seat 6: Melielvir (2.11€)
*** ANTE/BLINDS ***
billoss posts small blind 0.01€
Matofs posts big blind 0.02€
Dealt to Fried Berg [7c Ts]
*** PRE-FLOP *** 
nonoleboucan folds
Thequeen1205 folds
Fried Berg folds
Melielvir folds
billoss calls 0.01€
Matofs raises 0.04€ to 0.06€
billoss calls 0.04€
*** FLOP *** [Qd 4c Th]
billoss checks
Matofs checks
*** TURN *** [Qd 4c Th][7h]
billoss bets 0.04€
Matofs folds
billoss collected 0.15€ from pot
*** SUMMARY ***
Total pot 0.15€ | Rake 0.01€
Board: [Qd 4c Th 7h]
Seat 1: billoss (small blind) won 0.15€


Winamax Poker - HOLD-UP "Colorado" - HandId: #19116069-656222-1701677678 - Holdem no limit (0.01€/0.02€) - 2023/12/04 08:14:38 UTC
Table: 'Colorado' 6-max (real money) Seat #6 is the button
Seat 1: Sebidu57 (7.82€)
Seat 2: nonoleboucan (2€)
Seat 3: LoOooOliV13 (0.50€)
Seat 4: Fried Berg (0.85€)
Seat 5: DuroDePelar (2.24€)
Seat 6: pasquale202a (1.50€)
*** ANTE/BLINDS ***
Sebidu57 posts small blind 0.01€
nonoleboucan posts big blind 0.02€
Dealt to Fried Berg [4d Ad]
*** PRE-FLOP *** 
LoOooOliV13 folds
Fried Berg raises 0.02€ to 0.04€
DuroDePelar folds
pasquale202a folds
Sebidu57 folds
nonoleboucan folds
Fried Berg collected 0.07€ from pot
*** SUMMARY ***
Total pot 0.07€ | No rake
Seat 4: Fried Berg won 0.07€


Winamax Poker - HOLD-UP "Colorado" - HandId: #19116069-656237-1701677703 - Holdem no limit (0.01€/0.02€) - 2023/12/04 08:15:03 UTC
Table: 'Colorado' 6-max (real money) Seat #6 is the button
Seat 1: El tiki tiki (1.45€)
Seat 2: Fried Berg (0.88€)
Seat 3: mixtep (2.83€)
Seat 4: Suaterna207 (2€)
Seat 5: Sebidu57 (7.72€)
Seat 6: Piexxxe10 (1.43€)
*** ANTE/BLINDS ***
El tiki tiki posts small blind 0.01€
Fried Berg posts big blind 0.02€
Dealt to Fried Berg [2d 6c]
*** PRE-FLOP *** 
mixtep raises 0.04€ to 0.06€
Suaterna207 calls 0.06€
Sebidu57 folds
Piexxxe10 folds
El tiki tiki calls 0.05€
Fried Berg folds
*** FLOP *** [3s 3h 3c]
El tiki tiki checks
mixtep checks
Suaterna207 bets 0.07€
El tiki tiki folds
mixtep calls 0.07€
*** TURN *** [3s 3h 3c][Td]
mixtep checks
Suaterna207 bets 0.22€
mixtep folds
Suaterna207 collected 0.53€ from pot
*** SUMMARY ***
Total pot 0.53€ | Rake 0.03€
Board: [3s 3h 3c Td]
Seat 4: Suaterna207 won 0.53€


Winamax Poker - HOLD-UP "Colorado" - HandId: #19116069-656243-1701677707 - Holdem no limit (0.01€/0.02€) - 2023/12/04 08:15:07 UTC
Table: 'Colorado' 6-max (real money) Seat #6 is the button
Seat 1: nonoleboucan (2.28€)
Seat 2: DigBick99 (2.56€)
Seat 3: billoss (0.59€)
Seat 4: Piexxxe10 (1.43€)
Seat 5: Fried Berg (0.86€)
Seat 6: Thequeen1205 (2.54€)
*** ANTE/BLINDS ***
nonoleboucan posts small blind 0.01€
DigBick99 posts big blind 0.02€
Dealt to Fried Berg [Qd 2h]
*** PRE-FLOP *** 
billoss folds
Piexxxe10 folds
Fried Berg folds
Thequeen1205 folds
nonoleboucan folds
DigBick99 collected 0.03€ from pot
*** SUMMARY ***
Total pot 0.03€ | No rake
Seat 2: DigBick99 (big blind) won 0.03€


Winamax Poker - HOLD-UP "Colorado" - HandId: #19116069-656251-1701677715 - Holdem no limit (0.01€/0.02€) - 2023/12/04 08:15:15 UTC
Table: 'Colorado' 6-max (real money) Seat #6 is the button
Seat 1: Koinagaray (2€)
Seat 2: jdeepenslip (2€)
Seat 3: Fried Berg (0.86€)
Seat 4: Thequeen1205 (2€)
Seat 5: St. Germain (3.31€)
Seat 6: Matofs (2.88€)
*** ANTE/BLINDS ***
Koinagaray posts small blind 0.01€
jdeepenslip posts big blind 0.02€
Dealt to Fried Berg [4d 8h]
*** PRE-FLOP *** 
Fried Berg folds
Thequeen1205 folds
St. Germain folds
Matofs raises 0.03€ to 0.05€
Koinagaray folds
jdeepenslip folds
Matofs collected 0.08€ from pot
*** SUMMARY ***
Total pot 0.08€ | No rake
Seat 6: Matofs (button) won 0.08€


Winamax Poker - HOLD-UP "Colorado" - HandId: #19116069-656254-1701677718 - Holdem no limit (0.01€/0.02€) - 2023/12/04 08:15:18 UTC
Table: 'Colorado' 6-max (real money) Seat #6 is the button
Seat 1: Fried Berg (0.86€)
Seat 2: On100Fish (1.44€)
Seat 3: VR_King14 (0.81€)
Seat 4: fabrice8551 (2.23€)
Seat 5: nonoleboucan (2.27€)
Seat 6: billoss (0.59€)
*** ANTE/BLINDS ***
Fried Berg posts small blind 0.01€
On100Fish posts big blind 0.02€
Dealt to Fried Berg [5h Kh]
*** PRE-FLOP *** 
VR_King14 folds
fabrice8551 folds
nonoleboucan raises 0.03€ to 0.05€
billoss folds
Fried Berg folds
On100Fish folds
nonoleboucan collected 0.08€ from pot
*** SUMMARY ***
Total pot 0.08€ | No rake
Seat 5: nonoleboucan won 0.08€


Winamax Poker - HOLD-UP "Colorado" - HandId: #19116069-656271-1701677736 - Holdem no limit (0.01€/0.02€) - 2023/12/04 08:15:36 UTC
Table: 'Colorado' 6-max (real money) Seat #6 is the button
Seat 1: SashaTDouss (2.04€)
Seat 2: loox7 (1.30€)
Seat 3: Thequeen1205 (2.11€)
Seat 4: Fried Berg (0.85€)
Seat 5: DuroDePelar (2.32€)
Seat 6: 48centaure (3.85€)
*** ANTE/BLINDS ***
SashaTDouss posts small blind 0.01€
loox7 posts big blind 0.02€
Dealt to Fried Berg [Kh 3h]
*** PRE-FLOP *** 
Thequeen1205 folds
Fried Berg folds
DuroDePelar folds
48centaure folds
SashaTDouss folds
loox7 collected 0.03€ from pot
*** SUMMARY ***
Total pot 0.03€ | No rake
Seat 2: loox7 (big blind) won 0.03€


Winamax Poker - HOLD-UP "Colorado" - HandId: #19116069-656276-1701677741 - Holdem no limit (0.01€/0.02€) - 2023/12/04 08:15:41 UTC
Table: 'Colorado' 6-max (real money) Seat #6 is the button
Seat 1: Koinagaray (2€)
Seat 2: St. Germain (3.18€)
Seat 3: DuroDePelar (2.08€)
Seat 4: Fried Berg (0.85€)
Seat 5: Piexxxe10 (1.45€)
Seat 6: LilRun (2.01€)
*** ANTE/BLINDS ***
Koinagaray posts small blind 0.01€
St. Germain posts big blind 0.02€
Dealt to Fried Berg [Kc Ad]
*** PRE-FLOP *** 
DuroDePelar folds
Fried Berg raises 0.02€ to 0.04€
Piexxxe10 calls 0.04€
LilRun calls 0.04€
Koinagaray folds
St. Germain folds
*** FLOP *** [9c Qc Js]
Fried Berg checks
Piexxxe10 checks
LilRun bets 0.10€
Fried Berg calls 0.10€
Piexxxe10 calls 0.10€
*** TURN *** [9c Qc Js][5h]
Fried Berg checks
Piexxxe10 checks
LilRun bets 0.18€
Fried Berg calls 0.18€
Piexxxe10 folds
*** RIVER *** [9c Qc Js 5h][Tc]
Fried Berg checks
LilRun checks
*** SHOW DOWN ***
LilRun shows [Qs 8s] (Straight Queen high)
Fried Berg shows [Kc Ad] (Straight Ace high)
Fried Berg collected 0.73€ from pot
*** SUMMARY ***
Total pot 0.73€ | Rake 0.08€
Board: [9c Qc Js 5h Tc]
Seat 4: Fried Berg showed [Kc Ad] and won 0.73€ with Straight Ace high
Seat 6: LilRun (button) showed [Qs 8s] and lost with Straight Queen high


Winamax Poker - HOLD-UP "Colorado" - HandId: #19116069-656369-1701677876 - Holdem no limit (0.01€/0.02€) - 2023/12/04 08:17:56 UTC
Table: 'Colorado' 6-max (real money) Seat #6 is the button
Seat 1: stevebalboni (4.10€)
Seat 2: DigBick99 (2.09€)
Seat 3: LilRun (1.69€)
Seat 4: nda94 (0.48€)
Seat 5: Fried Berg (1.26€)
Seat 6: pasquale202a (1.47€)
*** ANTE/BLINDS ***
stevebalboni posts small blind 0.01€
DigBick99 posts big blind 0.02€
Dealt to Fried Berg [6s Qh]
*** PRE-FLOP *** 
LilRun folds
nda94 calls 0.02€
Fried Berg folds
pasquale202a folds
stevebalboni raises 0.03€ to 0.05€
DigBick99 calls 0.03€
nda94 calls 0.03€
*** FLOP *** [Th Ks Js]
stevebalboni bets 0.05€
DigBick99 folds
nda94 calls 0.05€
*** TURN *** [Th Ks Js][4c]
stevebalboni bets 0.09€
nda94 calls 0.09€
*** RIVER *** [Th Ks Js 4c][3c]
stevebalboni bets 0.15€
nda94 calls 0.15€
*** SHOW DOWN ***
nda94 shows [Tc Qs] (One pair : Tens)
stevebalboni shows [Td Ts] (Trips of Tens)
stevebalboni collected 0.66€ from pot
*** SUMMARY ***
Total pot 0.66€ | Rake 0.07€
Board: [Th Ks Js 4c 3c]
Seat 1: stevebalboni (small blind) showed [Td Ts] and won 0.66€ with Trips of Tens
Seat 4: nda94 showed [Tc Qs] and lost with One pair : Tens


Winamax Poker - HOLD-UP "Colorado" - HandId: #19116069-656373-1701677881 - Holdem no limit (0.01€/0.02€) - 2023/12/04 08:18:01 UTC
Table: 'Colorado' 6-max (real money) Seat #6 is the button
Seat 1: pie38_x (7.88€)
Seat 2: Fried Berg (1.26€)
Seat 3: Matofs (2.28€)
Seat 4: jdeepenslip (2€)
Seat 5: Piexxxe10 (1.27€)
Seat 6: Suaterna207 (2.14€)
*** ANTE/BLINDS ***
pie38_x posts small blind 0.01€
Fried Berg posts big blind 0.02€
Dealt to Fried Berg [7d Ts]
*** PRE-FLOP *** 
Matofs raises 0.03€ to 0.05€
jdeepenslip folds
Piexxxe10 folds
Suaterna207 folds
pie38_x folds
Fried Berg folds
Matofs collected 0.08€ from pot
*** SUMMARY ***
Total pot 0.08€ | No rake
Seat 3: Matofs won 0.08€


Winamax Poker - HOLD-UP "Colorado" - HandId: #19116069-656413-1701677930 - Holdem no limit (0.01€/0.02€) - 2023/12/04 08:18:50 UTC
Table: 'Colorado' 6-max (real money) Seat #6 is the button
Seat 1: Fried Berg (1.24€)
Seat 2: TimToBey (3.56€)
Seat 3: nonoleboucan (3.30€)
Seat 4: DigBick99 (6.36€)
Seat 5: mixtep (2.63€)
Seat 6: DuroDePelar (2.59€)
*** ANTE/BLINDS ***
Fried Berg posts small blind 0.01€
TimToBey posts big blind 0.02€
Dealt to Fried Berg [Td 7h]
*** PRE-FLOP *** 
nonoleboucan folds
DigBick99 folds
mixtep folds
DuroDePelar raises 0.04€ to 0.06€
Fried Berg folds
TimToBey calls 0.04€
*** FLOP *** [Kh 5h Jd]
TimToBey checks
DuroDePelar checks
*** TURN *** [Kh 5h Jd][8d]
TimToBey checks
DuroDePelar checks
*** RIVER *** [Kh 5h Jd 8d][Tc]
TimToBey bets 0.09€
DuroDePelar raises 2.44€ to 2.53€ and is all-in
TimToBey folds
DuroDePelar collected 2.72€ from pot
*** SUMMARY ***
Total pot 2.72€ | Rake 0.03€
Board: [Kh 5h Jd 8d Tc]
Seat 6: DuroDePelar (button) won 2.72€


Winamax Poker - HOLD-UP "Colorado" - HandId: #19116069-656417-1701677937 - Holdem no limit (0.01€/0.02€) - 2023/12/04 08:18:57 UTC
Table: 'Colorado' 6-max (real money) Seat #6 is the button
Seat 1: jdeepenslip (2€)
Seat 2: 48centaure (2€)
Seat 3: El tiki tiki (1.50€)
Seat 4: On100Fish (2.09€)
Seat 5: Fried Berg (1.23€)
Seat 6: Bunny37 (2.75€)
*** ANTE/BLINDS ***
jdeepenslip posts small blind 0.01€
48centaure posts big blind 0.02€
Dealt to Fried Berg [Ts Td]
*** PRE-FLOP *** 
El tiki tiki raises 0.04€ to 0.06€
On100Fish folds
Fried Berg calls 0.06€
Bunny37 folds
jdeepenslip folds
48centaure calls 0.04€
*** FLOP *** [Th 3h 4h]
48centaure checks
El tiki tiki bets 0.07€
Fried Berg calls 0.07€
48centaure folds
*** TURN *** [Th 3h 4h][8s]
El tiki tiki bets 0.21€
Fried Berg calls 0.21€
*** RIVER *** [Th 3h 4h 8s][Jc]
El tiki tiki bets 1.16€ and is all-in
Fried Berg folds
El tiki tiki collected 1.83€ from pot
*** SUMMARY ***
Total pot 1.83€ | Rake 0.08€
Board: [Th 3h 4h 8s Jc]
Seat 3: El tiki tiki won 1.83€


Winamax Poker - HOLD-UP "Colorado" - HandId: #19116069-656473-1701678013 - Holdem no limit (0.01€/0.02€) - 2023/12/04 08:20:13 UTC
Table: 'Colorado' 6-max (real money) Seat #6 is the button
Seat 1: Dankadu60 (0.46€)
Seat 2: Kapo10 (2.05€)
Seat 3: Fried Berg (0.89€)
Seat 4: DuroDePelar (2.08€)
Seat 5: 48centaure (1.96€)
Seat 6: Redemption90 (2€)
*** ANTE/BLINDS ***
Dankadu60 posts small blind 0.01€
Kapo10 posts big blind 0.02€
Dealt to Fried Berg [8s As]
*** PRE-FLOP *** 
Fried Berg raises 0.02€ to 0.04€
DuroDePelar raises 0.15€ to 0.19€
48centaure folds
Redemption90 raises 0.29€ to 0.48€
Dankadu60 folds
Kapo10 folds
Fried Berg raises 0.41€ to 0.89€ and is all-in
DuroDePelar folds
Redemption90 calls 0.41€
*** FLOP *** [7h Jc 4h]
*** TURN *** [7h Jc 4h][6s]
*** RIVER *** [7h Jc 4h 6s][Qd]
*** SHOW DOWN ***
Fried Berg shows [8s As] (High card : Ace)
Redemption90 shows [Kc Ah] (High card : Ace)
Redemption90 collected 1.80€ from pot
*** SUMMARY ***
Total pot 1.80€ | Rake 0.20€
Board: [7h Jc 4h 6s Qd]
Seat 3: Fried Berg showed [8s As] and lost with High card : Ace
Seat 6: Redemption90 (button) showed [Kc Ah] and won 1.80€ with High card : Ace


Winamax Poker - HOLD-UP "Colorado" - HandId: #19116069-656519-1701678078 - Holdem no limit (0.01€/0.02€) - 2023/12/04 08:21:18 UTC
Table: 'Colorado' 6-max (real money) Seat #6 is the button
Seat 1: Matofs (3.11€)
Seat 2: Fried Berg (0.50€)
Seat 3: Thequeen1205 (2.62€)
Seat 4: dan.doc (2.16€)
Seat 5: stevebalboni (4.32€)
Seat 6: nonoleboucan (2€)
*** ANTE/BLINDS ***
Matofs posts small blind 0.01€
Fried Berg posts big blind 0.02€
Dealt to Fried Berg [8h 7h]
*** PRE-FLOP *** 
Thequeen1205 folds
dan.doc calls 0.02€
stevebalboni folds
nonoleboucan raises 0.09€ to 0.11€
Matofs raises 0.15€ to 0.26€
Fried Berg raises 0.24€ to 0.50€ and is all-in
dan.doc folds
nonoleboucan calls 0.39€
Matofs raises 0.24€ to 0.74€
nonoleboucan calls 0.24€
*** FLOP *** [9c 4d Qc]
Matofs bets 0.50€
nonoleboucan raises 0.76€ to 1.26€ and is all-in
Matofs calls 0.76€
*** TURN *** [9c 4d Qc][9s]
*** RIVER *** [9c 4d Qc 9s][Th]
*** SHOW DOWN ***
Fried Berg shows [8h 7h] (One pair : 9)
nonoleboucan shows [3c Ac] (One pair : 9)
Matofs shows [Ah Ad] (Two pairs : Aces and 9)
Matofs collected 4.07€ from pot
*** SUMMARY ***
Total pot 4.07€ | Rake 0.45€
Board: [9c 4d Qc 9s Th]
Seat 1: Matofs (small blind) showed [Ah Ad] and won 4.07€ with Two pairs : Aces and 9
Seat 2: Fried Berg (big blind) showed [8h 7h] and lost with One pair : 9
Seat 6: nonoleboucan (button) showed [3c Ac] and lost with One pair : 9


Winamax Poker - HOLD-UP "Colorado" - HandId: #19116069-656575-1701678146 - Holdem no limit (0.01€/0.02€) - 2023/12/04 08:22:26 UTC
Table: 'Colorado' 6-max (real money) Seat #6 is the button
Seat 1: Fried Berg (0.50€)
Seat 2: Amazigh 78 (0.54€)
Seat 3: TheRealWill (2.65€)
Seat 4: nonoleboucan (2.14€)
Seat 5: Richardmill (3.58€)
Seat 6: Thequeen1205 (2.28€)
*** ANTE/BLINDS ***
Fried Berg posts small blind 0.01€
Amazigh 78 posts big blind 0.02€
Dealt to Fried Berg [5s 3h]
*** PRE-FLOP *** 
TheRealWill folds
nonoleboucan folds
Richardmill folds
Thequeen1205 folds
Fried Berg folds
Amazigh 78 collected 0.03€ from pot
*** SUMMARY ***
Total pot 0.03€ | No rake
Seat 2: Amazigh 78 (big blind) won 0.03€


Winamax Poker - HOLD-UP "Colorado" - HandId: #19116069-656582-1701678155 - Holdem no limit (0.01€/0.02€) - 2023/12/04 08:22:35 UTC
Table: 'Colorado' 6-max (real money) Seat #6 is the button
Seat 1: Sebidu57 (9.49€)
Seat 2: Thequeen1205 (2.28€)
Seat 3: Pr.Nimbus (1.16€)
Seat 4: DigBick99 (2€)
Seat 5: Fried Berg (0.49€)
Seat 6: Rottel (1.92€)
*** ANTE/BLINDS ***
Sebidu57 posts small blind 0.01€
Thequeen1205 posts big blind 0.02€
Dealt to Fried Berg [Jh 8s]
*** PRE-FLOP *** 
Pr.Nimbus folds
DigBick99 folds
Fried Berg folds
Rottel folds
Sebidu57 folds
Thequeen1205 collected 0.03€ from pot
*** SUMMARY ***
Total pot 0.03€ | No rake
Seat 2: Thequeen1205 (big blind) won 0.03€


Winamax Poker - HOLD-UP "Colorado" - HandId: #19116069-656587-1701678160 - Holdem no limit (0.01€/0.02€) - 2023/12/04 08:22:40 UTC
Table: 'Colorado' 6-max (real money) Seat #6 is the button
Seat 1: Matofs (2€)
Seat 2: nonoleboucan (2.09€)
Seat 3: DigBick99 (2€)
Seat 4: Fried Berg (0.49€)
Seat 5: DuroDePelar (2.52€)
Seat 6: TimToBey (5.51€)
*** ANTE/BLINDS ***
Matofs posts small blind 0.01€
nonoleboucan posts big blind 0.02€
Dealt to Fried Berg [2s Kh]
*** PRE-FLOP *** 
DigBick99 folds
Fried Berg folds
DuroDePelar folds
TimToBey raises 0.03€ to 0.05€
Matofs folds
nonoleboucan folds
TimToBey collected 0.08€ from pot
*** SUMMARY ***
Total pot 0.08€ | No rake
Seat 6: TimToBey (button) won 0.08€


Winamax Poker - HOLD-UP "Colorado" - HandId: #19116069-656588-1701678163 - Holdem no limit (0.01€/0.02€) - 2023/12/04 08:22:43 UTC
Table: 'Colorado' 6-max (real money) Seat #6 is the button
Seat 1: rigolodlazac (2.37€)
Seat 2: jdeepenslip (2.82€)
Seat 3: Fried Berg (0.49€)
Seat 4: fabrice8551 (1.68€)
Seat 5: mymag (0.41€)
Seat 6: Sebidu57 (9.48€)
*** ANTE/BLINDS ***
rigolodlazac posts small blind 0.01€
jdeepenslip posts big blind 0.02€
Dealt to Fried Berg [7c Jh]
*** PRE-FLOP *** 
Fried Berg folds
fabrice8551 folds
mymag folds
Sebidu57 raises 0.03€ to 0.05€
rigolodlazac folds
jdeepenslip raises 0.15€ to 0.20€
Sebidu57 folds
jdeepenslip collected 0.26€ from pot
*** SUMMARY ***
Total pot 0.26€ | No rake
Seat 2: jdeepenslip (big blind) won 0.26€


Winamax Poker - HOLD-UP "Colorado" - HandId: #19116069-656590-1701678164 - Holdem no limit (0.01€/0.02€) - 2023/12/04 08:22:44 UTC
Table: 'Colorado' 6-max (real money) Seat #6 is the button
Seat 1: Bunny37 (2.58€)
Seat 2: DigBick99 (5.25€)
Seat 3: Fried Berg (0.49€)
Seat 4: Halmosthard (2.30€)
Seat 5: Killim (2.19€)
Seat 6: pasquale202a (2.49€)
*** ANTE/BLINDS ***
Bunny37 posts small blind 0.01€
DigBick99 posts big blind 0.02€
Dealt to Fried Berg [Jh 3c]
*** PRE-FLOP *** 
Fried Berg folds
Halmosthard calls 0.02€
Killim folds
pasquale202a folds
Bunny37 raises 0.03€ to 0.05€
DigBick99 folds
Halmosthard calls 0.03€
*** FLOP *** [Ts 6h 5s]
Bunny37 checks
Halmosthard bets 0.04€
Bunny37 calls 0.04€
*** TURN *** [Ts 6h 5s][4c]
Bunny37 bets 0.13€
Halmosthard calls 0.13€
*** RIVER *** [Ts 6h 5s 4c][Js]
Bunny37 bets 0.16€
Halmosthard calls 0.16€
*** SHOW DOWN ***
Halmosthard shows [Td 9h] (One pair : Tens)
Bunny37 shows [Kh Tc] (One pair : Tens)
Bunny37 collected 0.70€ from pot
*** SUMMARY ***
Total pot 0.70€ | Rake 0.08€
Board: [Ts 6h 5s 4c Js]
Seat 1: Bunny37 (small blind) showed [Kh Tc] and won 0.70€ with One pair : Tens
Seat 4: Halmosthard showed [Td 9h] and lost with One pair : Tens


Winamax Poker - HOLD-UP "Colorado" - HandId: #19116069-656592-1701678167 - Holdem no limit (0.01€/0.02€) - 2023/12/04 08:22:47 UTC
Table: 'Colorado' 6-max (real money) Seat #6 is the button
Seat 1: Killim (2.19€)
Seat 2: Koinagaray (2€)
Seat 3: fabrice8551 (1.68€)
Seat 4: Fried Berg (0.49€)
Seat 5: MoneyGrowing (2.03€)
Seat 6: mymag (0.41€)
*** ANTE/BLINDS ***
Killim posts small blind 0.01€
Koinagaray posts big blind 0.02€
Dealt to Fried Berg [Kd 4h]
*** PRE-FLOP *** 
fabrice8551 raises 0.05€ to 0.07€
Fried Berg folds
MoneyGrowing folds
mymag folds
Killim folds
Koinagaray folds
fabrice8551 collected 0.10€ from pot
*** SUMMARY ***
Total pot 0.10€ | No rake
Seat 3: fabrice8551 won 0.10€


Winamax Poker - HOLD-UP "Colorado" - HandId: #19116069-656595-1701678170 - Holdem no limit (0.01€/0.02€) - 2023/12/04 08:22:50 UTC
Table: 'Colorado' 6-max (real money) Seat #6 is the button
Seat 1: Levanball18 (0.50€)
Seat 2: rigolodlazac (2.36€)
Seat 3: Redemption90 (2.12€)
Seat 4: DuroDePelar (2€)
Seat 5: Fried Berg (0.49€)
Seat 6: MoneyGrowing (2.03€)
*** ANTE/BLINDS ***
Levanball18 posts small blind 0.01€
rigolodlazac posts big blind 0.02€
Dealt to Fried Berg [5c 7s]
*** PRE-FLOP *** 
Redemption90 folds
DuroDePelar folds
Fried Berg folds
MoneyGrowing raises 0.04€ to 0.06€
Levanball18 folds
rigolodlazac calls 0.04€
*** FLOP *** [7d 9h 2h]
rigolodlazac checks
MoneyGrowing checks
*** TURN *** [7d 9h 2h][6s]
rigolodlazac bets 0.08€
MoneyGrowing folds
rigolodlazac collected 0.20€ from pot
*** SUMMARY ***
Total pot 0.20€ | Rake 0.01€
Board: [7d 9h 2h 6s]
Seat 2: rigolodlazac (big blind) won 0.20€


Winamax Poker - HOLD-UP "Colorado" - HandId: #19116069-656598-1701678175 - Holdem no limit (0.01€/0.02€) - 2023/12/04 08:22:55 UTC
Table: 'Colorado' 6-max (real money) Seat #6 is the button
Seat 1: Redemption90 (2.12€)
Seat 2: Fried Berg (0.49€)
Seat 3: Levanball18 (0.49€)
Seat 4: DuroDePelar (2€)
Seat 5: Richardmill (3.52€)
Seat 6: nda94 (0.26€)
*** ANTE/BLINDS ***
Redemption90 posts small blind 0.01€
Fried Berg posts big blind 0.02€
Dealt to Fried Berg [Tc 2d]
*** PRE-FLOP *** 
Levanball18 raises 0.02€ to 0.04€
DuroDePelar folds
Richardmill folds
nda94 calls 0.04€
Redemption90 folds
Fried Berg folds
*** FLOP *** [9d 5c Jd]
Levanball18 bets 0.07€
nda94 folds
Levanball18 collected 0.17€ from pot
*** SUMMARY ***
Total pot 0.17€ | Rake 0.01€
Board: [9d 5c Jd]
Seat 3: Levanball18 won 0.17€


Winamax Poker - HOLD-UP "Colorado" - HandId: #19116069-656606-1701678187 - Holdem no limit (0.01€/0.02€) - 2023/12/04 08:23:07 UTC
Table: 'Colorado' 6-max (real money) Seat #6 is the button
Seat 1: Fried Berg (0.47€)
Seat 2: Killim (2.16€)
Seat 3: nonoleboucan (2.10€)
Seat 4: muespachois1 (2.07€)
Seat 5: TheRealWill (3.01€)
Seat 6: Sebidu57 (9.43€)
*** ANTE/BLINDS ***
Fried Berg posts small blind 0.01€
Killim posts big blind 0.02€
Dealt to Fried Berg [Kh 4h]
*** PRE-FLOP *** 
nonoleboucan folds
muespachois1 folds
TheRealWill folds
Sebidu57 calls 0.02€
Fried Berg calls 0.01€
Killim checks
*** FLOP *** [3c Qh Ts]
Fried Berg checks
Killim checks
Sebidu57 bets 0.02€
Fried Berg folds
Killim calls 0.02€
*** TURN *** [3c Qh Ts][Qd]
Killim checks
Sebidu57 checks
*** RIVER *** [3c Qh Ts Qd][7c]
Killim bets 0.07€
Sebidu57 folds
Killim collected 0.16€ from pot
*** SUMMARY ***
Total pot 0.16€ | Rake 0.01€
Board: [3c Qh Ts Qd 7c]
Seat 2: Killim (big blind) won 0.16€


Winamax Poker - HOLD-UP "Colorado" - HandId: #19116069-656642-1701678229 - Holdem no limit (0.01€/0.02€) - 2023/12/04 08:23:49 UTC
Table: 'Colorado' 6-max (real money) Seat #6 is the button
Seat 1: Ju973asse (1.95€)
Seat 2: Redemption90 (4.30€)
Seat 3: jdeepenslip (2€)
Seat 4: nonoleboucan (2.13€)
Seat 5: Matofs (2€)
Seat 6: Fried Berg (0.45€)
*** ANTE/BLINDS ***
Ju973asse posts small blind 0.01€
Redemption90 posts big blind 0.02€
Dealt to Fried Berg [3s 3d]
*** PRE-FLOP *** 
jdeepenslip folds
nonoleboucan folds
Matofs folds
Fried Berg raises 0.02€ to 0.04€
Ju973asse folds
Redemption90 calls 0.02€
*** FLOP *** [6d Js 9c]
Redemption90 checks
Fried Berg bets 0.12€
Redemption90 folds
Fried Berg collected 0.20€ from pot
*** SUMMARY ***
Total pot 0.20€ | Rake 0.01€
Board: [6d Js 9c]
Seat 6: Fried Berg (button) won 0.20€


Winamax Poker - HOLD-UP "Colorado" - HandId: #19116069-656684-1701678280 - Holdem no limit (0.01€/0.02€) - 2023/12/04 08:24:40 UTC
Table: 'Colorado' 6-max (real money) Seat #6 is the button
Seat 1: badou29 (3.25€)
Seat 2: Piexxxe10 (1.56€)
Seat 3: Jose A. W_18 (2€)
Seat 4: Redemption90 (2€)
Seat 5: Richardmill (3.41€)
Seat 6: Fried Berg (0.49€)
Hold-up to Pot: total 0.20€
*** ANTE/BLINDS ***
badou29 posts small blind 0.01€
Piexxxe10 posts big blind 0.02€
Dealt to Fried Berg [As 7h]
*** PRE-FLOP *** 
Jose A. W_18 raises 0.04€ to 0.06€
Redemption90 folds
Richardmill folds
Fried Berg raises 0.18€ to 0.24€
badou29 folds
Piexxxe10 folds
Jose A. W_18 raises 0.18€ to 0.42€
Fried Berg raises 0.07€ to 0.49€ and is all-in
Jose A. W_18 calls 0.07€
*** FLOP *** [5h 9s 2c]
*** TURN *** [5h 9s 2c][6s]
*** RIVER *** [5h 9s 2c 6s][8c]
*** SHOW DOWN ***
Jose A. W_18 shows [Ac Qs] (High card : Ace)
Fried Berg shows [As 7h] (Straight 9 high)
Fried Berg collected 1.11€ from pot
*** SUMMARY ***
Total pot 1.11€ | Rake 0.10€
Board: [5h 9s 2c 6s 8c]
Seat 3: Jose A. W_18 showed [Ac Qs] and lost with High card : Ace
Seat 6: Fried Berg (button) showed [As 7h] and won 1.11€ with Straight 9 high


Winamax Poker - HOLD-UP "Colorado" - HandId: #19116069-656714-1701678334 - Holdem no limit (0.01€/0.02€) - 2023/12/04 08:25:34 UTC
Table: 'Colorado' 6-max (real money) Seat #6 is the button
Seat 1: liseau5312 (1.77€)
Seat 2: jdeepenslip (3.06€)
Seat 3: Matofs (4.95€)
Seat 4: Fried Berg (1.11€)
Seat 5: Fandelpoker (2€)
Seat 6: DuroDePelar (2.03€)
*** ANTE/BLINDS ***
liseau5312 posts small blind 0.01€
jdeepenslip posts big blind 0.02€
Dealt to Fried Berg [3d 4h]
*** PRE-FLOP *** 
Matofs folds
Fried Berg folds
Fandelpoker raises 0.04€ to 0.06€
DuroDePelar raises 0.12€ to 0.18€
liseau5312 folds
jdeepenslip folds
Fandelpoker calls 0.12€
*** FLOP *** [8h Js Jh]
Fandelpoker checks
DuroDePelar bets 0.16€
Fandelpoker folds
DuroDePelar collected 0.51€ from pot
*** SUMMARY ***
Total pot 0.51€ | Rake 0.04€
Board: [8h Js Jh]
Seat 6: DuroDePelar (button) won 0.51€


Winamax Poker - HOLD-UP "Colorado" - HandId: #19116069-656729-1701678350 - Holdem no limit (0.01€/0.02€) - 2023/12/04 08:25:50 UTC
Table: 'Colorado' 6-max (real money) Seat #6 is the button
Seat 1: Fried Berg (1.11€)
Seat 2: liseau5312 (1.76€)
Seat 3: TheRealWill (2.13€)
Seat 4: pasquale202a (4.06€)
Seat 5: mixtep (3.73€)
Seat 6: fabrice8551 (2.15€)
*** ANTE/BLINDS ***
Fried Berg posts small blind 0.01€
liseau5312 posts big blind 0.02€
Dealt to Fried Berg [7s Qc]
*** PRE-FLOP *** 
TheRealWill folds
pasquale202a raises 0.04€ to 0.06€
mixtep folds
fabrice8551 folds
Fried Berg folds
liseau5312 folds
pasquale202a collected 0.09€ from pot
*** SUMMARY ***
Total pot 0.09€ | No rake
Seat 4: pasquale202a won 0.09€


Winamax Poker - HOLD-UP "Colorado" - HandId: #19116069-656735-1701678358 - Holdem no limit (0.01€/0.02€) - 2023/12/04 08:25:58 UTC
Table: 'Colorado' 6-max (real money) Seat #6 is the button
Seat 1: dan.doc (1.56€)
Seat 2: DigBick99 (5.11€)
Seat 3: tout- DTC (2.79€)
Seat 4: Fried Berg (1.10€)
Seat 5: HardiGibbon2 (3.78€)
Seat 6: TheRealWill (2.13€)
*** ANTE/BLINDS ***
dan.doc posts small blind 0.01€
DigBick99 posts big blind 0.02€
Dealt to Fried Berg [Qh Ac]
*** PRE-FLOP *** 
tout- DTC folds
Fried Berg raises 0.02€ to 0.04€
HardiGibbon2 calls 0.04€
TheRealWill folds
dan.doc folds
DigBick99 folds
*** FLOP *** [7h 7s Jh]
Fried Berg bets 0.06€
HardiGibbon2 folds
Fried Berg collected 0.16€ from pot
*** SUMMARY ***
Total pot 0.16€ | Rake 0.01€
Board: [7h 7s Jh]
Seat 4: Fried Berg won 0.16€


Winamax Poker - HOLD-UP "Colorado" - HandId: #19116069-656764-1701678404 - Holdem no limit (0.01€/0.02€) - 2023/12/04 08:26:44 UTC
Table: 'Colorado' 6-max (real money) Seat #6 is the button
Seat 1: Richardmill (3.17€)
Seat 2: DuroDePelar (3.32€)
Seat 3: Bunny37 (2.74€)
Seat 4: pasquale202a (4.06€)
Seat 5: TheRealWill (2.03€)
Seat 6: Fried Berg (1.16€)
Hold-up to Pot: total 0.10€
*** ANTE/BLINDS ***
Richardmill posts small blind 0.01€
DuroDePelar posts big blind 0.02€
Dealt to Fried Berg [9c 2s]
*** PRE-FLOP *** 
Bunny37 folds
pasquale202a calls 0.02€
TheRealWill folds
Fried Berg folds
Richardmill folds
DuroDePelar checks
*** FLOP *** [3c Kd Jh]
DuroDePelar checks
pasquale202a checks
*** TURN *** [3c Kd Jh][4h]
DuroDePelar bets 0.06€
pasquale202a folds
DuroDePelar collected 0.20€ from pot
*** SUMMARY ***
Total pot 0.20€ | Rake 0.01€
Board: [3c Kd Jh 4h]
Seat 2: DuroDePelar (big blind) won 0.20€


Winamax Poker - HOLD-UP "Colorado" - HandId: #19116069-656769-1701678410 - Holdem no limit (0.01€/0.02€) - 2023/12/04 08:26:50 UTC
Table: 'Colorado' 6-max (real money) Seat #6 is the button
Seat 1: dan.doc (1.51€)
Seat 2: Fried Berg (1.16€)
Seat 3: pastel.55786 (2.03€)
Seat 4: Richardmill (3.16€)
Seat 5: Matofs (5€)
Seat 6: VR_King14 (0.82€)
*** ANTE/BLINDS ***
dan.doc posts small blind 0.01€
Fried Berg posts big blind 0.02€
Dealt to Fried Berg [5h 6c]
*** PRE-FLOP *** 
pastel.55786 raises 0.02€ to 0.04€
Richardmill folds
Matofs calls 0.04€
VR_King14 folds
dan.doc folds
Fried Berg folds
*** FLOP *** [Td Js 9d]
pastel.55786 checks
Matofs bets 0.10€
pastel.55786 calls 0.10€
*** TURN *** [Td Js 9d][2d]
pastel.55786 checks
Matofs bets 0.24€
pastel.55786 calls 0.24€
*** RIVER *** [Td Js 9d 2d][9h]
pastel.55786 checks
Matofs bets 0.59€
pastel.55786 calls 0.59€
*** SHOW DOWN ***
pastel.55786 shows [Ks Jc] (Two pairs : Jacks and 9)
Matofs shows [Ad 7d] (Flush Ace high)
Matofs collected 1.77€ from pot
*** SUMMARY ***
Total pot 1.77€ | Rake 0.20€
Board: [Td Js 9d 2d 9h]
Seat 3: pastel.55786 showed [Ks Jc] and lost with Two pairs : Jacks and 9
Seat 5: Matofs showed [Ad 7d] and won 1.77€ with Flush Ace high


Winamax Poker - HOLD-UP "Colorado" - HandId: #19116069-656773-1701678414 - Holdem no limit (0.01€/0.02€) - 2023/12/04 08:26:54 UTC
Table: 'Colorado' 6-max (real money) Seat #6 is the button
Seat 1: Fried Berg (1.14€)
Seat 2: muespachois1 (3.78€)
Seat 3: fabrice8551 (1.80€)
Seat 4: Levanball18 (0.66€)
Seat 5: dan.doc (1.50€)
Seat 6: FC_Ghost1 (1.97€)
*** ANTE/BLINDS ***
Fried Berg posts small blind 0.01€
muespachois1 posts big blind 0.02€
Dealt to Fried Berg [Kh Jc]
*** PRE-FLOP *** 
fabrice8551 folds
Levanball18 folds
dan.doc folds
FC_Ghost1 folds
Fried Berg raises 0.02€ to 0.04€
muespachois1 calls 0.02€
*** FLOP *** [As 7d 5c]
Fried Berg checks
muespachois1 checks
*** TURN *** [As 7d 5c][Td]
Fried Berg checks
muespachois1 checks
*** RIVER *** [As 7d 5c Td][Jh]
Fried Berg bets 0.02€
muespachois1 calls 0.02€
*** SHOW DOWN ***
muespachois1 shows [7s 6s] (One pair : 7)
Fried Berg shows [Kh Jc] (One pair : Jacks)
Fried Berg collected 0.11€ from pot
*** SUMMARY ***
Total pot 0.11€ | Rake 0.01€
Board: [As 7d 5c Td Jh]
Seat 1: Fried Berg (small blind) showed [Kh Jc] and won 0.11€ with One pair : Jacks
Seat 2: muespachois1 (big blind) showed [7s 6s] and lost with One pair : 7


Winamax Poker - HOLD-UP "Colorado" - HandId: #19116069-656801-1701678454 - Holdem no limit (0.01€/0.02€) - 2023/12/04 08:27:34 UTC
Table: 'Colorado' 6-max (real money) Seat #6 is the button
Seat 1: muespachois1 (3.72€)
Seat 2: Fried Berg (1.19€)
Seat 3: DigBick99 (5.08€)
Seat 4: Redemption90 (4.49€)
Seat 5: Jokerchess10 (2.64€)
Seat 6: jdeepenslip (2.15€)
Hold-up to Pot: total 0.10€
*** ANTE/BLINDS ***
muespachois1 posts small blind 0.01€
Fried Berg posts big blind 0.02€
Dealt to Fried Berg [7d 9h]
*** PRE-FLOP *** 
DigBick99 raises 0.04€ to 0.06€
Redemption90 folds
Jokerchess10 folds
jdeepenslip calls 0.06€
muespachois1 calls 0.05€
Fried Berg folds
*** FLOP *** [Jd 9s Kd]
muespachois1 checks
DigBick99 checks
jdeepenslip checks
*** TURN *** [Jd 9s Kd][As]
muespachois1 checks
DigBick99 checks
jdeepenslip bets 0.20€
muespachois1 folds
DigBick99 folds
jdeepenslip collected 0.48€ from pot
*** SUMMARY ***
Total pot 0.48€ | Rake 0.02€
Board: [Jd 9s Kd As]
Seat 6: jdeepenslip (button) won 0.48€


Winamax Poker - HOLD-UP "Colorado" - HandId: #19116069-656835-1701678499 - Holdem no limit (0.01€/0.02€) - 2023/12/04 08:28:19 UTC
Table: 'Colorado' 6-max (real money) Seat #6 is the button
Seat 1: Redemption90 (5.27€)
Seat 2: pasquale202a (1.21€)
Seat 3: Fried Berg (1.17€)
Seat 4: Thequeen1205 (2.35€)
Seat 5: DuroDePelar (2.73€)
Seat 6: Masterab (0.29€)
*** ANTE/BLINDS ***
Redemption90 posts small blind 0.01€
pasquale202a posts big blind 0.02€
Dealt to Fried Berg [Ad 3d]
*** PRE-FLOP *** 
Fried Berg raises 0.02€ to 0.04€
Thequeen1205 folds
DuroDePelar raises 0.08€ to 0.12€
Masterab folds
Redemption90 folds
pasquale202a folds
Fried Berg folds
DuroDePelar collected 0.19€ from pot
*** SUMMARY ***
Total pot 0.19€ | No rake
Seat 5: DuroDePelar won 0.19€


Winamax Poker - HOLD-UP "Colorado" - HandId: #19116069-656860-1701678530 - Holdem no limit (0.01€/0.02€) - 2023/12/04 08:28:50 UTC
Table: 'Colorado' 6-max (real money) Seat #6 is the button
Seat 1: badou29 (3.77€)
Seat 2: pasquale202a (4.19€)
Seat 3: DigBick99 (2.84€)
Seat 4: Thequeen1205 (4.17€)
Seat 5: LilRun (3.06€)
Seat 6: Fried Berg (1.13€)
*** ANTE/BLINDS ***
badou29 posts small blind 0.01€
pasquale202a posts big blind 0.02€
Dealt to Fried Berg [9d Ad]
*** PRE-FLOP *** 
DigBick99 folds
Thequeen1205 folds
LilRun folds
Fried Berg raises 0.02€ to 0.04€
badou29 calls 0.03€
pasquale202a calls 0.02€
*** FLOP *** [6d 2h Qs]
badou29 checks
pasquale202a checks
Fried Berg bets 0.06€
badou29 folds
pasquale202a folds
Fried Berg collected 0.17€ from pot
*** SUMMARY ***
Total pot 0.17€ | Rake 0.01€
Board: [6d 2h Qs]
Seat 6: Fried Berg (button) won 0.17€


Winamax Poker - HOLD-UP "Colorado" - HandId: #19116069-656903-1701678583 - Holdem no limit (0.01€/0.02€) - 2023/12/04 08:29:43 UTC
Table: 'Colorado' 6-max (real money) Seat #6 is the button
Seat 1: BAVAROIS09 (0.56€)
Seat 2: _Sephi (2.19€)
Seat 3: dan.doc (1.69€)
Seat 4: DigBick99 (2.29€)
Seat 5: Fried Berg (1.20€)
Seat 6: pasquale202a (1.13€)
*** ANTE/BLINDS ***
BAVAROIS09 posts small blind 0.01€
_Sephi posts big blind 0.02€
Dealt to Fried Berg [Ac 6d]
*** PRE-FLOP *** 
dan.doc calls 0.02€
DigBick99 folds
Fried Berg folds
pasquale202a folds
BAVAROIS09 calls 0.01€
_Sephi checks
*** FLOP *** [Jh Th Td]
BAVAROIS09 checks
_Sephi checks
dan.doc checks
*** TURN *** [Jh Th Td][Ts]
BAVAROIS09 checks
_Sephi checks
dan.doc bets 0.02€
BAVAROIS09 calls 0.02€
_Sephi folds
*** RIVER *** [Jh Th Td Ts][6s]
BAVAROIS09 checks
dan.doc bets 0.08€
BAVAROIS09 folds
dan.doc collected 0.17€ from pot
*** SUMMARY ***
Total pot 0.17€ | Rake 0.01€
Board: [Jh Th Td Ts 6s]
Seat 3: dan.doc won 0.17€


Winamax Poker - HOLD-UP "Colorado" - HandId: #19116069-656911-1701678594 - Holdem no limit (0.01€/0.02€) - 2023/12/04 08:29:54 UTC
Table: 'Colorado' 6-max (real money) Seat #6 is the button
Seat 1: Jmim911 (0.48€)
Seat 2: Amazigh 78 (1.99€)
Seat 3: Jose A. W_18 (2.10€)
Seat 4: Alexis-paris (1.79€)
Seat 5: CrazyBlutch (2.65€)
Seat 6: Fried Berg (1.20€)
*** ANTE/BLINDS ***
Jmim911 posts small blind 0.01€
Amazigh 78 posts big blind 0.02€
Dealt to Fried Berg [Kc 5d]
*** PRE-FLOP *** 
Jose A. W_18 raises 0.04€ to 0.06€
Alexis-paris folds
CrazyBlutch folds
Fried Berg folds
Jmim911 folds
Amazigh 78 calls 0.04€
*** FLOP *** [7c Ac 3d]
Amazigh 78 bets 0.02€
Jose A. W_18 raises 0.17€ to 0.19€
Amazigh 78 calls 0.17€
*** TURN *** [7c Ac 3d][Th]
Amazigh 78 checks
Jose A. W_18 bets 0.50€
Amazigh 78 calls 0.50€
*** RIVER *** [7c Ac 3d Th][3c]
Amazigh 78 bets 1.24€ and is all-in
Jose A. W_18 calls 1.24€
*** SHOW DOWN ***
Amazigh 78 shows [Ah 4s] (Two pairs : Aces and 3)
Jose A. W_18 shows [7h 7s] (Full of 7 and 3)
Jose A. W_18 collected 3.59€ from pot
*** SUMMARY ***
Total pot 3.59€ | Rake 0.40€
Board: [7c Ac 3d Th 3c]
Seat 2: Amazigh 78 (big blind) showed [Ah 4s] and lost with Two pairs : Aces and 3
Seat 3: Jose A. W_18 showed [7h 7s] and won 3.59€ with Full of 7 and 3


Winamax Poker - HOLD-UP "Colorado" - HandId: #19116069-656954-1701678641 - Holdem no limit (0.01€/0.02€) - 2023/12/04 08:30:41 UTC
Table: 'Colorado' 6-max (real money) Seat #6 is the button
Seat 1: scach-111 (2.01€)
Seat 2: DuroDePelar (3.31€)
Seat 3: BAVAROIS09 (0.52€)
Seat 4: Fried Berg (1.20€)
Seat 5: Thequeen1205 (2.20€)
Seat 6: DigBick99 (2.85€)
*** ANTE/BLINDS ***
scach-111 posts small blind 0.01€
DuroDePelar posts big blind 0.02€
Dealt to Fried Berg [Jc Ks]
*** PRE-FLOP *** 
BAVAROIS09 raises 0.05€ to 0.07€
Fried Berg calls 0.07€
Thequeen1205 folds
DigBick99 folds
scach-111 calls 0.06€
DuroDePelar folds
*** FLOP *** [9c Ac 8c]
scach-111 checks
BAVAROIS09 bets 0.23€
Fried Berg folds
scach-111 folds
BAVAROIS09 collected 0.44€ from pot
*** SUMMARY ***
Total pot 0.44€ | Rake 0.02€
Board: [9c Ac 8c]
Seat 3: BAVAROIS09 won 0.44€


Winamax Poker - HOLD-UP "Colorado" - HandId: #19116069-656982-1701678676 - Holdem no limit (0.01€/0.02€) - 2023/12/04 08:31:16 UTC
Table: 'Colorado' 6-max (real money) Seat #6 is the button
Seat 1: TimToBey (2.60€)
Seat 2: Matofs (3.83€)
Seat 3: packymaitre (1.90€)
Seat 4: MoneyGrowing (3.02€)
Seat 5: scach-111 (2€)
Seat 6: Fried Berg (1.13€)
Hold-up to Pot: total 0.10€
*** ANTE/BLINDS ***
TimToBey posts small blind 0.01€
Matofs posts big blind 0.02€
Dealt to Fried Berg [8s Jc]
*** PRE-FLOP *** 
packymaitre calls 0.02€
MoneyGrowing folds
scach-111 folds
Fried Berg folds
TimToBey calls 0.01€
Matofs checks
*** FLOP *** [7h Kc 5s]
TimToBey bets 0.11€
Matofs folds
packymaitre folds
TimToBey collected 0.26€ from pot
*** SUMMARY ***
Total pot 0.26€ | Rake 0.01€
Board: [7h Kc 5s]
Seat 1: TimToBey (small blind) won 0.26€


Winamax Poker - HOLD-UP "Colorado" - HandId: #19116069-656988-1701678684 - Holdem no limit (0.01€/0.02€) - 2023/12/04 08:31:24 UTC
Table: 'Colorado' 6-max (real money) Seat #6 is the button
Seat 1: Bunny37 (2.56€)
Seat 2: Jolicoeur977 (2.53€)
Seat 3: Fried Berg (1.13€)
Seat 4: DigBick99 (2.40€)
Seat 5: muespachois1 (3.59€)
Seat 6: scach-111 (2€)
*** ANTE/BLINDS ***
Bunny37 posts small blind 0.01€
Jolicoeur977 posts big blind 0.02€
Dealt to Fried Berg [7c 8h]
*** PRE-FLOP *** 
Fried Berg folds
DigBick99 folds
muespachois1 folds
scach-111 folds
Bunny37 folds
Jolicoeur977 collected 0.03€ from pot
*** SUMMARY ***
Total pot 0.03€ | No rake
Seat 2: Jolicoeur977 (big blind) won 0.03€


Winamax Poker - HOLD-UP "Colorado" - HandId: #19116069-656991-1701678686 - Holdem no limit (0.01€/0.02€) - 2023/12/04 08:31:26 UTC
Table: 'Colorado' 6-max (real money) Seat #6 is the button
Seat 1: MrFlash9 (3.92€)
Seat 2: sAArtouKK (2€)
Seat 3: Thequeen1205 (2€)
Seat 4: BAVAROIS09 (0.66€)
Seat 5: Fried Berg (1.13€)
Seat 6: scach-111 (2€)
*** ANTE/BLINDS ***
MrFlash9 posts small blind 0.01€
sAArtouKK posts big blind 0.02€
Dealt to Fried Berg [5c 5h]
*** PRE-FLOP *** 
Thequeen1205 folds
BAVAROIS09 folds
Fried Berg raises 0.02€ to 0.04€
scach-111 calls 0.04€
MrFlash9 calls 0.03€
sAArtouKK calls 0.02€
*** FLOP *** [Kh 9h Js]
MrFlash9 checks
sAArtouKK checks
Fried Berg checks
scach-111 checks
*** TURN *** [Kh 9h Js][As]
MrFlash9 bets 0.13€
sAArtouKK folds
Fried Berg folds
scach-111 calls 0.13€
*** RIVER *** [Kh 9h Js As][6c]
MrFlash9 bets 0.27€
scach-111 folds
MrFlash9 collected 0.65€ from pot
*** SUMMARY ***
Total pot 0.65€ | Rake 0.04€
Board: [Kh 9h Js As 6c]
Seat 1: MrFlash9 (small blind) won 0.65€


Winamax Poker - HOLD-UP "Colorado" - HandId: #19116069-657035-1701678739 - Holdem no limit (0.01€/0.02€) - 2023/12/04 08:32:19 UTC
Table: 'Colorado' 6-max (real money) Seat #6 is the button
Seat 1: sAArtouKK (2€)
Seat 2: Jack Bruel (2€)
Seat 3: rigolodlazac (2.88€)
Seat 4: pasquale202a (3.93€)
Seat 5: Matofs (5.57€)
Seat 6: Fried Berg (1.09€)
*** ANTE/BLINDS ***
sAArtouKK posts small blind 0.01€
Jack Bruel posts big blind 0.02€
Dealt to Fried Berg [4d 2h]
*** PRE-FLOP *** 
rigolodlazac calls 0.02€
pasquale202a folds
Matofs folds
Fried Berg folds
sAArtouKK folds
Jack Bruel checks
*** FLOP *** [3h Kc Ah]
Jack Bruel checks
rigolodlazac bets 0.03€
Jack Bruel folds
rigolodlazac collected 0.07€ from pot
*** SUMMARY ***
Total pot 0.07€ | Rake 0.01€
Board: [3h Kc Ah]
Seat 3: rigolodlazac won 0.07€


Winamax Poker - HOLD-UP "Colorado" - HandId: #19116069-657059-1701678761 - Holdem no limit (0.01€/0.02€) - 2023/12/04 08:32:41 UTC
Table: 'Colorado' 6-max (real money) Seat #6 is the button
Seat 1: Fried Berg (1.09€)
Seat 2: COLAZERO (1€)
Seat 3: CrazyBlutch (2.76€)
Seat 4: mixtep (3.80€)
Seat 5: Jose A. W_18 (2€)
Seat 6: liseau5312 (1.34€)
*** ANTE/BLINDS ***
Fried Berg posts small blind 0.01€
COLAZERO posts big blind 0.02€
Dealt to Fried Berg [Jc 5h]
*** PRE-FLOP *** 
CrazyBlutch folds
mixtep folds
Jose A. W_18 folds
liseau5312 folds
Fried Berg folds
COLAZERO collected 0.03€ from pot
*** SUMMARY ***
Total pot 0.03€ | No rake
Seat 2: COLAZERO (big blind) won 0.03€


Winamax Poker - HOLD-UP "Colorado" - HandId: #19116069-657068-1701678770 - Holdem no limit (0.01€/0.02€) - 2023/12/04 08:32:50 UTC
Table: 'Colorado' 6-max (real money) Seat #6 is the button
Seat 1: Jack Bruel (2€)
Seat 2: MCGHansen (2€)
Seat 3: Redemption90 (2.03€)
Seat 4: Piexxxe10 (1.48€)
Seat 5: DuroDePelar (3.27€)
Seat 6: Fried Berg (1.08€)
Hold-up to Pot: total 0.20€
*** ANTE/BLINDS ***
Jack Bruel posts small blind 0.01€
MCGHansen posts big blind 0.02€
Dealt to Fried Berg [Qd 4c]
*** PRE-FLOP *** 
Redemption90 folds
Piexxxe10 folds
DuroDePelar folds
Fried Berg folds
Jack Bruel folds
MCGHansen collected 0.23€ from pot
*** SUMMARY ***
Total pot 0.23€ | No rake
Seat 2: MCGHansen (big blind) won 0.23€


Winamax Poker - HOLD-UP "Colorado" - HandId: #19116069-657077-1701678780 - Holdem no limit (0.01€/0.02€) - 2023/12/04 08:33:00 UTC
Table: 'Colorado' 6-max (real money) Seat #6 is the button
Seat 1: pasquale202a (2.16€)
Seat 2: Fried Berg (1.08€)
Seat 3: AllDiamond (0.93€)
Seat 4: Thequeen1205 (2.03€)
Seat 5: Jack Bruel (2€)
Seat 6: MrFlash9 (4.16€)
*** ANTE/BLINDS ***
pasquale202a posts small blind 0.01€
Fried Berg posts big blind 0.02€
Dealt to Fried Berg [Ad 7d]
*** PRE-FLOP *** 
AllDiamond folds
Thequeen1205 folds
Jack Bruel raises 0.03€ to 0.05€
MrFlash9 folds
pasquale202a folds
Fried Berg calls 0.03€
*** FLOP *** [4h Ah 4d]
Fried Berg bets 0.04€
Jack Bruel calls 0.04€
*** TURN *** [4h Ah 4d][Ks]
Fried Berg checks
Jack Bruel bets 0.05€
Fried Berg calls 0.05€
*** RIVER *** [4h Ah 4d Ks][Jc]
Fried Berg checks
Jack Bruel checks
*** SHOW DOWN ***
Fried Berg shows [Ad 7d] (Two pairs : Aces and 4)
Jack Bruel shows [2c As] (Two pairs : Aces and 4)
Jack Bruel collected 0.13€ from pot
Fried Berg collected 0.13€ from pot
*** SUMMARY ***
Total pot 0.26€ | Rake 0.03€
Board: [4h Ah 4d Ks Jc]
Seat 2: Fried Berg (big blind) showed [Ad 7d] and won 0.13€ with Two pairs : Aces and 4
Seat 5: Jack Bruel showed [2c As] and won 0.13€ with Two pairs : Aces and 4


Winamax Poker - HOLD-UP "Colorado" - HandId: #19116069-657107-1701678821 - Holdem no limit (0.01€/0.02€) - 2023/12/04 08:33:41 UTC
Table: 'Colorado' 6-max (real money) Seat #6 is the button
Seat 1: Fried Berg (1.07€)
Seat 2: 48centaure (1.36€)
Seat 3: Redemption90 (1.85€)
Seat 4: pasquale202a (2.18€)
Seat 5: Ju973asse (2.24€)
Seat 6: Jack Bruel (2€)
*** ANTE/BLINDS ***
Fried Berg posts small blind 0.01€
48centaure posts big blind 0.02€
Dealt to Fried Berg [Ks 5s]
*** PRE-FLOP *** 
Redemption90 folds
pasquale202a folds
Ju973asse folds
Jack Bruel folds
Fried Berg folds
48centaure collected 0.03€ from pot
*** SUMMARY ***
Total pot 0.03€ | No rake
Seat 2: 48centaure (big blind) won 0.03€


Winamax Poker - HOLD-UP "Colorado" - HandId: #19116069-657142-1701678860 - Holdem no limit (0.01€/0.02€) - 2023/12/04 08:34:20 UTC
Table: 'Colorado' 6-max (real money) Seat #6 is the button
Seat 1: LOQping (0.54€)
Seat 2: sAArtouKK (2€)
Seat 3: NiggRice (2€)
Seat 4: Ju973asse (2.27€)
Seat 5: Fried Berg (1.06€)
Seat 6: jdeepenslip (2€)
*** ANTE/BLINDS ***
LOQping posts small blind 0.01€
sAArtouKK posts big blind 0.02€
Dealt to Fried Berg [4d 8d]
*** PRE-FLOP *** 
NiggRice folds
Ju973asse folds
Fried Berg folds
jdeepenslip folds
LOQping calls 0.01€
sAArtouKK checks
*** FLOP *** [3c 7d Kc]
LOQping checks
sAArtouKK checks
*** TURN *** [3c 7d Kc][Jd]
LOQping checks
sAArtouKK checks
*** RIVER *** [3c 7d Kc Jd][2s]
LOQping checks
sAArtouKK checks
*** SHOW DOWN ***
LOQping shows [4s As] (High card : Ace)
sAArtouKK shows [4c Ks] (One pair : Kings)
sAArtouKK collected 0.04€ from pot
*** SUMMARY ***
Total pot 0.04€ | No rake
Board: [3c 7d Kc Jd 2s]
Seat 1: LOQping (small blind) showed [4s As] and lost with High card : Ace
Seat 2: sAArtouKK (big blind) showed [4c Ks] and won 0.04€ with One pair : Kings


Winamax Poker - HOLD-UP "Colorado" - HandId: #19116069-664070-1701685537 - Holdem no limit (0.01€/0.02€) - 2023/12/04 10:25:37 UTC
Table: 'Colorado' 6-max (real money) Seat #6 is the button
Seat 1: PwedzaM (2.44€)
Seat 2: Fried Berg (0.50€)
Seat 3: Thequeen1205 (3.10€)
Seat 4: St. Germain (2€)
Seat 5: Yondaime M (2€)
Seat 6: franckyrud (1.98€)
*** ANTE/BLINDS ***
PwedzaM posts small blind 0.01€
Fried Berg posts big blind 0.02€
Dealt to Fried Berg [9h Kc]
*** PRE-FLOP *** 
Thequeen1205 folds
St. Germain folds
Yondaime M folds
franckyrud folds
PwedzaM calls 0.01€
Fried Berg checks
*** FLOP *** [5d Kh 9c]
PwedzaM checks
Fried Berg bets 0.04€
PwedzaM calls 0.04€
*** TURN *** [5d Kh 9c][7c]
PwedzaM checks
Fried Berg bets 0.08€
PwedzaM calls 0.08€
*** RIVER *** [5d Kh 9c 7c][9d]
PwedzaM bets 0.07€
Fried Berg raises 0.07€ to 0.14€
PwedzaM folds
Fried Berg collected 0.45€ from pot
*** SUMMARY ***
Total pot 0.45€ | Rake 0.04€
Board: [5d Kh 9c 7c 9d]
Seat 2: Fried Berg (big blind) won 0.45€


Winamax Poker - HOLD-UP "Colorado" - HandId: #19116069-664202-1701685625 - Holdem no limit (0.01€/0.02€) - 2023/12/04 10:27:05 UTC
Table: 'Colorado' 6-max (real money) Seat #6 is the button
Seat 1: Fried Berg (0.67€)
Seat 2: yann_Lord590 (0.47€)
Seat 3: S-aaron24 (3.97€)
Seat 4: rick26 (1.04€)
Seat 5: Johnytop (2.68€)
Seat 6: GTO-Mieko (2.06€)
Hold-up to Pot: total 0.10€
*** ANTE/BLINDS ***
Fried Berg posts small blind 0.01€
yann_Lord590 posts big blind 0.02€
Dealt to Fried Berg [Jc Kc]
*** PRE-FLOP *** 
S-aaron24 folds
rick26 folds
Johnytop folds
GTO-Mieko raises 0.04€ to 0.06€
Fried Berg raises 0.61€ to 0.67€ and is all-in
yann_Lord590 calls 0.45€ and is all-in
GTO-Mieko calls 0.61€
*** FLOP *** [6d 6c Ks]
*** TURN *** [6d 6c Ks][Jh]
*** RIVER *** [6d 6c Ks Jh][9s]
*** SHOW DOWN ***
yann_Lord590 shows [5c Tc] (One pair : 6)
GTO-Mieko shows [Ad 2d] (One pair : 6)
Fried Berg shows [Jc Kc] (Two pairs : Kings and Jacks)
Fried Berg collected 1.73€ from pot
*** SUMMARY ***
Total pot 1.73€ | Rake 0.18€
Board: [6d 6c Ks Jh 9s]
Seat 1: Fried Berg (small blind) showed [Jc Kc] and won 1.73€ with Two pairs : Kings and Jacks
Seat 2: yann_Lord590 (big blind) showed [5c Tc] and lost with One pair : 6
Seat 6: GTO-Mieko (button) showed [Ad 2d] and lost with One pair : 6


Winamax Poker - HOLD-UP "Colorado" - HandId: #19116069-664288-1701685683 - Holdem no limit (0.01€/0.02€) - 2023/12/04 10:28:03 UTC
Table: 'Colorado' 6-max (real money) Seat #6 is the button
Seat 1: Leneuf9 (1.99€)
Seat 2: tumbetjtepet (2.71€)
Seat 3: Fried Berg (1.73€)
Seat 4: Migueldo22 (2.07€)
Seat 5: GTO-Mieko (2€)
Seat 6: Thequeen1205 (5.62€)
*** ANTE/BLINDS ***
Leneuf9 posts small blind 0.01€
tumbetjtepet posts big blind 0.02€
Dealt to Fried Berg [3d Kc]
*** PRE-FLOP *** 
Fried Berg folds
Migueldo22 raises 0.03€ to 0.05€
GTO-Mieko raises 0.10€ to 0.15€
Thequeen1205 folds
Leneuf9 folds
tumbetjtepet folds
Migueldo22 folds
GTO-Mieko collected 0.23€ from pot
*** SUMMARY ***
Total pot 0.23€ | No rake
Seat 5: GTO-Mieko won 0.23€


Winamax Poker - HOLD-UP "Colorado" - HandId: #19116069-664296-1701685688 - Holdem no limit (0.01€/0.02€) - 2023/12/04 10:28:08 UTC
Table: 'Colorado' 6-max (real money) Seat #6 is the button
Seat 1: gimini (5.28€)
Seat 2: Trader2020 (1.51€)
Seat 3: TaBrEaMoI (3.81€)
Seat 4: Fried Berg (1.73€)
Seat 5: S-aaron24 (3.93€)
Seat 6: Magicienvav (1.41€)
*** ANTE/BLINDS ***
gimini posts small blind 0.01€
Trader2020 posts big blind 0.02€
Dealt to Fried Berg [9d 6c]
*** PRE-FLOP *** 
TaBrEaMoI folds
Fried Berg folds
S-aaron24 folds
Magicienvav folds
gimini folds
Trader2020 collected 0.03€ from pot
*** SUMMARY ***
Total pot 0.03€ | No rake
Seat 2: Trader2020 (big blind) won 0.03€


Winamax Poker - HOLD-UP "Colorado" - HandId: #19116069-664309-1701685698 - Holdem no limit (0.01€/0.02€) - 2023/12/04 10:28:18 UTC
Table: 'Colorado' 6-max (real money) Seat #6 is the button
Seat 1: stevebalboni (4.57€)
Seat 2: bandarra8520 (2€)
Seat 3: MoneyGrowing (2€)
Seat 4: tumbetjtepet (2.69€)
Seat 5: Fried Berg (1.73€)
Seat 6: Ga31k (2€)
*** ANTE/BLINDS ***
stevebalboni posts small blind 0.01€
bandarra8520 posts big blind 0.02€
Dealt to Fried Berg [5h 6s]
*** PRE-FLOP *** 
MoneyGrowing folds
tumbetjtepet folds
Fried Berg folds
Ga31k folds
stevebalboni folds
bandarra8520 collected 0.03€ from pot
*** SUMMARY ***
Total pot 0.03€ | No rake
Seat 2: bandarra8520 (big blind) won 0.03€


Winamax Poker - HOLD-UP "Colorado" - HandId: #19116069-664330-1701685713 - Holdem no limit (0.01€/0.02€) - 2023/12/04 10:28:33 UTC
Table: 'Colorado' 6-max (real money) Seat #6 is the button
Seat 1: S-aaron24 (4.56€)
Seat 2: MoneyGrowing (2€)
Seat 3: JLB berber (4.03€)
Seat 4: Ga31k (2€)
Seat 5: Thor99 (4.78€)
Seat 6: Fried Berg (1.73€)
*** ANTE/BLINDS ***
S-aaron24 posts small blind 0.01€
MoneyGrowing posts big blind 0.02€
Dealt to Fried Berg [Ac 5s]
*** PRE-FLOP *** 
JLB berber folds
Ga31k folds
Thor99 folds
Fried Berg raises 0.02€ to 0.04€
S-aaron24 calls 0.03€
MoneyGrowing folds
*** FLOP *** [8c As Jh]
S-aaron24 checks
Fried Berg bets 0.02€
S-aaron24 folds
Fried Berg collected 0.11€ from pot
*** SUMMARY ***
Total pot 0.11€ | Rake 0.01€
Board: [8c As Jh]
Seat 6: Fried Berg (button) won 0.11€


Winamax Poker - HOLD-UP "Colorado" - HandId: #19116069-664409-1701685774 - Holdem no limit (0.01€/0.02€) - 2023/12/04 10:29:34 UTC
Table: 'Colorado' 6-max (real money) Seat #6 is the button
Seat 1: Txoko_Txiki (0.88€)
Seat 2: Trader2020 (1.68€)
Seat 3: Leneuf9 (1.21€)
Seat 4: Fried Berg (1.78€)
Seat 5: FABIEN.1309 (4.24€)
Seat 6: _Croute_ (3.30€)
*** ANTE/BLINDS ***
Txoko_Txiki posts small blind 0.01€
Trader2020 posts big blind 0.02€
Dealt to Fried Berg [7s 2s]
*** PRE-FLOP *** 
Leneuf9 raises 0.04€ to 0.06€
Fried Berg folds
FABIEN.1309 calls 0.06€
_Croute_ folds
Txoko_Txiki folds
Trader2020 calls 0.04€
*** FLOP *** [Tc Jh 5d]
Trader2020 checks
Leneuf9 bets 0.07€
FABIEN.1309 calls 0.07€
Trader2020 folds
*** TURN *** [Tc Jh 5d][5h]
Leneuf9 bets 0.21€
FABIEN.1309 calls 0.21€
*** RIVER *** [Tc Jh 5d 5h][9c]
Leneuf9 bets 0.87€ and is all-in
FABIEN.1309 calls 0.87€
*** SHOW DOWN ***
FABIEN.1309 shows [Jd Ks] (Two pairs : Jacks and 5)
Leneuf9 shows [As Js] (Two pairs : Jacks and 5)
Leneuf9 collected 2.24€ from pot
*** SUMMARY ***
Total pot 2.24€ | Rake 0.25€
Board: [Tc Jh 5d 5h 9c]
Seat 3: Leneuf9 showed [As Js] and won 2.24€ with Two pairs : Jacks and 5
Seat 5: FABIEN.1309 showed [Jd Ks] and lost with Two pairs : Jacks and 5


Winamax Poker - HOLD-UP "Colorado" - HandId: #19116069-664419-1701685781 - Holdem no limit (0.01€/0.02€) - 2023/12/04 10:29:41 UTC
Table: 'Colorado' 6-max (real money) Seat #6 is the button
Seat 1: Jdeug (0.53€)
Seat 2: Fried Berg (1.78€)
Seat 3: Txoko_Txiki (0.87€)
Seat 4: Johnytop (2.91€)
Seat 5: Diego00gc (4.69€)
Seat 6: JLB berber (2.15€)
*** ANTE/BLINDS ***
Jdeug posts small blind 0.01€
Fried Berg posts big blind 0.02€
Dealt to Fried Berg [Ac Ad]
*** PRE-FLOP *** 
Txoko_Txiki folds
Johnytop folds
Diego00gc folds
JLB berber raises 0.04€ to 0.06€
Jdeug folds
Fried Berg raises 0.12€ to 0.18€
JLB berber folds
Fried Berg collected 0.25€ from pot
*** SUMMARY ***
Total pot 0.25€ | No rake
Seat 2: Fried Berg (big blind) won 0.25€


Winamax Poker - HOLD-UP "Colorado" - HandId: #19116069-664455-1701685801 - Holdem no limit (0.01€/0.02€) - 2023/12/04 10:30:01 UTC
Table: 'Colorado' 6-max (real money) Seat #6 is the button
Seat 1: Fried Berg (1.85€)
Seat 2: TaBrEaMoI (2.23€)
Seat 3: Neferusobek (2.01€)
Seat 4: Johnytop (2.91€)
Seat 5: FreeLaZL (2.08€)
Seat 6: QRIKS-27 (0.85€)
*** ANTE/BLINDS ***
Fried Berg posts small blind 0.01€
TaBrEaMoI posts big blind 0.02€
Dealt to Fried Berg [2c Tc]
*** PRE-FLOP *** 
Neferusobek folds
Johnytop folds
FreeLaZL folds
QRIKS-27 folds
Fried Berg folds
TaBrEaMoI collected 0.03€ from pot
*** SUMMARY ***
Total pot 0.03€ | No rake
Seat 2: TaBrEaMoI (big blind) won 0.03€


Winamax Poker - HOLD-UP "Colorado" - HandId: #19116069-664475-1701685814 - Holdem no limit (0.01€/0.02€) - 2023/12/04 10:30:14 UTC
Table: 'Colorado' 6-max (real money) Seat #6 is the button
Seat 1: nunsuka69 (2.55€)
Seat 2: RrAaCcHhEeLl (2€)
Seat 3: Fried Berg (1.84€)
Seat 4: Txoko_Txiki (1€)
Seat 5: badou29 (2.08€)
Seat 6: tumbetjtepet (2.49€)
*** ANTE/BLINDS ***
nunsuka69 posts small blind 0.01€
RrAaCcHhEeLl posts big blind 0.02€
Dealt to Fried Berg [5c 9s]
*** PRE-FLOP *** 
Fried Berg folds
Txoko_Txiki folds
badou29 folds
tumbetjtepet raises 0.03€ to 0.05€
nunsuka69 folds
RrAaCcHhEeLl folds
tumbetjtepet collected 0.08€ from pot
*** SUMMARY ***
Total pot 0.08€ | No rake
Seat 6: tumbetjtepet (button) won 0.08€


Winamax Poker - HOLD-UP "Colorado" - HandId: #19116069-664478-1701685816 - Holdem no limit (0.01€/0.02€) - 2023/12/04 10:30:16 UTC
Table: 'Colorado' 6-max (real money) Seat #6 is the button
Seat 1: PwedzaM (2.52€)
Seat 2: rick26 (0.99€)
Seat 3: Ga31k (2.04€)
Seat 4: Thequeen1205 (2.33€)
Seat 5: Fried Berg (1.84€)
Seat 6: Levanball18 (0.67€)
*** ANTE/BLINDS ***
PwedzaM posts small blind 0.01€
rick26 posts big blind 0.02€
Dealt to Fried Berg [4c 4d]
*** PRE-FLOP *** 
Ga31k folds
Thequeen1205 folds
Fried Berg raises 0.02€ to 0.04€
Levanball18 folds
PwedzaM folds
rick26 folds
Fried Berg collected 0.07€ from pot
*** SUMMARY ***
Total pot 0.07€ | No rake
Seat 5: Fried Berg won 0.07€


Winamax Poker - HOLD-UP "Colorado" - HandId: #19116069-664508-1701685833 - Holdem no limit (0.01€/0.02€) - 2023/12/04 10:30:33 UTC
Table: 'Colorado' 6-max (real money) Seat #6 is the button
Seat 1: Neferusobek (2.41€)
Seat 2: Ga31k (3.65€)
Seat 3: sundaedu84 (0.29€)
Seat 4: G0R0N11 (3.50€)
Seat 5: Fried Berg (1.87€)
Seat 6: FreeLaZL (2.07€)
*** ANTE/BLINDS ***
Neferusobek posts small blind 0.01€
Ga31k posts big blind 0.02€
Dealt to Fried Berg [3d 6c]
*** PRE-FLOP *** 
sundaedu84 calls 0.02€
G0R0N11 folds
Fried Berg folds
FreeLaZL folds
Neferusobek folds
Ga31k checks
*** FLOP *** [As Ac Jd]
Ga31k checks
sundaedu84 checks
*** TURN *** [As Ac Jd][Kc]
Ga31k checks
sundaedu84 checks
*** RIVER *** [As Ac Jd Kc][6s]
Ga31k checks
sundaedu84 checks
*** SHOW DOWN ***
sundaedu84 shows [4h 4d] (Two pairs : Aces and 4)
Ga31k shows [6h 2s] (Two pairs : Aces and 6)
Ga31k collected 0.04€ from pot
*** SUMMARY ***
Total pot 0.04€ | Rake 0.01€
Board: [As Ac Jd Kc 6s]
Seat 2: Ga31k (big blind) showed [6h 2s] and won 0.04€ with Two pairs : Aces and 6
Seat 3: sundaedu84 showed [4h 4d] and lost with Two pairs : Aces and 4


Winamax Poker - HOLD-UP "Colorado" - HandId: #19116069-664515-1701685837 - Holdem no limit (0.01€/0.02€) - 2023/12/04 10:30:37 UTC
Table: 'Colorado' 6-max (real money) Seat #6 is the button
Seat 1: Leneuf9 (2.24€)
Seat 2: Thequeen1205 (2.31€)
Seat 3: Levanball18 (0.68€)
Seat 4: Fried Berg (1.87€)
Seat 5: rick26 (1.93€)
Seat 6: RrAaCcHhEeLl (2€)
*** ANTE/BLINDS ***
Leneuf9 posts small blind 0.01€
Thequeen1205 posts big blind 0.02€
Dealt to Fried Berg [4c 8c]
*** PRE-FLOP *** 
Levanball18 folds
Fried Berg folds
rick26 folds
RrAaCcHhEeLl folds
Leneuf9 raises 0.04€ to 0.06€
Thequeen1205 calls 0.04€
*** FLOP *** [7h Kc 7c]
Leneuf9 bets 0.04€
Thequeen1205 calls 0.04€
*** TURN *** [7h Kc 7c][4h]
Leneuf9 bets 0.13€
Thequeen1205 calls 0.13€
*** RIVER *** [7h Kc 7c 4h][Ks]
Leneuf9 bets 0.37€
Thequeen1205 folds
Leneuf9 collected 0.78€ from pot
*** SUMMARY ***
Total pot 0.78€ | Rake 0.05€
Board: [7h Kc 7c 4h Ks]
Seat 1: Leneuf9 (small blind) won 0.78€


Winamax Poker - HOLD-UP "Colorado" - HandId: #19116069-664523-1701685843 - Holdem no limit (0.01€/0.02€) - 2023/12/04 10:30:43 UTC
Table: 'Colorado' 6-max (real money) Seat #6 is the button
Seat 1: Txoko_Txiki (1.83€)
Seat 2: Fried Berg (1.87€)
Seat 3: Magicienvav (1.42€)
Seat 4: slowreplay (2.42€)
Seat 5: Kkomental (2.10€)
Seat 6: Rasqual1110 (2.98€)
*** ANTE/BLINDS ***
Txoko_Txiki posts small blind 0.01€
Fried Berg posts big blind 0.02€
Dealt to Fried Berg [6c 3d]
*** PRE-FLOP *** 
Magicienvav folds
slowreplay raises 0.03€ to 0.05€
Kkomental folds
Rasqual1110 folds
Txoko_Txiki calls 0.04€
Fried Berg folds
*** FLOP *** [8s 9d Jc]
Txoko_Txiki bets 0.02€
slowreplay raises 0.14€ to 0.16€
Txoko_Txiki folds
slowreplay collected 0.28€ from pot
*** SUMMARY ***
Total pot 0.28€ | Rake 0.02€
Board: [8s 9d Jc]
Seat 4: slowreplay won 0.28€


Winamax Poker - HOLD-UP "Colorado" - HandId: #19116069-664667-1701685939 - Holdem no limit (0.01€/0.02€) - 2023/12/04 10:32:19 UTC
Table: 'Colorado' 6-max (real money) Seat #6 is the button
Seat 1: Fried Berg (1.85€)
Seat 2: matmyl (4.06€)
Seat 3: -genzo- (2€)
Seat 4: Thor99 (4.69€)
Seat 5: jeanpi 2B (1.58€)
Seat 6: franckyrud (1.81€)
*** ANTE/BLINDS ***
Fried Berg posts small blind 0.01€
matmyl posts big blind 0.02€
Dealt to Fried Berg [9h Qh]
*** PRE-FLOP *** 
-genzo- folds
Thor99 folds
jeanpi 2B folds
franckyrud folds
Fried Berg raises 0.02€ to 0.04€
matmyl calls 0.02€
*** FLOP *** [5s 5c 2c]
Fried Berg bets 0.04€
matmyl folds
Fried Berg collected 0.11€ from pot
*** SUMMARY ***
Total pot 0.11€ | Rake 0.01€
Board: [5s 5c 2c]
Seat 1: Fried Berg (small blind) won 0.11€


Winamax Poker - HOLD-UP "Colorado" - HandId: #19116069-664709-1701685963 - Holdem no limit (0.01€/0.02€) - 2023/12/04 10:32:43 UTC
Table: 'Colorado' 6-max (real money) Seat #6 is the button
Seat 1: Leneuf9 (1.51€)
Seat 2: cybok20001 (0.61€)
Seat 3: Fried Berg (1.88€)
Seat 4: jeanpi 2B (1.71€)
Seat 5: gimini (2.33€)
Seat 6: NoNo-MaHa2.0 (0.45€)
Hold-up to Pot: total 2€
*** ANTE/BLINDS ***
Leneuf9 posts small blind 0.01€
cybok20001 posts big blind 0.02€
Dealt to Fried Berg [Qh 4h]
*** PRE-FLOP *** 
Fried Berg folds
jeanpi 2B calls 0.02€
gimini calls 0.02€
NoNo-MaHa2.0 raises 0.43€ to 0.45€ and is all-in
Leneuf9 raises 1.06€ to 1.51€ and is all-in
cybok20001 folds
jeanpi 2B calls 1.49€
gimini calls 1.49€
*** FLOP *** [3d 6d 2h]
jeanpi 2B bets 0.20€ and is all-in
gimini calls 0.20€
*** TURN *** [3d 6d 2h][5c]
*** RIVER *** [3d 6d 2h 5c][Jc]
*** SHOW DOWN ***
gimini shows [5h Ah] (One pair : 5)
NoNo-MaHa2.0 shows [Ks Th] (High card : King)
Leneuf9 shows [4c Ad] (Straight 6 high)
jeanpi 2B shows [Qs Js] (One pair : Jacks)
jeanpi 2B collected 0.36€ from side pot 1
Leneuf9 collected 6.50€ from main pot
*** SUMMARY ***
Total pot 6.86€ | Rake 0.54€
Board: [3d 6d 2h 5c Jc]
Seat 1: Leneuf9 (small blind) showed [4c Ad] and won 6.50€ with Straight 6 high
Seat 4: jeanpi 2B showed [Qs Js] and won 0.36€ with One pair : Jacks
Seat 5: gimini showed [5h Ah] and lost with One pair : 5
Seat 6: NoNo-MaHa2.0 (button) showed [Ks Th] and lost with High card : King


Winamax Poker - HOLD-UP "Colorado" - HandId: #19116069-664725-1701685975 - Holdem no limit (0.01€/0.02€) - 2023/12/04 10:32:55 UTC
Table: 'Colorado' 6-max (real money) Seat #6 is the button
Seat 1: Kkomental (2.33€)
Seat 2: Migueldo22 (2.16€)
Seat 3: CB-Joker6274 (2.25€)
Seat 4: Direct Oli (1.80€)
Seat 5: matmyl (4.01€)
Seat 6: Fried Berg (1.88€)
*** ANTE/BLINDS ***
Kkomental posts small blind 0.01€
Migueldo22 posts big blind 0.02€
Dealt to Fried Berg [2h 9s]
*** PRE-FLOP *** 
CB-Joker6274 calls 0.02€
Direct Oli folds
matmyl raises 0.03€ to 0.05€
Fried Berg folds
Kkomental folds
Migueldo22 folds
CB-Joker6274 calls 0.03€
*** FLOP *** [9h Ks Qd]
CB-Joker6274 checks
matmyl checks
*** TURN *** [9h Ks Qd][Ts]
CB-Joker6274 bets 0.02€
matmyl folds
CB-Joker6274 collected 0.14€ from pot
*** SUMMARY ***
Total pot 0.14€ | Rake 0.01€
Board: [9h Ks Qd Ts]
Seat 3: CB-Joker6274 won 0.14€


Winamax Poker - HOLD-UP "Colorado" - HandId: #19116069-664739-1701685985 - Holdem no limit (0.01€/0.02€) - 2023/12/04 10:33:05 UTC
Table: 'Colorado' 6-max (real money) Seat #6 is the button
Seat 1: -genzo- (2€)
Seat 2: TaBrEaMoI (2€)
Seat 3: Justo_170382 (0.34€)
Seat 4: fishkingbull (4.36€)
Seat 5: Homer14510 (2€)
Seat 6: Fried Berg (1.88€)
*** ANTE/BLINDS ***
-genzo- posts small blind 0.01€
TaBrEaMoI posts big blind 0.02€
Dealt to Fried Berg [7c 3h]
*** PRE-FLOP *** 
Justo_170382 folds
fishkingbull folds
Homer14510 folds
Fried Berg folds
-genzo- folds
TaBrEaMoI collected 0.03€ from pot
*** SUMMARY ***
Total pot 0.03€ | No rake
Seat 2: TaBrEaMoI (big blind) won 0.03€


Winamax Poker - HOLD-UP "Colorado" - HandId: #19116069-664744-1701685988 - Holdem no limit (0.01€/0.02€) - 2023/12/04 10:33:08 UTC
Table: 'Colorado' 6-max (real money) Seat #6 is the button
Seat 1: Migueldo22 (2.14€)
Seat 2: Thequeen1205 (3.10€)
Seat 3: Fried Berg (1.88€)
Seat 4: Justo_170382 (0.33€)
Seat 5: Jokerchess10 (2.20€)
Seat 6: Homer14510 (2€)
*** ANTE/BLINDS ***
Migueldo22 posts small blind 0.01€
Thequeen1205 posts big blind 0.02€
Dealt to Fried Berg [Qc 9s]
*** PRE-FLOP *** 
Fried Berg folds
Justo_170382 raises 0.31€ to 0.33€ and is all-in
Jokerchess10 folds
Homer14510 folds
Migueldo22 folds
Thequeen1205 folds
Justo_170382 collected 0.36€ from pot
*** SUMMARY ***
Total pot 0.36€ | No rake
Seat 4: Justo_170382 won 0.36€


Winamax Poker - HOLD-UP "Colorado" - HandId: #19116069-664754-1701685995 - Holdem no limit (0.01€/0.02€) - 2023/12/04 10:33:15 UTC
Table: 'Colorado' 6-max (real money) Seat #6 is the button
Seat 1: FABIEN.1309 (3.32€)
Seat 2: Fried Berg (1.88€)
Seat 3: Migueldo22 (1.43€)
Seat 4: Tracman (2.06€)
Seat 5: PompoPeluche (1.88€)
Seat 6: Killim (1.20€)
*** ANTE/BLINDS ***
FABIEN.1309 posts small blind 0.01€
Fried Berg posts big blind 0.02€
Dealt to Fried Berg [Qc 6h]
*** PRE-FLOP *** 
Migueldo22 raises 0.03€ to 0.05€
Tracman raises 0.13€ to 0.18€
PompoPeluche folds
Killim folds
FABIEN.1309 folds
Fried Berg folds
Migueldo22 folds
Tracman collected 0.26€ from pot
*** SUMMARY ***
Total pot 0.26€ | No rake
Seat 4: Tracman won 0.26€


Winamax Poker - HOLD-UP "Colorado" - HandId: #19116069-664760-1701685998 - Holdem no limit (0.01€/0.02€) - 2023/12/04 10:33:18 UTC
Table: 'Colorado' 6-max (real money) Seat #6 is the button
Seat 1: wavega (1.74€)
Seat 2: fishkingbull (4.35€)
Seat 3: RrAaCcHhEeLl (2€)
Seat 4: Fried Berg (1.86€)
Seat 5: tumbetjtepet (2.58€)
Seat 6: TaBrEaMoI (2.14€)
*** ANTE/BLINDS ***
wavega posts small blind 0.01€
fishkingbull posts big blind 0.02€
Dealt to Fried Berg [Ah 3d]
*** PRE-FLOP *** 
RrAaCcHhEeLl folds
Fried Berg folds
tumbetjtepet folds
TaBrEaMoI folds
wavega folds
fishkingbull collected 0.03€ from pot
*** SUMMARY ***
Total pot 0.03€ | No rake
Seat 2: fishkingbull (big blind) won 0.03€


Winamax Poker - HOLD-UP "Colorado" - HandId: #19116069-664765-1701686000 - Holdem no limit (0.01€/0.02€) - 2023/12/04 10:33:20 UTC
Table: 'Colorado' 6-max (real money) Seat #6 is the button
Seat 1: Fried Berg (1.86€)
Seat 2: PwedzaM (3.42€)
Seat 3: Neferusobek (2.13€)
Seat 4: hello7585 (2.02€)
Seat 5: TaBrEaMoI (2.14€)
Seat 6: tumbetjtepet (2.57€)
*** ANTE/BLINDS ***
Fried Berg posts small blind 0.01€
PwedzaM posts big blind 0.02€
Dealt to Fried Berg [6s 4h]
*** PRE-FLOP *** 
Neferusobek folds
hello7585 folds
TaBrEaMoI folds
tumbetjtepet folds
Fried Berg folds
PwedzaM collected 0.03€ from pot
*** SUMMARY ***
Total pot 0.03€ | No rake
Seat 2: PwedzaM (big blind) won 0.03€


Winamax Poker - HOLD-UP "Colorado" - HandId: #19116069-664773-1701686004 - Holdem no limit (0.01€/0.02€) - 2023/12/04 10:33:24 UTC
Table: 'Colorado' 6-max (real money) Seat #6 is the button
Seat 1: sundaedu84 (0.37€)
Seat 2: Thequeen1205 (3.07€)
Seat 3: FreeLaZL (2.06€)
Seat 4: Trader2020 (1.99€)
Seat 5: Fried Berg (1.85€)
Seat 6: OLGUITA5 (0.91€)
*** ANTE/BLINDS ***
sundaedu84 posts small blind 0.01€
Thequeen1205 posts big blind 0.02€
Dealt to Fried Berg [4h Kc]
*** PRE-FLOP *** 
FreeLaZL raises 0.04€ to 0.06€
Trader2020 folds
Fried Berg folds
OLGUITA5 raises 0.85€ to 0.91€ and is all-in
sundaedu84 folds
Thequeen1205 folds
FreeLaZL folds
OLGUITA5 collected 1€ from pot
*** SUMMARY ***
Total pot 1€ | No rake
Seat 6: OLGUITA5 (button) won 1€


Winamax Poker - HOLD-UP "Colorado" - HandId: #19116069-664785-1701686009 - Holdem no limit (0.01€/0.02€) - 2023/12/04 10:33:29 UTC
Table: 'Colorado' 6-max (real money) Seat #6 is the button
Seat 1: GTO-Mieko (2.12€)
Seat 2: MrFlash9 (3.11€)
Seat 3: Johnytop (4.71€)
Seat 4: RrAaCcHhEeLl (2€)
Seat 5: PwedzaM (3.43€)
Seat 6: Fried Berg (1.85€)
*** ANTE/BLINDS ***
GTO-Mieko posts small blind 0.01€
MrFlash9 posts big blind 0.02€
Dealt to Fried Berg [9s 9d]
*** PRE-FLOP *** 
Johnytop raises 0.03€ to 0.05€
RrAaCcHhEeLl folds
PwedzaM folds
Fried Berg calls 0.05€
GTO-Mieko folds
MrFlash9 folds
*** FLOP *** [Qd 3d Jh]
Johnytop checks
Fried Berg bets 0.04€
Johnytop folds
Fried Berg collected 0.16€ from pot
*** SUMMARY ***
Total pot 0.16€ | Rake 0.01€
Board: [Qd 3d Jh]
Seat 6: Fried Berg (button) won 0.16€


Winamax Poker - HOLD-UP "Colorado" - HandId: #19116069-664852-1701686048 - Holdem no limit (0.01€/0.02€) - 2023/12/04 10:34:08 UTC
Table: 'Colorado' 6-max (real money) Seat #6 is the button
Seat 1: Johnytop (3.13€)
Seat 2: tumbetjtepet (3.27€)
Seat 3: sundaedu84 (0.38€)
Seat 4: _Croute_ (2.69€)
Seat 5: Fried Berg (1.92€)
Seat 6: Jokerchess10 (2.11€)
*** ANTE/BLINDS ***
Johnytop posts small blind 0.01€
tumbetjtepet posts big blind 0.02€
Dealt to Fried Berg [6s 7c]
*** PRE-FLOP *** 
sundaedu84 folds
_Croute_ folds
Fried Berg folds
Jokerchess10 folds
Johnytop raises 0.04€ to 0.06€
tumbetjtepet folds
Johnytop collected 0.08€ from pot
*** SUMMARY ***
Total pot 0.08€ | No rake
Seat 1: Johnytop (small blind) won 0.08€


Winamax Poker - HOLD-UP "Colorado" - HandId: #19116069-664863-1701686055 - Holdem no limit (0.01€/0.02€) - 2023/12/04 10:34:15 UTC
Table: 'Colorado' 6-max (real money) Seat #6 is the button
Seat 1: Diego00gc (4.48€)
Seat 2: Fried Berg (1.92€)
Seat 3: SirX (4.66€)
Seat 4: wavega (1.60€)
Seat 5: - Hyperion - (2.01€)
Seat 6: sundaedu84 (0.38€)
*** ANTE/BLINDS ***
Diego00gc posts small blind 0.01€
Fried Berg posts big blind 0.02€
Dealt to Fried Berg [5h 9d]
*** PRE-FLOP *** 
SirX raises 0.05€ to 0.07€
wavega folds
- Hyperion - folds
sundaedu84 folds
Diego00gc folds
Fried Berg folds
SirX collected 0.10€ from pot
*** SUMMARY ***
Total pot 0.10€ | No rake
Seat 3: SirX won 0.10€


Winamax Poker - HOLD-UP "Colorado" - HandId: #19116069-664880-1701686068 - Holdem no limit (0.01€/0.02€) - 2023/12/04 10:34:28 UTC
Table: 'Colorado' 6-max (real money) Seat #6 is the button
Seat 1: Fried Berg (1.90€)
Seat 2: FreeLaZL (2.66€)
Seat 3: wmx-6j46k48 (1.18€)
Seat 4: BAAC0 (3.42€)
Seat 5: TaBrEaMoI (2.11€)
Seat 6: Neferusobek (2.26€)
*** ANTE/BLINDS ***
Fried Berg posts small blind 0.01€
FreeLaZL posts big blind 0.02€
Dealt to Fried Berg [7s 5d]
*** PRE-FLOP *** 
wmx-6j46k48 calls 0.02€
BAAC0 folds
TaBrEaMoI folds
Neferusobek folds
Fried Berg folds
FreeLaZL checks
*** FLOP *** [5s 6d 5c]
FreeLaZL checks
wmx-6j46k48 checks
*** TURN *** [5s 6d 5c][Kh]
FreeLaZL bets 0.03€
wmx-6j46k48 calls 0.03€
*** RIVER *** [5s 6d 5c Kh][Ts]
FreeLaZL checks
wmx-6j46k48 checks
*** SHOW DOWN ***
FreeLaZL shows [2h 8h] (One pair : 5)
wmx-6j46k48 shows [Ad Jd] (One pair : 5)
wmx-6j46k48 collected 0.10€ from pot
*** SUMMARY ***
Total pot 0.10€ | Rake 0.01€
Board: [5s 6d 5c Kh Ts]
Seat 2: FreeLaZL (big blind) showed [2h 8h] and lost with One pair : 5
Seat 3: wmx-6j46k48 showed [Ad Jd] and won 0.10€ with One pair : 5


Winamax Poker - HOLD-UP "Colorado" - HandId: #19116069-664883-1701686071 - Holdem no limit (0.01€/0.02€) - 2023/12/04 10:34:31 UTC
Table: 'Colorado' 6-max (real money) Seat #6 is the button
Seat 1: TaBrEaMoI (2.11€)
Seat 2: HARMAND (2€)
Seat 3: hello7585 (1.97€)
Seat 4: Fried Berg (1.89€)
Seat 5: Leneuf9 (2.73€)
Seat 6: - Hyperion - (2.40€)
*** ANTE/BLINDS ***
TaBrEaMoI posts small blind 0.01€
HARMAND posts big blind 0.02€
Dealt to Fried Berg [9h Ad]
*** PRE-FLOP *** 
hello7585 folds
Fried Berg raises 0.02€ to 0.04€
Leneuf9 folds
- Hyperion - folds
TaBrEaMoI folds
HARMAND calls 0.02€
*** FLOP *** [2s 8s Jd]
HARMAND checks
Fried Berg bets 0.02€
HARMAND calls 0.02€
*** TURN *** [2s 8s Jd][Qs]
HARMAND checks
Fried Berg checks
*** RIVER *** [2s 8s Jd Qs][Js]
HARMAND bets 0.13€
Fried Berg folds
HARMAND collected 0.25€ from pot
*** SUMMARY ***
Total pot 0.25€ | Rake 0.01€
Board: [2s 8s Jd Qs Js]
Seat 2: HARMAND (big blind) won 0.25€


Winamax Poker - HOLD-UP "Colorado" - HandId: #19116069-664933-1701686108 - Holdem no limit (0.01€/0.02€) - 2023/12/04 10:35:08 UTC
Table: 'Colorado' 6-max (real money) Seat #6 is the button
Seat 1: Diego00gc (4.23€)
Seat 2: MoneyGrowing (2.11€)
Seat 3: Avril Bibi (1.98€)
Seat 4: badou29 (2€)
Seat 5: hello7585 (4.05€)
Seat 6: Fried Berg (1.83€)
*** ANTE/BLINDS ***
Diego00gc posts small blind 0.01€
MoneyGrowing posts big blind 0.02€
Dealt to Fried Berg [7h 4h]
*** PRE-FLOP *** 
Avril Bibi folds
badou29 folds
hello7585 folds
Fried Berg folds
Diego00gc raises 0.03€ to 0.05€
MoneyGrowing calls 0.03€
*** FLOP *** [Ks 3d Jd]
Diego00gc bets 0.04€
MoneyGrowing folds
Diego00gc collected 0.13€ from pot
*** SUMMARY ***
Total pot 0.13€ | Rake 0.01€
Board: [Ks 3d Jd]
Seat 1: Diego00gc (small blind) won 0.13€


Winamax Poker - HOLD-UP "Colorado" - HandId: #19116069-664944-1701686118 - Holdem no limit (0.01€/0.02€) - 2023/12/04 10:35:18 UTC
Table: 'Colorado' 6-max (real money) Seat #6 is the button
Seat 1: Migueldo22 (1.17€)
Seat 2: Thequeen1205 (3.02€)
Seat 3: Fried Berg (1.83€)
Seat 4: TaBrEaMoI (2.08€)
Seat 5: bahim9375 (0.70€)
Seat 6: Neferusobek (2.16€)
*** ANTE/BLINDS ***
Migueldo22 posts small blind 0.01€
Thequeen1205 posts big blind 0.02€
Dealt to Fried Berg [Ac 6c]
*** PRE-FLOP *** 
Fried Berg raises 0.02€ to 0.04€
TaBrEaMoI folds
bahim9375 folds
Neferusobek folds
Migueldo22 folds
Thequeen1205 calls 0.02€
*** FLOP *** [As 4s Qc]
Thequeen1205 bets 0.05€
Fried Berg calls 0.05€
*** TURN *** [As 4s Qc][Qh]
Thequeen1205 bets 0.10€
Fried Berg calls 0.10€
*** RIVER *** [As 4s Qc Qh][Ad]
Thequeen1205 bets 0.14€
Fried Berg calls 0.14€
*** SHOW DOWN ***
Thequeen1205 shows [Kc Qs] (Full of Queens and Aces)
Fried Berg shows [Ac 6c] (Full of Aces and Queens)
Fried Berg collected 0.60€ from pot
*** SUMMARY ***
Total pot 0.60€ | Rake 0.07€
Board: [As 4s Qc Qh Ad]
Seat 2: Thequeen1205 (big blind) showed [Kc Qs] and lost with Full of Queens and Aces
Seat 3: Fried Berg showed [Ac 6c] and won 0.60€ with Full of Aces and Queens


Winamax Poker - HOLD-UP "Colorado" - HandId: #19116069-664993-1701686152 - Holdem no limit (0.01€/0.02€) - 2023/12/04 10:35:52 UTC
Table: 'Colorado' 6-max (real money) Seat #6 is the button
Seat 1: hello7585 (4.03€)
Seat 2: Thequeen1205 (2.69€)
Seat 3: OURSMARIN (1.97€)
Seat 4: Neferusobek (2.38€)
Seat 5: Fried Berg (2.10€)
Seat 6: sundaedu84 (0.67€)
*** ANTE/BLINDS ***
hello7585 posts small blind 0.01€
Thequeen1205 posts big blind 0.02€
Dealt to Fried Berg [Qs 9c]
*** PRE-FLOP *** 
OURSMARIN folds
Neferusobek raises 0.04€ to 0.06€
Fried Berg folds
sundaedu84 folds
hello7585 calls 0.05€
Thequeen1205 folds
*** FLOP *** [As 4s Qh]
hello7585 checks
Neferusobek checks
*** TURN *** [As 4s Qh][Ac]
hello7585 bets 0.09€
Neferusobek folds
hello7585 collected 0.22€ from pot
*** SUMMARY ***
Total pot 0.22€ | Rake 0.01€
Board: [As 4s Qh Ac]
Seat 1: hello7585 (small blind) won 0.22€


Winamax Poker - HOLD-UP "Colorado" - HandId: #19116069-665041-1701686178 - Holdem no limit (0.01€/0.02€) - 2023/12/04 10:36:18 UTC
Table: 'Colorado' 6-max (real money) Seat #6 is the button
Seat 1: Fried Berg (2.10€)
Seat 2: Txoko_Txiki (1.57€)
Seat 3: Naga Viper (1.45€)
Seat 4: Leneuf9 (2.41€)
Seat 5: G0R0N11 (3.11€)
Seat 6: Jesperord98 (2€)
*** ANTE/BLINDS ***
Fried Berg posts small blind 0.01€
Txoko_Txiki posts big blind 0.02€
Dealt to Fried Berg [3h 2c]
*** PRE-FLOP *** 
Naga Viper folds
Leneuf9 folds
G0R0N11 folds
Jesperord98 folds
Fried Berg folds
Txoko_Txiki collected 0.03€ from pot
*** SUMMARY ***
Total pot 0.03€ | No rake
Seat 2: Txoko_Txiki (big blind) won 0.03€


Winamax Poker - HOLD-UP "Colorado" - HandId: #19116069-665057-1701686188 - Holdem no limit (0.01€/0.02€) - 2023/12/04 10:36:28 UTC
Table: 'Colorado' 6-max (real money) Seat #6 is the button
Seat 1: GTO-Mieko (2.08€)
Seat 2: Fried Berg (2.09€)
Seat 3: rick26 (1.97€)
Seat 4: stevebalboni (5€)
Seat 5: slowreplay (2€)
Seat 6: TaBrEaMoI (2.48€)
*** ANTE/BLINDS ***
GTO-Mieko posts small blind 0.01€
Fried Berg posts big blind 0.02€
Dealt to Fried Berg [4h Tc]
*** PRE-FLOP *** 
rick26 folds
stevebalboni raises 0.02€ to 0.04€
slowreplay folds
TaBrEaMoI folds
GTO-Mieko folds
Fried Berg folds
stevebalboni collected 0.07€ from pot
*** SUMMARY ***
Total pot 0.07€ | No rake
Seat 4: stevebalboni won 0.07€


Winamax Poker - HOLD-UP "Colorado" - HandId: #19116069-665090-1701686208 - Holdem no limit (0.01€/0.02€) - 2023/12/04 10:36:48 UTC
Table: 'Colorado' 6-max (real money) Seat #6 is the button
Seat 1: Johnytop (2€)
Seat 2: RrAaCcHhEeLl (2€)
Seat 3: - Hyperion - (2.43€)
Seat 4: Fried Berg (2.07€)
Seat 5: slowreplay (3.82€)
Seat 6: Le nouche 71 (1.19€)
*** ANTE/BLINDS ***
Johnytop posts small blind 0.01€
RrAaCcHhEeLl posts big blind 0.02€
Dealt to Fried Berg [6s Th]
*** PRE-FLOP *** 
- Hyperion - folds
Fried Berg folds
slowreplay folds
Le nouche 71 folds
Johnytop folds
RrAaCcHhEeLl collected 0.03€ from pot
*** SUMMARY ***
Total pot 0.03€ | No rake
Seat 2: RrAaCcHhEeLl (big blind) won 0.03€


Winamax Poker - HOLD-UP "Colorado" - HandId: #19116069-665106-1701686216 - Holdem no limit (0.01€/0.02€) - 2023/12/04 10:36:56 UTC
Table: 'Colorado' 6-max (real money) Seat #6 is the button
Seat 1: rick26 (2.17€)
Seat 2: TaBrEaMoI (2.23€)
Seat 3: Fried Berg (2.07€)
Seat 4: Thor99 (3.95€)
Seat 5: Homer14510 (1.87€)
Seat 6: slowreplay (4.04€)
*** ANTE/BLINDS ***
rick26 posts small blind 0.01€
TaBrEaMoI posts big blind 0.02€
Dealt to Fried Berg [Ah 6h]
*** PRE-FLOP *** 
Fried Berg raises 0.02€ to 0.04€
Thor99 folds
Homer14510 folds
slowreplay folds
rick26 folds
TaBrEaMoI folds
Fried Berg collected 0.07€ from pot
*** SUMMARY ***
Total pot 0.07€ | No rake
Seat 3: Fried Berg won 0.07€


Winamax Poker - HOLD-UP "Colorado" - HandId: #19116069-665139-1701686235 - Holdem no limit (0.01€/0.02€) - 2023/12/04 10:37:15 UTC
Table: 'Colorado' 6-max (real money) Seat #6 is the button
Seat 1: pasquale202a (3.30€)
Seat 2: FreeLaZL (2.06€)
Seat 3: Johnytop (2.10€)
Seat 4: Thor99 (3.95€)
Seat 5: gimini (1.16€)
Seat 6: Fried Berg (2.10€)
*** ANTE/BLINDS ***
pasquale202a posts small blind 0.01€
FreeLaZL posts big blind 0.02€
Dealt to Fried Berg [8c Th]
*** PRE-FLOP *** 
Johnytop raises 0.03€ to 0.05€
Thor99 folds
gimini folds
Fried Berg folds
pasquale202a folds
FreeLaZL folds
Johnytop collected 0.08€ from pot
*** SUMMARY ***
Total pot 0.08€ | No rake
Seat 3: Johnytop won 0.08€


Winamax Poker - HOLD-UP "Colorado" - HandId: #19116069-665169-1701686253 - Holdem no limit (0.01€/0.02€) - 2023/12/04 10:37:33 UTC
Table: 'Colorado' 6-max (real money) Seat #6 is the button
Seat 1: GTO-Mieko (2.31€)
Seat 2: badou29 (2€)
Seat 3: slowreplay (3.69€)
Seat 4: Leneuf9 (2.85€)
Seat 5: Thequeen1205 (5.64€)
Seat 6: Fried Berg (2.10€)
*** ANTE/BLINDS ***
GTO-Mieko posts small blind 0.01€
badou29 posts big blind 0.02€
Dealt to Fried Berg [Jd Qc]
*** PRE-FLOP *** 
slowreplay folds
Leneuf9 raises 0.04€ to 0.06€
Thequeen1205 folds
Fried Berg calls 0.06€
GTO-Mieko folds
badou29 folds
*** FLOP *** [7d Ac 6s]
Leneuf9 bets 0.05€
Fried Berg folds
Leneuf9 collected 0.18€ from pot
*** SUMMARY ***
Total pot 0.18€ | Rake 0.02€
Board: [7d Ac 6s]
Seat 4: Leneuf9 won 0.18€


Winamax Poker - HOLD-UP "Colorado" - HandId: #19116069-665197-1701686271 - Holdem no limit (0.01€/0.02€) - 2023/12/04 10:37:51 UTC
Table: 'Colorado' 6-max (real money) Seat #6 is the button
Seat 1: GTO-Mieko (2.28€)
Seat 2: Fried Berg (2.04€)
Seat 3: TaBrEaMoI (2.17€)
Seat 4: _Croute_ (3.01€)
Seat 5: Johnytop (2.13€)
Seat 6: evaia (0.65€)
*** ANTE/BLINDS ***
GTO-Mieko posts small blind 0.01€
Fried Berg posts big blind 0.02€
Dealt to Fried Berg [9s 7h]
*** PRE-FLOP *** 
TaBrEaMoI folds
_Croute_ folds
Johnytop folds
evaia folds
GTO-Mieko folds
Fried Berg collected 0.03€ from pot
*** SUMMARY ***
Total pot 0.03€ | No rake
Seat 2: Fried Berg (big blind) won 0.03€


Winamax Poker - HOLD-UP "Colorado" - HandId: #19116069-665257-1701686309 - Holdem no limit (0.01€/0.02€) - 2023/12/04 10:38:29 UTC
Table: 'Colorado' 6-max (real money) Seat #6 is the button
Seat 1: Fried Berg (2.05€)
Seat 2: Tracman (2.11€)
Seat 3: slowreplay (3.87€)
Seat 4: hello7585 (1.51€)
Seat 5: Adame199623 (2€)
Seat 6: Leneuf9 (3.07€)
*** ANTE/BLINDS ***
Fried Berg posts small blind 0.01€
Tracman posts big blind 0.02€
Dealt to Fried Berg [6c 2c]
*** PRE-FLOP *** 
slowreplay folds
hello7585 raises 0.03€ to 0.05€
Adame199623 folds
Leneuf9 folds
Fried Berg folds
Tracman calls 0.03€
*** FLOP *** [5d 3d 2d]
Tracman checks
hello7585 bets 0.07€
Tracman folds
hello7585 collected 0.17€ from pot
*** SUMMARY ***
Total pot 0.17€ | Rake 0.01€
Board: [5d 3d 2d]
Seat 4: hello7585 won 0.17€


Winamax Poker - HOLD-UP "Colorado" - HandId: #19116069-665269-1701686315 - Holdem no limit (0.01€/0.02€) - 2023/12/04 10:38:35 UTC
Table: 'Colorado' 6-max (real money) Seat #6 is the button
Seat 1: rick26 (1.68€)
Seat 2: TaBrEaMoI (2.25€)
Seat 3: Fried Berg (2.04€)
Seat 4: -genzo- (2€)
Seat 5: kameleon73 (3.47€)
Seat 6: nunsuka69 (2.12€)
*** ANTE/BLINDS ***
rick26 posts small blind 0.01€
TaBrEaMoI posts big blind 0.02€
Dealt to Fried Berg [Qc 5s]
*** PRE-FLOP *** 
Fried Berg folds
-genzo- folds
kameleon73 folds
nunsuka69 raises 0.04€ to 0.06€
rick26 folds
TaBrEaMoI calls 0.04€
*** FLOP *** [Qs 3c 6s]
TaBrEaMoI checks
nunsuka69 bets 0.05€
TaBrEaMoI calls 0.05€
*** TURN *** [Qs 3c 6s][7c]
TaBrEaMoI checks
nunsuka69 checks
*** RIVER *** [Qs 3c 6s 7c][4h]
TaBrEaMoI bets 0.18€
nunsuka69 folds
TaBrEaMoI collected 0.39€ from pot
*** SUMMARY ***
Total pot 0.39€ | Rake 0.02€
Board: [Qs 3c 6s 7c 4h]
Seat 2: TaBrEaMoI (big blind) won 0.39€


Winamax Poker - HOLD-UP "Colorado" - HandId: #19116069-665274-1701686317 - Holdem no limit (0.01€/0.02€) - 2023/12/04 10:38:37 UTC
Table: 'Colorado' 6-max (real money) Seat #6 is the button
Seat 1: -genzo- (2€)
Seat 2: Barbonne (2€)
Seat 3: RrAaCcHhEeLl (2€)
Seat 4: Fried Berg (2.04€)
Seat 5: bandarra8520 (2.47€)
Seat 6: Thequeen1205 (2€)
*** ANTE/BLINDS ***
-genzo- posts small blind 0.01€
Barbonne posts big blind 0.02€
Dealt to Fried Berg [Th 6s]
*** PRE-FLOP *** 
RrAaCcHhEeLl folds
Fried Berg folds
bandarra8520 folds
Thequeen1205 folds
-genzo- raises 0.04€ to 0.06€
Barbonne calls 0.04€
*** FLOP *** [As 3d 2c]
-genzo- bets 0.04€
Barbonne raises 0.12€ to 0.16€
-genzo- folds
Barbonne collected 0.30€ from pot
*** SUMMARY ***
Total pot 0.30€ | Rake 0.02€
Board: [As 3d 2c]
Seat 2: Barbonne (big blind) won 0.30€


Winamax Poker - HOLD-UP "Colorado" - HandId: #19116069-665279-1701686319 - Holdem no limit (0.01€/0.02€) - 2023/12/04 10:38:39 UTC
Table: 'Colorado' 6-max (real money) Seat #6 is the button
Seat 1: gimini (0.50€)
Seat 2: GTO-Mieko (2.03€)
Seat 3: MrFlash9 (5.11€)
Seat 4: MoneyGrowing (2.28€)
Seat 5: Fried Berg (2.04€)
Seat 6: JG813 (2.03€)
*** ANTE/BLINDS ***
gimini posts small blind 0.01€
GTO-Mieko posts big blind 0.02€
Dealt to Fried Berg [5h Th]
*** PRE-FLOP *** 
MrFlash9 folds
MoneyGrowing folds
Fried Berg folds
JG813 folds
gimini folds
GTO-Mieko collected 0.03€ from pot
*** SUMMARY ***
Total pot 0.03€ | No rake
Seat 2: GTO-Mieko (big blind) won 0.03€


Winamax Poker - HOLD-UP "Colorado" - HandId: #19116069-665292-1701686327 - Holdem no limit (0.01€/0.02€) - 2023/12/04 10:38:47 UTC
Table: 'Colorado' 6-max (real money) Seat #6 is the button
Seat 1: Tracman (2.06€)
Seat 2: Thequeen1205 (2€)
Seat 3: matmyl (8.81€)
Seat 4: HARMAND (2.08€)
Seat 5: slowreplay (3.88€)
Seat 6: Fried Berg (2.04€)
*** ANTE/BLINDS ***
Tracman posts small blind 0.01€
Thequeen1205 posts big blind 0.02€
Dealt to Fried Berg [Ks 4h]
*** PRE-FLOP *** 
matmyl folds
HARMAND folds
slowreplay folds
Fried Berg folds
Tracman folds
Thequeen1205 collected 0.03€ from pot
*** SUMMARY ***
Total pot 0.03€ | No rake
Seat 2: Thequeen1205 (big blind) won 0.03€


Winamax Poker - HOLD-UP "Colorado" - HandId: #19116069-665301-1701686331 - Holdem no limit (0.01€/0.02€) - 2023/12/04 10:38:51 UTC
Table: 'Colorado' 6-max (real money) Seat #6 is the button
Seat 1: slowreplay (3.97€)
Seat 2: jeanpi 2B (1.09€)
Seat 3: Diego00gc (4.25€)
Seat 4: RrAaCcHhEeLl (5.71€)
Seat 5: Fried Berg (2.04€)
Seat 6: PwedzaM (2€)
Hold-up to Pot: total 0.20€
*** ANTE/BLINDS ***
slowreplay posts small blind 0.01€
jeanpi 2B posts big blind 0.02€
Dealt to Fried Berg [2d Jd]
*** PRE-FLOP *** 
Diego00gc calls 0.02€
RrAaCcHhEeLl calls 0.02€
Fried Berg calls 0.02€
PwedzaM folds
slowreplay calls 0.01€
jeanpi 2B checks
*** FLOP *** [Ks Qd 5c]
slowreplay checks
jeanpi 2B checks
Diego00gc checks
RrAaCcHhEeLl checks
Fried Berg checks
*** TURN *** [Ks Qd 5c][5h]
slowreplay checks
jeanpi 2B bets 0.02€
Diego00gc calls 0.02€
RrAaCcHhEeLl folds
Fried Berg folds
slowreplay calls 0.02€
*** RIVER *** [Ks Qd 5c 5h][Jh]
slowreplay checks
jeanpi 2B checks
Diego00gc checks
*** SHOW DOWN ***
jeanpi 2B shows [3h 3d] (Two pairs : 5 and 3)
Diego00gc shows [8d Ah] (One pair : 5)
slowreplay shows [Qc 8c] (Two pairs : Queens and 5)
slowreplay collected 0.34€ from pot
*** SUMMARY ***
Total pot 0.34€ | Rake 0.02€
Board: [Ks Qd 5c 5h Jh]
Seat 1: slowreplay (small blind) showed [Qc 8c] and won 0.34€ with Two pairs : Queens and 5
Seat 2: jeanpi 2B (big blind) showed [3h 3d] and lost with Two pairs : 5 and 3
Seat 3: Diego00gc showed [8d Ah] and lost with One pair : 5


Winamax Poker - HOLD-UP "Colorado" - HandId: #19116069-665401-1701686392 - Holdem no limit (0.01€/0.02€) - 2023/12/04 10:39:52 UTC
Table: 'Colorado' 6-max (real money) Seat #6 is the button
Seat 1: Neferusobek (2.27€)
Seat 2: Fried Berg (2.02€)
Seat 3: CB-Joker6274 (1.06€)
Seat 4: cybok20001 (0.51€)
Seat 5: Thequeen1205 (8.02€)
Seat 6: DieToBorn (2.26€)
Hold-up to Pot: total 0.10€
*** ANTE/BLINDS ***
Neferusobek posts small blind 0.01€
Fried Berg posts big blind 0.02€
Dealt to Fried Berg [3d Ts]
*** PRE-FLOP *** 
CB-Joker6274 calls 0.02€
cybok20001 calls 0.02€
Thequeen1205 folds
DieToBorn folds
Neferusobek folds
Fried Berg checks
*** FLOP *** [2s Ah Js]
Fried Berg checks
CB-Joker6274 checks
cybok20001 checks
*** TURN *** [2s Ah Js][9s]
Fried Berg checks
CB-Joker6274 checks
cybok20001 bets 0.04€
Fried Berg calls 0.04€
CB-Joker6274 folds
*** RIVER *** [2s Ah Js 9s][6c]
Fried Berg checks
cybok20001 checks
*** SHOW DOWN ***
Fried Berg shows [3d Ts] (High card : Ace)
cybok20001 shows [9h Th] (One pair : 9)
cybok20001 collected 0.23€ from pot
*** SUMMARY ***
Total pot 0.23€ | Rake 0.02€
Board: [2s Ah Js 9s 6c]
Seat 2: Fried Berg (big blind) showed [3d Ts] and lost with High card : Ace
Seat 4: cybok20001 showed [9h Th] and won 0.23€ with One pair : 9


Winamax Poker - HOLD-UP "Colorado" - HandId: #19116069-665486-1701686451 - Holdem no limit (0.01€/0.02€) - 2023/12/04 10:40:51 UTC
Table: 'Colorado' 6-max (real money) Seat #6 is the button
Seat 1: Fried Berg (1.96€)
Seat 2: -genzo- (2.07€)
Seat 3: rick26 (2.23€)
Seat 4: Thequeen1205 (2.65€)
Seat 5: cybok20001 (0.68€)
Seat 6: Migueldo22 (2.25€)
*** ANTE/BLINDS ***
Fried Berg posts small blind 0.01€
-genzo- posts big blind 0.02€
Dealt to Fried Berg [Qd 2s]
*** PRE-FLOP *** 
rick26 folds
Thequeen1205 folds
cybok20001 folds
Migueldo22 folds
Fried Berg folds
-genzo- collected 0.03€ from pot
*** SUMMARY ***
Total pot 0.03€ | No rake
Seat 2: -genzo- (big blind) won 0.03€


Winamax Poker - HOLD-UP "Colorado" - HandId: #19116069-665504-1701686462 - Holdem no limit (0.01€/0.02€) - 2023/12/04 10:41:02 UTC
Table: 'Colorado' 6-max (real money) Seat #6 is the button
Seat 1: Thequeen1205 (2.65€)
Seat 2: JLB berber (2.07€)
Seat 3: Fried Berg (1.95€)
Seat 4: DieToBorn (2.34€)
Seat 5: Naga Viper (1.55€)
Seat 6: cheep06 (6.14€)
*** ANTE/BLINDS ***
Thequeen1205 posts small blind 0.01€
JLB berber posts big blind 0.02€
Dealt to Fried Berg [7c Qc]
*** PRE-FLOP *** 
Fried Berg folds
DieToBorn folds
Naga Viper folds
cheep06 raises 0.03€ to 0.05€
Thequeen1205 folds
JLB berber folds
cheep06 collected 0.08€ from pot
*** SUMMARY ***
Total pot 0.08€ | No rake
Seat 6: cheep06 (button) won 0.08€


Winamax Poker - HOLD-UP "Colorado" - HandId: #19116069-665519-1701686470 - Holdem no limit (0.01€/0.02€) - 2023/12/04 10:41:10 UTC
Table: 'Colorado' 6-max (real money) Seat #6 is the button
Seat 1: pasquale202a (3.32€)
Seat 2: MrFlash9 (3.15€)
Seat 3: matmyl (8.82€)
Seat 4: Fried Berg (1.95€)
Seat 5: Neferusobek (2.36€)
Seat 6: bahim9375 (0.70€)
*** ANTE/BLINDS ***
pasquale202a posts small blind 0.01€
MrFlash9 posts big blind 0.02€
Dealt to Fried Berg [7s 7h]
*** PRE-FLOP *** 
matmyl folds
Fried Berg raises 0.02€ to 0.04€
Neferusobek folds
bahim9375 folds
pasquale202a raises 3.28€ to 3.32€ and is all-in
MrFlash9 folds
Fried Berg folds
pasquale202a collected 3.38€ from pot
*** SUMMARY ***
Total pot 3.38€ | No rake
Seat 1: pasquale202a (small blind) won 3.38€


Winamax Poker - HOLD-UP "Colorado" - HandId: #19116069-665571-1701686505 - Holdem no limit (0.01€/0.02€) - 2023/12/04 10:41:45 UTC
Table: 'Colorado' 6-max (real money) Seat #6 is the button
Seat 1: Migueldo22 (2.16€)
Seat 2: nunsuka69 (2.20€)
Seat 3: JLB berber (2€)
Seat 4: Fried Berg (1.91€)
Seat 5: Homer14510 (2.12€)
Seat 6: didi5959 (1.17€)
*** ANTE/BLINDS ***
Migueldo22 posts small blind 0.01€
nunsuka69 posts big blind 0.02€
Dealt to Fried Berg [6h Js]
*** PRE-FLOP *** 
JLB berber raises 0.04€ to 0.06€
Fried Berg folds
Homer14510 folds
didi5959 folds
Migueldo22 calls 0.05€
nunsuka69 folds
*** FLOP *** [7d Kc As]
Migueldo22 checks
JLB berber bets 0.07€
Migueldo22 calls 0.07€
*** TURN *** [7d Kc As][2c]
Migueldo22 checks
JLB berber checks
*** RIVER *** [7d Kc As 2c][Ac]
Migueldo22 bets 2.03€ and is all-in
JLB berber folds
Migueldo22 collected 2.28€ from pot
*** SUMMARY ***
Total pot 2.28€ | Rake 0.03€
Board: [7d Kc As 2c Ac]
Seat 1: Migueldo22 (small blind) won 2.28€


Winamax Poker - HOLD-UP "Colorado" - HandId: #19116069-665582-1701686512 - Holdem no limit (0.01€/0.02€) - 2023/12/04 10:41:52 UTC
Table: 'Colorado' 6-max (real money) Seat #6 is the button
Seat 1: FreeLaZL (2.27€)
Seat 2: Merci ki j&m (3.27€)
Seat 3: Fried Berg (1.91€)
Seat 4: swag-Morue73 (2.03€)
Seat 5: - Hyperion - (2.05€)
Seat 6: DieToBorn (2.32€)
*** ANTE/BLINDS ***
FreeLaZL posts small blind 0.01€
Merci ki j&m posts big blind 0.02€
Dealt to Fried Berg [3h Qh]
*** PRE-FLOP *** 
Fried Berg folds
swag-Morue73 folds
- Hyperion - raises 0.04€ to 0.06€
DieToBorn folds
FreeLaZL folds
Merci ki j&m folds
- Hyperion - collected 0.09€ from pot
*** SUMMARY ***
Total pot 0.09€ | No rake
Seat 5: - Hyperion - won 0.09€


Winamax Poker - HOLD-UP "Colorado" - HandId: #19116069-665585-1701686514 - Holdem no limit (0.01€/0.02€) - 2023/12/04 10:41:54 UTC
Table: 'Colorado' 6-max (real money) Seat #6 is the button
Seat 1: DieToBorn (2.32€)
Seat 2: Fried Berg (1.91€)
Seat 3: slowreplay (4.35€)
Seat 4: G0R0N11 (3.60€)
Seat 5: Killim (1.44€)
Seat 6: Thequeen1205 (2.56€)
*** ANTE/BLINDS ***
DieToBorn posts small blind 0.01€
Fried Berg posts big blind 0.02€
Dealt to Fried Berg [3h As]
*** PRE-FLOP *** 
slowreplay folds
G0R0N11 folds
Killim raises 0.03€ to 0.05€
Thequeen1205 folds
DieToBorn calls 0.04€
Fried Berg folds
*** FLOP *** [Ts Kd 9h]
DieToBorn checks
Killim bets 0.03€
DieToBorn folds
Killim collected 0.14€ from pot
*** SUMMARY ***
Total pot 0.14€ | Rake 0.01€
Board: [Ts Kd 9h]
Seat 5: Killim won 0.14€


Winamax Poker - HOLD-UP "Colorado" - HandId: #19116069-665604-1701686530 - Holdem no limit (0.01€/0.02€) - 2023/12/04 10:42:10 UTC
Table: 'Colorado' 6-max (real money) Seat #6 is the button
Seat 1: Fried Berg (1.89€)
Seat 2: nunsuka69 (2€)
Seat 3: PompoPeluche (4.67€)
Seat 4: Direct Oli (1.47€)
Seat 5: Barbonne (2.03€)
Seat 6: Leneuf9 (2.42€)
*** ANTE/BLINDS ***
Fried Berg posts small blind 0.01€
nunsuka69 posts big blind 0.02€
Dealt to Fried Berg [4s Js]
*** PRE-FLOP *** 
PompoPeluche folds
Direct Oli folds
Barbonne folds
Leneuf9 folds
Fried Berg calls 0.01€
nunsuka69 checks
*** FLOP *** [3s 8d 3h]
Fried Berg checks
nunsuka69 checks
*** TURN *** [3s 8d 3h][7h]
Fried Berg checks
nunsuka69 bets 0.04€
Fried Berg folds
nunsuka69 collected 0.08€ from pot
*** SUMMARY ***
Total pot 0.08€ | No rake
Board: [3s 8d 3h 7h]
Seat 2: nunsuka69 (big blind) won 0.08€


Winamax Poker - HOLD-UP "Colorado" - HandId: #19116069-665664-1701686570 - Holdem no limit (0.01€/0.02€) - 2023/12/04 10:42:50 UTC
Table: 'Colorado' 6-max (real money) Seat #6 is the button
Seat 1: bahim9375 (0.65€)
Seat 2: Trader2020 (2.07€)
Seat 3: GTO-Mieko (2.62€)
Seat 4: FreeLaZL (2.18€)
Seat 5: Fried Berg (1.87€)
Seat 6: bAd_b3At (0.43€)
*** ANTE/BLINDS ***
bahim9375 posts small blind 0.01€
Trader2020 posts big blind 0.02€
Dealt to Fried Berg [3s Tc]
*** PRE-FLOP *** 
GTO-Mieko folds
FreeLaZL folds
Fried Berg folds
bAd_b3At folds
bahim9375 calls 0.01€
Trader2020 checks
*** FLOP *** [3h Qs 8c]
bahim9375 checks
Trader2020 checks
*** TURN *** [3h Qs 8c][Jd]
bahim9375 bets 0.02€
Trader2020 folds
bahim9375 collected 0.06€ from pot
*** SUMMARY ***
Total pot 0.06€ | No rake
Board: [3h Qs 8c Jd]
Seat 1: bahim9375 (small blind) won 0.06€


Winamax Poker - HOLD-UP "Colorado" - HandId: #19116069-665669-1701686574 - Holdem no limit (0.01€/0.02€) - 2023/12/04 10:42:54 UTC
Table: 'Colorado' 6-max (real money) Seat #6 is the button
Seat 1: JLB berber (2€)
Seat 2: jeanpi 2B (1.26€)
Seat 3: OURSMARIN (0.77€)
Seat 4: nunsuka69 (2.15€)
Seat 5: FreeLaZL (2.18€)
Seat 6: Fried Berg (1.87€)
*** ANTE/BLINDS ***
JLB berber posts small blind 0.01€
jeanpi 2B posts big blind 0.02€
Dealt to Fried Berg [Qh 6c]
*** PRE-FLOP *** 
OURSMARIN folds
nunsuka69 folds
FreeLaZL raises 0.04€ to 0.06€
Fried Berg folds
JLB berber folds
jeanpi 2B folds
FreeLaZL collected 0.09€ from pot
*** SUMMARY ***
Total pot 0.09€ | No rake
Seat 5: FreeLaZL won 0.09€


Winamax Poker - HOLD-UP "Colorado" - HandId: #19116069-665680-1701686580 - Holdem no limit (0.01€/0.02€) - 2023/12/04 10:43:00 UTC
Table: 'Colorado' 6-max (real money) Seat #6 is the button
Seat 1: Fried Berg (1.87€)
Seat 2: JLB berber (2.02€)
Seat 3: rick26 (1.88€)
Seat 4: hello7585 (1.75€)
Seat 5: nunsuka69 (2.01€)
Seat 6: matmyl (3.08€)
*** ANTE/BLINDS ***
Fried Berg posts small blind 0.01€
JLB berber posts big blind 0.02€
Dealt to Fried Berg [Qs 7d]
*** PRE-FLOP *** 
rick26 folds
hello7585 raises 0.04€ to 0.06€
nunsuka69 folds
matmyl folds
Fried Berg folds
JLB berber folds
hello7585 collected 0.09€ from pot
*** SUMMARY ***
Total pot 0.09€ | No rake
Seat 4: hello7585 won 0.09€


Winamax Poker - HOLD-UP "Colorado" - HandId: #19116069-665685-1701686583 - Holdem no limit (0.01€/0.02€) - 2023/12/04 10:43:03 UTC
Table: 'Colorado' 6-max (real money) Seat #6 is the button
Seat 1: Thequeen1205 (2.31€)
Seat 2: Fried Berg (1.86€)
Seat 3: slowreplay (2.01€)
Seat 4: matmyl (3.08€)
Seat 5: MCGHansen (2.03€)
Seat 6: nunsuka69 (2.01€)
*** ANTE/BLINDS ***
Thequeen1205 posts small blind 0.01€
Fried Berg posts big blind 0.02€
Dealt to Fried Berg [As 2h]
*** PRE-FLOP *** 
slowreplay folds
matmyl folds
MCGHansen folds
nunsuka69 folds
Thequeen1205 folds
Fried Berg collected 0.03€ from pot
*** SUMMARY ***
Total pot 0.03€ | No rake
Seat 2: Fried Berg (big blind) won 0.03€


Winamax Poker - HOLD-UP "Colorado" - HandId: #19116069-665699-1701686591 - Holdem no limit (0.01€/0.02€) - 2023/12/04 10:43:11 UTC
Table: 'Colorado' 6-max (real money) Seat #6 is the button
Seat 1: QRIKS-27 (0.54€)
Seat 2: cybok20001 (0.61€)
Seat 3: Homer14510 (1.98€)
Seat 4: - Hyperion - (2.24€)
Seat 5: Fried Berg (1.87€)
Seat 6: FreeLaZL (2.84€)
*** ANTE/BLINDS ***
QRIKS-27 posts small blind 0.01€
cybok20001 posts big blind 0.02€
Dealt to Fried Berg [8c 8d]
*** PRE-FLOP *** 
Homer14510 folds
- Hyperion - folds
Fried Berg raises 0.02€ to 0.04€
FreeLaZL folds
QRIKS-27 calls 0.03€
cybok20001 folds
*** FLOP *** [Jh Jc 3d]
QRIKS-27 checks
Fried Berg bets 0.08€
QRIKS-27 folds
Fried Berg collected 0.17€ from pot
*** SUMMARY ***
Total pot 0.17€ | Rake 0.01€
Board: [Jh Jc 3d]
Seat 5: Fried Berg won 0.17€


Winamax Poker - HOLD-UP "Colorado" - HandId: #19116069-665736-1701686620 - Holdem no limit (0.01€/0.02€) - 2023/12/04 10:43:40 UTC
Table: 'Colorado' 6-max (real money) Seat #6 is the button
Seat 1: FreeLaZL (2.48€)
Seat 2: G0R0N11 (3.68€)
Seat 3: Fried Berg (1.92€)
Seat 4: GTO-Mieko (2.03€)
Seat 5: nunsuka69 (2.44€)
Seat 6: KingSoto (2.07€)
*** ANTE/BLINDS ***
FreeLaZL posts small blind 0.01€
G0R0N11 posts big blind 0.02€
Dealt to Fried Berg [Kd 9s]
*** PRE-FLOP *** 
Fried Berg folds
GTO-Mieko raises 0.04€ to 0.06€
nunsuka69 folds
KingSoto folds
FreeLaZL folds
G0R0N11 folds
GTO-Mieko collected 0.09€ from pot
*** SUMMARY ***
Total pot 0.09€ | No rake
Seat 4: GTO-Mieko won 0.09€


Winamax Poker - HOLD-UP "Colorado" - HandId: #19116069-665741-1701686624 - Holdem no limit (0.01€/0.02€) - 2023/12/04 10:43:44 UTC
Table: 'Colorado' 6-max (real money) Seat #6 is the button
Seat 1: rick26 (1.86€)
Seat 2: KingSoto (2.06€)
Seat 3: cybok20001 (0.58€)
Seat 4: CB-Joker6274 (1.83€)
Seat 5: Naga Viper (0.34€)
Seat 6: Fried Berg (1.92€)
*** ANTE/BLINDS ***
rick26 posts small blind 0.01€
KingSoto posts big blind 0.02€
Dealt to Fried Berg [3h 9h]
*** PRE-FLOP *** 
cybok20001 folds
CB-Joker6274 folds
Naga Viper raises 0.32€ to 0.34€ and is all-in
Fried Berg folds
rick26 folds
KingSoto folds
Naga Viper collected 0.37€ from pot
*** SUMMARY ***
Total pot 0.37€ | No rake
Seat 5: Naga Viper won 0.37€


Winamax Poker - HOLD-UP "Colorado" - HandId: #19116069-665752-1701686632 - Holdem no limit (0.01€/0.02€) - 2023/12/04 10:43:52 UTC
Table: 'Colorado' 6-max (real money) Seat #6 is the button
Seat 1: JG813 (2.30€)
Seat 2: Jesperord98 (2.54€)
Seat 3: Barbonne (2.02€)
Seat 4: Fried Berg (1.92€)
Seat 5: KingSoto (2.04€)
Seat 6: gimini (0.59€)
*** ANTE/BLINDS ***
JG813 posts small blind 0.01€
Jesperord98 posts big blind 0.02€
Dealt to Fried Berg [9h 9s]
*** PRE-FLOP *** 
Barbonne raises 0.03€ to 0.05€
Fried Berg calls 0.05€
KingSoto folds
gimini folds
JG813 folds
Jesperord98 folds
*** FLOP *** [As Ks 3c]
Barbonne bets 0.07€
Fried Berg folds
Barbonne collected 0.19€ from pot
*** SUMMARY ***
Total pot 0.19€ | Rake 0.01€
Board: [As Ks 3c]
Seat 3: Barbonne won 0.19€


Winamax Poker - HOLD-UP "Colorado" - HandId: #19116069-665797-1701686661 - Holdem no limit (0.01€/0.02€) - 2023/12/04 10:44:21 UTC
Table: 'Colorado' 6-max (real money) Seat #6 is the button
Seat 1: Paysan71 (2.10€)
Seat 2: rick26 (1.46€)
Seat 3: nunsuka69 (2€)
Seat 4: Fried Berg (1.87€)
Seat 5: kameleon73 (3.27€)
Seat 6: TaBrEaMoI (4.54€)
*** ANTE/BLINDS ***
Paysan71 posts small blind 0.01€
rick26 posts big blind 0.02€
Dealt to Fried Berg [Ts 8h]
*** PRE-FLOP *** 
nunsuka69 folds
Fried Berg folds
kameleon73 raises 0.04€ to 0.06€
TaBrEaMoI folds
Paysan71 folds
rick26 folds
kameleon73 collected 0.09€ from pot
*** SUMMARY ***
Total pot 0.09€ | No rake
Seat 5: kameleon73 won 0.09€


Winamax Poker - HOLD-UP "Colorado" - HandId: #19116069-665816-1701686674 - Holdem no limit (0.01€/0.02€) - 2023/12/04 10:44:34 UTC
Table: 'Colorado' 6-max (real money) Seat #6 is the button
Seat 1: Fried Berg (1.87€)
Seat 2: jeanpi 2B (1.16€)
Seat 3: Migueldo22 (2.39€)
Seat 4: FreeLaZL (2.45€)
Seat 5: Thequeen1205 (2.27€)
Seat 6: nunsuka69 (2€)
*** ANTE/BLINDS ***
Fried Berg posts small blind 0.01€
jeanpi 2B posts big blind 0.02€
Dealt to Fried Berg [Kd Ad]
*** PRE-FLOP *** 
Migueldo22 folds
FreeLaZL folds
Thequeen1205 folds
nunsuka69 folds
Fried Berg raises 0.02€ to 0.04€
jeanpi 2B calls 0.02€
*** FLOP *** [6s 8h 4d]
Fried Berg bets 0.04€
jeanpi 2B folds
Fried Berg collected 0.11€ from pot
*** SUMMARY ***
Total pot 0.11€ | Rake 0.01€
Board: [6s 8h 4d]
Seat 1: Fried Berg (small blind) won 0.11€


Winamax Poker - HOLD-UP "Colorado" - HandId: #19116069-665864-1701686704 - Holdem no limit (0.01€/0.02€) - 2023/12/04 10:45:04 UTC
Table: 'Colorado' 6-max (real money) Seat #6 is the button
Seat 1: Trader2020 (2.06€)
Seat 2: Fried Berg (1.90€)
Seat 3: kameleon73 (3.28€)
Seat 4: nunsuka69 (2€)
Seat 5: Neferusobek (2.44€)
Seat 6: stevebalboni (5.70€)
*** ANTE/BLINDS ***
Trader2020 posts small blind 0.01€
Fried Berg posts big blind 0.02€
Dealt to Fried Berg [Qs 5h]
*** PRE-FLOP *** 
kameleon73 raises 0.02€ to 0.04€
nunsuka69 folds
Neferusobek raises 0.12€ to 0.16€
stevebalboni folds
Trader2020 folds
Fried Berg folds
kameleon73 folds
Neferusobek collected 0.23€ from pot
*** SUMMARY ***
Total pot 0.23€ | No rake
Seat 5: Neferusobek won 0.23€


Winamax Poker - HOLD-UP "Colorado" - HandId: #19116069-665872-1701686709 - Holdem no limit (0.01€/0.02€) - 2023/12/04 10:45:09 UTC
Table: 'Colorado' 6-max (real money) Seat #6 is the button
Seat 1: Thor99 (2.06€)
Seat 2: Thequeen1205 (2.24€)
Seat 3: Fried Berg (1.88€)
Seat 4: FABIEN.1309 (2.76€)
Seat 5: TaBrEaMoI (4.49€)
Seat 6: cheep06 (6.55€)
*** ANTE/BLINDS ***
Thor99 posts small blind 0.01€
Thequeen1205 posts big blind 0.02€
Dealt to Fried Berg [Kd Qs]
*** PRE-FLOP *** 
Fried Berg raises 0.02€ to 0.04€
FABIEN.1309 calls 0.04€
TaBrEaMoI folds
cheep06 folds
Thor99 folds
Thequeen1205 folds
*** FLOP *** [4s 4d 4c]
Fried Berg checks
FABIEN.1309 checks
*** TURN *** [4s 4d 4c][9d]
Fried Berg checks
FABIEN.1309 checks
*** RIVER *** [4s 4d 4c 9d][9h]
Fried Berg checks
FABIEN.1309 checks
*** SHOW DOWN ***
Fried Berg shows [Kd Qs] (Full of 4 and 9)
FABIEN.1309 shows [Tc Kc] (Full of 4 and 9)
FABIEN.1309 collected 0.05€ from pot
Fried Berg collected 0.05€ from pot
*** SUMMARY ***
Total pot 0.10€ | Rake 0.01€
Board: [4s 4d 4c 9d 9h]
Seat 3: Fried Berg showed [Kd Qs] and won 0.05€ with Full of 4 and 9
Seat 4: FABIEN.1309 showed [Tc Kc] and won 0.05€ with Full of 4 and 9


Winamax Poker - HOLD-UP "Colorado" - HandId: #19116069-665920-1701686740 - Holdem no limit (0.01€/0.02€) - 2023/12/04 10:45:40 UTC
Table: 'Colorado' 6-max (real money) Seat #6 is the button
Seat 1: Rasqual1110 (1.93€)
Seat 2: jackie_chun (1.97€)
Seat 3: FABIEN.1309 (2.77€)
Seat 4: Grisom (0.44€)
Seat 5: hello7585 (2.66€)
Seat 6: Fried Berg (1.89€)
*** ANTE/BLINDS ***
Rasqual1110 posts small blind 0.01€
jackie_chun posts big blind 0.02€
Dealt to Fried Berg [7s Qd]
*** PRE-FLOP *** 
FABIEN.1309 folds
Grisom folds
hello7585 folds
Fried Berg folds
Rasqual1110 folds
jackie_chun collected 0.03€ from pot
*** SUMMARY ***
Total pot 0.03€ | No rake
Seat 2: jackie_chun (big blind) won 0.03€


Winamax Poker - HOLD-UP "Colorado" - HandId: #19116069-665931-1701686746 - Holdem no limit (0.01€/0.02€) - 2023/12/04 10:45:46 UTC
Table: 'Colorado' 6-max (real money) Seat #6 is the button
Seat 1: Grisom (0.45€)
Seat 2: OURSMARIN (0.44€)
Seat 3: FreeLaZL (2.07€)
Seat 4: TaBrEaMoI (3.23€)
Seat 5: Fried Berg (1.89€)
Seat 6: Naga Viper (1.35€)
*** ANTE/BLINDS ***
Grisom posts small blind 0.01€
OURSMARIN posts big blind 0.02€
Dealt to Fried Berg [9s 5h]
*** PRE-FLOP *** 
FreeLaZL calls 0.02€
TaBrEaMoI folds
Fried Berg folds
Naga Viper folds
Grisom folds
OURSMARIN checks
*** FLOP *** [5d 7d Ts]
OURSMARIN checks
FreeLaZL bets 0.03€
OURSMARIN calls 0.03€
*** TURN *** [5d 7d Ts][5c]
OURSMARIN checks
FreeLaZL bets 0.08€
OURSMARIN folds
FreeLaZL collected 0.18€ from pot
*** SUMMARY ***
Total pot 0.18€ | Rake 0.01€
Board: [5d 7d Ts 5c]
Seat 3: FreeLaZL won 0.18€


Winamax Poker - HOLD-UP "Colorado" - HandId: #19116069-665940-1701686751 - Holdem no limit (0.01€/0.02€) - 2023/12/04 10:45:51 UTC
Table: 'Colorado' 6-max (real money) Seat #6 is the button
Seat 1: Roulex (1.38€)
Seat 2: rick26 (2.19€)
Seat 3: CrazyBlutch (2.02€)
Seat 4: Fried Berg (1.89€)
Seat 5: TaBrEaMoI (3.23€)
Seat 6: hello7585 (1.11€)
*** ANTE/BLINDS ***
Roulex posts small blind 0.01€
rick26 posts big blind 0.02€
Dealt to Fried Berg [Jc 6s]
*** PRE-FLOP *** 
CrazyBlutch folds
Fried Berg folds
TaBrEaMoI folds
hello7585 folds
Roulex folds
rick26 collected 0.03€ from pot
*** SUMMARY ***
Total pot 0.03€ | No rake
Seat 2: rick26 (big blind) won 0.03€


Winamax Poker - HOLD-UP "Colorado" - HandId: #19116069-665943-1701686754 - Holdem no limit (0.01€/0.02€) - 2023/12/04 10:45:54 UTC
Table: 'Colorado' 6-max (real money) Seat #6 is the button
Seat 1: slowreplay (2.17€)
Seat 2: JLB berber (2.11€)
Seat 3: Fried Berg (1.89€)
Seat 4: Migueldo22 (2.35€)
Seat 5: G0R0N11 (3.41€)
Seat 6: SirX (6.41€)
*** ANTE/BLINDS ***
slowreplay posts small blind 0.01€
JLB berber posts big blind 0.02€
Dealt to Fried Berg [2d 2h]
*** PRE-FLOP *** 
Fried Berg raises 0.02€ to 0.04€
Migueldo22 raises 0.06€ to 0.10€
G0R0N11 folds
SirX folds
slowreplay folds
JLB berber calls 0.08€
Fried Berg folds
*** FLOP *** [4h As 8s]
JLB berber checks
Migueldo22 checks
*** TURN *** [4h As 8s][4s]
JLB berber checks
Migueldo22 bets 0.16€
JLB berber folds
Migueldo22 collected 0.38€ from pot
*** SUMMARY ***
Total pot 0.38€ | Rake 0.03€
Board: [4h As 8s 4s]
Seat 4: Migueldo22 won 0.38€


Winamax Poker - HOLD-UP "Colorado" - HandId: #19116069-665963-1701686770 - Holdem no limit (0.01€/0.02€) - 2023/12/04 10:46:10 UTC
Table: 'Colorado' 6-max (real money) Seat #6 is the button
Seat 1: swag-Morue73 (2.05€)
Seat 2: Fried Berg (1.85€)
Seat 3: Merci ki j&m (3.29€)
Seat 4: gimini (5.26€)
Seat 5: Thequeen1205 (2.61€)
Seat 6: rick26 (1.46€)
*** ANTE/BLINDS ***
swag-Morue73 posts small blind 0.01€
Fried Berg posts big blind 0.02€
Dealt to Fried Berg [2h Ad]
*** PRE-FLOP *** 
Merci ki j&m calls 0.02€
gimini folds
Thequeen1205 folds
rick26 folds
swag-Morue73 calls 0.01€
Fried Berg checks
*** FLOP *** [Qs 8d Kc]
swag-Morue73 bets 0.02€
Fried Berg folds
Merci ki j&m calls 0.02€
*** TURN *** [Qs 8d Kc][Qc]
swag-Morue73 bets 0.03€
Merci ki j&m calls 0.03€
*** RIVER *** [Qs 8d Kc Qc][8h]
swag-Morue73 bets 0.06€
Merci ki j&m folds
swag-Morue73 collected 0.20€ from pot
*** SUMMARY ***
Total pot 0.20€ | Rake 0.02€
Board: [Qs 8d Kc Qc 8h]
Seat 1: swag-Morue73 (small blind) won 0.20€


Winamax Poker - HOLD-UP "Colorado" - HandId: #19116069-665988-1701686791 - Holdem no limit (0.01€/0.02€) - 2023/12/04 10:46:31 UTC
Table: 'Colorado' 6-max (real money) Seat #6 is the button
Seat 1: Fried Berg (1.83€)
Seat 2: nunsuka69 (2.34€)
Seat 3: Neferusobek (3.94€)
Seat 4: Justo_170382 (0.42€)
Seat 5: GTO-Mieko (2.25€)
Seat 6: Thequeen1205 (2.33€)
*** ANTE/BLINDS ***
Fried Berg posts small blind 0.01€
nunsuka69 posts big blind 0.02€
Dealt to Fried Berg [2d Td]
*** PRE-FLOP *** 
Neferusobek folds
Justo_170382 folds
GTO-Mieko folds
Thequeen1205 folds
Fried Berg folds
nunsuka69 collected 0.03€ from pot
*** SUMMARY ***
Total pot 0.03€ | No rake
Seat 2: nunsuka69 (big blind) won 0.03€


Winamax Poker - HOLD-UP "Colorado" - HandId: #19116069-666003-1701686800 - Holdem no limit (0.01€/0.02€) - 2023/12/04 10:46:40 UTC
Table: 'Colorado' 6-max (real money) Seat #6 is the button
Seat 1: MoneyGrowing (2.94€)
Seat 2: FABIEN.1309 (2.66€)
Seat 3: Thequeen1205 (2.35€)
Seat 4: Jesperord98 (2.31€)
Seat 5: Fried Berg (1.82€)
Seat 6: pasquale202a (3.10€)
*** ANTE/BLINDS ***
MoneyGrowing posts small blind 0.01€
FABIEN.1309 posts big blind 0.02€
Dealt to Fried Berg [9d 7c]
*** PRE-FLOP *** 
Thequeen1205 folds
Jesperord98 folds
Fried Berg folds
pasquale202a folds
MoneyGrowing folds
FABIEN.1309 collected 0.03€ from pot
*** SUMMARY ***
Total pot 0.03€ | No rake
Seat 2: FABIEN.1309 (big blind) won 0.03€


Winamax Poker - HOLD-UP "Colorado" - HandId: #19116069-666010-1701686806 - Holdem no limit (0.01€/0.02€) - 2023/12/04 10:46:46 UTC
Table: 'Colorado' 6-max (real money) Seat #6 is the button
Seat 1: TaBrEaMoI (4.43€)
Seat 2: Levanball18 (0.60€)
Seat 3: Neferusobek (3.93€)
Seat 4: Fried Berg (1.82€)
Seat 5: veve 13 (0.53€)
Seat 6: Upswing11 (2€)
*** ANTE/BLINDS ***
TaBrEaMoI posts small blind 0.01€
Levanball18 posts big blind 0.02€
Dealt to Fried Berg [8d 2c]
*** PRE-FLOP *** 
Neferusobek folds
Fried Berg folds
veve 13 calls 0.02€
Upswing11 folds
TaBrEaMoI folds
Levanball18 checks
*** FLOP *** [4h 4c 5h]
Levanball18 checks
veve 13 checks
*** TURN *** [4h 4c 5h][Jd]
Levanball18 checks
veve 13 checks
*** RIVER *** [4h 4c 5h Jd][6d]
Levanball18 bets 0.05€
veve 13 folds
Levanball18 collected 0.09€ from pot
*** SUMMARY ***
Total pot 0.09€ | Rake 0.01€
Board: [4h 4c 5h Jd 6d]
Seat 2: Levanball18 (big blind) won 0.09€


Winamax Poker - HOLD-UP "Colorado" - HandId: #19116069-666013-1701686807 - Holdem no limit (0.01€/0.02€) - 2023/12/04 10:46:47 UTC
Table: 'Colorado' 6-max (real money) Seat #6 is the button
Seat 1: Thequeen1205 (2.35€)
Seat 2: Neferusobek (2.20€)
Seat 3: nunsuka69 (2.35€)
Seat 4: Tracman (1.95€)
Seat 5: 2winchester (0.64€)
Seat 6: Fried Berg (1.82€)
*** ANTE/BLINDS ***
Thequeen1205 posts small blind 0.01€
Neferusobek posts big blind 0.02€
Dealt to Fried Berg [2h 7d]
*** PRE-FLOP *** 
nunsuka69 folds
Tracman folds
2winchester raises 0.04€ to 0.06€
Fried Berg folds
Thequeen1205 folds
Neferusobek calls 0.04€
*** FLOP *** [Jd Tc 3c]
Neferusobek checks
2winchester bets 0.13€
Neferusobek folds
2winchester collected 0.25€ from pot
*** SUMMARY ***
Total pot 0.25€ | Rake 0.01€
Board: [Jd Tc 3c]
Seat 5: 2winchester won 0.25€


Winamax Poker - HOLD-UP "Colorado" - HandId: #19116069-666016-1701686810 - Holdem no limit (0.01€/0.02€) - 2023/12/04 10:46:50 UTC
Table: 'Colorado' 6-max (real money) Seat #6 is the button
Seat 1: GTO-Mieko (2.23€)
Seat 2: Tracman (1.95€)
Seat 3: thebestt693 (2.71€)
Seat 4: hello7585 (2.62€)
Seat 5: Fried Berg (1.82€)
Seat 6: matmyl (3.64€)
*** ANTE/BLINDS ***
GTO-Mieko posts small blind 0.01€
Tracman posts big blind 0.02€
Dealt to Fried Berg [9d 2d]
*** PRE-FLOP *** 
thebestt693 folds
hello7585 folds
Fried Berg folds
matmyl raises 0.03€ to 0.05€
GTO-Mieko folds
Tracman folds
matmyl collected 0.08€ from pot
*** SUMMARY ***
Total pot 0.08€ | No rake
Seat 6: matmyl (button) won 0.08€


Winamax Poker - HOLD-UP "Colorado" - HandId: #19116069-666019-1701686812 - Holdem no limit (0.01€/0.02€) - 2023/12/04 10:46:52 UTC
Table: 'Colorado' 6-max (real money) Seat #6 is the button
Seat 1: nunsuka69 (2€)
Seat 2: muespachois1 (2€)
Seat 3: Fried Berg (1.82€)
Seat 4: swag-Morue73 (0.56€)
Seat 5: JLB berber (3.74€)
Seat 6: TaBrEaMoI (4.42€)
*** ANTE/BLINDS ***
nunsuka69 posts small blind 0.01€
muespachois1 posts big blind 0.02€
Dealt to Fried Berg [Ac 9c]
*** PRE-FLOP *** 
Fried Berg raises 0.02€ to 0.04€
swag-Morue73 folds
JLB berber folds
TaBrEaMoI folds
nunsuka69 calls 0.03€
muespachois1 calls 0.02€
*** FLOP *** [2s 4c Jh]
nunsuka69 checks
muespachois1 checks
Fried Berg bets 0.04€
nunsuka69 calls 0.04€
muespachois1 calls 0.04€
*** TURN *** [2s 4c Jh][2d]
nunsuka69 checks
muespachois1 checks
Fried Berg checks
*** RIVER *** [2s 4c Jh 2d][2c]
nunsuka69 bets 0.08€
muespachois1 folds
Fried Berg folds
nunsuka69 collected 0.30€ from pot
*** SUMMARY ***
Total pot 0.30€ | Rake 0.02€
Board: [2s 4c Jh 2d 2c]
Seat 1: nunsuka69 (small blind) won 0.30€


Winamax Poker - HOLD-UP "Colorado" - HandId: #19116069-666253-1701686970 - Holdem no limit (0.01€/0.02€) - 2023/12/04 10:49:30 UTC
Table: 'Colorado' 6-max (real money) Seat #6 is the button
Seat 1: pasquale202a (1.29€)
Seat 2: Fried Berg (1.74€)
Seat 3: GTO-Mieko (3.53€)
Seat 4: Migueldo22 (2.08€)
Seat 5: migmmmm (1.88€)
Seat 6: g8o8k8u (2.16€)
*** ANTE/BLINDS ***
pasquale202a posts small blind 0.01€
Fried Berg posts big blind 0.02€
Dealt to Fried Berg [Tc 6c]
*** PRE-FLOP *** 
GTO-Mieko folds
Migueldo22 folds
migmmmm raises 0.04€ to 0.06€
g8o8k8u raises 0.12€ to 0.18€
pasquale202a folds
Fried Berg folds
migmmmm folds
g8o8k8u collected 0.27€ from pot
*** SUMMARY ***
Total pot 0.27€ | No rake
Seat 6: g8o8k8u (button) won 0.27€


Winamax Poker - HOLD-UP "Colorado" - HandId: #19116069-666264-1701686977 - Holdem no limit (0.01€/0.02€) - 2023/12/04 10:49:37 UTC
Table: 'Colorado' 6-max (real money) Seat #6 is the button
Seat 1: Lego-AAs (1.81€)
Seat 2: Lumayou (3.21€)
Seat 3: Leneuf9 (2.11€)
Seat 4: stevebalboni (7.25€)
Seat 5: St. Germain (2€)
Seat 6: Fried Berg (1.72€)
*** ANTE/BLINDS ***
Lego-AAs posts small blind 0.01€
Lumayou posts big blind 0.02€
Dealt to Fried Berg [9h 5s]
*** PRE-FLOP *** 
Leneuf9 folds
stevebalboni folds
St. Germain raises 0.03€ to 0.05€
Fried Berg folds
Lego-AAs calls 0.04€
Lumayou raises 0.10€ to 0.15€
St. Germain folds
Lego-AAs calls 0.10€
*** FLOP *** [2h Ts Qh]
Lego-AAs checks
Lumayou bets 0.12€
Lego-AAs folds
Lumayou collected 0.43€ from pot
*** SUMMARY ***
Total pot 0.43€ | Rake 0.04€
Board: [2h Ts Qh]
Seat 2: Lumayou (big blind) won 0.43€


Winamax Poker - HOLD-UP "Colorado" - HandId: #19116069-666267-1701686979 - Holdem no limit (0.01€/0.02€) - 2023/12/04 10:49:39 UTC
Table: 'Colorado' 6-max (real money) Seat #6 is the button
Seat 1: Ga31k (2.01€)
Seat 2: kameleon73 (3.46€)
Seat 3: OPENCHAUVE13 (1.70€)
Seat 4: fred-k76 (0.51€)
Seat 5: Roulex (1.77€)
Seat 6: Fried Berg (1.72€)
*** ANTE/BLINDS ***
Ga31k posts small blind 0.01€
kameleon73 posts big blind 0.02€
Dealt to Fried Berg [Qh 6c]
*** PRE-FLOP *** 
OPENCHAUVE13 folds
fred-k76 folds
Roulex folds
Fried Berg folds
Ga31k raises 0.04€ to 0.06€
kameleon73 folds
Ga31k collected 0.08€ from pot
*** SUMMARY ***
Total pot 0.08€ | No rake
Seat 1: Ga31k (small blind) won 0.08€


Winamax Poker - HOLD-UP "Colorado" - HandId: #19116069-666269-1701686981 - Holdem no limit (0.01€/0.02€) - 2023/12/04 10:49:41 UTC
Table: 'Colorado' 6-max (real money) Seat #6 is the button
Seat 1: Fried Berg (1.72€)
Seat 2: thebestt693 (2.71€)
Seat 3: Killim (1.55€)
Seat 4: Thor99 (2.02€)
Seat 5: Roulex (1.77€)
Seat 6: nunsuka69 (2.14€)
*** ANTE/BLINDS ***
Fried Berg posts small blind 0.01€
thebestt693 posts big blind 0.02€
Dealt to Fried Berg [5s 5c]
*** PRE-FLOP *** 
Killim folds
Thor99 folds
Roulex folds
nunsuka69 folds
Fried Berg raises 0.02€ to 0.04€
thebestt693 folds
Fried Berg collected 0.06€ from pot
*** SUMMARY ***
Total pot 0.06€ | No rake
Seat 1: Fried Berg (small blind) won 0.06€


Winamax Poker - HOLD-UP "Colorado" - HandId: #19116069-666300-1701686999 - Holdem no limit (0.01€/0.02€) - 2023/12/04 10:49:59 UTC
Table: 'Colorado' 6-max (real money) Seat #6 is the button
Seat 1: GTO-Mieko (2.57€)
Seat 2: Fried Berg (1.74€)
Seat 3: Ga31k (2.01€)
Seat 4: thebestt693 (2.69€)
Seat 5: Kkomental (5.69€)
Seat 6: Trader2020 (2.35€)
*** ANTE/BLINDS ***
GTO-Mieko posts small blind 0.01€
Fried Berg posts big blind 0.02€
Dealt to Fried Berg [9h 3h]
*** PRE-FLOP *** 
Ga31k folds
thebestt693 calls 0.02€
Kkomental folds
Trader2020 folds
GTO-Mieko folds
Fried Berg checks
*** FLOP *** [Js Kd 2c]
Fried Berg checks
thebestt693 bets 0.02€
Fried Berg folds
thebestt693 collected 0.06€ from pot
*** SUMMARY ***
Total pot 0.06€ | Rake 0.01€
Board: [Js Kd 2c]
Seat 4: thebestt693 won 0.06€


Winamax Poker - HOLD-UP "Colorado" - HandId: #19116069-666316-1701687010 - Holdem no limit (0.01€/0.02€) - 2023/12/04 10:50:10 UTC
Table: 'Colorado' 6-max (real money) Seat #6 is the button
Seat 1: Fried Berg (1.72€)
Seat 2: Migueldo22 (3.55€)
Seat 3: MoneyGrowing (3.34€)
Seat 4: Amenlebif (2€)
Seat 5: Tracman (1.75€)
Seat 6: Lego-AAs (1.66€)
*** ANTE/BLINDS ***
Fried Berg posts small blind 0.01€
Migueldo22 posts big blind 0.02€
Dealt to Fried Berg [Kd 6c]
*** PRE-FLOP *** 
MoneyGrowing folds
Amenlebif raises 0.04€ to 0.06€
Tracman folds
Lego-AAs folds
Fried Berg folds
Migueldo22 folds
Amenlebif collected 0.09€ from pot
*** SUMMARY ***
Total pot 0.09€ | No rake
Seat 4: Amenlebif won 0.09€


Winamax Poker - HOLD-UP "Colorado" - HandId: #19116069-666338-1701687026 - Holdem no limit (0.01€/0.02€) - 2023/12/04 10:50:26 UTC
Table: 'Colorado' 6-max (real money) Seat #6 is the button
Seat 1: X3a26J23i54 (0.66€)
Seat 2: TaBrEaMoI (3.32€)
Seat 3: Fried Berg (1.71€)
Seat 4: MCGHansen (2.05€)
Seat 5: nunsuka69 (2€)
Seat 6: JLB berber (2.01€)
Hold-up to Pot: total 0.20€
*** ANTE/BLINDS ***
X3a26J23i54 posts small blind 0.01€
TaBrEaMoI posts big blind 0.02€
Dealt to Fried Berg [Kh 9c]
*** PRE-FLOP *** 
Fried Berg calls 0.02€
MCGHansen folds
nunsuka69 folds
JLB berber calls 0.02€
X3a26J23i54 raises 0.02€ to 0.04€
TaBrEaMoI calls 0.02€
Fried Berg folds
JLB berber calls 0.02€
*** FLOP *** [3c 2h 4d]
X3a26J23i54 checks
TaBrEaMoI checks
JLB berber bets 0.17€
X3a26J23i54 folds
TaBrEaMoI raises 0.26€ to 0.43€
JLB berber raises 1.54€ to 1.97€ and is all-in
TaBrEaMoI folds
JLB berber collected 2.64€ from pot
*** SUMMARY ***
Total pot 2.64€ | Rake 0.10€
Board: [3c 2h 4d]
Seat 6: JLB berber (button) won 2.64€


Winamax Poker - HOLD-UP "Colorado" - HandId: #19116069-666399-1701687068 - Holdem no limit (0.01€/0.02€) - 2023/12/04 10:51:08 UTC
Table: 'Colorado' 6-max (real money) Seat #6 is the button
Seat 1: nunsuka69 (2.15€)
Seat 2: Roulex (1.63€)
Seat 3: Leneuf9 (2.17€)
Seat 4: Fried Berg (1.69€)
Seat 5: GTO-Mieko (2.71€)
Seat 6: - ONZE - (2.23€)
*** ANTE/BLINDS ***
nunsuka69 posts small blind 0.01€
Roulex posts big blind 0.02€
Dealt to Fried Berg [2c 4d]
*** PRE-FLOP *** 
Leneuf9 folds
Fried Berg folds
GTO-Mieko folds
- ONZE - folds
nunsuka69 raises 0.03€ to 0.05€
Roulex folds
nunsuka69 collected 0.07€ from pot
*** SUMMARY ***
Total pot 0.07€ | No rake
Seat 1: nunsuka69 (small blind) won 0.07€


Winamax Poker - HOLD-UP "Colorado" - HandId: #19116069-666406-1701687072 - Holdem no limit (0.01€/0.02€) - 2023/12/04 10:51:12 UTC
Table: 'Colorado' 6-max (real money) Seat #6 is the button
Seat 1: Homer14510 (1.98€)
Seat 2: matmyl (3.20€)
Seat 3: Ga31k (2€)
Seat 4: Thequeen1205 (5.14€)
Seat 5: Fried Berg (1.69€)
Seat 6: Leneuf9 (1.66€)
*** ANTE/BLINDS ***
Homer14510 posts small blind 0.01€
matmyl posts big blind 0.02€
Dealt to Fried Berg [Qc 6c]
*** PRE-FLOP *** 
Ga31k folds
Thequeen1205 folds
Fried Berg raises 0.02€ to 0.04€
Leneuf9 folds
Homer14510 folds
matmyl raises 0.15€ to 0.19€
Fried Berg folds
matmyl collected 0.24€ from pot
*** SUMMARY ***
Total pot 0.24€ | No rake
Seat 2: matmyl (big blind) won 0.24€


Winamax Poker - HOLD-UP "Colorado" - HandId: #19116069-666446-1701687093 - Holdem no limit (0.01€/0.02€) - 2023/12/04 10:51:33 UTC
Table: 'Colorado' 6-max (real money) Seat #6 is the button
Seat 1: Upswing11 (2€)
Seat 2: stevebalboni (6.89€)
Seat 3: nunsuka69 (2€)
Seat 4: PompoPeluche (3.82€)
Seat 5: migmmmm (2.24€)
Seat 6: Fried Berg (1.65€)
*** ANTE/BLINDS ***
Upswing11 posts small blind 0.01€
stevebalboni posts big blind 0.02€
Dealt to Fried Berg [4d Ah]
*** PRE-FLOP *** 
nunsuka69 folds
PompoPeluche folds
migmmmm raises 0.05€ to 0.07€
Fried Berg folds
Upswing11 folds
stevebalboni calls 0.05€
*** FLOP *** [4c 6s 8c]
stevebalboni checks
migmmmm checks
*** TURN *** [4c 6s 8c][9s]
stevebalboni checks
migmmmm checks
*** RIVER *** [4c 6s 8c 9s][Kd]
stevebalboni checks
migmmmm checks
*** SHOW DOWN ***
migmmmm shows [As Qc] (High card : Ace)
stevebalboni shows [8s Ad] (One pair : 8)
stevebalboni collected 0.13€ from pot
*** SUMMARY ***
Total pot 0.13€ | Rake 0.02€
Board: [4c 6s 8c 9s Kd]
Seat 2: stevebalboni (big blind) showed [8s Ad] and won 0.13€ with One pair : 8
Seat 5: migmmmm showed [As Qc] and lost with High card : Ace


Winamax Poker - HOLD-UP "Colorado" - HandId: #19116069-666457-1701687098 - Holdem no limit (0.01€/0.02€) - 2023/12/04 10:51:38 UTC
Table: 'Colorado' 6-max (real money) Seat #6 is the button
Seat 1: Richihawting (2.04€)
Seat 2: Thequeen1205 (2.19€)
Seat 3: Fried Berg (1.65€)
Seat 4: Levanball18 (0.53€)
Seat 5: Ju89400 (2.54€)
Seat 6: Tracman (1.84€)
*** ANTE/BLINDS ***
Richihawting posts small blind 0.01€
Thequeen1205 posts big blind 0.02€
Dealt to Fried Berg [Qs 8d]
*** PRE-FLOP *** 
Fried Berg folds
Levanball18 folds
Ju89400 folds
Tracman folds
Richihawting folds
Thequeen1205 collected 0.03€ from pot
*** SUMMARY ***
Total pot 0.03€ | No rake
Seat 2: Thequeen1205 (big blind) won 0.03€


Winamax Poker - HOLD-UP "Colorado" - HandId: #19116069-666463-1701687100 - Holdem no limit (0.01€/0.02€) - 2023/12/04 10:51:40 UTC
Table: 'Colorado' 6-max (real money) Seat #6 is the button
Seat 1: veve 13 (1.33€)
Seat 2: PseudoFC (2€)
Seat 3: - Hyperion - (2.10€)
Seat 4: Fried Berg (1.65€)
Seat 5: g8o8k8u (2.22€)
Seat 6: Tchioun21 (0.53€)
*** ANTE/BLINDS ***
veve 13 posts small blind 0.01€
PseudoFC posts big blind 0.02€
Dealt to Fried Berg [2c 7d]
*** PRE-FLOP *** 
- Hyperion - folds
Fried Berg folds
g8o8k8u folds
Tchioun21 folds
veve 13 folds
PseudoFC collected 0.03€ from pot
*** SUMMARY ***
Total pot 0.03€ | No rake
Seat 2: PseudoFC (big blind) won 0.03€


Winamax Poker - HOLD-UP "Colorado" - HandId: #19116069-666467-1701687102 - Holdem no limit (0.01€/0.02€) - 2023/12/04 10:51:42 UTC
Table: 'Colorado' 6-max (real money) Seat #6 is the button
Seat 1: JLB berber (2.64€)
Seat 2: Fried Berg (1.65€)
Seat 3: G0R0N11 (2.64€)
Seat 4: matmyl (8.67€)
Seat 5: Ggteker (1.86€)
Seat 6: Tchioun21 (0.53€)
*** ANTE/BLINDS ***
JLB berber posts small blind 0.01€
Fried Berg posts big blind 0.02€
Dealt to Fried Berg [4d Js]
*** PRE-FLOP *** 
G0R0N11 raises 0.04€ to 0.06€
matmyl folds
Ggteker folds
Tchioun21 folds
JLB berber folds
Fried Berg folds
G0R0N11 collected 0.09€ from pot
*** SUMMARY ***
Total pot 0.09€ | No rake
Seat 3: G0R0N11 won 0.09€


Winamax Poker - HOLD-UP "Colorado" - HandId: #19116069-666474-1701687107 - Holdem no limit (0.01€/0.02€) - 2023/12/04 10:51:47 UTC
Table: 'Colorado' 6-max (real money) Seat #6 is the button
Seat 1: Fried Berg (1.63€)
Seat 2: TaBrEaMoI (2.09€)
Seat 3: GTO-Mieko (3.48€)
Seat 4: Roulex (1.59€)
Seat 5: Lego-AAs (0.99€)
Seat 6: nunsuka69 (2.14€)
*** ANTE/BLINDS ***
Fried Berg posts small blind 0.01€
TaBrEaMoI posts big blind 0.02€
Dealt to Fried Berg [2c 5h]
*** PRE-FLOP *** 
GTO-Mieko folds
Roulex folds
Lego-AAs folds
nunsuka69 raises 0.03€ to 0.05€
Fried Berg folds
TaBrEaMoI calls 0.03€
*** FLOP *** [3d 7d 2h]
TaBrEaMoI checks
nunsuka69 bets 0.06€
TaBrEaMoI folds
nunsuka69 collected 0.16€ from pot
*** SUMMARY ***
Total pot 0.16€ | Rake 0.01€
Board: [3d 7d 2h]
Seat 6: nunsuka69 (button) won 0.16€


Winamax Poker - HOLD-UP "Colorado" - HandId: #19116069-666478-1701687109 - Holdem no limit (0.01€/0.02€) - 2023/12/04 10:51:49 UTC
Table: 'Colorado' 6-max (real money) Seat #6 is the button
Seat 1: g8o8k8u (2.38€)
Seat 2: Charafed07 (2€)
Seat 3: Richihawting (2.03€)
Seat 4: YYOOYYOOYY (2.70€)
Seat 5: Fried Berg (1.62€)
Seat 6: Ggteker (1.86€)
*** ANTE/BLINDS ***
g8o8k8u posts small blind 0.01€
Charafed07 posts big blind 0.02€
Dealt to Fried Berg [6h 8h]
*** PRE-FLOP *** 
Richihawting folds
YYOOYYOOYY folds
Fried Berg folds
Ggteker raises 0.03€ to 0.05€
g8o8k8u raises 0.12€ to 0.17€
Charafed07 folds
Ggteker calls 0.12€
*** FLOP *** [Ad 9c Js]
g8o8k8u checks
Ggteker checks
*** TURN *** [Ad 9c Js][Ts]
g8o8k8u bets 0.23€
Ggteker folds
g8o8k8u collected 0.55€ from pot
*** SUMMARY ***
Total pot 0.55€ | Rake 0.04€
Board: [Ad 9c Js Ts]
Seat 1: g8o8k8u (small blind) won 0.55€


Winamax Poker - HOLD-UP "Colorado" - HandId: #19116069-666482-1701687112 - Holdem no limit (0.01€/0.02€) - 2023/12/04 10:51:52 UTC
Table: 'Colorado' 6-max (real money) Seat #6 is the button
Seat 1: Thor99 (2.08€)
Seat 2: DigBick99 (2€)
Seat 3: Lego-AAs (0.99€)
Seat 4: Fried Berg (1.62€)
Seat 5: Leneuf9 (1.64€)
Seat 6: jackie_chun (1.63€)
*** ANTE/BLINDS ***
Thor99 posts small blind 0.01€
DigBick99 posts big blind 0.02€
Dealt to Fried Berg [2d Th]
*** PRE-FLOP *** 
Lego-AAs folds
Fried Berg folds
Leneuf9 folds
jackie_chun raises 0.03€ to 0.05€
Thor99 folds
DigBick99 folds
jackie_chun collected 0.08€ from pot
*** SUMMARY ***
Total pot 0.08€ | No rake
Seat 6: jackie_chun (button) won 0.08€


Winamax Poker - HOLD-UP "Colorado" - HandId: #19116069-666485-1701687114 - Holdem no limit (0.01€/0.02€) - 2023/12/04 10:51:54 UTC
Table: 'Colorado' 6-max (real money) Seat #6 is the button
Seat 1: Lego-AAs (0.99€)
Seat 2: Justo_170382 (0.72€)
Seat 3: JLB berber (2.63€)
Seat 4: GTO-Mieko (3.48€)
Seat 5: Fried Berg (1.62€)
Seat 6: Upswing11 (3.18€)
*** ANTE/BLINDS ***
Lego-AAs posts small blind 0.01€
Justo_170382 posts big blind 0.02€
Dealt to Fried Berg [7h Kd]
*** PRE-FLOP *** 
JLB berber folds
GTO-Mieko folds
Fried Berg folds
Upswing11 folds
Lego-AAs calls 0.01€
Justo_170382 checks
*** FLOP *** [8d 6d 8h]
Lego-AAs checks
Justo_170382 bets 0.04€
Lego-AAs folds
Justo_170382 collected 0.08€ from pot
*** SUMMARY ***
Total pot 0.08€ | No rake
Board: [8d 6d 8h]
Seat 2: Justo_170382 (big blind) won 0.08€


Winamax Poker - HOLD-UP "Colorado" - HandId: #19116069-666488-1701687116 - Holdem no limit (0.01€/0.02€) - 2023/12/04 10:51:56 UTC
Table: 'Colorado' 6-max (real money) Seat #6 is the button
Seat 1: GTO-Mieko (3.48€)
Seat 2: Fried Berg (1.62€)
Seat 3: lebossdimi (0.82€)
Seat 4: stevebalboni (6.95€)
Seat 5: Thor99 (2.07€)
Seat 6: Johnbedoin18 (2.71€)
Hold-up to Pot: total 0.10€
*** ANTE/BLINDS ***
GTO-Mieko posts small blind 0.01€
Fried Berg posts big blind 0.02€
Dealt to Fried Berg [4h Ad]
*** PRE-FLOP *** 
lebossdimi calls 0.02€
stevebalboni folds
Thor99 folds
Johnbedoin18 folds
GTO-Mieko folds
Fried Berg checks
*** FLOP *** [As 4s 8s]
Fried Berg bets 0.08€
lebossdimi folds
Fried Berg collected 0.22€ from pot
*** SUMMARY ***
Total pot 0.22€ | Rake 0.01€
Board: [As 4s 8s]
Seat 2: Fried Berg (big blind) won 0.22€


Winamax Poker - HOLD-UP "Colorado" - HandId: #19116069-666527-1701687145 - Holdem no limit (0.01€/0.02€) - 2023/12/04 10:52:25 UTC
Table: 'Colorado' 6-max (real money) Seat #6 is the button
Seat 1: DigBick99 (2€)
Seat 2: JLB berber (2.09€)
Seat 3: Johnbedoin18 (2.69€)
Seat 4: Leneuf9 (1.56€)
Seat 5: FABIEN.1309 (2.39€)
Seat 6: Fried Berg (1.74€)
*** ANTE/BLINDS ***
DigBick99 posts small blind 0.01€
JLB berber posts big blind 0.02€
Dealt to Fried Berg [Tc 6d]
*** PRE-FLOP *** 
Johnbedoin18 folds
Leneuf9 folds
FABIEN.1309 folds
Fried Berg folds
DigBick99 raises 0.04€ to 0.06€
JLB berber folds
DigBick99 collected 0.08€ from pot
*** SUMMARY ***
Total pot 0.08€ | No rake
Seat 1: DigBick99 (small blind) won 0.08€


Winamax Poker - HOLD-UP "Colorado" - HandId: #19116069-666539-1701687156 - Holdem no limit (0.01€/0.02€) - 2023/12/04 10:52:36 UTC
Table: 'Colorado' 6-max (real money) Seat #6 is the button
Seat 1: Fried Berg (1.74€)
Seat 2: Amenlebif (2€)
Seat 3: Leneuf9 (2.43€)
Seat 4: G0R0N11 (2.73€)
Seat 5: noctastellar (2.10€)
Seat 6: Migueldo22 (2.53€)
*** ANTE/BLINDS ***
Fried Berg posts small blind 0.01€
Amenlebif posts big blind 0.02€
Dealt to Fried Berg [Jc 6c]
*** PRE-FLOP *** 
Leneuf9 folds
G0R0N11 folds
noctastellar folds
Migueldo22 folds
Fried Berg calls 0.01€
Amenlebif raises 0.05€ to 0.07€
Fried Berg calls 0.05€
*** FLOP *** [Kh 2c 2s]
Fried Berg checks
Amenlebif bets 0.05€
Fried Berg folds
Amenlebif collected 0.18€ from pot
*** SUMMARY ***
Total pot 0.18€ | Rake 0.01€
Board: [Kh 2c 2s]
Seat 2: Amenlebif (big blind) won 0.18€


Winamax Poker - HOLD-UP "Colorado" - HandId: #19116069-666620-1701687212 - Holdem no limit (0.01€/0.02€) - 2023/12/04 10:53:32 UTC
Table: 'Colorado' 6-max (real money) Seat #6 is the button
Seat 1: Magicienvav (1.98€)
Seat 2: Leneuf9 (2.43€)
Seat 3: Upswing11 (2.16€)
Seat 4: PtitDidine (1.15€)
Seat 5: Fried Berg (1.67€)
Seat 6: Jesperord98 (2.08€)
*** ANTE/BLINDS ***
Magicienvav posts small blind 0.01€
Leneuf9 posts big blind 0.02€
Dealt to Fried Berg [Qs Ts]
*** PRE-FLOP *** 
Upswing11 folds
PtitDidine folds
Fried Berg raises 0.02€ to 0.04€
Jesperord98 raises 0.10€ to 0.14€
Magicienvav folds
Leneuf9 folds
Fried Berg calls 0.10€
*** FLOP *** [3c 7c Js]
Fried Berg bets 0.06€
Jesperord98 calls 0.06€
*** TURN *** [3c 7c Js][Ks]
Fried Berg checks
Jesperord98 checks
*** RIVER *** [3c 7c Js Ks][Jc]
Fried Berg checks
Jesperord98 checks
*** SHOW DOWN ***
Fried Berg shows [Qs Ts] (One pair : Jacks)
Jesperord98 shows [3d Ad] (Two pairs : Jacks and 3)
Jesperord98 collected 0.39€ from pot
*** SUMMARY ***
Total pot 0.39€ | Rake 0.04€
Board: [3c 7c Js Ks Jc]
Seat 5: Fried Berg showed [Qs Ts] and lost with One pair : Jacks
Seat 6: Jesperord98 (button) showed [3d Ad] and won 0.39€ with Two pairs : Jacks and 3


Winamax Poker - HOLD-UP "Colorado" - HandId: #19116069-666750-1701687295 - Holdem no limit (0.01€/0.02€) - 2023/12/04 10:54:55 UTC
Table: 'Colorado' 6-max (real money) Seat #6 is the button
Seat 1: Jesperord98 (2.27€)
Seat 2: PffffUuuu (0.47€)
Seat 3: Fried Berg (1.47€)
Seat 4: veve 13 (0.38€)
Seat 5: MCGHansen (2.58€)
Seat 6: Johnbedoin18 (2.70€)
*** ANTE/BLINDS ***
Jesperord98 posts small blind 0.01€
PffffUuuu posts big blind 0.02€
Dealt to Fried Berg [7h 9d]
*** PRE-FLOP *** 
Fried Berg folds
veve 13 folds
MCGHansen folds
Johnbedoin18 folds
Jesperord98 folds
PffffUuuu collected 0.03€ from pot
*** SUMMARY ***
Total pot 0.03€ | No rake
Seat 2: PffffUuuu (big blind) won 0.03€


Winamax Poker - HOLD-UP "Colorado" - HandId: #19116069-666764-1701687304 - Holdem no limit (0.01€/0.02€) - 2023/12/04 10:55:04 UTC
Table: 'Colorado' 6-max (real money) Seat #6 is the button
Seat 1: Leneuf9 (7.20€)
Seat 2: TaBrEaMoI (5.29€)
Seat 3: Fried Berg (1.47€)
Seat 4: Magicienvav (1.74€)
Seat 5: muespachois1 (2.34€)
Seat 6: Tchioun21 (0.55€)
*** ANTE/BLINDS ***
Leneuf9 posts small blind 0.01€
TaBrEaMoI posts big blind 0.02€
Dealt to Fried Berg [5d Qs]
*** PRE-FLOP *** 
Fried Berg folds
Magicienvav folds
muespachois1 folds
Tchioun21 calls 0.02€
Leneuf9 raises 0.08€ to 0.10€
TaBrEaMoI folds
Tchioun21 folds
Leneuf9 collected 0.14€ from pot
*** SUMMARY ***
Total pot 0.14€ | No rake
Seat 1: Leneuf9 (small blind) won 0.14€


Winamax Poker - HOLD-UP "Colorado" - HandId: #19116069-666767-1701687306 - Holdem no limit (0.01€/0.02€) - 2023/12/04 10:55:06 UTC
Table: 'Colorado' 6-max (real money) Seat #6 is the button
Seat 1: Fried Berg (1.47€)
Seat 2: Migueldo22 (2.49€)
Seat 3: Thequeen1205 (2.27€)
Seat 4: muespachois1 (2.34€)
Seat 5: Charafed07 (2€)
Seat 6: Ga31k (2.11€)
*** ANTE/BLINDS ***
Fried Berg posts small blind 0.01€
Migueldo22 posts big blind 0.02€
Dealt to Fried Berg [9d 7d]
*** PRE-FLOP *** 
Thequeen1205 folds
muespachois1 folds
Charafed07 folds
Ga31k folds
Fried Berg raises 0.02€ to 0.04€
Migueldo22 folds
Fried Berg collected 0.06€ from pot
*** SUMMARY ***
Total pot 0.06€ | No rake
Seat 1: Fried Berg (small blind) won 0.06€


Winamax Poker - HOLD-UP "Colorado" - HandId: #19116069-668848-1701688730 - Holdem no limit (0.01€/0.02€) - 2023/12/04 11:18:50 UTC
Table: 'Colorado' 6-max (real money) Seat #6 is the button
Seat 1: Erenox (2.19€)
Seat 2: Fried Berg (0.50€)
Seat 3: Yondaime M (3.78€)
Seat 4: Harywin (2.11€)
Seat 5: FreeLaZL (2.11€)
Seat 6: Jimbiosis (2.20€)
*** ANTE/BLINDS ***
Erenox posts small blind 0.01€
Fried Berg posts big blind 0.02€
Dealt to Fried Berg [Ad 3c]
*** PRE-FLOP *** 
Yondaime M folds
Harywin folds
FreeLaZL folds
Jimbiosis folds
Erenox raises 0.04€ to 0.06€
Fried Berg folds
Erenox collected 0.08€ from pot
*** SUMMARY ***
Total pot 0.08€ | No rake
Seat 1: Erenox (small blind) won 0.08€


Winamax Poker - HOLD-UP "Colorado" - HandId: #19116069-668885-1701688755 - Holdem no limit (0.01€/0.02€) - 2023/12/04 11:19:15 UTC
Table: 'Colorado' 6-max (real money) Seat #6 is the button
Seat 1: Fried Berg (0.48€)
Seat 2: nunsuka69 (4.34€)
Seat 3: goubau43 (2.07€)
Seat 4: AAlba (2.22€)
Seat 5: KPZK (6.16€)
Seat 6: Roberfrk (2.74€)
*** ANTE/BLINDS ***
Fried Berg posts small blind 0.01€
nunsuka69 posts big blind 0.02€
Dealt to Fried Berg [Jh 4d]
*** PRE-FLOP *** 
goubau43 calls 0.02€
AAlba folds
KPZK folds
Roberfrk calls 0.02€
Fried Berg folds
nunsuka69 checks
*** FLOP *** [Jd 3c 4s]
nunsuka69 checks
goubau43 checks
Roberfrk bets 0.04€
nunsuka69 folds
goubau43 folds
Roberfrk collected 0.10€ from pot
*** SUMMARY ***
Total pot 0.10€ | Rake 0.01€
Board: [Jd 3c 4s]
Seat 6: Roberfrk (button) won 0.10€


Winamax Poker - HOLD-UP "Colorado" - HandId: #19116069-668929-1701688779 - Holdem no limit (0.01€/0.02€) - 2023/12/04 11:19:39 UTC
Table: 'Colorado' 6-max (real money) Seat #6 is the button
Seat 1: rigolodlazac (2.12€)
Seat 2: Thequeen1205 (3.12€)
Seat 3: Fried Berg (0.47€)
Seat 4: Fabpique16 (2.15€)
Seat 5: KhakiField (2.52€)
Seat 6: Erenox (1.97€)
*** ANTE/BLINDS ***
rigolodlazac posts small blind 0.01€
Thequeen1205 posts big blind 0.02€
Dealt to Fried Berg [Ks Jc]
*** PRE-FLOP *** 
Fried Berg raises 0.02€ to 0.04€
Fabpique16 folds
KhakiField folds
Erenox folds
rigolodlazac calls 0.03€
Thequeen1205 calls 0.02€
*** FLOP *** [Qs Jd Ac]
rigolodlazac checks
Thequeen1205 checks
Fried Berg bets 0.06€
rigolodlazac folds
Thequeen1205 folds
Fried Berg collected 0.17€ from pot
*** SUMMARY ***
Total pot 0.17€ | Rake 0.01€
Board: [Qs Jd Ac]
Seat 3: Fried Berg won 0.17€


Winamax Poker - HOLD-UP "Colorado" - HandId: #19116069-668990-1701688823 - Holdem no limit (0.01€/0.02€) - 2023/12/04 11:20:23 UTC
Table: 'Colorado' 6-max (real money) Seat #6 is the button
Seat 1: JissEl1te (2.49€)
Seat 2: Emmanuelange (3.17€)
Seat 3: Zile741 (2€)
Seat 4: Fried Berg (0.54€)
Seat 5: Fabpique16 (2.18€)
Seat 6: Jesperord98 (6.85€)
*** ANTE/BLINDS ***
JissEl1te posts small blind 0.01€
Emmanuelange posts big blind 0.02€
Dealt to Fried Berg [2d Qh]
*** PRE-FLOP *** 
Zile741 folds
Fried Berg folds
Fabpique16 calls 0.02€
Jesperord98 raises 0.06€ to 0.08€
JissEl1te folds
Emmanuelange folds
Fabpique16 calls 0.06€
*** FLOP *** [5d 7h Ah]
Fabpique16 checks
Jesperord98 checks
*** TURN *** [5d 7h Ah][8h]
Fabpique16 bets 0.07€
Jesperord98 folds
Fabpique16 collected 0.24€ from pot
*** SUMMARY ***
Total pot 0.24€ | Rake 0.02€
Board: [5d 7h Ah 8h]
Seat 5: Fabpique16 won 0.24€


Winamax Poker - HOLD-UP "Colorado" - HandId: #19116069-669000-1701688831 - Holdem no limit (0.01€/0.02€) - 2023/12/04 11:20:31 UTC
Table: 'Colorado' 6-max (real money) Seat #6 is the button
Seat 1: Mouaxx (2.85€)
Seat 2: Neferusobek (2.06€)
Seat 3: DaniRama (2.18€)
Seat 4: FreeLaZL (2€)
Seat 5: Fried Berg (0.54€)
Seat 6: Harywin (3.06€)
*** ANTE/BLINDS ***
Mouaxx posts small blind 0.01€
Neferusobek posts big blind 0.02€
Dealt to Fried Berg [4s 7c]
*** PRE-FLOP *** 
DaniRama folds
FreeLaZL folds
Fried Berg folds
Harywin raises 0.04€ to 0.06€
Mouaxx folds
Neferusobek folds
Harywin collected 0.09€ from pot
*** SUMMARY ***
Total pot 0.09€ | No rake
Seat 6: Harywin (button) won 0.09€


Winamax Poker - HOLD-UP "Colorado" - HandId: #19116069-669018-1701688843 - Holdem no limit (0.01€/0.02€) - 2023/12/04 11:20:43 UTC
Table: 'Colorado' 6-max (real money) Seat #6 is the button
Seat 1: angelirola14 (1.95€)
Seat 2: Ggteker (1.54€)
Seat 3: Jacop0113 (0.18€)
Seat 4: TaBrEaMoI (2.78€)
Seat 5: Mouaxx (1.86€)
Seat 6: Fried Berg (0.54€)
*** ANTE/BLINDS ***
angelirola14 posts small blind 0.01€
Ggteker posts big blind 0.02€
Dealt to Fried Berg [Jh 2c]
*** PRE-FLOP *** 
Jacop0113 folds
TaBrEaMoI folds
Mouaxx raises 0.03€ to 0.05€
Fried Berg folds
angelirola14 folds
Ggteker calls 0.03€
*** FLOP *** [Ad Ks 7h]
Ggteker checks
Mouaxx bets 0.09€
Ggteker folds
Mouaxx collected 0.19€ from pot
*** SUMMARY ***
Total pot 0.19€ | Rake 0.01€
Board: [Ad Ks 7h]
Seat 5: Mouaxx won 0.19€


Winamax Poker - HOLD-UP "Colorado" - HandId: #19116069-669066-1701688873 - Holdem no limit (0.01€/0.02€) - 2023/12/04 11:21:13 UTC
Table: 'Colorado' 6-max (real money) Seat #6 is the button
Seat 1: KhakiField (2.07€)
Seat 2: Fried Berg (0.54€)
Seat 3: ricki64 (1.20€)
Seat 4: Neferusobek (3.53€)
Seat 5: cheep06 (7.43€)
Seat 6: PIQSOU (2€)
*** ANTE/BLINDS ***
KhakiField posts small blind 0.01€
Fried Berg posts big blind 0.02€
Dealt to Fried Berg [6h 2d]
*** PRE-FLOP *** 
ricki64 folds
Neferusobek folds
cheep06 calls 0.02€
PIQSOU folds
KhakiField raises 0.06€ to 0.08€
Fried Berg folds
cheep06 calls 0.06€
*** FLOP *** [6d Th Kc]
KhakiField checks
cheep06 bets 0.12€
KhakiField folds
cheep06 collected 0.28€ from pot
*** SUMMARY ***
Total pot 0.28€ | Rake 0.02€
Board: [6d Th Kc]
Seat 5: cheep06 won 0.28€


Winamax Poker - HOLD-UP "Colorado" - HandId: #19116069-669093-1701688891 - Holdem no limit (0.01€/0.02€) - 2023/12/04 11:21:31 UTC
Table: 'Colorado' 6-max (real money) Seat #6 is the button
Seat 1: Fried Berg (0.52€)
Seat 2: ricki64 (1.23€)
Seat 3: vpcd4 (3.53€)
Seat 4: Salvidm (0.80€)
Seat 5: JLB berber (5.55€)
Seat 6: kRaSsNy (1.97€)
*** ANTE/BLINDS ***
Fried Berg posts small blind 0.01€
ricki64 posts big blind 0.02€
Dealt to Fried Berg [6c Qs]
*** PRE-FLOP *** 
vpcd4 folds
Salvidm folds
JLB berber folds
kRaSsNy folds
Fried Berg folds
ricki64 collected 0.03€ from pot
*** SUMMARY ***
Total pot 0.03€ | No rake
Seat 2: ricki64 (big blind) won 0.03€


Winamax Poker - HOLD-UP "Colorado" - HandId: #19116069-669103-1701688897 - Holdem no limit (0.01€/0.02€) - 2023/12/04 11:21:37 UTC
Table: 'Colorado' 6-max (real money) Seat #6 is the button
Seat 1: Thequeen1205 (2.21€)
Seat 2: nunsuka69 (2.03€)
Seat 3: Fried Berg (0.51€)
Seat 4: Le nouche 71 (0.50€)
Seat 5: AAlba (2.18€)
Seat 6: Migueldo22 (1.40€)
*** ANTE/BLINDS ***
Thequeen1205 posts small blind 0.01€
nunsuka69 posts big blind 0.02€
Dealt to Fried Berg [Kd Ad]
*** PRE-FLOP *** 
Fried Berg raises 0.02€ to 0.04€
Le nouche 71 calls 0.04€
AAlba folds
Migueldo22 folds
Thequeen1205 calls 0.03€
nunsuka69 folds
*** FLOP *** [2s 6c Qh]
Thequeen1205 checks
Fried Berg checks
Le nouche 71 checks
*** TURN *** [2s 6c Qh][6d]
Thequeen1205 checks
Fried Berg checks
Le nouche 71 checks
*** RIVER *** [2s 6c Qh 6d][8s]
Thequeen1205 checks
Fried Berg checks
Le nouche 71 checks
*** SHOW DOWN ***
Fried Berg shows [Kd Ad] (One pair : 6)
Le nouche 71 shows [Tc 9s] (One pair : 6)
Thequeen1205 shows [4s 4c] (Two pairs : 6 and 4)
Thequeen1205 collected 0.13€ from pot
*** SUMMARY ***
Total pot 0.13€ | Rake 0.01€
Board: [2s 6c Qh 6d 8s]
Seat 1: Thequeen1205 (small blind) showed [4s 4c] and won 0.13€ with Two pairs : 6 and 4
Seat 3: Fried Berg showed [Kd Ad] and lost with One pair : 6
Seat 4: Le nouche 71 showed [Tc 9s] and lost with One pair : 6


Winamax Poker - HOLD-UP "Colorado" - HandId: #19116069-669183-1701688955 - Holdem no limit (0.01€/0.02€) - 2023/12/04 11:22:35 UTC
Table: 'Colorado' 6-max (real money) Seat #6 is the button
Seat 1: FreeLaZL (2.13€)
Seat 2: nunsuka69 (2.06€)
Seat 3: TaBrEaMoI (3.28€)
Seat 4: PIQSOU (2.18€)
Seat 5: Fried Berg (0.47€)
Seat 6: Thequeen1205 (3.71€)
*** ANTE/BLINDS ***
FreeLaZL posts small blind 0.01€
nunsuka69 posts big blind 0.02€
Dealt to Fried Berg [Kc 6c]
*** PRE-FLOP *** 
TaBrEaMoI folds
PIQSOU raises 0.03€ to 0.05€
Fried Berg folds
Thequeen1205 calls 0.05€
FreeLaZL folds
nunsuka69 folds
*** FLOP *** [Ad 8d 7h]
PIQSOU bets 0.07€
Thequeen1205 folds
PIQSOU collected 0.19€ from pot
*** SUMMARY ***
Total pot 0.19€ | Rake 0.01€
Board: [Ad 8d 7h]
Seat 4: PIQSOU won 0.19€


Winamax Poker - HOLD-UP "Colorado" - HandId: #19116069-669206-1701688968 - Holdem no limit (0.01€/0.02€) - 2023/12/04 11:22:48 UTC
Table: 'Colorado' 6-max (real money) Seat #6 is the button
Seat 1: Harywin (2.62€)
Seat 2: Richardmill (2€)
Seat 3: DonKmillo (1.96€)
Seat 4: Fried Berg (0.47€)
Seat 5: Tahitia-vs (2.07€)
Seat 6: KhakiField (2.63€)
*** ANTE/BLINDS ***
Harywin posts small blind 0.01€
Richardmill posts big blind 0.02€
Dealt to Fried Berg [5s 3d]
*** PRE-FLOP *** 
DonKmillo folds
Fried Berg folds
Tahitia-vs folds
KhakiField folds
Harywin folds
Richardmill collected 0.03€ from pot
*** SUMMARY ***
Total pot 0.03€ | No rake
Seat 2: Richardmill (big blind) won 0.03€


Winamax Poker - HOLD-UP "Colorado" - HandId: #19116069-669222-1701688977 - Holdem no limit (0.01€/0.02€) - 2023/12/04 11:22:57 UTC
Table: 'Colorado' 6-max (real money) Seat #6 is the button
Seat 1: NoThLo (2.05€)
Seat 2: DonKmillo (1.95€)
Seat 3: FreeLaZL (2.09€)
Seat 4: Killim (1.42€)
Seat 5: franckyrud (2.98€)
Seat 6: Fried Berg (0.47€)
Hold-up to Pot: total 0.50€
*** ANTE/BLINDS ***
NoThLo posts small blind 0.01€
DonKmillo posts big blind 0.02€
Dealt to Fried Berg [6d Jc]
*** PRE-FLOP *** 
FreeLaZL folds
Killim calls 0.02€
franckyrud calls 0.02€
Fried Berg folds
NoThLo calls 0.01€
DonKmillo checks
*** FLOP *** [4d Jh Jd]
NoThLo checks
DonKmillo checks
Killim checks
franckyrud checks
*** TURN *** [4d Jh Jd][As]
NoThLo checks
DonKmillo checks
Killim checks
franckyrud checks
*** RIVER *** [4d Jh Jd As][3d]
NoThLo checks
DonKmillo checks
Killim checks
franckyrud checks
*** SHOW DOWN ***
NoThLo shows [Kc Qd] (One pair : Jacks)
Killim shows [Kh 3s] (Two pairs : Jacks and 3)
franckyrud shows [5h Qh] (One pair : Jacks)
DonKmillo shows [4h 7s] (Two pairs : Jacks and 4)
DonKmillo collected 0.57€ from pot
*** SUMMARY ***
Total pot 0.57€ | Rake 0.01€
Board: [4d Jh Jd As 3d]
Seat 1: NoThLo (small blind) showed [Kc Qd] and lost with One pair : Jacks
Seat 2: DonKmillo (big blind) showed [4h 7s] and won 0.57€ with Two pairs : Jacks and 4
Seat 4: Killim showed [Kh 3s] and lost with Two pairs : Jacks and 3
Seat 5: franckyrud showed [5h Qh] and lost with One pair : Jacks


Winamax Poker - HOLD-UP "Colorado" - HandId: #19116069-669239-1701688991 - Holdem no limit (0.01€/0.02€) - 2023/12/04 11:23:11 UTC
Table: 'Colorado' 6-max (real money) Seat #6 is the button
Seat 1: Jesperord98 (6.67€)
Seat 2: Tahitia-vs (2.03€)
Seat 3: Fried Berg (0.47€)
Seat 4: Harywin (2.41€)
Seat 5: Erenox (2.06€)
Seat 6: Elou84 (0.45€)
*** ANTE/BLINDS ***
Jesperord98 posts small blind 0.01€
Tahitia-vs posts big blind 0.02€
Dealt to Fried Berg [8d 5h]
*** PRE-FLOP *** 
Fried Berg folds
Harywin folds
Erenox raises 0.04€ to 0.06€
Elou84 folds
Jesperord98 folds
Tahitia-vs folds
Erenox collected 0.09€ from pot
*** SUMMARY ***
Total pot 0.09€ | No rake
Seat 5: Erenox won 0.09€


Winamax Poker - HOLD-UP "Colorado" - HandId: #19116069-669242-1701688993 - Holdem no limit (0.01€/0.02€) - 2023/12/04 11:23:13 UTC
Table: 'Colorado' 6-max (real money) Seat #6 is the button
Seat 1: wmx-b6v02tv (0.61€)
Seat 2: Fried Berg (0.47€)
Seat 3: Zaerts (2.54€)
Seat 4: Jesperord98 (6.66€)
Seat 5: Migueldo22 (1.37€)
Seat 6: Harywin (2.41€)
*** ANTE/BLINDS ***
wmx-b6v02tv posts small blind 0.01€
Fried Berg posts big blind 0.02€
Dealt to Fried Berg [Ah 9d]
*** PRE-FLOP *** 
Zaerts folds
Jesperord98 folds
Migueldo22 raises 0.03€ to 0.05€
Harywin folds
wmx-b6v02tv calls 0.04€
Fried Berg calls 0.03€
*** FLOP *** [4h 5d 4s]
wmx-b6v02tv checks
Fried Berg checks
Migueldo22 checks
*** TURN *** [4h 5d 4s][8d]
wmx-b6v02tv checks
Fried Berg checks
Migueldo22 checks
*** RIVER *** [4h 5d 4s 8d][3d]
wmx-b6v02tv bets 0.15€
Fried Berg folds
Migueldo22 folds
wmx-b6v02tv collected 0.28€ from pot
*** SUMMARY ***
Total pot 0.28€ | Rake 0.02€
Board: [4h 5d 4s 8d 3d]
Seat 1: wmx-b6v02tv (small blind) won 0.28€


Winamax Poker - HOLD-UP "Colorado" - HandId: #19116069-669335-1701689052 - Holdem no limit (0.01€/0.02€) - 2023/12/04 11:24:12 UTC
Table: 'Colorado' 6-max (real money) Seat #6 is the button
Seat 1: Fried Berg (0.42€)
Seat 2: robertvali20 (1.30€)
Seat 3: bentado (0.90€)
Seat 4: KhakiField (2€)
Seat 5: JLB berber (2.94€)
Seat 6: PIQSOU (2.22€)
*** ANTE/BLINDS ***
Fried Berg posts small blind 0.01€
robertvali20 posts big blind 0.02€
Dealt to Fried Berg [3h Kh]
*** PRE-FLOP *** 
bentado folds
KhakiField raises 0.03€ to 0.05€
JLB berber calls 0.05€
PIQSOU folds
Fried Berg folds
robertvali20 calls 0.03€
*** FLOP *** [Ad Qc 8d]
robertvali20 bets 0.16€
KhakiField calls 0.16€
JLB berber folds
*** TURN *** [Ad Qc 8d][2h]
robertvali20 bets 0.48€
KhakiField raises 1.06€ to 1.54€
robertvali20 calls 0.61€ and is all-in
*** RIVER *** [Ad Qc 8d 2h][Tc]
*** SHOW DOWN ***
robertvali20 shows [Ac Jh] (One pair : Aces)
KhakiField shows [Qd Qs] (Trips of Queens)
KhakiField collected 2.84€ from pot
*** SUMMARY ***
Total pot 2.84€ | Rake 0.27€
Board: [Ad Qc 8d 2h Tc]
Seat 2: robertvali20 (big blind) showed [Ac Jh] and lost with One pair : Aces
Seat 4: KhakiField showed [Qd Qs] and won 2.84€ with Trips of Queens


Winamax Poker - HOLD-UP "Colorado" - HandId: #19116069-669358-1701689068 - Holdem no limit (0.01€/0.02€) - 2023/12/04 11:24:28 UTC
Table: 'Colorado' 6-max (real money) Seat #6 is the button
Seat 1: DaniRama (2€)
Seat 2: 1trospecti0n (2€)
Seat 3: Zile741 (2.03€)
Seat 4: Fried Berg (0.41€)
Seat 5: TaBrEaMoI (4.32€)
Seat 6: Harywin (2.63€)
*** ANTE/BLINDS ***
DaniRama posts small blind 0.01€
1trospecti0n posts big blind 0.02€
Dealt to Fried Berg [Jh Tc]
*** PRE-FLOP *** 
Zile741 raises 0.04€ to 0.06€
Fried Berg folds
TaBrEaMoI folds
Harywin folds
DaniRama folds
1trospecti0n folds
Zile741 collected 0.09€ from pot
*** SUMMARY ***
Total pot 0.09€ | No rake
Seat 3: Zile741 won 0.09€


Winamax Poker - HOLD-UP "Colorado" - HandId: #19116069-669370-1701689075 - Holdem no limit (0.01€/0.02€) - 2023/12/04 11:24:35 UTC
Table: 'Colorado' 6-max (real money) Seat #6 is the button
Seat 1: G0R0N11 (4.38€)
Seat 2: Harywin (2.63€)
Seat 3: FreeLaZL (2.06€)
Seat 4: TaBrEaMoI (2.94€)
Seat 5: Fried Berg (0.41€)
Seat 6: nunsuka69 (2.56€)
*** ANTE/BLINDS ***
G0R0N11 posts small blind 0.01€
Harywin posts big blind 0.02€
Dealt to Fried Berg [Tc 5c]
*** PRE-FLOP *** 
FreeLaZL folds
TaBrEaMoI folds
Fried Berg folds
nunsuka69 folds
G0R0N11 raises 0.04€ to 0.06€
Harywin folds
G0R0N11 collected 0.08€ from pot
*** SUMMARY ***
Total pot 0.08€ | No rake
Seat 1: G0R0N11 (small blind) won 0.08€


Winamax Poker - HOLD-UP "Colorado" - HandId: #19116069-669379-1701689081 - Holdem no limit (0.01€/0.02€) - 2023/12/04 11:24:41 UTC
Table: 'Colorado' 6-max (real money) Seat #6 is the button
Seat 1: Sinsinsin (2.32€)
Seat 2: Upswing11 (2.46€)
Seat 3: 1trospecti0n (2€)
Seat 4: thebestt693 (5.29€)
Seat 5: nunsuka69 (2.56€)
Seat 6: Fried Berg (0.41€)
*** ANTE/BLINDS ***
Sinsinsin posts small blind 0.01€
Upswing11 posts big blind 0.02€
Dealt to Fried Berg [3h 8c]
*** PRE-FLOP *** 
1trospecti0n folds
thebestt693 folds
nunsuka69 folds
Fried Berg folds
Sinsinsin raises 0.04€ to 0.06€
Upswing11 calls 0.04€
*** FLOP *** [Kd 5d 9c]
Sinsinsin checks
Upswing11 checks
*** TURN *** [Kd 5d 9c][2h]
Sinsinsin checks
Upswing11 bets 0.10€
Sinsinsin folds
Upswing11 collected 0.21€ from pot
*** SUMMARY ***
Total pot 0.21€ | Rake 0.01€
Board: [Kd 5d 9c 2h]
Seat 2: Upswing11 (big blind) won 0.21€


Winamax Poker - HOLD-UP "Colorado" - HandId: #19116069-669382-1701689083 - Holdem no limit (0.01€/0.02€) - 2023/12/04 11:24:43 UTC
Table: 'Colorado' 6-max (real money) Seat #6 is the button
Seat 1: 1trospecti0n (2€)
Seat 2: Tompahmax (2€)
Seat 3: Mouaxx (2.45€)
Seat 4: 2winchester (1.69€)
Seat 5: Fried Berg (0.41€)
Seat 6: Migueldo22 (0.97€)
*** ANTE/BLINDS ***
1trospecti0n posts small blind 0.01€
Tompahmax posts big blind 0.02€
Dealt to Fried Berg [9h 7s]
*** PRE-FLOP *** 
Mouaxx folds
2winchester folds
Fried Berg folds
Migueldo22 raises 0.04€ to 0.06€
1trospecti0n folds
Tompahmax folds
Migueldo22 collected 0.09€ from pot
*** SUMMARY ***
Total pot 0.09€ | No rake
Seat 6: Migueldo22 (button) won 0.09€


Winamax Poker - HOLD-UP "Colorado" - HandId: #19116069-669386-1701689085 - Holdem no limit (0.01€/0.02€) - 2023/12/04 11:24:45 UTC
Table: 'Colorado' 6-max (real money) Seat #6 is the button
Seat 1: Roberfrk (2.73€)
Seat 2: Fried Berg (0.41€)
Seat 3: 2winchester (1.69€)
Seat 4: thebestt693 (5.29€)
Seat 5: UnluckyEny (2.47€)
Seat 6: Tahitia-vs (2.04€)
*** ANTE/BLINDS ***
Roberfrk posts small blind 0.01€
Fried Berg posts big blind 0.02€
Dealt to Fried Berg [Ad As]
*** PRE-FLOP *** 
2winchester folds
thebestt693 folds
UnluckyEny folds
Tahitia-vs raises 0.04€ to 0.06€
Roberfrk folds
Fried Berg raises 0.12€ to 0.18€
Tahitia-vs folds
Fried Berg collected 0.25€ from pot
*** SUMMARY ***
Total pot 0.25€ | No rake
Seat 2: Fried Berg (big blind) won 0.25€


Winamax Poker - HOLD-UP "Colorado" - HandId: #19116069-669420-1701689105 - Holdem no limit (0.01€/0.02€) - 2023/12/04 11:25:05 UTC
Table: 'Colorado' 6-max (real money) Seat #6 is the button
Seat 1: Tompahmax (1.98€)
Seat 2: FreeLaZL (2€)
Seat 3: Fried Berg (0.48€)
Seat 4: Zile741 (2.14€)
Seat 5: boubou1582 (2.20€)
Seat 6: Harywin (2.53€)
*** ANTE/BLINDS ***
Tompahmax posts small blind 0.01€
FreeLaZL posts big blind 0.02€
Dealt to Fried Berg [2c 8c]
*** PRE-FLOP *** 
Fried Berg folds
Zile741 raises 0.04€ to 0.06€
boubou1582 folds
Harywin calls 0.06€
Tompahmax calls 0.05€
FreeLaZL folds
*** FLOP *** [4s Ah 9d]
Tompahmax checks
Zile741 checks
Harywin checks
*** TURN *** [4s Ah 9d][9h]
Tompahmax checks
Zile741 checks
Harywin bets 0.07€
Tompahmax folds
Zile741 calls 0.07€
*** RIVER *** [4s Ah 9d 9h][Ac]
Zile741 checks
Harywin checks
*** SHOW DOWN ***
Harywin shows [7c 7s] (Two pairs : Aces and 9)
Zile741 shows [Tc Td] (Two pairs : Aces and Tens)
Zile741 collected 0.31€ from pot
*** SUMMARY ***
Total pot 0.31€ | Rake 0.03€
Board: [4s Ah 9d 9h Ac]
Seat 4: Zile741 showed [Tc Td] and won 0.31€ with Two pairs : Aces and Tens
Seat 6: Harywin (button) showed [7c 7s] and lost with Two pairs : Aces and 9


Winamax Poker - HOLD-UP "Colorado" - HandId: #19116069-669435-1701689113 - Holdem no limit (0.01€/0.02€) - 2023/12/04 11:25:13 UTC
Table: 'Colorado' 6-max (real money) Seat #6 is the button
Seat 1: Fried Berg (0.48€)
Seat 2: boubou1582 (2.20€)
Seat 3: Diego00gc (1.31€)
Seat 4: AAlba (2.05€)
Seat 5: Neferusobek (2€)
Seat 6: stevebalboni (2.44€)
*** ANTE/BLINDS ***
Fried Berg posts small blind 0.01€
boubou1582 posts big blind 0.02€
Dealt to Fried Berg [8d Kc]
*** PRE-FLOP *** 
Diego00gc folds
AAlba folds
Neferusobek folds
stevebalboni folds
Fried Berg folds
boubou1582 collected 0.03€ from pot
*** SUMMARY ***
Total pot 0.03€ | No rake
Seat 2: boubou1582 (big blind) won 0.03€


Winamax Poker - HOLD-UP "Colorado" - HandId: #19116069-669443-1701689116 - Holdem no limit (0.01€/0.02€) - 2023/12/04 11:25:16 UTC
Table: 'Colorado' 6-max (real money) Seat #6 is the button
Seat 1: coyoteuch (2.01€)
Seat 2: AAlba (3.59€)
Seat 3: Neferusobek (2.03€)
Seat 4: Fried Berg (0.47€)
Seat 5: UnluckyEny (2.44€)
Seat 6: Erenox (2.85€)
*** ANTE/BLINDS ***
coyoteuch posts small blind 0.01€
AAlba posts big blind 0.02€
Dealt to Fried Berg [Qd 3h]
*** PRE-FLOP *** 
Neferusobek folds
Fried Berg folds
UnluckyEny raises 0.04€ to 0.06€
Erenox folds
coyoteuch folds
AAlba folds
UnluckyEny collected 0.09€ from pot
*** SUMMARY ***
Total pot 0.09€ | No rake
Seat 5: UnluckyEny won 0.09€


Winamax Poker - HOLD-UP "Colorado" - HandId: #19116069-669447-1701689118 - Holdem no limit (0.01€/0.02€) - 2023/12/04 11:25:18 UTC
Table: 'Colorado' 6-max (real money) Seat #6 is the button
Seat 1: Elou84 (0.28€)
Seat 2: 2winchester (1.63€)
Seat 3: TaBrEaMoI (2.89€)
Seat 4: Upswing11 (2.50€)
Seat 5: DaniRama (2.02€)
Seat 6: Fried Berg (0.47€)
*** ANTE/BLINDS ***
Elou84 posts small blind 0.01€
2winchester posts big blind 0.02€
Dealt to Fried Berg [As Qd]
*** PRE-FLOP *** 
TaBrEaMoI folds
Upswing11 folds
DaniRama folds
Fried Berg raises 0.04€ to 0.06€
Elou84 calls 0.05€
2winchester folds
*** FLOP *** [2s 6s 7s]
Elou84 bets 0.22€ and is all-in
Fried Berg raises 0.19€ to 0.41€ and is all-in
*** TURN *** [2s 6s 7s][2h]
*** RIVER *** [2s 6s 7s 2h][Ah]
*** SHOW DOWN ***
Elou84 shows [Js 8s] (Flush Jack high)
Fried Berg shows [As Qd] (Two pairs : Aces and 2)
Fried Berg collected 0.19€ from side pot 1
Elou84 collected 0.52€ from main pot
*** SUMMARY ***
Total pot 0.71€ | Rake 0.06€
Board: [2s 6s 7s 2h Ah]
Seat 1: Elou84 (small blind) showed [Js 8s] and won 0.52€ with Flush Jack high
Seat 6: Fried Berg (button) showed [As Qd] and won 0.19€ with Two pairs : Aces and 2


Winamax Poker - HOLD-UP "Colorado" - HandId: #19116069-669493-1701689151 - Holdem no limit (0.01€/0.02€) - 2023/12/04 11:25:51 UTC
Table: 'Colorado' 6-max (real money) Seat #6 is the button
Seat 1: antoclem2A (1.93€)
Seat 2: KhakiField (2.41€)
Seat 3: Fried Berg (0.19€)
Seat 4: Tracman (1.83€)
Seat 5: Elou84 (0.52€)
Seat 6: stevebalboni (2.78€)
*** ANTE/BLINDS ***
antoclem2A posts small blind 0.01€
KhakiField posts big blind 0.02€
Dealt to Fried Berg [Ks Js]
*** PRE-FLOP *** 
Fried Berg raises 0.17€ to 0.19€ and is all-in
Tracman folds
Elou84 folds
stevebalboni folds
antoclem2A calls 0.18€
KhakiField folds
*** FLOP *** [Kc 5c 8c]
*** TURN *** [Kc 5c 8c][5s]
*** RIVER *** [Kc 5c 8c 5s][3s]
*** SHOW DOWN ***
antoclem2A shows [9c Kd] (Two pairs : Kings and 5)
Fried Berg shows [Ks Js] (Two pairs : Kings and 5)
Fried Berg collected 0.36€ from pot
*** SUMMARY ***
Total pot 0.36€ | Rake 0.04€
Board: [Kc 5c 8c 5s 3s]
Seat 1: antoclem2A (small blind) showed [9c Kd] and lost with Two pairs : Kings and 5
Seat 3: Fried Berg showed [Ks Js] and won 0.36€ with Two pairs : Kings and 5


Winamax Poker - HOLD-UP "Colorado" - HandId: #19116069-669517-1701689171 - Holdem no limit (0.01€/0.02€) - 2023/12/04 11:26:11 UTC
Table: 'Colorado' 6-max (real money) Seat #6 is the button
Seat 1: Jesperord98 (6.45€)
Seat 2: Fried Berg (0.36€)
Seat 3: KhakiField (2.42€)
Seat 4: antoclem2A (1.74€)
Seat 5: UnluckyEny (2.36€)
Seat 6: Erenox (4.01€)
*** ANTE/BLINDS ***
Jesperord98 posts small blind 0.01€
Fried Berg posts big blind 0.02€
Dealt to Fried Berg [3h 6h]
*** PRE-FLOP *** 
KhakiField folds
antoclem2A folds
UnluckyEny raises 0.05€ to 0.07€
Erenox folds
Jesperord98 folds
Fried Berg folds
UnluckyEny collected 0.10€ from pot
*** SUMMARY ***
Total pot 0.10€ | No rake
Seat 5: UnluckyEny won 0.10€


Winamax Poker - HOLD-UP "Colorado" - HandId: #19116069-669558-1701689197 - Holdem no limit (0.01€/0.02€) - 2023/12/04 11:26:37 UTC
Table: 'Colorado' 6-max (real money) Seat #6 is the button
Seat 1: PIQSOU (2.15€)
Seat 2: Tompahmax (2€)
Seat 3: ricki64 (1.10€)
Seat 4: Fried Berg (0.34€)
Seat 5: KhakiField (2.38€)
Seat 6: wavega (1.64€)
*** ANTE/BLINDS ***
PIQSOU posts small blind 0.01€
Tompahmax posts big blind 0.02€
Dealt to Fried Berg [Ah Th]
*** PRE-FLOP *** 
ricki64 raises 0.08€ to 0.10€
Fried Berg raises 0.24€ to 0.34€ and is all-in
KhakiField folds
wavega folds
PIQSOU folds
Tompahmax folds
ricki64 calls 0.24€
*** FLOP *** [5d 6h Jh]
*** TURN *** [5d 6h Jh][Jd]
*** RIVER *** [5d 6h Jh Jd][9c]
*** SHOW DOWN ***
Fried Berg shows [Ah Th] (One pair : Jacks)
ricki64 shows [Ad Qd] (One pair : Jacks)
ricki64 collected 0.64€ from pot
*** SUMMARY ***
Total pot 0.64€ | Rake 0.07€
Board: [5d 6h Jh Jd 9c]
Seat 3: ricki64 showed [Ad Qd] and won 0.64€ with One pair : Jacks
Seat 4: Fried Berg showed [Ah Th] and lost with One pair : Jacks


Winamax Poker - HOLD-UP "Colorado" - HandId: #19116069-669616-1701689237 - Holdem no limit (0.01€/0.02€) - 2023/12/04 11:27:17 UTC
Table: 'Colorado' 6-max (real money) Seat #6 is the button
Seat 1: Fried Berg (0.50€)
Seat 2: ischia (0.49€)
Seat 3: FreeLaZL (2€)
Seat 4: Mouaxx (2.51€)
Seat 5: nunsuka69 (4.13€)
Seat 6: Tahitia-vs (2.03€)
*** ANTE/BLINDS ***
Fried Berg posts small blind 0.01€
ischia posts big blind 0.02€
Dealt to Fried Berg [6d Qs]
*** PRE-FLOP *** 
FreeLaZL folds
Mouaxx folds
nunsuka69 folds
Tahitia-vs folds
Fried Berg folds
ischia collected 0.03€ from pot
*** SUMMARY ***
Total pot 0.03€ | No rake
Seat 2: ischia (big blind) won 0.03€


Winamax Poker - HOLD-UP "Colorado" - HandId: #19116069-669636-1701689252 - Holdem no limit (0.01€/0.02€) - 2023/12/04 11:27:32 UTC
Table: 'Colorado' 6-max (real money) Seat #6 is the button
Seat 1: Roberfrk (3.15€)
Seat 2: Richardmill (2.07€)
Seat 3: Harywin (3.20€)
Seat 4: Johnpanam77 (2.28€)
Seat 5: Fried Berg (0.49€)
Seat 6: Emmanuelange (3.30€)
*** ANTE/BLINDS ***
Roberfrk posts small blind 0.01€
Richardmill posts big blind 0.02€
Dealt to Fried Berg [Ac Qc]
*** PRE-FLOP *** 
Harywin folds
Johnpanam77 folds
Fried Berg raises 0.02€ to 0.04€
Emmanuelange folds
Roberfrk folds
Richardmill folds
Fried Berg collected 0.07€ from pot
*** SUMMARY ***
Total pot 0.07€ | No rake
Seat 5: Fried Berg won 0.07€


Winamax Poker - HOLD-UP "Colorado" - HandId: #19116069-669650-1701689262 - Holdem no limit (0.01€/0.02€) - 2023/12/04 11:27:42 UTC
Table: 'Colorado' 6-max (real money) Seat #6 is the button
Seat 1: AAlba (3.43€)
Seat 2: DaniRama (2.05€)
Seat 3: Jesperord98 (6.54€)
Seat 4: Roberfrk (3.14€)
Seat 5: FreeLaZL (2€)
Seat 6: Fried Berg (0.52€)
*** ANTE/BLINDS ***
AAlba posts small blind 0.01€
DaniRama posts big blind 0.02€
Dealt to Fried Berg [9d 4s]
*** PRE-FLOP *** 
Jesperord98 folds
Roberfrk folds
FreeLaZL folds
Fried Berg folds
AAlba raises 0.05€ to 0.07€
DaniRama folds
AAlba collected 0.09€ from pot
*** SUMMARY ***
Total pot 0.09€ | No rake
Seat 1: AAlba (small blind) won 0.09€


Winamax Poker - HOLD-UP "Colorado" - HandId: #19116069-669671-1701689279 - Holdem no limit (0.01€/0.02€) - 2023/12/04 11:27:59 UTC
Table: 'Colorado' 6-max (real money) Seat #6 is the button
Seat 1: Fried Berg (0.52€)
Seat 2: Roberfrk (3.14€)
Seat 3: Le nouche 71 (0.43€)
Seat 4: nunsuka69 (2.44€)
Seat 5: Tompahmax (2.12€)
Seat 6: G0R0N11 (6.89€)
*** ANTE/BLINDS ***
Fried Berg posts small blind 0.01€
Roberfrk posts big blind 0.02€
Dealt to Fried Berg [5s 8s]
*** PRE-FLOP *** 
Le nouche 71 calls 0.02€
nunsuka69 folds
Tompahmax calls 0.02€
G0R0N11 folds
Fried Berg folds
Roberfrk checks
*** FLOP *** [Qs Td Ad]
Roberfrk checks
Le nouche 71 checks
Tompahmax checks
*** TURN *** [Qs Td Ad][Jh]
Roberfrk checks
Le nouche 71 checks
Tompahmax checks
*** RIVER *** [Qs Td Ad Jh][7h]
Roberfrk checks
Le nouche 71 checks
Tompahmax bets 0.08€
Roberfrk folds
Le nouche 71 folds
Tompahmax collected 0.14€ from pot
*** SUMMARY ***
Total pot 0.14€ | Rake 0.01€
Board: [Qs Td Ad Jh 7h]
Seat 5: Tompahmax won 0.14€


Winamax Poker - HOLD-UP "Colorado" - HandId: #19116069-669705-1701689298 - Holdem no limit (0.01€/0.02€) - 2023/12/04 11:28:18 UTC
Table: 'Colorado' 6-max (real money) Seat #6 is the button
Seat 1: mouche113 (0.19€)
Seat 2: Fried Berg (0.51€)
Seat 3: TaBrEaMoI (3.03€)
Seat 4: Emmanuelange (3.28€)
Seat 5: AAlba (3.43€)
Seat 6: Harywin (2.62€)
*** ANTE/BLINDS ***
mouche113 posts small blind 0.01€
Fried Berg posts big blind 0.02€
Dealt to Fried Berg [3c 2s]
*** PRE-FLOP *** 
TaBrEaMoI folds
Emmanuelange folds
AAlba raises 0.03€ to 0.05€
Harywin calls 0.05€
mouche113 folds
Fried Berg folds
*** FLOP *** [Ah Tc 3h]
AAlba checks
Harywin bets 0.07€
AAlba folds
Harywin collected 0.19€ from pot
*** SUMMARY ***
Total pot 0.19€ | Rake 0.01€
Board: [Ah Tc 3h]
Seat 6: Harywin (button) won 0.19€


Winamax Poker - HOLD-UP "Colorado" - HandId: #19116069-669714-1701689305 - Holdem no limit (0.01€/0.02€) - 2023/12/04 11:28:25 UTC
Table: 'Colorado' 6-max (real money) Seat #6 is the button
Seat 1: 2winchester (1.89€)
Seat 2: Yondaime M (3.24€)
Seat 3: Fried Berg (0.49€)
Seat 4: Bilel9559 (1.73€)
Seat 5: Upswing11 (2€)
Seat 6: CB-Joker6274 (3.12€)
*** ANTE/BLINDS ***
2winchester posts small blind 0.01€
Yondaime M posts big blind 0.02€
Dealt to Fried Berg [5s 2s]
*** PRE-FLOP *** 
Fried Berg folds
Bilel9559 folds
Upswing11 raises 0.04€ to 0.06€
CB-Joker6274 folds
2winchester folds
Yondaime M folds
Upswing11 collected 0.09€ from pot
*** SUMMARY ***
Total pot 0.09€ | No rake
Seat 5: Upswing11 won 0.09€


Winamax Poker - HOLD-UP "Colorado" - HandId: #19116069-669716-1701689307 - Holdem no limit (0.01€/0.02€) - 2023/12/04 11:28:27 UTC
Table: 'Colorado' 6-max (real money) Seat #6 is the button
Seat 1: Bilel9559 (1.73€)
Seat 2: Mouaxx (1.93€)
Seat 3: franckyrud (3.31€)
Seat 4: Fried Berg (0.49€)
Seat 5: totomax22 (2.50€)
Seat 6: DonKmillo (2.43€)
*** ANTE/BLINDS ***
Bilel9559 posts small blind 0.01€
Mouaxx posts big blind 0.02€
Dealt to Fried Berg [7c 8c]
*** PRE-FLOP *** 
franckyrud folds
Fried Berg raises 0.02€ to 0.04€
totomax22 folds
DonKmillo calls 0.04€
Bilel9559 calls 0.03€
Mouaxx folds
*** FLOP *** [7h 8s Ks]
Bilel9559 checks
Fried Berg bets 0.08€
DonKmillo folds
Bilel9559 folds
Fried Berg collected 0.21€ from pot
*** SUMMARY ***
Total pot 0.21€ | Rake 0.01€
Board: [7h 8s Ks]
Seat 4: Fried Berg won 0.21€


Winamax Poker - HOLD-UP "Colorado" - HandId: #19116069-669773-1701689357 - Holdem no limit (0.01€/0.02€) - 2023/12/04 11:29:17 UTC
Table: 'Colorado' 6-max (real money) Seat #6 is the button
Seat 1: Pwinpwin (2.01€)
Seat 2: Anubis1983 (1.19€)
Seat 3: JLB berber (5.38€)
Seat 4: antoclem2A (2.45€)
Seat 5: Fried Berg (0.58€)
Seat 6: Sodam84 (1.43€)
*** ANTE/BLINDS ***
Pwinpwin posts small blind 0.01€
Anubis1983 posts big blind 0.02€
Dealt to Fried Berg [9h 8d]
*** PRE-FLOP *** 
JLB berber folds
antoclem2A raises 0.02€ to 0.04€
Fried Berg folds
Sodam84 folds
Pwinpwin calls 0.03€
Anubis1983 folds
*** FLOP *** [4s 2h Th]
Pwinpwin checks
antoclem2A checks
*** TURN *** [4s 2h Th][8h]
Pwinpwin checks
antoclem2A bets 0.03€
Pwinpwin calls 0.03€
*** RIVER *** [4s 2h Th 8h][9c]
Pwinpwin checks
antoclem2A checks
*** SHOW DOWN ***
Pwinpwin shows [Jh As] (High card : Ace)
antoclem2A shows [Kc 9s] (One pair : 9)
antoclem2A collected 0.14€ from pot
*** SUMMARY ***
Total pot 0.14€ | Rake 0.02€
Board: [4s 2h Th 8h 9c]
Seat 1: Pwinpwin (small blind) showed [Jh As] and lost with High card : Ace
Seat 4: antoclem2A showed [Kc 9s] and won 0.14€ with One pair : 9


Winamax Poker - HOLD-UP "Colorado" - HandId: #19116069-669786-1701689366 - Holdem no limit (0.01€/0.02€) - 2023/12/04 11:29:26 UTC
Table: 'Colorado' 6-max (real money) Seat #6 is the button
Seat 1: nunsuka69 (2.88€)
Seat 2: Erenox (1.45€)
Seat 3: Zile741 (2.25€)
Seat 4: JLB berber (3.39€)
Seat 5: Fried Berg (0.58€)
Seat 6: Tracman (1.96€)
*** ANTE/BLINDS ***
nunsuka69 posts small blind 0.01€
Erenox posts big blind 0.02€
Dealt to Fried Berg [Ac Jd]
*** PRE-FLOP *** 
Zile741 folds
JLB berber folds
Fried Berg raises 0.02€ to 0.04€
Tracman folds
nunsuka69 folds
Erenox folds
Fried Berg collected 0.07€ from pot
*** SUMMARY ***
Total pot 0.07€ | No rake
Seat 5: Fried Berg won 0.07€


Winamax Poker - HOLD-UP "Colorado" - HandId: #19116069-669808-1701689376 - Holdem no limit (0.01€/0.02€) - 2023/12/04 11:29:36 UTC
Table: 'Colorado' 6-max (real money) Seat #6 is the button
Seat 1: Zaerts (6.11€)
Seat 2: Tompahmax (2.16€)
Seat 3: totomax22 (2.30€)
Seat 4: JLB berber (5.36€)
Seat 5: KhakiField (2.42€)
Seat 6: Fried Berg (0.61€)
*** ANTE/BLINDS ***
Zaerts posts small blind 0.01€
Tompahmax posts big blind 0.02€
Dealt to Fried Berg [5c Jh]
*** PRE-FLOP *** 
totomax22 folds
JLB berber folds
KhakiField folds
Fried Berg folds
Zaerts raises 0.04€ to 0.06€
Tompahmax calls 0.04€
*** FLOP *** [9c Jd 9s]
Zaerts bets 0.08€
Tompahmax folds
Zaerts collected 0.19€ from pot
*** SUMMARY ***
Total pot 0.19€ | Rake 0.01€
Board: [9c Jd 9s]
Seat 1: Zaerts (small blind) won 0.19€


Winamax Poker - HOLD-UP "Colorado" - HandId: #19116069-669829-1701689387 - Holdem no limit (0.01€/0.02€) - 2023/12/04 11:29:47 UTC
Table: 'Colorado' 6-max (real money) Seat #6 is the button
Seat 1: UnluckyEny (2.45€)
Seat 2: Fried Berg (0.61€)
Seat 3: Mouaxx (2.46€)
Seat 4: franckyrud (3.54€)
Seat 5: coyoteuch (2€)
Seat 6: Tracman (1.94€)
*** ANTE/BLINDS ***
UnluckyEny posts small blind 0.01€
Fried Berg posts big blind 0.02€
Dealt to Fried Berg [2d Qd]
*** PRE-FLOP *** 
Mouaxx folds
franckyrud folds
coyoteuch raises 0.03€ to 0.05€
Tracman folds
UnluckyEny raises 0.14€ to 0.19€
Fried Berg folds
coyoteuch folds
UnluckyEny collected 0.26€ from pot
*** SUMMARY ***
Total pot 0.26€ | No rake
Seat 1: UnluckyEny (small blind) won 0.26€


Winamax Poker - HOLD-UP "Colorado" - HandId: #19116069-669871-1701689416 - Holdem no limit (0.01€/0.02€) - 2023/12/04 11:30:16 UTC
Table: 'Colorado' 6-max (real money) Seat #6 is the button
Seat 1: scoubidou (2.06€)
Seat 2: Zaerts (3.24€)
Seat 3: Fried Berg (0.59€)
Seat 4: Sinsinsin (1.57€)
Seat 5: Jimbiosis (2€)
Seat 6: floflo31490 (1.73€)
*** ANTE/BLINDS ***
scoubidou posts small blind 0.01€
Zaerts posts big blind 0.02€
Dealt to Fried Berg [3c 9c]
*** PRE-FLOP *** 
Fried Berg folds
Sinsinsin raises 0.04€ to 0.06€
Jimbiosis folds
floflo31490 folds
scoubidou folds
Zaerts calls 0.04€
*** FLOP *** [6d 7c 2d]
Zaerts checks
Sinsinsin checks
*** TURN *** [6d 7c 2d][Qs]
Zaerts checks
Sinsinsin bets 0.08€
Zaerts calls 0.08€
*** RIVER *** [6d 7c 2d Qs][5s]
Zaerts checks
Sinsinsin checks
*** SHOW DOWN ***
Zaerts shows [8c Td] (High card : Queen)
Sinsinsin shows [Qc Kc] (One pair : Queens)
Sinsinsin collected 0.26€ from pot
*** SUMMARY ***
Total pot 0.26€ | Rake 0.03€
Board: [6d 7c 2d Qs 5s]
Seat 2: Zaerts (big blind) showed [8c Td] and lost with High card : Queen
Seat 4: Sinsinsin showed [Qc Kc] and won 0.26€ with One pair : Queens


Winamax Poker - HOLD-UP "Colorado" - HandId: #19116069-669882-1701689425 - Holdem no limit (0.01€/0.02€) - 2023/12/04 11:30:25 UTC
Table: 'Colorado' 6-max (real money) Seat #6 is the button
Seat 1: Arumakan (1.69€)
Seat 2: PIQSOU (2.13€)
Seat 3: TaBrEaMoI (4.33€)
Seat 4: Tahitia-vs (2€)
Seat 5: Killim (1.62€)
Seat 6: Fried Berg (0.59€)
*** ANTE/BLINDS ***
Arumakan posts small blind 0.01€
PIQSOU posts big blind 0.02€
Dealt to Fried Berg [Qd 7s]
*** PRE-FLOP *** 
TaBrEaMoI folds
Tahitia-vs folds
Killim folds
Fried Berg raises 0.02€ to 0.04€
Arumakan calls 0.03€
PIQSOU folds
*** FLOP *** [Kc 9d Kh]
Arumakan checks
Fried Berg checks
*** TURN *** [Kc 9d Kh][8c]
Arumakan checks
Fried Berg checks
*** RIVER *** [Kc 9d Kh 8c][2c]
Arumakan checks
Fried Berg bets 0.04€
Arumakan calls 0.04€
*** SHOW DOWN ***
Fried Berg shows [Qd 7s] (One pair : Kings)
Arumakan shows [6s As] (One pair : Kings)
Arumakan collected 0.16€ from pot
*** SUMMARY ***
Total pot 0.16€ | Rake 0.02€
Board: [Kc 9d Kh 8c 2c]
Seat 1: Arumakan (small blind) showed [6s As] and won 0.16€ with One pair : Kings
Seat 6: Fried Berg (button) showed [Qd 7s] and lost with One pair : Kings


Winamax Poker - HOLD-UP "Colorado" - HandId: #19116069-669933-1701689465 - Holdem no limit (0.01€/0.02€) - 2023/12/04 11:31:05 UTC
Table: 'Colorado' 6-max (real money) Seat #6 is the button
Seat 1: Pwinpwin (2€)
Seat 2: 2winchester (3.30€)
Seat 3: coyoteuch (2€)
Seat 4: Fried Berg (0.51€)
Seat 5: JLB berber (3.35€)
Seat 6: Harywin (2.32€)
*** ANTE/BLINDS ***
Pwinpwin posts small blind 0.01€
2winchester posts big blind 0.02€
Dealt to Fried Berg [3c 2d]
*** PRE-FLOP *** 
coyoteuch folds
Fried Berg folds
JLB berber folds
Harywin raises 0.04€ to 0.06€
Pwinpwin folds
2winchester calls 0.04€
*** FLOP *** [As Td 7s]
2winchester checks
Harywin checks
*** TURN *** [As Td 7s][9c]
2winchester checks
Harywin bets 0.06€
2winchester calls 0.06€
*** RIVER *** [As Td 7s 9c][Ts]
2winchester checks
Harywin checks
*** SHOW DOWN ***
2winchester shows [Qc Jc] (One pair : Tens)
Harywin shows [9h 6h] (Two pairs : Tens and 9)
Harywin collected 0.22€ from pot
*** SUMMARY ***
Total pot 0.22€ | Rake 0.03€
Board: [As Td 7s 9c Ts]
Seat 2: 2winchester (big blind) showed [Qc Jc] and lost with One pair : Tens
Seat 6: Harywin (button) showed [9h 6h] and won 0.22€ with Two pairs : Tens and 9


Winamax Poker - HOLD-UP "Colorado" - HandId: #19116069-669954-1701689482 - Holdem no limit (0.01€/0.02€) - 2023/12/04 11:31:22 UTC
Table: 'Colorado' 6-max (real money) Seat #6 is the button
Seat 1: Fried Berg (0.51€)
Seat 2: Tahitia-vs (3.59€)
Seat 3: Killim (1.65€)
Seat 4: Marto69 (2.59€)
Seat 5: Zile741 (2.69€)
Seat 6: TaBrEaMoI (2.03€)
*** ANTE/BLINDS ***
Fried Berg posts small blind 0.01€
Tahitia-vs posts big blind 0.02€
Dealt to Fried Berg [Qd 3h]
*** PRE-FLOP *** 
Killim folds
Marto69 folds
Zile741 folds
TaBrEaMoI folds
Fried Berg folds
Tahitia-vs collected 0.03€ from pot
*** SUMMARY ***
Total pot 0.03€ | No rake
Seat 2: Tahitia-vs (big blind) won 0.03€


Winamax Poker - HOLD-UP "Colorado" - HandId: #19116069-669986-1701689501 - Holdem no limit (0.01€/0.02€) - 2023/12/04 11:31:41 UTC
Table: 'Colorado' 6-max (real money) Seat #6 is the button
Seat 1: Remy_Lord265 (0.23€)
Seat 2: KhakiField (2.34€)
Seat 3: EchoCharly (1.97€)
Seat 4: Fried Berg (0.50€)
Seat 5: Diego00gc (1.98€)
Seat 6: TaBrEaMoI (3.13€)
*** ANTE/BLINDS ***
Remy_Lord265 posts small blind 0.01€
KhakiField posts big blind 0.02€
Dealt to Fried Berg [9h Qc]
*** PRE-FLOP *** 
EchoCharly folds
Fried Berg folds
Diego00gc folds
TaBrEaMoI folds
Remy_Lord265 calls 0.01€
KhakiField checks
*** FLOP *** [6c 4c 9d]
Remy_Lord265 checks
KhakiField checks
*** TURN *** [6c 4c 9d][4s]
Remy_Lord265 checks
KhakiField checks
*** RIVER *** [6c 4c 9d 4s][Qs]
Remy_Lord265 checks
KhakiField checks
*** SHOW DOWN ***
Remy_Lord265 shows [Jd Ts] (One pair : 4)
KhakiField shows [Kh 6d] (Two pairs : 6 and 4)
KhakiField collected 0.04€ from pot
*** SUMMARY ***
Total pot 0.04€ | No rake
Board: [6c 4c 9d 4s Qs]
Seat 1: Remy_Lord265 (small blind) showed [Jd Ts] and lost with One pair : 4
Seat 2: KhakiField (big blind) showed [Kh 6d] and won 0.04€ with Two pairs : 6 and 4


Winamax Poker - HOLD-UP "Colorado" - HandId: #19116069-669997-1701689510 - Holdem no limit (0.01€/0.02€) - 2023/12/04 11:31:50 UTC
Table: 'Colorado' 6-max (real money) Seat #6 is the button
Seat 1: abisis (1.71€)
Seat 2: PIQSOU (2€)
Seat 3: Fried Berg (0.50€)
Seat 4: Upswing11 (3.51€)
Seat 5: Le nouche 71 (0.84€)
Seat 6: Mouaxx (1.88€)
*** ANTE/BLINDS ***
abisis posts small blind 0.01€
PIQSOU posts big blind 0.02€
Dealt to Fried Berg [Ad 5d]
*** PRE-FLOP *** 
Fried Berg raises 0.02€ to 0.04€
Upswing11 folds
Le nouche 71 folds
Mouaxx folds
abisis folds
PIQSOU folds
Fried Berg collected 0.07€ from pot
*** SUMMARY ***
Total pot 0.07€ | No rake
Seat 3: Fried Berg won 0.07€


Winamax Poker - HOLD-UP "Colorado" - HandId: #19116069-672290-1701691101 - Holdem no limit (0.01€/0.02€) - 2023/12/04 11:58:21 UTC
Table: 'Colorado' 6-max (real money) Seat #6 is the button
Seat 1: Antoo_10 (4.11€)
Seat 2: Fried Berg (0.50€)
Seat 3: _ilTulipano_ (2.36€)
Seat 4: robertvali20 (2.82€)
Seat 5: PIQSOU (2.17€)
Seat 6: cygoud (2.38€)
*** ANTE/BLINDS ***
Antoo_10 posts small blind 0.01€
Fried Berg posts big blind 0.02€
Dealt to Fried Berg [Jh 8c]
*** PRE-FLOP *** 
_ilTulipano_ folds
robertvali20 raises 0.05€ to 0.07€
PIQSOU folds
cygoud raises 0.14€ to 0.21€
Antoo_10 folds
Fried Berg folds
robertvali20 calls 0.14€
*** FLOP *** [As Qs 2d]
robertvali20 checks
cygoud checks
*** TURN *** [As Qs 2d][4h]
robertvali20 bets 0.02€
cygoud calls 0.02€
*** RIVER *** [As Qs 2d 4h][3c]
robertvali20 bets 0.05€
cygoud calls 0.05€
*** SHOW DOWN ***
robertvali20 shows [7d 7c] (One pair : 7)
cygoud shows [Kc Kd] (One pair : Kings)
cygoud collected 0.53€ from pot
*** SUMMARY ***
Total pot 0.53€ | Rake 0.06€
Board: [As Qs 2d 4h 3c]
Seat 4: robertvali20 showed [7d 7c] and lost with One pair : 7
Seat 6: cygoud (button) showed [Kc Kd] and won 0.53€ with One pair : Kings


Winamax Poker - HOLD-UP "Colorado" - HandId: #19116069-672300-1701691106 - Holdem no limit (0.01€/0.02€) - 2023/12/04 11:58:26 UTC
Table: 'Colorado' 6-max (real money) Seat #6 is the button
Seat 1: Fried Berg (0.48€)
Seat 2: BMWTPM (3.17€)
Seat 3: Kekoke (0.38€)
Seat 4: Eddy Agricol (2.43€)
Seat 5: Erenox (1.66€)
Seat 6: Tompahmax (1.92€)
*** ANTE/BLINDS ***
Fried Berg posts small blind 0.01€
BMWTPM posts big blind 0.02€
Dealt to Fried Berg [Kd Qh]
*** PRE-FLOP *** 
Kekoke raises 0.05€ to 0.07€
Eddy Agricol folds
Erenox folds
Tompahmax folds
Fried Berg calls 0.06€
BMWTPM folds
*** FLOP *** [5d 7d 2h]
Fried Berg checks
Kekoke bets 0.06€
Fried Berg calls 0.06€
*** TURN *** [5d 7d 2h][Ts]
Fried Berg checks
Kekoke bets 0.25€ and is all-in
Fried Berg calls 0.25€
*** RIVER *** [5d 7d 2h Ts][Kh]
*** SHOW DOWN ***
Kekoke shows [Ac Th] (One pair : Tens)
Fried Berg shows [Kd Qh] (One pair : Kings)
Fried Berg collected 0.70€ from pot
*** SUMMARY ***
Total pot 0.70€ | Rake 0.08€
Board: [5d 7d 2h Ts Kh]
Seat 1: Fried Berg (small blind) showed [Kd Qh] and won 0.70€ with One pair : Kings
Seat 3: Kekoke showed [Ac Th] and lost with One pair : Tens


Winamax Poker - HOLD-UP "Colorado" - HandId: #19116069-672402-1701691174 - Holdem no limit (0.01€/0.02€) - 2023/12/04 11:59:34 UTC
Table: 'Colorado' 6-max (real money) Seat #6 is the button
Seat 1: Killim (1.63€)
Seat 2: UnluckyEny (3.85€)
Seat 3: Fried Berg (0.80€)
Seat 4: _ilTulipano_ (5.40€)
Seat 5: Melielvir (2.29€)
Seat 6: metamex (1.47€)
*** ANTE/BLINDS ***
Killim posts small blind 0.01€
UnluckyEny posts big blind 0.02€
Dealt to Fried Berg [5s 5c]
*** PRE-FLOP *** 
Fried Berg folds
_ilTulipano_ raises 0.04€ to 0.06€
Melielvir folds
metamex folds
Killim folds
UnluckyEny folds
_ilTulipano_ collected 0.09€ from pot
*** SUMMARY ***
Total pot 0.09€ | No rake
Seat 4: _ilTulipano_ won 0.09€


Winamax Poker - HOLD-UP "Colorado" - HandId: #19116069-672417-1701691186 - Holdem no limit (0.01€/0.02€) - 2023/12/04 11:59:46 UTC
Table: 'Colorado' 6-max (real money) Seat #6 is the button
Seat 1: Richard Reuk (2.14€)
Seat 2: Le nouche 71 (0.34€)
Seat 3: BMWTPM (3.14€)
Seat 4: Fried Berg (0.80€)
Seat 5: wAAlterrr (2.07€)
Seat 6: Pwinpwin (2.02€)
*** ANTE/BLINDS ***
Richard Reuk posts small blind 0.01€
Le nouche 71 posts big blind 0.02€
Dealt to Fried Berg [Ad 3c]
*** PRE-FLOP *** 
BMWTPM folds
Fried Berg folds
wAAlterrr folds
Pwinpwin folds
Richard Reuk folds
Le nouche 71 collected 0.03€ from pot
*** SUMMARY ***
Total pot 0.03€ | No rake
Seat 2: Le nouche 71 (big blind) won 0.03€


Winamax Poker - HOLD-UP "Colorado" - HandId: #19116069-672433-1701691196 - Holdem no limit (0.01€/0.02€) - 2023/12/04 11:59:56 UTC
Table: 'Colorado' 6-max (real money) Seat #6 is the button
Seat 1: Joan009 (2€)
Seat 2: CB-Joker6274 (3.42€)
Seat 3: BMWTPM (1.91€)
Seat 4: Zile741 (2.73€)
Seat 5: Fried Berg (0.80€)
Seat 6: JFSredbaron (2.82€)
*** ANTE/BLINDS ***
Joan009 posts small blind 0.01€
CB-Joker6274 posts big blind 0.02€
Dealt to Fried Berg [Qh 6s]
*** PRE-FLOP *** 
BMWTPM folds
Zile741 folds
Fried Berg folds
JFSredbaron raises 0.04€ to 0.06€
Joan009 folds
CB-Joker6274 folds
JFSredbaron collected 0.09€ from pot
*** SUMMARY ***
Total pot 0.09€ | No rake
Seat 6: JFSredbaron (button) won 0.09€


Winamax Poker - HOLD-UP "Colorado" - HandId: #19116069-672446-1701691204 - Holdem no limit (0.01€/0.02€) - 2023/12/04 12:00:04 UTC
Table: 'Colorado' 6-max (real money) Seat #6 is the button
Seat 1: BMWTPM (1.91€)
Seat 2: Falckorn (1.44€)
Seat 3: Melielvir (2.31€)
Seat 4: GTO-Mieko (2.69€)
Seat 5: grut28 (3.71€)
Seat 6: Fried Berg (0.80€)
*** ANTE/BLINDS ***
BMWTPM posts small blind 0.01€
Falckorn posts big blind 0.02€
Dealt to Fried Berg [Qc 8h]
*** PRE-FLOP *** 
Melielvir folds
GTO-Mieko folds
grut28 folds
Fried Berg raises 0.02€ to 0.04€
BMWTPM folds
Falckorn calls 0.02€
*** FLOP *** [Ah 2h 9s]
Falckorn checks
Fried Berg checks
*** TURN *** [Ah 2h 9s][Tc]
Falckorn bets 0.06€
Fried Berg folds
Falckorn collected 0.14€ from pot
*** SUMMARY ***
Total pot 0.14€ | Rake 0.01€
Board: [Ah 2h 9s Tc]
Seat 2: Falckorn (big blind) won 0.14€


Winamax Poker - HOLD-UP "Colorado" - HandId: #19116069-672513-1701691255 - Holdem no limit (0.01€/0.02€) - 2023/12/04 12:00:55 UTC
Table: 'Colorado' 6-max (real money) Seat #6 is the button
Seat 1: Obiwan70 (4.72€)
Seat 2: Joan009 (2€)
Seat 3: _laguigne (1.94€)
Seat 4: LeoPirat (1.97€)
Seat 5: ilergeta (2.02€)
Seat 6: Fried Berg (0.76€)
*** ANTE/BLINDS ***
Obiwan70 posts small blind 0.01€
Joan009 posts big blind 0.02€
Dealt to Fried Berg [Qc Ks]
*** PRE-FLOP *** 
_laguigne calls 0.02€
LeoPirat calls 0.02€
ilergeta folds
Fried Berg raises 0.18€ to 0.20€
Obiwan70 folds
Joan009 folds
_laguigne calls 0.18€
LeoPirat calls 0.18€
*** FLOP *** [2s Ac 3s]
_laguigne checks
LeoPirat bets 0.41€
Fried Berg folds
_laguigne raises 1.33€ to 1.74€ and is all-in
LeoPirat calls 1.33€
*** TURN *** [2s Ac 3s][4c]
*** RIVER *** [2s Ac 3s 4c][Tc]
*** SHOW DOWN ***
_laguigne shows [3h 3c] (Trips of 3)
LeoPirat shows [5s As] (Straight 5 high)
LeoPirat collected 3.70€ from pot
*** SUMMARY ***
Total pot 3.70€ | Rake 0.41€
Board: [2s Ac 3s 4c Tc]
Seat 3: _laguigne showed [3h 3c] and lost with Trips of 3
Seat 4: LeoPirat showed [5s As] and won 3.70€ with Straight 5 high


Winamax Poker - HOLD-UP "Colorado" - HandId: #19116069-672611-1701691326 - Holdem no limit (0.01€/0.02€) - 2023/12/04 12:02:06 UTC
Table: 'Colorado' 6-max (real money) Seat #6 is the button
Seat 1: Zile741 (3.03€)
Seat 2: Fried Berg (0.56€)
Seat 3: Eddy Agricol (3.61€)
Seat 4: JissEl1te (3.53€)
Seat 5: Pwinpwin (2.08€)
Seat 6: Ga31k (2.21€)
*** ANTE/BLINDS ***
Zile741 posts small blind 0.01€
Fried Berg posts big blind 0.02€
Dealt to Fried Berg [3d 2d]
*** PRE-FLOP *** 
Eddy Agricol raises 0.04€ to 0.06€
JissEl1te folds
Pwinpwin folds
Ga31k folds
Zile741 folds
Fried Berg folds
Eddy Agricol collected 0.09€ from pot
*** SUMMARY ***
Total pot 0.09€ | No rake
Seat 3: Eddy Agricol won 0.09€


Winamax Poker - HOLD-UP "Colorado" - HandId: #19116069-672617-1701691329 - Holdem no limit (0.01€/0.02€) - 2023/12/04 12:02:09 UTC
Table: 'Colorado' 6-max (real money) Seat #6 is the button
Seat 1: Fried Berg (0.54€)
Seat 2: OBEY-ME (2.16€)
Seat 3: Eytrewq (2.30€)
Seat 4: Hagreed (2.13€)
Seat 5: kamoulox_93 (1.45€)
Seat 6: Killim (1.32€)
*** ANTE/BLINDS ***
Fried Berg posts small blind 0.01€
OBEY-ME posts big blind 0.02€
Dealt to Fried Berg [Qs 7h]
*** PRE-FLOP *** 
Eytrewq raises 0.04€ to 0.06€
Hagreed folds
kamoulox_93 folds
Killim folds
Fried Berg folds
OBEY-ME folds
Eytrewq collected 0.09€ from pot
*** SUMMARY ***
Total pot 0.09€ | No rake
Seat 3: Eytrewq won 0.09€


Winamax Poker - HOLD-UP "Colorado" - HandId: #19116069-672623-1701691332 - Holdem no limit (0.01€/0.02€) - 2023/12/04 12:02:12 UTC
Table: 'Colorado' 6-max (real money) Seat #6 is the button
Seat 1: Glory utd (1.86€)
Seat 2: grut28 (3.48€)
Seat 3: Fried Berg (0.53€)
Seat 4: _ilTulipano_ (2.83€)
Seat 5: Maxou72120 (0.77€)
Seat 6: Melielvir (2.56€)
*** ANTE/BLINDS ***
Glory utd posts small blind 0.01€
grut28 posts big blind 0.02€
Dealt to Fried Berg [8d Ac]
*** PRE-FLOP *** 
Fried Berg raises 0.02€ to 0.04€
_ilTulipano_ folds
Maxou72120 calls 0.04€
Melielvir folds
Glory utd folds
grut28 folds
*** FLOP *** [9c Jc Ks]
Fried Berg checks
Maxou72120 bets 0.02€
Fried Berg raises 0.10€ to 0.12€
Maxou72120 calls 0.10€
*** TURN *** [9c Jc Ks][3c]
Fried Berg checks
Maxou72120 checks
*** RIVER *** [9c Jc Ks 3c][Kd]
Fried Berg checks
Maxou72120 checks
*** SHOW DOWN ***
Fried Berg shows [8d Ac] (One pair : Kings)
Maxou72120 shows [Qd Jd] (Two pairs : Kings and Jacks)
Maxou72120 collected 0.31€ from pot
*** SUMMARY ***
Total pot 0.31€ | Rake 0.04€
Board: [9c Jc Ks 3c Kd]
Seat 3: Fried Berg showed [8d Ac] and lost with One pair : Kings
Seat 5: Maxou72120 showed [Qd Jd] and won 0.31€ with Two pairs : Kings and Jacks


Winamax Poker - HOLD-UP "Colorado" - HandId: #19116069-672713-1701691389 - Holdem no limit (0.01€/0.02€) - 2023/12/04 12:03:09 UTC
Table: 'Colorado' 6-max (real money) Seat #6 is the button
Seat 1: Emmanuelange (3.40€)
Seat 2: Maxou72120 (0.92€)
Seat 3: _ilTulipano_ (5.36€)
Seat 4: Fried Berg (0.37€)
Seat 5: GTO-Mieko (2.67€)
Seat 6: slowreplay (3.63€)
*** ANTE/BLINDS ***
Emmanuelange posts small blind 0.01€
Maxou72120 posts big blind 0.02€
Dealt to Fried Berg [9c Js]
*** PRE-FLOP *** 
_ilTulipano_ raises 0.04€ to 0.06€
Fried Berg folds
GTO-Mieko folds
slowreplay folds
Emmanuelange folds
Maxou72120 folds
_ilTulipano_ collected 0.09€ from pot
*** SUMMARY ***
Total pot 0.09€ | No rake
Seat 3: _ilTulipano_ won 0.09€


Winamax Poker - HOLD-UP "Colorado" - HandId: #19116069-672736-1701691401 - Holdem no limit (0.01€/0.02€) - 2023/12/04 12:03:21 UTC
Table: 'Colorado' 6-max (real money) Seat #6 is the button
Seat 1: Melielvir (2.66€)
Seat 2: robertvali20 (2.43€)
Seat 3: Richard Reuk (2€)
Seat 4: Killim (0.98€)
Seat 5: Fried Berg (0.37€)
Seat 6: Solda14 (2.15€)
*** ANTE/BLINDS ***
Melielvir posts small blind 0.01€
robertvali20 posts big blind 0.02€
Dealt to Fried Berg [Th 5s]
*** PRE-FLOP *** 
Richard Reuk folds
Killim folds
Fried Berg folds
Solda14 folds
Melielvir folds
robertvali20 collected 0.03€ from pot
*** SUMMARY ***
Total pot 0.03€ | No rake
Seat 2: robertvali20 (big blind) won 0.03€


Winamax Poker - HOLD-UP "Colorado" - HandId: #19116069-672739-1701691403 - Holdem no limit (0.01€/0.02€) - 2023/12/04 12:03:23 UTC
Table: 'Colorado' 6-max (real money) Seat #6 is the button
Seat 1: Ertorko (3.63€)
Seat 2: slowreplay (3.63€)
Seat 3: deadpool1968 (2.25€)
Seat 4: Lipau14 (2.04€)
Seat 5: Fried Berg (0.37€)
Seat 6: Killim (0.98€)
*** ANTE/BLINDS ***
Ertorko posts small blind 0.01€
slowreplay posts big blind 0.02€
Dealt to Fried Berg [5d 8s]
*** PRE-FLOP *** 
deadpool1968 raises 0.02€ to 0.04€
Lipau14 calls 0.04€
Fried Berg folds
Killim folds
Ertorko folds
slowreplay folds
*** FLOP *** [6h 4c 5s]
deadpool1968 bets 0.04€
Lipau14 folds
deadpool1968 collected 0.14€ from pot
*** SUMMARY ***
Total pot 0.14€ | Rake 0.01€
Board: [6h 4c 5s]
Seat 3: deadpool1968 won 0.14€


Winamax Poker - HOLD-UP "Colorado" - HandId: #19116069-672742-1701691405 - Holdem no limit (0.01€/0.02€) - 2023/12/04 12:03:25 UTC
Table: 'Colorado' 6-max (real money) Seat #6 is the button
Seat 1: Fried Berg (0.37€)
Seat 2: CrazyRoxx (2€)
Seat 3: BMWTPM (1.91€)
Seat 4: Pwinpwin (2€)
Seat 5: Erenox (1.80€)
Seat 6: Roberfrk (1.87€)
*** ANTE/BLINDS ***
Fried Berg posts small blind 0.01€
CrazyRoxx posts big blind 0.02€
Dealt to Fried Berg [3h 8d]
*** PRE-FLOP *** 
BMWTPM calls 0.02€
Pwinpwin folds
Erenox raises 0.04€ to 0.06€
Roberfrk folds
Fried Berg folds
CrazyRoxx calls 0.04€
BMWTPM calls 0.04€
*** FLOP *** [3s Kc 5d]
CrazyRoxx checks
BMWTPM bets 0.09€
Erenox calls 0.09€
CrazyRoxx calls 0.09€
*** TURN *** [3s Kc 5d][5c]
CrazyRoxx checks
BMWTPM checks
Erenox checks
*** RIVER *** [3s Kc 5d 5c][5s]
CrazyRoxx checks
BMWTPM bets 0.12€
Erenox folds
CrazyRoxx folds
BMWTPM collected 0.53€ from pot
*** SUMMARY ***
Total pot 0.53€ | Rake 0.05€
Board: [3s Kc 5d 5c 5s]
Seat 3: BMWTPM won 0.53€


Winamax Poker - HOLD-UP "Colorado" - HandId: #19116069-672746-1701691408 - Holdem no limit (0.01€/0.02€) - 2023/12/04 12:03:28 UTC
Table: 'Colorado' 6-max (real money) Seat #6 is the button
Seat 1: GTO-Mieko (2.08€)
Seat 2: Fried Berg (0.36€)
Seat 3: Killim (0.98€)
Seat 4: JFSredbaron (2€)
Seat 5: Pop_hop_hop (2.78€)
Seat 6: SharkAKK (2.06€)
*** ANTE/BLINDS ***
GTO-Mieko posts small blind 0.01€
Fried Berg posts big blind 0.02€
Dealt to Fried Berg [7s Jc]
*** PRE-FLOP *** 
Killim folds
JFSredbaron folds
Pop_hop_hop folds
SharkAKK folds
GTO-Mieko folds
Fried Berg collected 0.03€ from pot
*** SUMMARY ***
Total pot 0.03€ | No rake
Seat 2: Fried Berg (big blind) won 0.03€


Winamax Poker - HOLD-UP "Colorado" - HandId: #19116069-672760-1701691420 - Holdem no limit (0.01€/0.02€) - 2023/12/04 12:03:40 UTC
Table: 'Colorado' 6-max (real money) Seat #6 is the button
Seat 1: slowreplay (3.61€)
Seat 2: rogabi (3.73€)
Seat 3: Fried Berg (0.37€)
Seat 4: Eddy Agricol (2€)
Seat 5: wAAlterrr (1.79€)
Seat 6: Durantula_6 (2.48€)
*** ANTE/BLINDS ***
slowreplay posts small blind 0.01€
rogabi posts big blind 0.02€
Dealt to Fried Berg [Ts 6c]
*** PRE-FLOP *** 
Fried Berg folds
Eddy Agricol raises 0.04€ to 0.06€
wAAlterrr folds
Durantula_6 folds
slowreplay folds
rogabi folds
Eddy Agricol collected 0.09€ from pot
*** SUMMARY ***
Total pot 0.09€ | No rake
Seat 4: Eddy Agricol won 0.09€


Winamax Poker - HOLD-UP "Colorado" - HandId: #19116069-672767-1701691424 - Holdem no limit (0.01€/0.02€) - 2023/12/04 12:03:44 UTC
Table: 'Colorado' 6-max (real money) Seat #6 is the button
Seat 1: Pop_hop_hop (2.78€)
Seat 2: Lipau14 (1.99€)
Seat 3: elx111 (1.70€)
Seat 4: Fried Berg (0.37€)
Seat 5: Kryshus (2.46€)
Seat 6: Pwinpwin (2.21€)
*** ANTE/BLINDS ***
Pop_hop_hop posts small blind 0.01€
Lipau14 posts big blind 0.02€
Dealt to Fried Berg [4h 2c]
*** PRE-FLOP *** 
elx111 folds
Fried Berg folds
Kryshus raises 0.04€ to 0.06€
Pwinpwin raises 0.18€ to 0.24€
Pop_hop_hop folds
Lipau14 folds
Kryshus folds
Pwinpwin collected 0.33€ from pot
*** SUMMARY ***
Total pot 0.33€ | No rake
Seat 6: Pwinpwin (button) won 0.33€


Winamax Poker - HOLD-UP "Colorado" - HandId: #19116069-672769-1701691425 - Holdem no limit (0.01€/0.02€) - 2023/12/04 12:03:45 UTC
Table: 'Colorado' 6-max (real money) Seat #6 is the button
Seat 1: SharkAKK (2.06€)
Seat 2: Hagreed (2.21€)
Seat 3: Zile741 (2.83€)
Seat 4: deadpool1968 (2.31€)
Seat 5: toka30 (2.35€)
Seat 6: Fried Berg (0.37€)
*** ANTE/BLINDS ***
SharkAKK posts small blind 0.01€
Hagreed posts big blind 0.02€
Dealt to Fried Berg [7c 8d]
*** PRE-FLOP *** 
Zile741 raises 0.04€ to 0.06€
deadpool1968 folds
toka30 folds
Fried Berg folds
SharkAKK folds
Hagreed calls 0.04€
*** FLOP *** [3s 2c 8c]
Hagreed checks
Zile741 bets 0.05€
Hagreed calls 0.05€
*** TURN *** [3s 2c 8c][Ah]
Hagreed checks
Zile741 bets 0.06€
Hagreed folds
Zile741 collected 0.27€ from pot
*** SUMMARY ***
Total pot 0.27€ | Rake 0.02€
Board: [3s 2c 8c Ah]
Seat 3: Zile741 won 0.27€


Winamax Poker - HOLD-UP "Colorado" - HandId: #19116069-672773-1701691429 - Holdem no limit (0.01€/0.02€) - 2023/12/04 12:03:49 UTC
Table: 'Colorado' 6-max (real money) Seat #6 is the button
Seat 1: OBEY-ME (2.12€)
Seat 2: Ga31k (2.33€)
Seat 3: Fried Berg (0.37€)
Seat 4: elx111 (1.70€)
Seat 5: Ziildjiin (1.95€)
Seat 6: thebestt693 (2.86€)
*** ANTE/BLINDS ***
OBEY-ME posts small blind 0.01€
Ga31k posts big blind 0.02€
Dealt to Fried Berg [7c Qs]
*** PRE-FLOP *** 
Fried Berg folds
elx111 folds
Ziildjiin raises 0.02€ to 0.04€
thebestt693 folds
OBEY-ME folds
Ga31k folds
Ziildjiin collected 0.07€ from pot
*** SUMMARY ***
Total pot 0.07€ | No rake
Seat 5: Ziildjiin won 0.07€


Winamax Poker - HOLD-UP "Colorado" - HandId: #19116069-672775-1701691430 - Holdem no limit (0.01€/0.02€) - 2023/12/04 12:03:50 UTC
Table: 'Colorado' 6-max (real money) Seat #6 is the button
Seat 1: Roberfrk (1.57€)
Seat 2: Fried Berg (0.37€)
Seat 3: AMBM2729 (1.21€)
Seat 4: Zangii13 (2.86€)
Seat 5: JissEl1te (3.74€)
Seat 6: GTO-Mieko (2.49€)
*** ANTE/BLINDS ***
Roberfrk posts small blind 0.01€
Fried Berg posts big blind 0.02€
Dealt to Fried Berg [2d 7h]
*** PRE-FLOP *** 
AMBM2729 folds
Zangii13 folds
JissEl1te folds
GTO-Mieko folds
Roberfrk raises 0.04€ to 0.06€
Fried Berg folds
Roberfrk collected 0.08€ from pot
*** SUMMARY ***
Total pot 0.08€ | No rake
Seat 1: Roberfrk (small blind) won 0.08€


Winamax Poker - HOLD-UP "Colorado" - HandId: #19116069-672801-1701691446 - Holdem no limit (0.01€/0.02€) - 2023/12/04 12:04:06 UTC
Table: 'Colorado' 6-max (real money) Seat #6 is the button
Seat 1: Fried Berg (0.35€)
Seat 2: JFSredbaron (2€)
Seat 3: elx111 (1.25€)
Seat 4: Ga31k (2.30€)
Seat 5: Joan009 (2.17€)
Seat 6: Jorj-X-McKie (2.58€)
*** ANTE/BLINDS ***
Fried Berg posts small blind 0.01€
JFSredbaron posts big blind 0.02€
Dealt to Fried Berg [3h 2d]
*** PRE-FLOP *** 
elx111 folds
Ga31k folds
Joan009 folds
Jorj-X-McKie raises 0.02€ to 0.04€
Fried Berg folds
JFSredbaron folds
Jorj-X-McKie collected 0.07€ from pot
*** SUMMARY ***
Total pot 0.07€ | No rake
Seat 6: Jorj-X-McKie (button) won 0.07€


Winamax Poker - HOLD-UP "Colorado" - HandId: #19116069-672808-1701691450 - Holdem no limit (0.01€/0.02€) - 2023/12/04 12:04:10 UTC
Table: 'Colorado' 6-max (real money) Seat #6 is the button
Seat 1: _ilTulipano_ (2.87€)
Seat 2: thonyo 88 (2.43€)
Seat 3: slowreplay (3.61€)
Seat 4: Fried Berg (0.34€)
Seat 5: Richard Reuk (2€)
Seat 6: LeoPirat (3.65€)
*** ANTE/BLINDS ***
_ilTulipano_ posts small blind 0.01€
thonyo 88 posts big blind 0.02€
Dealt to Fried Berg [8h 3h]
*** PRE-FLOP *** 
slowreplay folds
Fried Berg folds
Richard Reuk folds
LeoPirat folds
_ilTulipano_ folds
thonyo 88 collected 0.03€ from pot
*** SUMMARY ***
Total pot 0.03€ | No rake
Seat 2: thonyo 88 (big blind) won 0.03€


Winamax Poker - HOLD-UP "Colorado" - HandId: #19116069-672812-1701691453 - Holdem no limit (0.01€/0.02€) - 2023/12/04 12:04:13 UTC
Table: 'Colorado' 6-max (real money) Seat #6 is the button
Seat 1: Durantula_6 (2.44€)
Seat 2: JissEl1te (3.65€)
Seat 3: ilergeta (3.11€)
Seat 4: Joan009 (2.03€)
Seat 5: Fried Berg (0.34€)
Seat 6: Zanghief068 (2.08€)
Hold-up to Pot: total 0.10€
*** ANTE/BLINDS ***
Durantula_6 posts small blind 0.01€
JissEl1te posts big blind 0.02€
Dealt to Fried Berg [Qc 3c]
*** PRE-FLOP *** 
ilergeta folds
Joan009 raises 0.15€ to 0.17€
Fried Berg folds
Zanghief068 folds
Durantula_6 folds
JissEl1te folds
Joan009 collected 0.30€ from pot
*** SUMMARY ***
Total pot 0.30€ | No rake
Seat 4: Joan009 won 0.30€


Winamax Poker - HOLD-UP "Colorado" - HandId: #19116069-672821-1701691458 - Holdem no limit (0.01€/0.02€) - 2023/12/04 12:04:18 UTC
Table: 'Colorado' 6-max (real money) Seat #6 is the button
Seat 1: Zanghief068 (2.08€)
Seat 2: antoclem2A (2.21€)
Seat 3: Emmanuelange (3.35€)
Seat 4: cygoud (2.07€)
Seat 5: Ga31k (2.28€)
Seat 6: Fried Berg (0.34€)
*** ANTE/BLINDS ***
Zanghief068 posts small blind 0.01€
antoclem2A posts big blind 0.02€
Dealt to Fried Berg [Th 5s]
*** PRE-FLOP *** 
Emmanuelange folds
cygoud folds
Ga31k folds
Fried Berg folds
Zanghief068 folds
antoclem2A collected 0.03€ from pot
*** SUMMARY ***
Total pot 0.03€ | No rake
Seat 2: antoclem2A (big blind) won 0.03€


Winamax Poker - HOLD-UP "Colorado" - HandId: #19116069-672825-1701691460 - Holdem no limit (0.01€/0.02€) - 2023/12/04 12:04:20 UTC
Table: 'Colorado' 6-max (real money) Seat #6 is the button
Seat 1: Ertorko (3.60€)
Seat 2: GTO-Mieko (2.58€)
Seat 3: ilergeta (3.73€)
Seat 4: Fried Berg (0.34€)
Seat 5: Zanghief068 (2.07€)
Seat 6: robertvali20 (2.47€)
*** ANTE/BLINDS ***
Ertorko posts small blind 0.01€
GTO-Mieko posts big blind 0.02€
Dealt to Fried Berg [4d 8h]
*** PRE-FLOP *** 
ilergeta folds
Fried Berg folds
Zanghief068 raises 0.04€ to 0.06€
robertvali20 folds
Ertorko folds
GTO-Mieko raises 0.12€ to 0.18€
Zanghief068 calls 0.12€
*** FLOP *** [Jc Jd Kh]
GTO-Mieko bets 0.13€
Zanghief068 folds
GTO-Mieko collected 0.46€ from pot
*** SUMMARY ***
Total pot 0.46€ | Rake 0.04€
Board: [Jc Jd Kh]
Seat 2: GTO-Mieko (big blind) won 0.46€


Winamax Poker - HOLD-UP "Colorado" - HandId: #19116069-672830-1701691463 - Holdem no limit (0.01€/0.02€) - 2023/12/04 12:04:23 UTC
Table: 'Colorado' 6-max (real money) Seat #6 is the button
Seat 1: EDPR (2€)
Seat 2: Fried Berg (0.34€)
Seat 3: thonyo 88 (2.44€)
Seat 4: JFSredbaron (2.51€)
Seat 5: slowreplay (2.94€)
Seat 6: Richard Reuk (2€)
*** ANTE/BLINDS ***
EDPR posts small blind 0.01€
Fried Berg posts big blind 0.02€
Dealt to Fried Berg [8s Th]
*** PRE-FLOP *** 
thonyo 88 calls 0.02€
JFSredbaron folds
slowreplay folds
Richard Reuk folds
EDPR folds
Fried Berg checks
*** FLOP *** [Ts Jc Td]
Fried Berg bets 0.04€
thonyo 88 folds
Fried Berg collected 0.08€ from pot
*** SUMMARY ***
Total pot 0.08€ | Rake 0.01€
Board: [Ts Jc Td]
Seat 2: Fried Berg (big blind) won 0.08€


Winamax Poker - HOLD-UP "Colorado" - HandId: #19116069-672864-1701691487 - Holdem no limit (0.01€/0.02€) - 2023/12/04 12:04:47 UTC
Table: 'Colorado' 6-max (real money) Seat #6 is the button
Seat 1: Fried Berg (0.36€)
Seat 2: grut28 (3.47€)
Seat 3: Machiavel- (2€)
Seat 4: Zile741 (2.97€)
Seat 5: EDPR (2€)
Seat 6: Ertorko (3.50€)
*** ANTE/BLINDS ***
Fried Berg posts small blind 0.01€
grut28 posts big blind 0.02€
Dealt to Fried Berg [2c 5d]
*** PRE-FLOP *** 
Machiavel- folds
Zile741 folds
EDPR raises 0.04€ to 0.06€
Ertorko folds
Fried Berg folds
grut28 folds
EDPR collected 0.09€ from pot
*** SUMMARY ***
Total pot 0.09€ | No rake
Seat 5: EDPR won 0.09€


Winamax Poker - HOLD-UP "Colorado" - HandId: #19116069-672875-1701691495 - Holdem no limit (0.01€/0.02€) - 2023/12/04 12:04:55 UTC
Table: 'Colorado' 6-max (real money) Seat #6 is the button
Seat 1: Jorj-X-McKie (2.62€)
Seat 2: AMBM2729 (1.24€)
Seat 3: Fried Berg (0.35€)
Seat 4: NE PA (1.81€)
Seat 5: grut28 (3.45€)
Seat 6: robertvali20 (2.47€)
*** ANTE/BLINDS ***
Jorj-X-McKie posts small blind 0.01€
AMBM2729 posts big blind 0.02€
Dealt to Fried Berg [8h 2s]
*** PRE-FLOP *** 
Fried Berg folds
NE PA folds
grut28 folds
robertvali20 raises 0.05€ to 0.07€
Jorj-X-McKie folds
AMBM2729 folds
robertvali20 collected 0.10€ from pot
*** SUMMARY ***
Total pot 0.10€ | No rake
Seat 6: robertvali20 (button) won 0.10€


Winamax Poker - HOLD-UP "Colorado" - HandId: #19116069-672877-1701691497 - Holdem no limit (0.01€/0.02€) - 2023/12/04 12:04:57 UTC
Table: 'Colorado' 6-max (real money) Seat #6 is the button
Seat 1: Machiavel- (2€)
Seat 2: CB-Joker6274 (2.62€)
Seat 3: BMWTPM (1.69€)
Seat 4: slowreplay (2.91€)
Seat 5: Fried Berg (0.35€)
Seat 6: Antoo_10 (4.33€)
*** ANTE/BLINDS ***
Machiavel- posts small blind 0.01€
CB-Joker6274 posts big blind 0.02€
Dealt to Fried Berg [7c 6h]
*** PRE-FLOP *** 
BMWTPM folds
slowreplay folds
Fried Berg folds
Antoo_10 folds
Machiavel- calls 0.01€
CB-Joker6274 checks
*** FLOP *** [Ad 8s 5d]
Machiavel- checks
CB-Joker6274 checks
*** TURN *** [Ad 8s 5d][3s]
Machiavel- checks
CB-Joker6274 checks
*** RIVER *** [Ad 8s 5d 3s][Qs]
Machiavel- bets 0.02€
CB-Joker6274 calls 0.02€
*** SHOW DOWN ***
CB-Joker6274 shows [Jd 2h] (High card : Ace)
Machiavel- shows [Ts 4s] (Flush Queen high)
Machiavel- collected 0.07€ from pot
*** SUMMARY ***
Total pot 0.07€ | Rake 0.01€
Board: [Ad 8s 5d 3s Qs]
Seat 1: Machiavel- (small blind) showed [Ts 4s] and won 0.07€ with Flush Queen high
Seat 2: CB-Joker6274 (big blind) showed [Jd 2h] and lost with High card : Ace


Winamax Poker - HOLD-UP "Colorado" - HandId: #19116069-672880-1701691498 - Holdem no limit (0.01€/0.02€) - 2023/12/04 12:04:58 UTC
Table: 'Colorado' 6-max (real money) Seat #6 is the button
Seat 1: Emmanuelange (3.44€)
Seat 2: Antoo_10 (4.33€)
Seat 3: yam69 (2.09€)
Seat 4: EDPR (2€)
Seat 5: Fried Berg (0.35€)
Seat 6: Ga31k (2.27€)
*** ANTE/BLINDS ***
Emmanuelange posts small blind 0.01€
Antoo_10 posts big blind 0.02€
Dealt to Fried Berg [As 3s]
*** PRE-FLOP *** 
yam69 folds
EDPR folds
Fried Berg raises 0.02€ to 0.04€
Ga31k folds
Emmanuelange folds
Antoo_10 folds
Fried Berg collected 0.07€ from pot
*** SUMMARY ***
Total pot 0.07€ | No rake
Seat 5: Fried Berg won 0.07€


Winamax Poker - HOLD-UP "Colorado" - HandId: #19116069-672903-1701691514 - Holdem no limit (0.01€/0.02€) - 2023/12/04 12:05:14 UTC
Table: 'Colorado' 6-max (real money) Seat #6 is the button
Seat 1: Kryshus (2.28€)
Seat 2: Fried Berg (0.38€)
Seat 3: Hagreed (2.16€)
Seat 4: Zamar6 (3.90€)
Seat 5: _ilTulipano_ (2.33€)
Seat 6: deadpool1968 (2.34€)
*** ANTE/BLINDS ***
Kryshus posts small blind 0.01€
Fried Berg posts big blind 0.02€
Dealt to Fried Berg [Ks 7c]
*** PRE-FLOP *** 
Hagreed folds
Zamar6 calls 0.02€
_ilTulipano_ folds
deadpool1968 folds
Kryshus calls 0.01€
Fried Berg checks
*** FLOP *** [7d Js Ac]
Kryshus checks
Fried Berg checks
Zamar6 checks
*** TURN *** [7d Js Ac][6d]
Kryshus checks
Fried Berg checks
Zamar6 checks
*** RIVER *** [7d Js Ac 6d][Th]
Kryshus checks
Fried Berg checks
Zamar6 checks
*** SHOW DOWN ***
Kryshus shows [5d 4c] (High card : Ace)
Zamar6 shows [Qc 8h] (High card : Ace)
Fried Berg shows [Ks 7c] (One pair : 7)
Fried Berg collected 0.05€ from pot
*** SUMMARY ***
Total pot 0.05€ | Rake 0.01€
Board: [7d Js Ac 6d Th]
Seat 1: Kryshus (small blind) showed [5d 4c] and lost with High card : Ace
Seat 2: Fried Berg (big blind) showed [Ks 7c] and won 0.05€ with One pair : 7
Seat 4: Zamar6 showed [Qc 8h] and lost with High card : Ace


Winamax Poker - HOLD-UP "Colorado" - HandId: #19116069-672969-1701691560 - Holdem no limit (0.01€/0.02€) - 2023/12/04 12:06:00 UTC
Table: 'Colorado' 6-max (real money) Seat #6 is the button
Seat 1: Fried Berg (0.41€)
Seat 2: CB-Joker6274 (2.72€)
Seat 3: Kryshus (2.26€)
Seat 4: slowreplay (2€)
Seat 5: AMBM2729 (1.20€)
Seat 6: Feo.Gallo703 (2€)
*** ANTE/BLINDS ***
Fried Berg posts small blind 0.01€
CB-Joker6274 posts big blind 0.02€
Dealt to Fried Berg [Th Jc]
*** PRE-FLOP *** 
Kryshus folds
slowreplay raises 0.03€ to 0.05€
AMBM2729 folds
Feo.Gallo703 folds
Fried Berg calls 0.04€
CB-Joker6274 folds
*** FLOP *** [Js Qd 6h]
Fried Berg bets 0.06€
slowreplay folds
Fried Berg collected 0.17€ from pot
*** SUMMARY ***
Total pot 0.17€ | Rake 0.01€
Board: [Js Qd 6h]
Seat 1: Fried Berg (small blind) won 0.17€


Winamax Poker - HOLD-UP "Colorado" - HandId: #19116069-673012-1701691590 - Holdem no limit (0.01€/0.02€) - 2023/12/04 12:06:30 UTC
Table: 'Colorado' 6-max (real money) Seat #6 is the button
Seat 1: metamex (1.84€)
Seat 2: Zile741 (3.33€)
Seat 3: R2Dread2 (6.07€)
Seat 4: Fried Berg (0.47€)
Seat 5: Eddy Agricol (4.64€)
Seat 6: Pwinpwin (2.85€)
*** ANTE/BLINDS ***
metamex posts small blind 0.01€
Zile741 posts big blind 0.02€
Dealt to Fried Berg [7c 4d]
*** PRE-FLOP *** 
R2Dread2 raises 0.05€ to 0.07€
Fried Berg folds
Eddy Agricol folds
Pwinpwin folds
metamex folds
Zile741 calls 0.05€
*** FLOP *** [4c Jc Ah]
Zile741 checks
R2Dread2 bets 0.10€
Zile741 folds
R2Dread2 collected 0.23€ from pot
*** SUMMARY ***
Total pot 0.23€ | Rake 0.02€
Board: [4c Jc Ah]
Seat 3: R2Dread2 won 0.23€


Winamax Poker - HOLD-UP "Colorado" - HandId: #19116069-673018-1701691596 - Holdem no limit (0.01€/0.02€) - 2023/12/04 12:06:36 UTC
Table: 'Colorado' 6-max (real money) Seat #6 is the button
Seat 1: cygoud (2.04€)
Seat 2: slowreplay (2€)
Seat 3: Fried Berg (0.47€)
Seat 4: Durantula_6 (2€)
Seat 5: Erenox (2.98€)
Seat 6: GTO-Mieko (2€)
*** ANTE/BLINDS ***
cygoud posts small blind 0.01€
slowreplay posts big blind 0.02€
Dealt to Fried Berg [9c Ks]
*** PRE-FLOP *** 
Fried Berg folds
Durantula_6 raises 0.03€ to 0.05€
Erenox folds
GTO-Mieko folds
cygoud folds
slowreplay folds
Durantula_6 collected 0.08€ from pot
*** SUMMARY ***
Total pot 0.08€ | No rake
Seat 4: Durantula_6 won 0.08€


Winamax Poker - HOLD-UP "Colorado" - HandId: #19116069-673020-1701691599 - Holdem no limit (0.01€/0.02€) - 2023/12/04 12:06:39 UTC
Table: 'Colorado' 6-max (real money) Seat #6 is the button
Seat 1: Upswing11 (3.11€)
Seat 2: GTO-Mieko (2.46€)
Seat 3: Sodam84 (2.69€)
Seat 4: CB-Joker6274 (2.66€)
Seat 5: Tompahmax (1.97€)
Seat 6: Fried Berg (0.47€)
Hold-up to Pot: total 0.10€
*** ANTE/BLINDS ***
Upswing11 posts small blind 0.01€
GTO-Mieko posts big blind 0.02€
Dealt to Fried Berg [9c Ah]
*** PRE-FLOP *** 
Sodam84 raises 0.02€ to 0.04€
CB-Joker6274 calls 0.04€
Tompahmax calls 0.04€
Fried Berg calls 0.04€
Upswing11 calls 0.03€
GTO-Mieko folds
*** FLOP *** [3c 4d 5d]
Upswing11 checks
Sodam84 bets 0.11€
CB-Joker6274 folds
Tompahmax folds
Fried Berg calls 0.11€
Upswing11 folds
*** TURN *** [3c 4d 5d][2d]
Sodam84 checks
Fried Berg bets 0.10€
Sodam84 calls 0.10€
*** RIVER *** [3c 4d 5d 2d][Qc]
Sodam84 checks
Fried Berg checks
*** SHOW DOWN ***
Sodam84 shows [3h 4h] (Two pairs : 4 and 3)
Fried Berg shows [9c Ah] (Straight 5 high)
Fried Berg collected 0.68€ from pot
*** SUMMARY ***
Total pot 0.68€ | Rake 0.06€
Board: [3c 4d 5d 2d Qc]
Seat 3: Sodam84 showed [3h 4h] and lost with Two pairs : 4 and 3
Seat 6: Fried Berg (button) showed [9c Ah] and won 0.68€ with Straight 5 high


Winamax Poker - HOLD-UP "Colorado" - HandId: #19116069-673095-1701691656 - Holdem no limit (0.01€/0.02€) - 2023/12/04 12:07:36 UTC
Table: 'Colorado' 6-max (real money) Seat #6 is the button
Seat 1: Erenox (1.05€)
Seat 2: ilergeta (2.08€)
Seat 3: Jorj-X-McKie (2.64€)
Seat 4: EDPR (2.03€)
Seat 5: Pwinpwin (2.81€)
Seat 6: Fried Berg (0.90€)
Hold-up to Pot: total 0.10€
*** ANTE/BLINDS ***
Erenox posts small blind 0.01€
ilergeta posts big blind 0.02€
Dealt to Fried Berg [Qc Ks]
*** PRE-FLOP *** 
Jorj-X-McKie folds
EDPR raises 0.04€ to 0.06€
Pwinpwin folds
Fried Berg raises 0.12€ to 0.18€
Erenox folds
ilergeta folds
EDPR calls 0.12€
*** FLOP *** [Qs Jd 6s]
EDPR checks
Fried Berg bets 0.20€
EDPR calls 0.20€
*** TURN *** [Qs Jd 6s][9d]
EDPR checks
Fried Berg checks
*** RIVER *** [Qs Jd 6s 9d][8s]
EDPR checks
Fried Berg checks
*** SHOW DOWN ***
Fried Berg shows [Qc Ks] (One pair : Queens)
EDPR shows [8h 8c] (Trips of 8)
EDPR collected 0.81€ from pot
*** SUMMARY ***
Total pot 0.81€ | Rake 0.08€
Board: [Qs Jd 6s 9d 8s]
Seat 4: EDPR showed [8h 8c] and won 0.81€ with Trips of 8
Seat 6: Fried Berg (button) showed [Qc Ks] and lost with One pair : Queens


Winamax Poker - HOLD-UP "Colorado" - HandId: #19116069-673192-1701691712 - Holdem no limit (0.01€/0.02€) - 2023/12/04 12:08:32 UTC
Table: 'Colorado' 6-max (real money) Seat #6 is the button
Seat 1: AMBM2729 (1.30€)
Seat 2: Richard Reuk (2.32€)
Seat 3: Fried Berg (0.52€)
Seat 4: slowreplay (2.07€)
Seat 5: EDPR (2.46€)
Seat 6: Joan009 (2.02€)
*** ANTE/BLINDS ***
AMBM2729 posts small blind 0.01€
Richard Reuk posts big blind 0.02€
Dealt to Fried Berg [3h 4d]
*** PRE-FLOP *** 
Fried Berg folds
slowreplay folds
EDPR raises 0.04€ to 0.06€
Joan009 folds
AMBM2729 folds
Richard Reuk folds
EDPR collected 0.09€ from pot
*** SUMMARY ***
Total pot 0.09€ | No rake
Seat 5: EDPR won 0.09€


Winamax Poker - HOLD-UP "Colorado" - HandId: #19116069-673203-1701691719 - Holdem no limit (0.01€/0.02€) - 2023/12/04 12:08:39 UTC
Table: 'Colorado' 6-max (real money) Seat #6 is the button
Seat 1: Ertorko (2.95€)
Seat 2: Fried Berg (0.52€)
Seat 3: Clapotis06 (1.94€)
Seat 4: elx111 (1.86€)
Seat 5: ElGringocoke (3.52€)
Seat 6: Joan009 (2.02€)
*** ANTE/BLINDS ***
Ertorko posts small blind 0.01€
Fried Berg posts big blind 0.02€
Dealt to Fried Berg [Jc 6d]
*** PRE-FLOP *** 
Clapotis06 folds
elx111 folds
ElGringocoke folds
Joan009 folds
Ertorko raises 0.05€ to 0.07€
Fried Berg folds
Ertorko collected 0.09€ from pot
*** SUMMARY ***
Total pot 0.09€ | No rake
Seat 1: Ertorko (small blind) won 0.09€


Winamax Poker - HOLD-UP "Colorado" - HandId: #19116069-673229-1701691739 - Holdem no limit (0.01€/0.02€) - 2023/12/04 12:08:59 UTC
Table: 'Colorado' 6-max (real money) Seat #6 is the button
Seat 1: Pablopenrais (1.98€)
Seat 2: grut28 (3.57€)
Seat 3: Durantula_6 (2.41€)
Seat 4: emojipok (0.47€)
Seat 5: Fried Berg (0.50€)
Seat 6: NE PA (1.63€)
*** ANTE/BLINDS ***
Pablopenrais posts small blind 0.01€
grut28 posts big blind 0.02€
Dealt to Fried Berg [Ts 8c]
*** PRE-FLOP *** 
Durantula_6 folds
emojipok folds
Fried Berg folds
NE PA raises 0.04€ to 0.06€
Pablopenrais calls 0.05€
grut28 folds
*** FLOP *** [6d 4c 3c]
Pablopenrais checks
NE PA checks
*** TURN *** [6d 4c 3c][7c]
Pablopenrais checks
NE PA checks
*** RIVER *** [6d 4c 3c 7c][9d]
Pablopenrais checks
NE PA checks
*** SHOW DOWN ***
Pablopenrais shows [Qs Th] (High card : Queen)
NE PA shows [Qd Jh] (High card : Queen)
NE PA collected 0.13€ from pot
*** SUMMARY ***
Total pot 0.13€ | Rake 0.01€
Board: [6d 4c 3c 7c 9d]
Seat 1: Pablopenrais (small blind) showed [Qs Th] and lost with High card : Queen
Seat 6: NE PA (button) showed [Qd Jh] and won 0.13€ with High card : Queen


Winamax Poker - HOLD-UP "Colorado" - HandId: #19116069-673249-1701691750 - Holdem no limit (0.01€/0.02€) - 2023/12/04 12:09:10 UTC
Table: 'Colorado' 6-max (real money) Seat #6 is the button
Seat 1: Fried Berg (0.50€)
Seat 2: Jesperord98 (4.77€)
Seat 3: Tompahmax (1.83€)
Seat 4: cygoud (2€)
Seat 5: Falckorn (1.22€)
Seat 6: GTO-Mieko (2.22€)
*** ANTE/BLINDS ***
Fried Berg posts small blind 0.01€
Jesperord98 posts big blind 0.02€
Dealt to Fried Berg [Qc 2d]
*** PRE-FLOP *** 
Tompahmax folds
cygoud raises 0.04€ to 0.06€
Falckorn folds
GTO-Mieko folds
Fried Berg folds
Jesperord98 folds
cygoud collected 0.09€ from pot
*** SUMMARY ***
Total pot 0.09€ | No rake
Seat 4: cygoud won 0.09€


Winamax Poker - HOLD-UP "Colorado" - HandId: #19116069-673253-1701691752 - Holdem no limit (0.01€/0.02€) - 2023/12/04 12:09:12 UTC
Table: 'Colorado' 6-max (real money) Seat #6 is the button
Seat 1: Durantula_6 (2.41€)
Seat 2: Ga31k (2.85€)
Seat 3: Machiavel- (2.89€)
Seat 4: Fried Berg (0.49€)
Seat 5: Ertorko (2.97€)
Seat 6: Emmanuelange (3.08€)
*** ANTE/BLINDS ***
Durantula_6 posts small blind 0.01€
Ga31k posts big blind 0.02€
Dealt to Fried Berg [2h 8h]
*** PRE-FLOP *** 
Machiavel- folds
Fried Berg folds
Ertorko raises 0.03€ to 0.05€
Emmanuelange calls 0.05€
Durantula_6 folds
Ga31k calls 0.03€
*** FLOP *** [Jc Kc 9c]
Ga31k bets 0.16€
Ertorko folds
Emmanuelange calls 0.16€
*** TURN *** [Jc Kc 9c][Qc]
Ga31k bets 0.02€
Emmanuelange calls 0.02€
*** RIVER *** [Jc Kc 9c Qc][2c]
Ga31k bets 2.62€ and is all-in
Emmanuelange calls 2.62€
*** SHOW DOWN ***
Emmanuelange shows [Ac 8s] (Flush Ace high)
Ga31k shows [Tc 7c] (Straight flush King)
Ga31k collected 5.18€ from pot
*** SUMMARY ***
Total pot 5.18€ | Rake 0.58€
Board: [Jc Kc 9c Qc 2c]
Seat 2: Ga31k (big blind) showed [Tc 7c] and won 5.18€ with Straight flush King
Seat 6: Emmanuelange (button) showed [Ac 8s] and lost with Flush Ace high


Winamax Poker - HOLD-UP "Colorado" - HandId: #19116069-673257-1701691755 - Holdem no limit (0.01€/0.02€) - 2023/12/04 12:09:15 UTC
Table: 'Colorado' 6-max (real money) Seat #6 is the button
Seat 1: Delpierrot10 (0.69€)
Seat 2: GTO-Mieko (2.20€)
Seat 3: Killim (0.67€)
Seat 4: Richard Reuk (2.43€)
Seat 5: Fried Berg (0.49€)
Seat 6: SharkAKK (2.12€)
*** ANTE/BLINDS ***
Delpierrot10 posts small blind 0.01€
GTO-Mieko posts big blind 0.02€
Dealt to Fried Berg [Js 7s]
*** PRE-FLOP *** 
Killim folds
Richard Reuk folds
Fried Berg raises 0.04€ to 0.06€
SharkAKK folds
Delpierrot10 raises 0.12€ to 0.18€
GTO-Mieko folds
Fried Berg calls 0.12€
*** FLOP *** [7h Ts Jc]
Delpierrot10 bets 0.13€
Fried Berg raises 0.13€ to 0.26€
Delpierrot10 raises 0.13€ to 0.39€
Fried Berg calls 0.05€ and is all-in
*** TURN *** [7h Ts Jc][3s]
*** RIVER *** [7h Ts Jc 3s][Ah]
*** SHOW DOWN ***
Delpierrot10 shows [Qd Qs] (One pair : Queens)
Fried Berg shows [Js 7s] (Two pairs : Jacks and 7)
Fried Berg collected 0.90€ from main pot
Delpierrot10 collected 0.08€ from side pot 1
*** SUMMARY ***
Total pot 0.98€ | Rake 0.10€
Board: [7h Ts Jc 3s Ah]
Seat 1: Delpierrot10 (small blind) showed [Qd Qs] and won 0.08€ with One pair : Queens
Seat 5: Fried Berg showed [Js 7s] and won 0.90€ with Two pairs : Jacks and 7


Winamax Poker - HOLD-UP "Colorado" - HandId: #19116069-673330-1701691801 - Holdem no limit (0.01€/0.02€) - 2023/12/04 12:10:01 UTC
Table: 'Colorado' 6-max (real money) Seat #6 is the button
Seat 1: e-card (1.91€)
Seat 2: Pwinpwin (2.78€)
Seat 3: n13tless (2.09€)
Seat 4: Delpierrot10 (0.20€)
Seat 5: AMBM2729 (1.20€)
Seat 6: Fried Berg (0.90€)
*** ANTE/BLINDS ***
e-card posts small blind 0.01€
Pwinpwin posts big blind 0.02€
Dealt to Fried Berg [7h Ad]
*** PRE-FLOP *** 
n13tless folds
Delpierrot10 folds
AMBM2729 folds
Fried Berg raises 0.02€ to 0.04€
e-card raises 0.10€ to 0.14€
Pwinpwin folds
Fried Berg calls 0.10€
*** FLOP *** [Qd Ts 6d]
e-card checks
Fried Berg bets 0.06€
e-card calls 0.06€
*** TURN *** [Qd Ts 6d][Td]
e-card checks
Fried Berg checks
*** RIVER *** [Qd Ts 6d Td][4s]
e-card checks
Fried Berg checks
*** SHOW DOWN ***
Fried Berg shows [7h Ad] (One pair : Tens)
e-card shows [Ah Kd] (One pair : Tens)
e-card collected 0.38€ from pot
*** SUMMARY ***
Total pot 0.38€ | Rake 0.04€
Board: [Qd Ts 6d Td 4s]
Seat 1: e-card (small blind) showed [Ah Kd] and won 0.38€ with One pair : Tens
Seat 6: Fried Berg (button) showed [7h Ad] and lost with One pair : Tens


Winamax Poker - HOLD-UP "Colorado" - HandId: #19116069-673403-1701691843 - Holdem no limit (0.01€/0.02€) - 2023/12/04 12:10:43 UTC
Table: 'Colorado' 6-max (real money) Seat #6 is the button
Seat 1: Fried Berg (0.70€)
Seat 2: Tompahmax (1.83€)
Seat 3: ilergeta (3.27€)
Seat 4: e-card (2.09€)
Seat 5: SharkAKK (2.03€)
Seat 6: AMBM2729 (1.24€)
*** ANTE/BLINDS ***
Fried Berg posts small blind 0.01€
Tompahmax posts big blind 0.02€
Dealt to Fried Berg [9c 8d]
*** PRE-FLOP *** 
ilergeta folds
e-card folds
SharkAKK raises 0.05€ to 0.07€
AMBM2729 folds
Fried Berg calls 0.06€
Tompahmax folds
*** FLOP *** [Js 7d 2c]
Fried Berg checks
SharkAKK bets 0.10€
Fried Berg folds
SharkAKK collected 0.24€ from pot
*** SUMMARY ***
Total pot 0.24€ | Rake 0.02€
Board: [Js 7d 2c]
Seat 5: SharkAKK won 0.24€


Winamax Poker - HOLD-UP "Colorado" - HandId: #19116069-673439-1701691871 - Holdem no limit (0.01€/0.02€) - 2023/12/04 12:11:11 UTC
Table: 'Colorado' 6-max (real money) Seat #6 is the button
Seat 1: AMBM2729 (1.20€)
Seat 2: Fried Berg (0.63€)
Seat 3: LeoPirat (3.98€)
Seat 4: NoThLo (2.11€)
Seat 5: Erenox (2.78€)
Seat 6: Jesperord98 (3.34€)
*** ANTE/BLINDS ***
AMBM2729 posts small blind 0.01€
Fried Berg posts big blind 0.02€
Dealt to Fried Berg [Kd 8s]
*** PRE-FLOP *** 
LeoPirat raises 0.03€ to 0.05€
NoThLo calls 0.05€
Erenox calls 0.05€
Jesperord98 folds
AMBM2729 folds
Fried Berg folds
*** FLOP *** [7s 3d Td]
LeoPirat checks
NoThLo checks
Erenox bets 0.09€
LeoPirat calls 0.09€
NoThLo folds
*** TURN *** [7s 3d Td][Ah]
LeoPirat bets 0.13€
Erenox calls 0.13€
*** RIVER *** [7s 3d Td Ah][2s]
LeoPirat checks
Erenox checks
*** SHOW DOWN ***
LeoPirat shows [8h 8c] (One pair : 8)
Erenox shows [4c As] (One pair : Aces)
Erenox collected 0.56€ from pot
*** SUMMARY ***
Total pot 0.56€ | Rake 0.06€
Board: [7s 3d Td Ah 2s]
Seat 3: LeoPirat showed [8h 8c] and lost with One pair : 8
Seat 5: Erenox showed [4c As] and won 0.56€ with One pair : Aces


Winamax Poker - HOLD-UP "Colorado" - HandId: #19116069-673441-1701691873 - Holdem no limit (0.01€/0.02€) - 2023/12/04 12:11:13 UTC
Table: 'Colorado' 6-max (real money) Seat #6 is the button
Seat 1: HawkinssTV (0.69€)
Seat 2: Zile741 (3.39€)
Seat 3: Fried Berg (0.61€)
Seat 4: Tompahmax (1.68€)
Seat 5: GTO-Mieko (2.59€)
Seat 6: Jesperord98 (3.34€)
*** ANTE/BLINDS ***
HawkinssTV posts small blind 0.01€
Zile741 posts big blind 0.02€
Dealt to Fried Berg [8c 3d]
*** PRE-FLOP *** 
Fried Berg folds
Tompahmax folds
GTO-Mieko folds
Jesperord98 raises 0.04€ to 0.06€
HawkinssTV folds
Zile741 calls 0.04€
*** FLOP *** [Ah 2s 2h]
Zile741 checks
Jesperord98 checks
*** TURN *** [Ah 2s 2h][8h]
Zile741 checks
Jesperord98 bets 0.07€
Zile741 raises 0.20€ to 0.27€
Jesperord98 folds
Zile741 collected 0.44€ from pot
*** SUMMARY ***
Total pot 0.44€ | Rake 0.03€
Board: [Ah 2s 2h 8h]
Seat 2: Zile741 (big blind) won 0.44€


Winamax Poker - HOLD-UP "Colorado" - HandId: #19116069-673445-1701691875 - Holdem no limit (0.01€/0.02€) - 2023/12/04 12:11:15 UTC
Table: 'Colorado' 6-max (real money) Seat #6 is the button
Seat 1: GTO-Mieko (2.33€)
Seat 2: Sebidu57 (1.88€)
Seat 3: JFSredbaron (2.41€)
Seat 4: Fried Berg (0.61€)
Seat 5: grut28 (5.29€)
Seat 6: EDPR (2.56€)
*** ANTE/BLINDS ***
GTO-Mieko posts small blind 0.01€
Sebidu57 posts big blind 0.02€
Dealt to Fried Berg [As 7h]
*** PRE-FLOP *** 
JFSredbaron folds
Fried Berg raises 0.02€ to 0.04€
grut28 folds
EDPR folds
GTO-Mieko folds
Sebidu57 folds
Fried Berg collected 0.07€ from pot
*** SUMMARY ***
Total pot 0.07€ | No rake
Seat 4: Fried Berg won 0.07€


Winamax Poker - HOLD-UP "Colorado" - HandId: #19116069-673467-1701691886 - Holdem no limit (0.01€/0.02€) - 2023/12/04 12:11:26 UTC
Table: 'Colorado' 6-max (real money) Seat #6 is the button
Seat 1: Eddy Agricol (2.25€)
Seat 2: GTO-Mieko (2.58€)
Seat 3: Sebidu57 (1.86€)
Seat 4: JFSredbaron (2.40€)
Seat 5: Zanghief068 (2.15€)
Seat 6: Fried Berg (0.64€)
*** ANTE/BLINDS ***
Eddy Agricol posts small blind 0.01€
GTO-Mieko posts big blind 0.02€
Dealt to Fried Berg [Jd Ts]
*** PRE-FLOP *** 
Sebidu57 folds
JFSredbaron folds
Zanghief068 raises 0.04€ to 0.06€
Fried Berg calls 0.06€
Eddy Agricol folds
GTO-Mieko folds
*** FLOP *** [Kc 5d 7h]
Zanghief068 bets 0.02€
Fried Berg calls 0.02€
*** TURN *** [Kc 5d 7h][Kh]
Zanghief068 bets 0.05€
Fried Berg folds
Zanghief068 collected 0.22€ from pot
*** SUMMARY ***
Total pot 0.22€ | Rake 0.02€
Board: [Kc 5d 7h Kh]
Seat 5: Zanghief068 won 0.22€


Winamax Poker - HOLD-UP "Colorado" - HandId: #19116069-673553-1701691940 - Holdem no limit (0.01€/0.02€) - 2023/12/04 12:12:20 UTC
Table: 'Colorado' 6-max (real money) Seat #6 is the button
Seat 1: ilergeta (2.46€)
Seat 2: Pwinpwin (2€)
Seat 3: Fried Berg (0.56€)
Seat 4: metamex (1.77€)
Seat 5: Homer14510 (1.87€)
Seat 6: EDPR (2.56€)
*** ANTE/BLINDS ***
ilergeta posts small blind 0.01€
Pwinpwin posts big blind 0.02€
Dealt to Fried Berg [3h 5h]
*** PRE-FLOP *** 
Fried Berg folds
metamex raises 0.04€ to 0.06€
Homer14510 folds
EDPR folds
ilergeta folds
Pwinpwin folds
metamex collected 0.09€ from pot
*** SUMMARY ***
Total pot 0.09€ | No rake
Seat 4: metamex won 0.09€


Winamax Poker - HOLD-UP "Colorado" - HandId: #19116069-673556-1701691942 - Holdem no limit (0.01€/0.02€) - 2023/12/04 12:12:22 UTC
Table: 'Colorado' 6-max (real money) Seat #6 is the button
Seat 1: Zangii13 (0.16€)
Seat 2: Fried Berg (0.56€)
Seat 3: FreeLouisias (4.71€)
Seat 4: EDPR (2.56€)
Seat 5: Ertorko (2.54€)
Seat 6: Zile741 (3.49€)
*** ANTE/BLINDS ***
Zangii13 posts small blind 0.01€
Fried Berg posts big blind 0.02€
Dealt to Fried Berg [7h 7d]
*** PRE-FLOP *** 
FreeLouisias raises 0.03€ to 0.05€
EDPR folds
Ertorko folds
Zile741 folds
Zangii13 raises 0.11€ to 0.16€ and is all-in
Fried Berg calls 0.14€
FreeLouisias raises 4.55€ to 4.71€ and is all-in
Fried Berg calls 0.40€ and is all-in
*** FLOP *** [9c 3h Ks]
*** TURN *** [9c 3h Ks][Ah]
*** RIVER *** [9c 3h Ks Ah][8h]
*** SHOW DOWN ***
Fried Berg shows [7h 7d] (One pair : 7)
Zangii13 shows [4s Ad] (One pair : Aces)
FreeLouisias shows [Qc Kd] (One pair : Kings)
FreeLouisias collected 4.87€ from side pot 1
Zangii13 collected 0.43€ from main pot
*** SUMMARY ***
Total pot 5.30€ | Rake 0.13€
Board: [9c 3h Ks Ah 8h]
Seat 1: Zangii13 (small blind) showed [4s Ad] and won 0.43€ with One pair : Aces
Seat 2: Fried Berg (big blind) showed [7h 7d] and lost with One pair : 7
Seat 3: FreeLouisias showed [Qc Kd] and won 4.87€ with One pair : Kings


Winamax Poker - HOLD-UP "Colorado" - HandId: #19116069-673617-1701691984 - Holdem no limit (0.01€/0.02€) - 2023/12/04 12:13:04 UTC
Table: 'Colorado' 6-max (real money) Seat #6 is the button
Seat 1: Fried Berg (0.50€)
Seat 2: Ertorko (2.56€)
Seat 3: Winico (0.45€)
Seat 4: metamex (1.81€)
Seat 5: GTO-Mieko (2.87€)
Seat 6: Zile741 (3.94€)
*** ANTE/BLINDS ***
Fried Berg posts small blind 0.01€
Ertorko posts big blind 0.02€
Dealt to Fried Berg [5c Ks]
*** PRE-FLOP *** 
Winico folds
metamex folds
GTO-Mieko folds
Zile741 folds
Fried Berg folds
Ertorko collected 0.03€ from pot
*** SUMMARY ***
Total pot 0.03€ | No rake
Seat 2: Ertorko (big blind) won 0.03€


Winamax Poker - HOLD-UP "Colorado" - HandId: #19116069-673631-1701691995 - Holdem no limit (0.01€/0.02€) - 2023/12/04 12:13:15 UTC
Table: 'Colorado' 6-max (real money) Seat #6 is the button
Seat 1: BMWTPM (2.10€)
Seat 2: Jorj-X-McKie (4.21€)
Seat 3: e-card (1.99€)
Seat 4: Fried Berg (0.49€)
Seat 5: ilergeta (2.23€)
Seat 6: Pwinpwin (2.24€)
*** ANTE/BLINDS ***
BMWTPM posts small blind 0.01€
Jorj-X-McKie posts big blind 0.02€
Dealt to Fried Berg [As 3d]
*** PRE-FLOP *** 
e-card folds
Fried Berg folds
ilergeta folds
Pwinpwin raises 0.03€ to 0.05€
BMWTPM folds
Jorj-X-McKie calls 0.03€
*** FLOP *** [8s 5h 2c]
Jorj-X-McKie checks
Pwinpwin bets 0.04€
Jorj-X-McKie folds
Pwinpwin collected 0.14€ from pot
*** SUMMARY ***
Total pot 0.14€ | Rake 0.01€
Board: [8s 5h 2c]
Seat 6: Pwinpwin (button) won 0.14€


Winamax Poker - HOLD-UP "Colorado" - HandId: #19116069-673634-1701691997 - Holdem no limit (0.01€/0.02€) - 2023/12/04 12:13:17 UTC
Table: 'Colorado' 6-max (real money) Seat #6 is the button
Seat 1: R2Dread2 (6.19€)
Seat 2: slowreplay (2.82€)
Seat 3: GTO-Mieko (2.33€)
Seat 4: wAAlterrr (1.45€)
Seat 5: Fried Berg (0.49€)
Seat 6: ASho-Hai (2.49€)
*** ANTE/BLINDS ***
R2Dread2 posts small blind 0.01€
slowreplay posts big blind 0.02€
Dealt to Fried Berg [4c 5c]
*** PRE-FLOP *** 
GTO-Mieko folds
wAAlterrr folds
Fried Berg raises 0.02€ to 0.04€
ASho-Hai folds
R2Dread2 folds
slowreplay folds
Fried Berg collected 0.07€ from pot
*** SUMMARY ***
Total pot 0.07€ | No rake
Seat 5: Fried Berg won 0.07€


Winamax Poker - HOLD-UP "Colorado" - HandId: #19116069-673655-1701692016 - Holdem no limit (0.01€/0.02€) - 2023/12/04 12:13:36 UTC
Table: 'Colorado' 6-max (real money) Seat #6 is the button
Seat 1: Richard Reuk (4.47€)
Seat 2: JFSredbaron (2.02€)
Seat 3: Jesperord98 (3.08€)
Seat 4: _ilTulipano_ (6.21€)
Seat 5: cygoud (3.54€)
Seat 6: Fried Berg (0.52€)
*** ANTE/BLINDS ***
Richard Reuk posts small blind 0.01€
JFSredbaron posts big blind 0.02€
Dealt to Fried Berg [Jc 3c]
*** PRE-FLOP *** 
Jesperord98 folds
_ilTulipano_ raises 0.04€ to 0.06€
cygoud folds
Fried Berg folds
Richard Reuk calls 0.05€
JFSredbaron calls 0.04€
*** FLOP *** [6h 6d 7d]
Richard Reuk checks
JFSredbaron checks
_ilTulipano_ bets 0.09€
Richard Reuk calls 0.09€
JFSredbaron folds
*** TURN *** [6h 6d 7d][3s]
Richard Reuk checks
_ilTulipano_ checks
*** RIVER *** [6h 6d 7d 3s][As]
Richard Reuk checks
_ilTulipano_ bets 0.13€
Richard Reuk folds
_ilTulipano_ collected 0.45€ from pot
*** SUMMARY ***
Total pot 0.45€ | Rake 0.04€
Board: [6h 6d 7d 3s As]
Seat 4: _ilTulipano_ won 0.45€


Winamax Poker - HOLD-UP "Colorado" - HandId: #19116069-673699-1701692052 - Holdem no limit (0.01€/0.02€) - 2023/12/04 12:14:12 UTC
Table: 'Colorado' 6-max (real money) Seat #6 is the button
Seat 1: R2Dread2 (7.20€)
Seat 2: Ertorko (3.66€)
Seat 3: Maxou72120 (1.71€)
Seat 4: Fried Berg (0.52€)
Seat 5: Jorj-X-McKie (2.67€)
Seat 6: GTO-Mieko (2.30€)
*** ANTE/BLINDS ***
R2Dread2 posts small blind 0.01€
Ertorko posts big blind 0.02€
Dealt to Fried Berg [3h Jd]
*** PRE-FLOP *** 
Maxou72120 folds
Fried Berg folds
Jorj-X-McKie folds
GTO-Mieko folds
R2Dread2 raises 0.04€ to 0.06€
Ertorko folds
R2Dread2 collected 0.08€ from pot
*** SUMMARY ***
Total pot 0.08€ | No rake
Seat 1: R2Dread2 (small blind) won 0.08€


Winamax Poker - HOLD-UP "Colorado" - HandId: #19116069-673707-1701692056 - Holdem no limit (0.01€/0.02€) - 2023/12/04 12:14:16 UTC
Table: 'Colorado' 6-max (real money) Seat #6 is the button
Seat 1: Jesperord98 (4.62€)
Seat 2: Polanskii (3.08€)
Seat 3: Fried Berg (0.52€)
Seat 4: Kryshus (1.94€)
Seat 5: Pwinpwin (2€)
Seat 6: Pablopenrais (2€)
*** ANTE/BLINDS ***
Jesperord98 posts small blind 0.01€
Polanskii posts big blind 0.02€
Dealt to Fried Berg [7h Ah]
*** PRE-FLOP *** 
Fried Berg raises 0.02€ to 0.04€
Kryshus folds
Pwinpwin folds
Pablopenrais folds
Jesperord98 folds
Polanskii folds
Fried Berg collected 0.07€ from pot
*** SUMMARY ***
Total pot 0.07€ | No rake
Seat 3: Fried Berg won 0.07€


Winamax Poker - HOLD-UP "Colorado" - HandId: #19116069-673731-1701692075 - Holdem no limit (0.01€/0.02€) - 2023/12/04 12:14:35 UTC
Table: 'Colorado' 6-max (real money) Seat #6 is the button
Seat 1: Polanskii (3.06€)
Seat 2: Fried Berg (0.55€)
Seat 3: Zile741 (3.25€)
Seat 4: PHeNiX_FiRe (0.47€)
Seat 5: ilergeta (3.22€)
Seat 6: metamex (1.76€)
*** ANTE/BLINDS ***
Polanskii posts small blind 0.01€
Fried Berg posts big blind 0.02€
Dealt to Fried Berg [8c 4h]
*** PRE-FLOP *** 
Zile741 raises 0.04€ to 0.06€
PHeNiX_FiRe folds
ilergeta calls 0.06€
metamex calls 0.06€
Polanskii folds
Fried Berg folds
*** FLOP *** [Kh 7d 7c]
Zile741 checks
ilergeta checks
metamex checks
*** TURN *** [Kh 7d 7c][Js]
Zile741 checks
ilergeta checks
metamex bets 0.11€
Zile741 folds
ilergeta folds
metamex collected 0.30€ from pot
*** SUMMARY ***
Total pot 0.30€ | Rake 0.02€
Board: [Kh 7d 7c Js]
Seat 6: metamex (button) won 0.30€


Winamax Poker - HOLD-UP "Colorado" - HandId: #19116069-673738-1701692081 - Holdem no limit (0.01€/0.02€) - 2023/12/04 12:14:41 UTC
Table: 'Colorado' 6-max (real money) Seat #6 is the button
Seat 1: Fried Berg (0.53€)
Seat 2: Pablopenrais (2.02€)
Seat 3: Kekoke (0.72€)
Seat 4: Syssy43 (2.05€)
Seat 5: elx111 (2.42€)
Seat 6: miguel07 (1.50€)
*** ANTE/BLINDS ***
Fried Berg posts small blind 0.01€
Pablopenrais posts big blind 0.02€
Dealt to Fried Berg [3d Qs]
*** PRE-FLOP *** 
Kekoke folds
Syssy43 folds
elx111 folds
miguel07 folds
Fried Berg folds
Pablopenrais collected 0.03€ from pot
*** SUMMARY ***
Total pot 0.03€ | No rake
Seat 2: Pablopenrais (big blind) won 0.03€


Winamax Poker - HOLD-UP "Colorado" - HandId: #19116069-673743-1701692085 - Holdem no limit (0.01€/0.02€) - 2023/12/04 12:14:45 UTC
Table: 'Colorado' 6-max (real money) Seat #6 is the button
Seat 1: yam69 (2.13€)
Seat 2: Machiavel- (3€)
Seat 3: Ertorko (3.66€)
Seat 4: solmer (1.93€)
Seat 5: Kekoke (0.72€)
Seat 6: Fried Berg (0.52€)
*** ANTE/BLINDS ***
yam69 posts small blind 0.01€
Machiavel- posts big blind 0.02€
Dealt to Fried Berg [5d 8h]
*** PRE-FLOP *** 
Ertorko folds
solmer folds
Kekoke folds
Fried Berg folds
yam69 raises 0.02€ to 0.04€
Machiavel- raises 0.10€ to 0.14€
yam69 calls 0.10€
*** FLOP *** [Kc 6s 3c]
yam69 checks
Machiavel- checks
*** TURN *** [Kc 6s 3c][Kd]
yam69 checks
Machiavel- bets 0.10€
yam69 folds
Machiavel- collected 0.35€ from pot
*** SUMMARY ***
Total pot 0.35€ | Rake 0.03€
Board: [Kc 6s 3c Kd]
Seat 2: Machiavel- (big blind) won 0.35€


Winamax Poker - HOLD-UP "Colorado" - HandId: #19116069-673747-1701692088 - Holdem no limit (0.01€/0.02€) - 2023/12/04 12:14:48 UTC
Table: 'Colorado' 6-max (real money) Seat #6 is the button
Seat 1: Kekoke (0.72€)
Seat 2: Jorj-X-McKie (4.12€)
Seat 3: Evla45 (2€)
Seat 4: Fried Berg (0.52€)
Seat 5: Feo.Gallo703 (2€)
Seat 6: AMBM2729 (1.20€)
*** ANTE/BLINDS ***
Kekoke posts small blind 0.01€
Jorj-X-McKie posts big blind 0.02€
Dealt to Fried Berg [Td Ks]
*** PRE-FLOP *** 
Evla45 folds
Fried Berg raises 0.02€ to 0.04€
Feo.Gallo703 calls 0.04€
AMBM2729 folds
Kekoke calls 0.03€
Jorj-X-McKie folds
*** FLOP *** [6c 7d 7h]
Kekoke checks
Fried Berg bets 0.04€
Feo.Gallo703 folds
Kekoke calls 0.04€
*** TURN *** [6c 7d 7h][Kd]
Kekoke checks
Fried Berg bets 0.08€
Kekoke calls 0.08€
*** RIVER *** [6c 7d 7h Kd][Jd]
Kekoke bets 0.13€
Fried Berg calls 0.13€
*** SHOW DOWN ***
Fried Berg shows [Td Ks] (Two pairs : Kings and 7)
Kekoke shows [Ad 4d] (Flush Ace high)
Kekoke collected 0.58€ from pot
*** SUMMARY ***
Total pot 0.58€ | Rake 0.06€
Board: [6c 7d 7h Kd Jd]
Seat 1: Kekoke (small blind) showed [Ad 4d] and won 0.58€ with Flush Ace high
Seat 4: Fried Berg showed [Td Ks] and lost with Two pairs : Kings and 7


Winamax Poker - HOLD-UP "Colorado" - HandId: #19116069-673842-1701692156 - Holdem no limit (0.01€/0.02€) - 2023/12/04 12:15:56 UTC
Table: 'Colorado' 6-max (real money) Seat #6 is the button
Seat 1: yam69 (2.02€)
Seat 2: Kekoke (1.01€)
Seat 3: emojipok (0.47€)
Seat 4: Pablopenrais (1.91€)
Seat 5: Fried Berg (0.23€)
Seat 6: Pwinpwin (5.04€)
*** ANTE/BLINDS ***
yam69 posts small blind 0.01€
Kekoke posts big blind 0.02€
Dealt to Fried Berg [4d 8h]
*** PRE-FLOP *** 
emojipok raises 0.04€ to 0.06€
Pablopenrais folds
Fried Berg folds
Pwinpwin folds
yam69 calls 0.05€
Kekoke folds
*** FLOP *** [2h Qs Ks]
yam69 checks
emojipok checks
*** TURN *** [2h Qs Ks][8s]
yam69 bets 0.09€
emojipok calls 0.09€
*** RIVER *** [2h Qs Ks 8s][5s]
yam69 checks
emojipok bets 0.21€
yam69 calls 0.21€
*** SHOW DOWN ***
emojipok shows [Th Ac] (High card : Ace)
yam69 shows [2s 2d] (Flush King high)
yam69 collected 0.67€ from pot
*** SUMMARY ***
Total pot 0.67€ | Rake 0.07€
Board: [2h Qs Ks 8s 5s]
Seat 1: yam69 (small blind) showed [2s 2d] and won 0.67€ with Flush King high
Seat 3: emojipok showed [Th Ac] and lost with High card : Ace


Winamax Poker - HOLD-UP "Colorado" - HandId: #19116069-673867-1701692176 - Holdem no limit (0.01€/0.02€) - 2023/12/04 12:16:16 UTC
Table: 'Colorado' 6-max (real money) Seat #6 is the button
Seat 1: JissEl1te (2.73€)
Seat 2: Fried Berg (0.23€)
Seat 3: JFSredbaron (3.73€)
Seat 4: blaha (1.97€)
Seat 5: Pablopenrais (2.11€)
Seat 6: FreeLouisias (2.28€)
*** ANTE/BLINDS ***
JissEl1te posts small blind 0.01€
Fried Berg posts big blind 0.02€
Dealt to Fried Berg [Td 4s]
*** PRE-FLOP *** 
JFSredbaron folds
blaha raises 0.04€ to 0.06€
Pablopenrais raises 0.24€ to 0.30€
FreeLouisias raises 0.45€ to 0.75€
JissEl1te calls 0.74€
Fried Berg folds
blaha folds
Pablopenrais raises 1.36€ to 2.11€ and is all-in
FreeLouisias raises 0.17€ to 2.28€ and is all-in
JissEl1te calls 1.53€
*** FLOP *** [Jc 6c 6s]
*** TURN *** [Jc 6c 6s][Th]
*** RIVER *** [Jc 6c 6s Th][Kc]
*** SHOW DOWN ***
JissEl1te shows [Qc Qd] (Two pairs : Queens and 6)
Pablopenrais shows [Ks Kh] (Full of Kings and 6)
FreeLouisias shows [Qs As] (Straight Ace high)
FreeLouisias collected 0.30€ from side pot 1
Pablopenrais collected 5.77€ from main pot
*** SUMMARY ***
Total pot 6.07€ | Rake 0.68€
Board: [Jc 6c 6s Th Kc]
Seat 1: JissEl1te (small blind) showed [Qc Qd] and lost with Two pairs : Queens and 6
Seat 5: Pablopenrais showed [Ks Kh] and won 5.77€ with Full of Kings and 6
Seat 6: FreeLouisias (button) showed [Qs As] and won 0.30€ with Straight Ace high


Winamax Poker - HOLD-UP "Colorado" - HandId: #19116069-673891-1701692195 - Holdem no limit (0.01€/0.02€) - 2023/12/04 12:16:35 UTC
Table: 'Colorado' 6-max (real money) Seat #6 is the button
Seat 1: Fried Berg (0.21€)
Seat 2: Durantula_6 (2.13€)
Seat 3: ilergeta (2.91€)
Seat 4: Pwinpwin (3.05€)
Seat 5: blaha (1.91€)
Seat 6: Elvis_Doogie (2.12€)
*** ANTE/BLINDS ***
Fried Berg posts small blind 0.01€
Durantula_6 posts big blind 0.02€
Dealt to Fried Berg [Qc Jh]
*** PRE-FLOP *** 
ilergeta folds
Pwinpwin folds
blaha folds
Elvis_Doogie raises 0.02€ to 0.04€
Fried Berg calls 0.03€
Durantula_6 raises 0.14€ to 0.18€
Elvis_Doogie folds
Fried Berg raises 0.03€ to 0.21€ and is all-in
Durantula_6 calls 0.03€
*** FLOP *** [4c Qd 6s]
*** TURN *** [4c Qd 6s][7d]
*** RIVER *** [4c Qd 6s 7d][3s]
*** SHOW DOWN ***
Fried Berg shows [Qc Jh] (One pair : Queens)
Durantula_6 shows [Kd Kh] (One pair : Kings)
Durantula_6 collected 0.41€ from pot
*** SUMMARY ***
Total pot 0.41€ | Rake 0.05€
Board: [4c Qd 6s 7d 3s]
Seat 1: Fried Berg (small blind) showed [Qc Jh] and lost with One pair : Queens
Seat 2: Durantula_6 (big blind) showed [Kd Kh] and won 0.41€ with One pair : Kings


Winamax Poker - HOLD-UP "Colorado" - HandId: #19116069-673949-1701692239 - Holdem no limit (0.01€/0.02€) - 2023/12/04 12:17:19 UTC
Table: 'Colorado' 6-max (real money) Seat #6 is the button
Seat 1: harleyQuiin (5.61€)
Seat 2: Jesperord98 (3.30€)
Seat 3: Noe_k17 (0.95€)
Seat 4: Machiavel- (2.53€)
Seat 5: Fried Berg (0.50€)
Seat 6: solmer (1.82€)
*** ANTE/BLINDS ***
harleyQuiin posts small blind 0.01€
Jesperord98 posts big blind 0.02€
Dealt to Fried Berg [6d 4h]
*** PRE-FLOP *** 
Noe_k17 folds
Machiavel- folds
Fried Berg folds
solmer calls 0.02€
harleyQuiin folds
Jesperord98 checks
*** FLOP *** [3h Ts 5s]
Jesperord98 checks
solmer checks
*** TURN *** [3h Ts 5s][3s]
Jesperord98 checks
solmer bets 0.02€
Jesperord98 calls 0.02€
*** RIVER *** [3h Ts 5s 3s][4d]
Jesperord98 checks
solmer bets 0.07€
Jesperord98 calls 0.07€
*** SHOW DOWN ***
Jesperord98 shows [5h 2c] (Two pairs : 5 and 3)
solmer shows [Js Ks] (Flush King high)
solmer collected 0.21€ from pot
*** SUMMARY ***
Total pot 0.21€ | Rake 0.02€
Board: [3h Ts 5s 3s 4d]
Seat 2: Jesperord98 (big blind) showed [5h 2c] and lost with Two pairs : 5 and 3
Seat 6: solmer (button) showed [Js Ks] and won 0.21€ with Flush King high


Winamax Poker - HOLD-UP "Colorado" - HandId: #19116069-673963-1701692248 - Holdem no limit (0.01€/0.02€) - 2023/12/04 12:17:28 UTC
Table: 'Colorado' 6-max (real money) Seat #6 is the button
Seat 1: AMBM2729 (1.21€)
Seat 2: Jorj-X-McKie (2.71€)
Seat 3: Fried Berg (0.50€)
Seat 4: Zile741 (3.63€)
Seat 5: Starjeff80 (2.06€)
Seat 6: slowreplay (2.55€)
*** ANTE/BLINDS ***
AMBM2729 posts small blind 0.01€
Jorj-X-McKie posts big blind 0.02€
Dealt to Fried Berg [Ts Ad]
*** PRE-FLOP *** 
Fried Berg raises 0.02€ to 0.04€
Zile741 folds
Starjeff80 folds
slowreplay folds
AMBM2729 folds
Jorj-X-McKie folds
Fried Berg collected 0.07€ from pot
*** SUMMARY ***
Total pot 0.07€ | No rake
Seat 3: Fried Berg won 0.07€


Winamax Poker - HOLD-UP "Colorado" - HandId: #19116069-673989-1701692268 - Holdem no limit (0.01€/0.02€) - 2023/12/04 12:17:48 UTC
Table: 'Colorado' 6-max (real money) Seat #6 is the button
Seat 1: AMBM2729 (1.21€)
Seat 2: Ertorko (2.23€)
Seat 3: GTO-Mieko (3.50€)
Seat 4: TD-Genie8310 (2.11€)
Seat 5: Fried Berg (0.53€)
Seat 6: Richard Reuk (2.58€)
*** ANTE/BLINDS ***
AMBM2729 posts small blind 0.01€
Ertorko posts big blind 0.02€
Dealt to Fried Berg [9s 4h]
*** PRE-FLOP *** 
GTO-Mieko folds
TD-Genie8310 calls 0.02€
Fried Berg folds
Richard Reuk folds
AMBM2729 folds
Ertorko checks
*** FLOP *** [2h Jh 3s]
Ertorko checks
TD-Genie8310 checks
*** TURN *** [2h Jh 3s][5c]
Ertorko checks
TD-Genie8310 checks
*** RIVER *** [2h Jh 3s 5c][8s]
Ertorko checks
TD-Genie8310 bets 2.09€ and is all-in
Ertorko folds
TD-Genie8310 collected 2.13€ from pot
*** SUMMARY ***
Total pot 2.13€ | Rake 0.01€
Board: [2h Jh 3s 5c 8s]
Seat 4: TD-Genie8310 won 2.13€


Winamax Poker - HOLD-UP "Colorado" - HandId: #19116069-673993-1701692270 - Holdem no limit (0.01€/0.02€) - 2023/12/04 12:17:50 UTC
Table: 'Colorado' 6-max (real money) Seat #6 is the button
Seat 1: FreeLouisias (2.22€)
Seat 2: Pablopenrais (3.61€)
Seat 3: Fried Berg (0.53€)
Seat 4: AGALMMLA (1.55€)
Seat 5: EMBATAA (2.36€)
Seat 6: GTO-Mieko (3.50€)
*** ANTE/BLINDS ***
FreeLouisias posts small blind 0.01€
Pablopenrais posts big blind 0.02€
Dealt to Fried Berg [5d 8h]
*** PRE-FLOP *** 
Fried Berg folds
AGALMMLA raises 0.05€ to 0.07€
EMBATAA folds
GTO-Mieko folds
FreeLouisias raises 0.22€ to 0.29€
Pablopenrais folds
AGALMMLA calls 0.22€
*** FLOP *** [Jc 2c Ts]
FreeLouisias checks
AGALMMLA checks
*** TURN *** [Jc 2c Ts][7h]
FreeLouisias bets 0.18€
AGALMMLA raises 0.18€ to 0.36€
FreeLouisias raises 1.57€ to 1.93€ and is all-in
AGALMMLA folds
FreeLouisias collected 2.76€ from pot
*** SUMMARY ***
Total pot 2.76€ | Rake 0.13€
Board: [Jc 2c Ts 7h]
Seat 1: FreeLouisias (small blind) won 2.76€


Winamax Poker - HOLD-UP "Colorado" - HandId: #19116069-673997-1701692273 - Holdem no limit (0.01€/0.02€) - 2023/12/04 12:17:53 UTC
Table: 'Colorado' 6-max (real money) Seat #6 is the button
Seat 1: Tompahmax (1.85€)
Seat 2: EMBATAA (2.36€)
Seat 3: GTO-Mieko (3.50€)
Seat 4: Hagreed (2.38€)
Seat 5: slowreplay (2.72€)
Seat 6: Fried Berg (0.53€)
*** ANTE/BLINDS ***
Tompahmax posts small blind 0.01€
EMBATAA posts big blind 0.02€
Dealt to Fried Berg [Kc 2s]
*** PRE-FLOP *** 
GTO-Mieko raises 0.04€ to 0.06€
Hagreed folds
slowreplay folds
Fried Berg folds
Tompahmax folds
EMBATAA folds
GTO-Mieko collected 0.09€ from pot
*** SUMMARY ***
Total pot 0.09€ | No rake
Seat 3: GTO-Mieko won 0.09€


Winamax Poker - HOLD-UP "Colorado" - HandId: #19116069-673999-1701692275 - Holdem no limit (0.01€/0.02€) - 2023/12/04 12:17:55 UTC
Table: 'Colorado' 6-max (real money) Seat #6 is the button
Seat 1: Jorj-X-McKie (3.79€)
Seat 2: Fried Berg (0.53€)
Seat 3: Erenox (1.37€)
Seat 4: LeCrimePaie (2.96€)
Seat 5: Kryshus (1.70€)
Seat 6: Homer14510 (1.99€)
*** ANTE/BLINDS ***
Jorj-X-McKie posts small blind 0.01€
Fried Berg posts big blind 0.02€
Dealt to Fried Berg [Tc Th]
*** PRE-FLOP *** 
Erenox raises 0.04€ to 0.06€
LeCrimePaie folds
Kryshus folds
Homer14510 folds
Jorj-X-McKie folds
Fried Berg raises 0.12€ to 0.18€
Erenox calls 0.12€
*** FLOP *** [3d 4h 9h]
Fried Berg bets 0.20€
Erenox raises 0.23€ to 0.43€
Fried Berg calls 0.15€ and is all-in
*** TURN *** [3d 4h 9h][Jc]
*** RIVER *** [3d 4h 9h Jc][Qs]
*** SHOW DOWN ***
Fried Berg shows [Tc Th] (One pair : Tens)
Erenox shows [9c As] (One pair : 9)
Erenox collected 0.08€ from side pot 1
Fried Berg collected 0.96€ from main pot
*** SUMMARY ***
Total pot 1.04€ | Rake 0.11€
Board: [3d 4h 9h Jc Qs]
Seat 2: Fried Berg (big blind) showed [Tc Th] and won 0.96€ with One pair : Tens
Seat 3: Erenox showed [9c As] and won 0.08€ with One pair : 9


Winamax Poker - HOLD-UP "Colorado" - HandId: #19116069-674040-1701692311 - Holdem no limit (0.01€/0.02€) - 2023/12/04 12:18:31 UTC
Table: 'Colorado' 6-max (real money) Seat #6 is the button
Seat 1: Fried Berg (0.96€)
Seat 2: Pwinpwin (2.14€)
Seat 3: FreeLouisias (2.78€)
Seat 4: Richard Reuk (2.53€)
Seat 5: Erenox (0.84€)
Seat 6: ilergeta (2.90€)
*** ANTE/BLINDS ***
Fried Berg posts small blind 0.01€
Pwinpwin posts big blind 0.02€
Dealt to Fried Berg [8s 2d]
*** PRE-FLOP *** 
FreeLouisias folds
Richard Reuk folds
Erenox raises 0.04€ to 0.06€
ilergeta folds
Fried Berg folds
Pwinpwin folds
Erenox collected 0.09€ from pot
*** SUMMARY ***
Total pot 0.09€ | No rake
Seat 5: Erenox won 0.09€


Winamax Poker - HOLD-UP "Colorado" - HandId: #19116069-674052-1701692323 - Holdem no limit (0.01€/0.02€) - 2023/12/04 12:18:43 UTC
Table: 'Colorado' 6-max (real money) Seat #6 is the button
Seat 1: oretli160 (1.62€)
Seat 2: 13-or63100 (0.96€)
Seat 3: Jorj-X-McKie (5.36€)
Seat 4: Fried Berg (0.95€)
Seat 5: MR-Sniper274 (0.77€)
Seat 6: RazzPoutine (2€)
*** ANTE/BLINDS ***
oretli160 posts small blind 0.01€
13-or63100 posts big blind 0.02€
Dealt to Fried Berg [Ts 9c]
*** PRE-FLOP *** 
Jorj-X-McKie folds
Fried Berg folds
MR-Sniper274 raises 0.03€ to 0.05€
RazzPoutine folds
oretli160 folds
13-or63100 calls 0.03€
*** FLOP *** [9d Qd Kh]
13-or63100 bets 0.02€
MR-Sniper274 raises 0.04€ to 0.06€
13-or63100 folds
MR-Sniper274 collected 0.17€ from pot
*** SUMMARY ***
Total pot 0.17€ | Rake 0.02€
Board: [9d Qd Kh]
Seat 5: MR-Sniper274 won 0.17€


Winamax Poker - HOLD-UP "Colorado" - HandId: #19116069-674060-1701692329 - Holdem no limit (0.01€/0.02€) - 2023/12/04 12:18:49 UTC
Table: 'Colorado' 6-max (real money) Seat #6 is the button
Seat 1: DubStyle60 (1.90€)
Seat 2: Erenox (0.87€)
Seat 3: _laguigne (3.81€)
Seat 4: Ertorko (2.90€)
Seat 5: BMWTPM (2.35€)
Seat 6: Fried Berg (0.95€)
*** ANTE/BLINDS ***
DubStyle60 posts small blind 0.01€
Erenox posts big blind 0.02€
Dealt to Fried Berg [6d 7h]
*** PRE-FLOP *** 
_laguigne folds
Ertorko raises 0.03€ to 0.05€
BMWTPM folds
Fried Berg folds
DubStyle60 folds
Erenox folds
Ertorko collected 0.08€ from pot
*** SUMMARY ***
Total pot 0.08€ | No rake
Seat 4: Ertorko won 0.08€


Winamax Poker - HOLD-UP "Colorado" - HandId: #19116069-674071-1701692339 - Holdem no limit (0.01€/0.02€) - 2023/12/04 12:18:59 UTC
Table: 'Colorado' 6-max (real money) Seat #6 is the button
Seat 1: Erenox (0.85€)
Seat 2: _ilTulipano_ (2.67€)
Seat 3: Fried Berg (0.95€)
Seat 4: Jorj-X-McKie (3.91€)
Seat 5: _laguigne (3.79€)
Seat 6: veve 13 (0.19€)
*** ANTE/BLINDS ***
Erenox posts small blind 0.01€
_ilTulipano_ posts big blind 0.02€
Dealt to Fried Berg [7c Ts]
*** PRE-FLOP *** 
Fried Berg folds
Jorj-X-McKie folds
_laguigne folds
veve 13 raises 0.17€ to 0.19€ and is all-in
Erenox folds
_ilTulipano_ calls 0.17€
*** FLOP *** [7s 3c 5d]
*** TURN *** [7s 3c 5d][6c]
*** RIVER *** [7s 3c 5d 6c][3h]
*** SHOW DOWN ***
veve 13 shows [Qc Jc] (One pair : 3)
_ilTulipano_ shows [2d As] (One pair : 3)
_ilTulipano_ collected 0.35€ from pot
*** SUMMARY ***
Total pot 0.35€ | Rake 0.04€
Board: [7s 3c 5d 6c 3h]
Seat 2: _ilTulipano_ (big blind) showed [2d As] and won 0.35€ with One pair : 3
Seat 6: veve 13 (button) showed [Qc Jc] and lost with One pair : 3


Winamax Poker - HOLD-UP "Colorado" - HandId: #19116069-674075-1701692341 - Holdem no limit (0.01€/0.02€) - 2023/12/04 12:19:01 UTC
Table: 'Colorado' 6-max (real money) Seat #6 is the button
Seat 1: nico033 (4.53€)
Seat 2: Fried Berg (0.95€)
Seat 3: antoclem2A (2.19€)
Seat 4: Syssy43 (4€)
Seat 5: Content91510 (2.23€)
Seat 6: _laguigne (3.79€)
Hold-up to Pot: total 0.10€
*** ANTE/BLINDS ***
nico033 posts small blind 0.01€
Fried Berg posts big blind 0.02€
Dealt to Fried Berg [7d 3d]
*** PRE-FLOP *** 
antoclem2A calls 0.02€
Syssy43 calls 0.02€
Content91510 raises 0.03€ to 0.05€
_laguigne folds
nico033 calls 0.04€
Fried Berg folds
antoclem2A calls 0.03€
Syssy43 calls 0.03€
*** FLOP *** [5s 4d Jc]
nico033 checks
antoclem2A checks
Syssy43 checks
Content91510 checks
*** TURN *** [5s 4d Jc][9d]
nico033 checks
antoclem2A checks
Syssy43 checks
Content91510 bets 0.21€
nico033 folds
antoclem2A calls 0.21€
Syssy43 calls 0.21€
*** RIVER *** [5s 4d Jc 9d][Ks]
antoclem2A checks
Syssy43 checks
Content91510 bets 0.95€
antoclem2A folds
Syssy43 folds
Content91510 collected 1.81€ from pot
*** SUMMARY ***
Total pot 1.81€ | Rake 0.09€
Board: [5s 4d Jc 9d Ks]
Seat 5: Content91510 won 1.81€


Winamax Poker - HOLD-UP "Colorado" - HandId: #19116069-674090-1701692354 - Holdem no limit (0.01€/0.02€) - 2023/12/04 12:19:14 UTC
Table: 'Colorado' 6-max (real money) Seat #6 is the button
Seat 1: Tompahmax (1.33€)
Seat 2: Homer14510 (2€)
Seat 3: AMBM2729 (1.20€)
Seat 4: Fried Berg (0.93€)
Seat 5: JFSredbaron (2.06€)
Seat 6: Ertorko (2€)
*** ANTE/BLINDS ***
Tompahmax posts small blind 0.01€
Homer14510 posts big blind 0.02€
Dealt to Fried Berg [Ac 5s]
*** PRE-FLOP *** 
AMBM2729 folds
Fried Berg folds
JFSredbaron folds
Ertorko raises 0.04€ to 0.06€
Tompahmax folds
Homer14510 folds
Ertorko collected 0.09€ from pot
*** SUMMARY ***
Total pot 0.09€ | No rake
Seat 6: Ertorko (button) won 0.09€


Winamax Poker - HOLD-UP "Colorado" - HandId: #19116069-674098-1701692360 - Holdem no limit (0.01€/0.02€) - 2023/12/04 12:19:20 UTC
Table: 'Colorado' 6-max (real money) Seat #6 is the button
Seat 1: Fried Berg (0.93€)
Seat 2: ilergeta (2.02€)
Seat 3: Jimmy91lenny (1.48€)
Seat 4: Jesperord98 (3.65€)
Seat 5: Erenox (0.87€)
Seat 6: Okapi_Poli29 (2.19€)
Hold-up to Pot: total 0.20€
*** ANTE/BLINDS ***
Fried Berg posts small blind 0.01€
ilergeta posts big blind 0.02€
Dealt to Fried Berg [5d 2s]
*** PRE-FLOP *** 
Jimmy91lenny calls 0.02€
Jesperord98 raises 0.13€ to 0.15€
Erenox raises 0.72€ to 0.87€ and is all-in
Okapi_Poli29 folds
Fried Berg folds
ilergeta folds
Jimmy91lenny folds
Jesperord98 calls 0.72€
*** FLOP *** [Ts 6c Kh]
*** TURN *** [Ts 6c Kh][8c]
*** RIVER *** [Ts 6c Kh 8c][7d]
*** SHOW DOWN ***
Jesperord98 shows [Qd Kd] (One pair : Kings)
Erenox shows [9s 9c] (Straight Ten high)
Erenox collected 1.81€ from pot
*** SUMMARY ***
Total pot 1.81€ | Rake 0.18€
Board: [Ts 6c Kh 8c 7d]
Seat 4: Jesperord98 showed [Qd Kd] and lost with One pair : Kings
Seat 5: Erenox showed [9s 9c] and won 1.81€ with Straight Ten high


Winamax Poker - HOLD-UP "Colorado" - HandId: #19116069-674119-1701692372 - Holdem no limit (0.01€/0.02€) - 2023/12/04 12:19:32 UTC
Table: 'Colorado' 6-max (real money) Seat #6 is the button
Seat 1: slowreplay (2.23€)
Seat 2: oretli160 (1.56€)
Seat 3: Zanghief068 (2.43€)
Seat 4: EMBATAA (2.31€)
Seat 5: Tompahmax (1.72€)
Seat 6: Fried Berg (0.92€)
*** ANTE/BLINDS ***
slowreplay posts small blind 0.01€
oretli160 posts big blind 0.02€
Dealt to Fried Berg [Qh 6c]
*** PRE-FLOP *** 
Zanghief068 folds
EMBATAA folds
Tompahmax folds
Fried Berg raises 0.02€ to 0.04€
slowreplay folds
oretli160 folds
Fried Berg collected 0.07€ from pot
*** SUMMARY ***
Total pot 0.07€ | No rake
Seat 6: Fried Berg (button) won 0.07€


Winamax Poker - HOLD-UP "Colorado" - HandId: #19116069-674139-1701692386 - Holdem no limit (0.01€/0.02€) - 2023/12/04 12:19:46 UTC
Table: 'Colorado' 6-max (real money) Seat #6 is the button
Seat 1: slowreplay (2.22€)
Seat 2: Polanskii (3.01€)
Seat 3: ilergeta (2€)
Seat 4: RazzPoutine (2.07€)
Seat 5: Fried Berg (0.95€)
Seat 6: Hagreed (2.49€)
Hold-up to Pot: total 0.20€
*** ANTE/BLINDS ***
slowreplay posts small blind 0.01€
Polanskii posts big blind 0.02€
Dealt to Fried Berg [Ah 8d]
*** PRE-FLOP *** 
ilergeta folds
RazzPoutine folds
Fried Berg raises 0.02€ to 0.04€
Hagreed folds
slowreplay folds
Polanskii calls 0.02€
*** FLOP *** [6d Qd Ks]
Polanskii bets 0.10€
Fried Berg raises 0.20€ to 0.30€
Polanskii folds
Fried Berg collected 0.66€ from pot
*** SUMMARY ***
Total pot 0.66€ | Rake 0.03€
Board: [6d Qd Ks]
Seat 5: Fried Berg won 0.66€


Winamax Poker - HOLD-UP "Colorado" - HandId: #19116069-674209-1701692431 - Holdem no limit (0.01€/0.02€) - 2023/12/04 12:20:31 UTC
Table: 'Colorado' 6-max (real money) Seat #6 is the button
Seat 1: GTO-Mieko (3.49€)
Seat 2: Alexisdpp (1€)
Seat 3: Samuelillo07 (2€)
Seat 4: Tompahmax (1.48€)
Seat 5: Fried Berg (1.27€)
Seat 6: slowreplay (3.73€)
*** ANTE/BLINDS ***
GTO-Mieko posts small blind 0.01€
Alexisdpp posts big blind 0.02€
Dealt to Fried Berg [6h Jh]
*** PRE-FLOP *** 
Samuelillo07 folds
Tompahmax folds
Fried Berg raises 0.02€ to 0.04€
slowreplay folds
GTO-Mieko folds
Alexisdpp folds
Fried Berg collected 0.07€ from pot
*** SUMMARY ***
Total pot 0.07€ | No rake
Seat 5: Fried Berg won 0.07€


Winamax Poker - HOLD-UP "Colorado" - HandId: #19116069-674246-1701692451 - Holdem no limit (0.01€/0.02€) - 2023/12/04 12:20:51 UTC
Table: 'Colorado' 6-max (real money) Seat #6 is the button
Seat 1: solmer (1.80€)
Seat 2: Pablopenrais (2.19€)
Seat 3: EMBATAA (2.15€)
Seat 4: Fried Berg (1.30€)
Seat 5: Jesperord98 (4.77€)
Seat 6: FreeLouisias (3.69€)
*** ANTE/BLINDS ***
solmer posts small blind 0.01€
Pablopenrais posts big blind 0.02€
Dealt to Fried Berg [Kh Js]
*** PRE-FLOP *** 
EMBATAA folds
Fried Berg raises 0.04€ to 0.06€
Jesperord98 folds
FreeLouisias folds
solmer folds
Pablopenrais calls 0.04€
*** FLOP *** [Td 8d Qs]
Pablopenrais bets 0.04€
Fried Berg calls 0.04€
*** TURN *** [Td 8d Qs][Ts]
Pablopenrais checks
Fried Berg checks
*** RIVER *** [Td 8d Qs Ts][Th]
Pablopenrais bets 0.11€
Fried Berg folds
Pablopenrais collected 0.30€ from pot
*** SUMMARY ***
Total pot 0.30€ | Rake 0.02€
Board: [Td 8d Qs Ts Th]
Seat 2: Pablopenrais (big blind) won 0.30€


Winamax Poker - HOLD-UP "Colorado" - HandId: #19116069-674298-1701692487 - Holdem no limit (0.01€/0.02€) - 2023/12/04 12:21:27 UTC
Table: 'Colorado' 6-max (real money) Seat #6 is the button
Seat 1: JFSredbaron (4.08€)
Seat 2: Raklur (1.99€)
Seat 3: Maxou72120 (0.33€)
Seat 4: SharkAKK (2.02€)
Seat 5: FLORENT12310 (2.14€)
Seat 6: Fried Berg (1.20€)
Hold-up to Pot: total 0.10€
*** ANTE/BLINDS ***
JFSredbaron posts small blind 0.01€
Raklur posts big blind 0.02€
Dealt to Fried Berg [5h Th]
*** PRE-FLOP *** 
Maxou72120 raises 0.15€ to 0.17€
SharkAKK folds
FLORENT12310 folds
Fried Berg folds
JFSredbaron folds
Raklur calls 0.15€
*** FLOP *** [7s 3c Kd]
Raklur checks
Maxou72120 bets 0.16€ and is all-in
Raklur calls 0.16€
*** TURN *** [7s 3c Kd][9c]
*** RIVER *** [7s 3c Kd 9c][3h]
*** SHOW DOWN ***
Maxou72120 shows [Qs 6d] (One pair : 3)
Raklur shows [8s 8h] (Two pairs : 8 and 3)
Raklur collected 0.70€ from pot
*** SUMMARY ***
Total pot 0.70€ | Rake 0.07€
Board: [7s 3c Kd 9c 3h]
Seat 2: Raklur (big blind) showed [8s 8h] and won 0.70€ with Two pairs : 8 and 3
Seat 3: Maxou72120 showed [Qs 6d] and lost with One pair : 3


Winamax Poker - HOLD-UP "Colorado" - HandId: #19116069-674320-1701692504 - Holdem no limit (0.01€/0.02€) - 2023/12/04 12:21:44 UTC
Table: 'Colorado' 6-max (real money) Seat #6 is the button
Seat 1: Evla45 (1.77€)
Seat 2: Fried Berg (1.20€)
Seat 3: R2Dread2 (7.38€)
Seat 4: Noe_k17 (1.94€)
Seat 5: La-Jonquera (1.24€)
Seat 6: BMWTPM (3.75€)
*** ANTE/BLINDS ***
Evla45 posts small blind 0.01€
Fried Berg posts big blind 0.02€
Dealt to Fried Berg [6h 9c]
*** PRE-FLOP *** 
R2Dread2 folds
Noe_k17 folds
La-Jonquera folds
BMWTPM calls 0.02€
Evla45 folds
Fried Berg checks
*** FLOP *** [Th Qh Kd]
Fried Berg checks
BMWTPM checks
*** TURN *** [Th Qh Kd][7c]
Fried Berg checks
BMWTPM checks
*** RIVER *** [Th Qh Kd 7c][5s]
Fried Berg checks
BMWTPM checks
*** SHOW DOWN ***
Fried Berg shows [6h 9c] (High card : King)
BMWTPM shows [Ac Td] (One pair : Tens)
BMWTPM collected 0.04€ from pot
*** SUMMARY ***
Total pot 0.04€ | Rake 0.01€
Board: [Th Qh Kd 7c 5s]
Seat 2: Fried Berg (big blind) showed [6h 9c] and lost with High card : King
Seat 6: BMWTPM (button) showed [Ac Td] and won 0.04€ with One pair : Tens


Winamax Poker - HOLD-UP "Colorado" - HandId: #19116069-674375-1701692544 - Holdem no limit (0.01€/0.02€) - 2023/12/04 12:22:24 UTC
Table: 'Colorado' 6-max (real money) Seat #6 is the button
Seat 1: Tompahmax (1.36€)
Seat 2: Maxou72120 (0.50€)
Seat 3: Tintin1520 (2.77€)
Seat 4: R2Dread2 (7.29€)
Seat 5: Fried Berg (1.18€)
Seat 6: Pablopenrais (1.97€)
*** ANTE/BLINDS ***
Tompahmax posts small blind 0.01€
Maxou72120 posts big blind 0.02€
Dealt to Fried Berg [3h 8h]
*** PRE-FLOP *** 
Tintin1520 folds
R2Dread2 folds
Fried Berg folds
Pablopenrais raises 0.04€ to 0.06€
Tompahmax calls 0.05€
Maxou72120 raises 0.44€ to 0.50€ and is all-in
Pablopenrais folds
Tompahmax folds
Maxou72120 collected 0.62€ from pot
*** SUMMARY ***
Total pot 0.62€ | No rake
Seat 2: Maxou72120 (big blind) won 0.62€


Winamax Poker - HOLD-UP "Colorado" - HandId: #19116069-674384-1701692550 - Holdem no limit (0.01€/0.02€) - 2023/12/04 12:22:30 UTC
Table: 'Colorado' 6-max (real money) Seat #6 is the button
Seat 1: Fried Berg (1.18€)
Seat 2: RazzPoutine (3.91€)
Seat 3: _ilTulipano_ (2.44€)
Seat 4: Kryshus (2.49€)
Seat 5: Machiavel- (2.43€)
Seat 6: Tintin1520 (2.77€)
Hold-up to Pot: total 0.20€
*** ANTE/BLINDS ***
Fried Berg posts small blind 0.01€
RazzPoutine posts big blind 0.02€
Dealt to Fried Berg [5s Tc]
*** PRE-FLOP *** 
_ilTulipano_ folds
Kryshus folds
Machiavel- folds
Tintin1520 folds
Fried Berg folds
RazzPoutine collected 0.23€ from pot
*** SUMMARY ***
Total pot 0.23€ | No rake
Seat 2: RazzPoutine (big blind) won 0.23€


Winamax Poker - HOLD-UP "Colorado" - HandId: #19116069-674391-1701692555 - Holdem no limit (0.01€/0.02€) - 2023/12/04 12:22:35 UTC
Table: 'Colorado' 6-max (real money) Seat #6 is the button
Seat 1: ilergeta (3.19€)
Seat 2: La-Jonquera (1.26€)
Seat 3: Fried Berg (1.17€)
Seat 4: Zile741 (2.67€)
Seat 5: JFSredbaron (4.04€)
Seat 6: 324517b13 (0.46€)
*** ANTE/BLINDS ***
ilergeta posts small blind 0.01€
La-Jonquera posts big blind 0.02€
Dealt to Fried Berg [9c Kd]
*** PRE-FLOP *** 
Fried Berg folds
Zile741 folds
JFSredbaron folds
324517b13 calls 0.02€
ilergeta folds
La-Jonquera checks
*** FLOP *** [3d 5h 5c]
La-Jonquera checks
324517b13 bets 0.05€
La-Jonquera folds
324517b13 collected 0.09€ from pot
*** SUMMARY ***
Total pot 0.09€ | Rake 0.01€
Board: [3d 5h 5c]
Seat 6: 324517b13 (button) won 0.09€


Winamax Poker - HOLD-UP "Colorado" - HandId: #19116069-674394-1701692557 - Holdem no limit (0.01€/0.02€) - 2023/12/04 12:22:37 UTC
Table: 'Colorado' 6-max (real money) Seat #6 is the button
Seat 1: Fried Berg (1.17€)
Seat 2: Jorj-X-McKie (4.72€)
Seat 3: Samuelillo07 (2€)
Seat 4: AMBM2729 (1.23€)
Seat 5: FLORENT12310 (1.65€)
Seat 6: cipiou91 (0.92€)
Hold-up to Pot: total 0.50€
*** ANTE/BLINDS ***
Fried Berg posts small blind 0.01€
Jorj-X-McKie posts big blind 0.02€
Dealt to Fried Berg [2s 9h]
*** PRE-FLOP *** 
Samuelillo07 folds
AMBM2729 raises 0.03€ to 0.05€
FLORENT12310 calls 0.05€
cipiou91 raises 0.08€ to 0.13€
Fried Berg folds
Jorj-X-McKie calls 0.11€
AMBM2729 calls 0.08€
FLORENT12310 calls 0.08€
*** FLOP *** [Th Kc 9c]
Jorj-X-McKie checks
AMBM2729 bets 1.10€ and is all-in
FLORENT12310 folds
cipiou91 folds
Jorj-X-McKie folds
AMBM2729 collected 2.08€ from pot
*** SUMMARY ***
Total pot 2.08€ | Rake 0.05€
Board: [Th Kc 9c]
Seat 4: AMBM2729 won 2.08€


Winamax Poker - HOLD-UP "Colorado" - HandId: #19116069-674402-1701692563 - Holdem no limit (0.01€/0.02€) - 2023/12/04 12:22:43 UTC
Table: 'Colorado' 6-max (real money) Seat #6 is the button
Seat 1: Maxou72120 (0.62€)
Seat 2: Fried Berg (1.16€)
Seat 3: Tompahmax (1.67€)
Seat 4: GTO-Mieko (2.84€)
Seat 5: joalbralo (2.11€)
Seat 6: Yvrin (1.10€)
*** ANTE/BLINDS ***
Maxou72120 posts small blind 0.01€
Fried Berg posts big blind 0.02€
Dealt to Fried Berg [Qc 8d]
*** PRE-FLOP *** 
Tompahmax folds
GTO-Mieko folds
joalbralo raises 0.04€ to 0.06€
Yvrin calls 0.06€
Maxou72120 folds
Fried Berg folds
*** FLOP *** [Ad 2h 9h]
joalbralo checks
Yvrin bets 0.08€
joalbralo folds
Yvrin collected 0.21€ from pot
*** SUMMARY ***
Total pot 0.21€ | Rake 0.02€
Board: [Ad 2h 9h]
Seat 6: Yvrin (button) won 0.21€


Winamax Poker - HOLD-UP "Colorado" - HandId: #19116069-674412-1701692571 - Holdem no limit (0.01€/0.02€) - 2023/12/04 12:22:51 UTC
Table: 'Colorado' 6-max (real money) Seat #6 is the button
Seat 1: _ilTulipano_ (9.67€)
Seat 2: hello7585 (1.79€)
Seat 3: Fried Berg (1.14€)
Seat 4: ASho-Hai (2.64€)
Seat 5: 49_3 (0.72€)
Seat 6: ilergeta (3.18€)
*** ANTE/BLINDS ***
_ilTulipano_ posts small blind 0.01€
hello7585 posts big blind 0.02€
Dealt to Fried Berg [Th Jd]
*** PRE-FLOP *** 
Fried Berg raises 0.02€ to 0.04€
ASho-Hai folds
49_3 folds
ilergeta folds
_ilTulipano_ calls 0.03€
hello7585 folds
*** FLOP *** [Ah 9d 4h]
_ilTulipano_ checks
Fried Berg checks
*** TURN *** [Ah 9d 4h][4s]
_ilTulipano_ checks
Fried Berg checks
*** RIVER *** [Ah 9d 4h 4s][8c]
_ilTulipano_ checks
Fried Berg checks
*** SHOW DOWN ***
_ilTulipano_ shows [Ts Js] (One pair : 4)
Fried Berg shows [Th Jd] (One pair : 4)
Fried Berg collected 0.05€ from pot
_ilTulipano_ collected 0.04€ from pot
*** SUMMARY ***
Total pot 0.09€ | Rake 0.01€
Board: [Ah 9d 4h 4s 8c]
Seat 1: _ilTulipano_ (small blind) showed [Ts Js] and won 0.04€ with One pair : 4
Seat 3: Fried Berg showed [Th Jd] and won 0.05€ with One pair : 4


Winamax Poker - HOLD-UP "Colorado" - HandId: #19116069-674483-1701692622 - Holdem no limit (0.01€/0.02€) - 2023/12/04 12:23:42 UTC
Table: 'Colorado' 6-max (real money) Seat #6 is the button
Seat 1: Jesperord98 (3.24€)
Seat 2: slowreplay (2.15€)
Seat 3: BMWTPM (3.23€)
Seat 4: Pablopenrais (1.89€)
Seat 5: _ilTulipano_ (9.67€)
Seat 6: Fried Berg (1.15€)
*** ANTE/BLINDS ***
Jesperord98 posts small blind 0.01€
slowreplay posts big blind 0.02€
Dealt to Fried Berg [8h 8d]
*** PRE-FLOP *** 
BMWTPM calls 0.02€
Pablopenrais raises 0.08€ to 0.10€
_ilTulipano_ folds
Fried Berg calls 0.10€
Jesperord98 folds
slowreplay folds
BMWTPM calls 0.08€
*** FLOP *** [6c 7h Ks]
BMWTPM checks
Pablopenrais bets 0.11€
Fried Berg folds
BMWTPM calls 0.11€
*** TURN *** [6c 7h Ks][3h]
BMWTPM checks
Pablopenrais checks
*** RIVER *** [6c 7h Ks 3h][Ah]
BMWTPM checks
Pablopenrais bets 0.28€
BMWTPM folds
Pablopenrais collected 0.77€ from pot
*** SUMMARY ***
Total pot 0.77€ | Rake 0.06€
Board: [6c 7h Ks 3h Ah]
Seat 4: Pablopenrais won 0.77€


Winamax Poker - HOLD-UP "Colorado" - HandId: #19116069-674530-1701692659 - Holdem no limit (0.01€/0.02€) - 2023/12/04 12:24:19 UTC
Table: 'Colorado' 6-max (real money) Seat #6 is the button
Seat 1: Yvrin (1.17€)
Seat 2: harleyQuiin (5.78€)
Seat 3: jelageirse (0.98€)
Seat 4: Ar gaouyat (2€)
Seat 5: Fried Berg (1.05€)
Seat 6: Noe_k17 (1.96€)
*** ANTE/BLINDS ***
Yvrin posts small blind 0.01€
harleyQuiin posts big blind 0.02€
Dealt to Fried Berg [5s 8d]
*** PRE-FLOP *** 
jelageirse calls 0.02€
Ar gaouyat folds
Fried Berg folds
Noe_k17 folds
Yvrin folds
harleyQuiin checks
*** FLOP *** [3d Ts 5h]
harleyQuiin checks
jelageirse bets 0.02€
harleyQuiin folds
jelageirse collected 0.06€ from pot
*** SUMMARY ***
Total pot 0.06€ | Rake 0.01€
Board: [3d Ts 5h]
Seat 3: jelageirse won 0.06€


Winamax Poker - HOLD-UP "Colorado" - HandId: #19116069-674535-1701692663 - Holdem no limit (0.01€/0.02€) - 2023/12/04 12:24:23 UTC
Table: 'Colorado' 6-max (real money) Seat #6 is the button
Seat 1: R2Dread2 (7.57€)
Seat 2: slowreplay (2.29€)
Seat 3: EMBATAA (2.22€)
Seat 4: FrappeLourde (1.12€)
Seat 5: fullawa (0.46€)
Seat 6: Fried Berg (1.05€)
*** ANTE/BLINDS ***
R2Dread2 posts small blind 0.01€
slowreplay posts big blind 0.02€
Dealt to Fried Berg [Qd Tc]
*** PRE-FLOP *** 
EMBATAA folds
FrappeLourde folds
fullawa raises 0.02€ to 0.04€
Fried Berg calls 0.04€
R2Dread2 folds
slowreplay folds
*** FLOP *** [3c Qh 8s]
fullawa checks
Fried Berg bets 0.08€
fullawa folds
Fried Berg collected 0.18€ from pot
*** SUMMARY ***
Total pot 0.18€ | Rake 0.01€
Board: [3c Qh 8s]
Seat 6: Fried Berg (button) won 0.18€


Winamax Poker - HOLD-UP "Colorado" - HandId: #19116069-674568-1701692690 - Holdem no limit (0.01€/0.02€) - 2023/12/04 12:24:50 UTC
Table: 'Colorado' 6-max (real money) Seat #6 is the button
Seat 1: JFSredbaron (4.53€)
Seat 2: Fried Berg (1.11€)
Seat 3: Erenox (1.57€)
Seat 4: slowreplay (2.13€)
Seat 5: AMBM2729 (2.01€)
Seat 6: Tompahmax (1.59€)
*** ANTE/BLINDS ***
JFSredbaron posts small blind 0.01€
Fried Berg posts big blind 0.02€
Dealt to Fried Berg [Jd Qh]
*** PRE-FLOP *** 
Erenox raises 0.04€ to 0.06€
slowreplay folds
AMBM2729 folds
Tompahmax calls 0.06€
JFSredbaron folds
Fried Berg calls 0.04€
*** FLOP *** [Kh 4s Ts]
Fried Berg checks
Erenox checks
Tompahmax checks
*** TURN *** [Kh 4s Ts][6s]
Fried Berg checks
Erenox bets 0.10€
Tompahmax folds
Fried Berg folds
Erenox collected 0.27€ from pot
*** SUMMARY ***
Total pot 0.27€ | Rake 0.02€
Board: [Kh 4s Ts 6s]
Seat 3: Erenox won 0.27€


Winamax Poker - HOLD-UP "Colorado" - HandId: #19116069-674624-1701692734 - Holdem no limit (0.01€/0.02€) - 2023/12/04 12:25:34 UTC
Table: 'Colorado' 6-max (real money) Seat #6 is the button
Seat 1: Samuelillo07 (2.06€)
Seat 2: ilergeta (3.28€)
Seat 3: Fried Berg (1.05€)
Seat 4: UnluckyEny (2€)
Seat 5: BMWTPM (3.85€)
Seat 6: Ar gaouyat (2€)
*** ANTE/BLINDS ***
Samuelillo07 posts small blind 0.01€
ilergeta posts big blind 0.02€
Dealt to Fried Berg [7c 2c]
*** PRE-FLOP *** 
Fried Berg folds
UnluckyEny folds
BMWTPM folds
Ar gaouyat folds
Samuelillo07 raises 0.03€ to 0.05€
ilergeta folds
Samuelillo07 collected 0.07€ from pot
*** SUMMARY ***
Total pot 0.07€ | No rake
Seat 1: Samuelillo07 (small blind) won 0.07€


Winamax Poker - HOLD-UP "Colorado" - HandId: #19116069-674626-1701692736 - Holdem no limit (0.01€/0.02€) - 2023/12/04 12:25:36 UTC
Table: 'Colorado' 6-max (real money) Seat #6 is the button
Seat 1: Fried Berg (1.05€)
Seat 2: Captainbroch (0.64€)
Seat 3: FreeLouisias (9.13€)
Seat 4: Richard Reuk (2.26€)
Seat 5: jeanpi 2B (1.87€)
Seat 6: SharkAKK (2€)
Hold-up to Pot: total 0.10€
*** ANTE/BLINDS ***
Fried Berg posts small blind 0.01€
Captainbroch posts big blind 0.02€
Dealt to Fried Berg [As Ks]
*** PRE-FLOP *** 
FreeLouisias raises 0.05€ to 0.07€
Richard Reuk folds
jeanpi 2B calls 0.07€
SharkAKK folds
Fried Berg raises 0.98€ to 1.05€ and is all-in
Captainbroch calls 0.62€ and is all-in
FreeLouisias folds
jeanpi 2B folds
*** FLOP *** [Ad 7d Jh]
*** TURN *** [Ad 7d Jh][7s]
*** RIVER *** [Ad 7d Jh 7s][2c]
*** SHOW DOWN ***
Captainbroch shows [9h 9c] (Two pairs : 9 and 7)
Fried Berg shows [As Ks] (Two pairs : Aces and 7)
Fried Berg collected 1.79€ from pot
*** SUMMARY ***
Total pot 1.79€ | Rake 0.14€
Board: [Ad 7d Jh 7s 2c]
Seat 1: Fried Berg (small blind) showed [As Ks] and won 1.79€ with Two pairs : Aces and 7
Seat 2: Captainbroch (big blind) showed [9h 9c] and lost with Two pairs : 9 and 7


Winamax Poker - HOLD-UP "Colorado" - HandId: #19116069-674669-1701692773 - Holdem no limit (0.01€/0.02€) - 2023/12/04 12:26:13 UTC
Table: 'Colorado' 6-max (real money) Seat #6 is the button
Seat 1: FreeLouisias (9.06€)
Seat 2: Kryshus (1.87€)
Seat 3: JFSredbaron (2.10€)
Seat 4: Fried Berg (1.79€)
Seat 5: slowreplay (2€)
Seat 6: Samuelillo07 (2.07€)
*** ANTE/BLINDS ***
FreeLouisias posts small blind 0.01€
Kryshus posts big blind 0.02€
Dealt to Fried Berg [5s 7h]
*** PRE-FLOP *** 
JFSredbaron raises 0.04€ to 0.06€
Fried Berg folds
slowreplay folds
Samuelillo07 folds
FreeLouisias folds
Kryshus calls 0.04€
*** FLOP *** [Ad Tc Qs]
Kryshus checks
JFSredbaron bets 0.08€
Kryshus calls 0.08€
*** TURN *** [Ad Tc Qs][8h]
Kryshus checks
JFSredbaron bets 0.29€
Kryshus folds
JFSredbaron collected 0.55€ from pot
*** SUMMARY ***
Total pot 0.55€ | Rake 0.03€
Board: [Ad Tc Qs 8h]
Seat 3: JFSredbaron won 0.55€


Winamax Poker - HOLD-UP "Colorado" - HandId: #19116069-674686-1701692786 - Holdem no limit (0.01€/0.02€) - 2023/12/04 12:26:26 UTC
Table: 'Colorado' 6-max (real money) Seat #6 is the button
Seat 1: BMWTPM (2€)
Seat 2: Ar gaouyat (3€)
Seat 3: hello7585 (1.97€)
Seat 4: balou10180 (1.72€)
Seat 5: EMBATAA (2.47€)
Seat 6: Fried Berg (1.79€)
*** ANTE/BLINDS ***
BMWTPM posts small blind 0.01€
Ar gaouyat posts big blind 0.02€
Dealt to Fried Berg [5c 7c]
*** PRE-FLOP *** 
hello7585 folds
balou10180 calls 0.02€
EMBATAA folds
Fried Berg raises 0.02€ to 0.04€
BMWTPM folds
Ar gaouyat folds
balou10180 calls 0.02€
*** FLOP *** [2c Ks Ac]
balou10180 checks
Fried Berg bets 0.08€
balou10180 folds
Fried Berg collected 0.18€ from pot
*** SUMMARY ***
Total pot 0.18€ | Rake 0.01€
Board: [2c Ks Ac]
Seat 6: Fried Berg (button) won 0.18€


Winamax Poker - HOLD-UP "Colorado" - HandId: #19116069-674742-1701692824 - Holdem no limit (0.01€/0.02€) - 2023/12/04 12:27:04 UTC
Table: 'Colorado' 6-max (real money) Seat #6 is the button
Seat 1: hello7585 (1.95€)
Seat 2: ilergeta (2.65€)
Seat 3: Pablopenrais (1.89€)
Seat 4: UnluckyEny (2€)
Seat 5: Fried Berg (1.85€)
Seat 6: Machiavel- (4.20€)
*** ANTE/BLINDS ***
hello7585 posts small blind 0.01€
ilergeta posts big blind 0.02€
Dealt to Fried Berg [9h Qc]
*** PRE-FLOP *** 
Pablopenrais folds
UnluckyEny folds
Fried Berg folds
Machiavel- folds
hello7585 folds
ilergeta collected 0.03€ from pot
*** SUMMARY ***
Total pot 0.03€ | No rake
Seat 2: ilergeta (big blind) won 0.03€


Winamax Poker - HOLD-UP "Colorado" - HandId: #19116069-674748-1701692829 - Holdem no limit (0.01€/0.02€) - 2023/12/04 12:27:09 UTC
Table: 'Colorado' 6-max (real money) Seat #6 is the button
Seat 1: Fried Berg (1.85€)
Seat 2: Roberfrk (2€)
Seat 3: BMWTPM (3.95€)
Seat 4: Hagreed (4.69€)
Seat 5: UnluckyEny (2€)
Seat 6: 14cruyff14 (0.50€)
*** ANTE/BLINDS ***
Fried Berg posts small blind 0.01€
Roberfrk posts big blind 0.02€
Dealt to Fried Berg [9h Qs]
*** PRE-FLOP *** 
BMWTPM raises 0.12€ to 0.14€
Hagreed folds
UnluckyEny folds
14cruyff14 folds
Fried Berg folds
Roberfrk folds
BMWTPM collected 0.17€ from pot
*** SUMMARY ***
Total pot 0.17€ | No rake
Seat 3: BMWTPM won 0.17€


Winamax Poker - HOLD-UP "Colorado" - HandId: #19116069-674752-1701692832 - Holdem no limit (0.01€/0.02€) - 2023/12/04 12:27:12 UTC
Table: 'Colorado' 6-max (real money) Seat #6 is the button
Seat 1: JFSredbaron (4.23€)
Seat 2: Fried Berg (1.84€)
Seat 3: DieToBorn (3.49€)
Seat 4: SharkAKK (2.10€)
Seat 5: Raklur (2.11€)
Seat 6: Ar gaouyat (2.08€)
*** ANTE/BLINDS ***
JFSredbaron posts small blind 0.01€
Fried Berg posts big blind 0.02€
Dealt to Fried Berg [Kd 5d]
*** PRE-FLOP *** 
DieToBorn folds
SharkAKK folds
Raklur folds
Ar gaouyat raises 0.03€ to 0.05€
JFSredbaron folds
Fried Berg folds
Ar gaouyat collected 0.08€ from pot
*** SUMMARY ***
Total pot 0.08€ | No rake
Seat 6: Ar gaouyat (button) won 0.08€


Winamax Poker - HOLD-UP "Colorado" - HandId: #19116069-674775-1701692848 - Holdem no limit (0.01€/0.02€) - 2023/12/04 12:27:28 UTC
Table: 'Colorado' 6-max (real money) Seat #6 is the button
Seat 1: Jorj-X-McKie (2.56€)
Seat 2: boulde34 (0.53€)
Seat 3: Fried Berg (1.82€)
Seat 4: JissEl1te (3.60€)
Seat 5: ilergeta (2.65€)
Seat 6: EMBATAA (2.50€)
*** ANTE/BLINDS ***
Jorj-X-McKie posts small blind 0.01€
boulde34 posts big blind 0.02€
Dealt to Fried Berg [4d Td]
*** PRE-FLOP *** 
Fried Berg folds
JissEl1te folds
ilergeta folds
EMBATAA folds
Jorj-X-McKie folds
boulde34 collected 0.03€ from pot
*** SUMMARY ***
Total pot 0.03€ | No rake
Seat 2: boulde34 (big blind) won 0.03€


Winamax Poker - HOLD-UP "Colorado" - HandId: #19116069-674778-1701692851 - Holdem no limit (0.01€/0.02€) - 2023/12/04 12:27:31 UTC
Table: 'Colorado' 6-max (real money) Seat #6 is the button
Seat 1: Jorj-X-McKie (2.55€)
Seat 2: Maxou72120 (0.65€)
Seat 3: GTO-Mieko (3.32€)
Seat 4: Fried Berg (1.82€)
Seat 5: Ertorko (3.13€)
Seat 6: Kryshus (7.19€)
*** ANTE/BLINDS ***
Jorj-X-McKie posts small blind 0.01€
Maxou72120 posts big blind 0.02€
Dealt to Fried Berg [7d Qh]
*** PRE-FLOP *** 
GTO-Mieko folds
Fried Berg folds
Ertorko raises 0.03€ to 0.05€
Kryshus folds
Jorj-X-McKie folds
Maxou72120 calls 0.03€
*** FLOP *** [Kc 9h As]
Maxou72120 checks
Ertorko bets 0.04€
Maxou72120 calls 0.04€
*** TURN *** [Kc 9h As][5h]
Maxou72120 checks
Ertorko checks
*** RIVER *** [Kc 9h As 5h][8d]
Maxou72120 checks
Ertorko checks
*** SHOW DOWN ***
Maxou72120 shows [Ts Jc] (High card : Ace)
Ertorko shows [Jd Kh] (One pair : Kings)
Ertorko collected 0.17€ from pot
*** SUMMARY ***
Total pot 0.17€ | Rake 0.02€
Board: [Kc 9h As 5h 8d]
Seat 2: Maxou72120 (big blind) showed [Ts Jc] and lost with High card : Ace
Seat 5: Ertorko showed [Jd Kh] and won 0.17€ with One pair : Kings


Winamax Poker - HOLD-UP "Colorado" - HandId: #19116069-674782-1701692854 - Holdem no limit (0.01€/0.02€) - 2023/12/04 12:27:34 UTC
Table: 'Colorado' 6-max (real money) Seat #6 is the button
Seat 1: AMBM2729 (1.24€)
Seat 2: GTO-Mieko (2.03€)
Seat 3: Jesperord98 (6.22€)
Seat 4: hello7585 (1.73€)
Seat 5: Fried Berg (1.82€)
Seat 6: 14cruyff14 (0.50€)
*** ANTE/BLINDS ***
AMBM2729 posts small blind 0.01€
GTO-Mieko posts big blind 0.02€
Dealt to Fried Berg [Kh Jd]
*** PRE-FLOP *** 
Jesperord98 folds
hello7585 raises 0.03€ to 0.05€
Fried Berg calls 0.05€
14cruyff14 folds
AMBM2729 folds
GTO-Mieko folds
*** FLOP *** [4d Qs Ts]
hello7585 bets 0.13€
Fried Berg calls 0.13€
*** TURN *** [4d Qs Ts][3s]
hello7585 checks
Fried Berg checks
*** RIVER *** [4d Qs Ts 3s][4s]
hello7585 checks
Fried Berg checks
*** SHOW DOWN ***
hello7585 shows [Jc Kc] (One pair : 4)
Fried Berg shows [Kh Jd] (One pair : 4)
Fried Berg collected 0.18€ from pot
hello7585 collected 0.17€ from pot
*** SUMMARY ***
Total pot 0.35€ | Rake 0.04€
Board: [4d Qs Ts 3s 4s]
Seat 4: hello7585 showed [Jc Kc] and won 0.17€ with One pair : 4
Seat 5: Fried Berg showed [Kh Jd] and won 0.18€ with One pair : 4


Winamax Poker - HOLD-UP "Colorado" - HandId: #19116069-674813-1701692882 - Holdem no limit (0.01€/0.02€) - 2023/12/04 12:28:02 UTC
Table: 'Colorado' 6-max (real money) Seat #6 is the button
Seat 1: nico033 (4.88€)
Seat 2: Jorj-X-McKie (4.16€)
Seat 3: jamesbean1 (2.36€)
Seat 4: Fried Berg (1.82€)
Seat 5: hello7585 (1.72€)
Seat 6: Richard Reuk (3.92€)
*** ANTE/BLINDS ***
nico033 posts small blind 0.01€
Jorj-X-McKie posts big blind 0.02€
Dealt to Fried Berg [6s Th]
*** PRE-FLOP *** 
jamesbean1 folds
Fried Berg folds
hello7585 folds
Richard Reuk folds
nico033 folds
Jorj-X-McKie collected 0.03€ from pot
*** SUMMARY ***
Total pot 0.03€ | No rake
Seat 2: Jorj-X-McKie (big blind) won 0.03€


Winamax Poker - HOLD-UP "Colorado" - HandId: #19116069-674818-1701692886 - Holdem no limit (0.01€/0.02€) - 2023/12/04 12:28:06 UTC
Table: 'Colorado' 6-max (real money) Seat #6 is the button
Seat 1: Pablopenrais (0.99€)
Seat 2: _ilTulipano_ (2.88€)
Seat 3: Tantouzz7 (4.30€)
Seat 4: Fried Berg (1.82€)
Seat 5: SharkAKK (2.08€)
Seat 6: JFSredbaron (4.38€)
*** ANTE/BLINDS ***
Pablopenrais posts small blind 0.01€
_ilTulipano_ posts big blind 0.02€
Dealt to Fried Berg [Jc 5c]
*** PRE-FLOP *** 
Tantouzz7 calls 0.02€
Fried Berg folds
SharkAKK folds
JFSredbaron folds
Pablopenrais folds
_ilTulipano_ checks
*** FLOP *** [Ts 5h Th]
_ilTulipano_ checks
Tantouzz7 checks
*** TURN *** [Ts 5h Th][4c]
_ilTulipano_ checks
Tantouzz7 bets 0.02€
_ilTulipano_ calls 0.02€
*** RIVER *** [Ts 5h Th 4c][2c]
_ilTulipano_ checks
Tantouzz7 bets 0.03€
_ilTulipano_ calls 0.03€
*** SHOW DOWN ***
_ilTulipano_ shows [Ad 7h] (One pair : Tens)
Tantouzz7 shows [Ac Jd] (One pair : Tens)
Tantouzz7 collected 0.13€ from pot
*** SUMMARY ***
Total pot 0.13€ | Rake 0.02€
Board: [Ts 5h Th 4c 2c]
Seat 2: _ilTulipano_ (big blind) showed [Ad 7h] and lost with One pair : Tens
Seat 3: Tantouzz7 showed [Ac Jd] and won 0.13€ with One pair : Tens


Winamax Poker - HOLD-UP "Colorado" - HandId: #19116069-674826-1701692891 - Holdem no limit (0.01€/0.02€) - 2023/12/04 12:28:11 UTC
Table: 'Colorado' 6-max (real money) Seat #6 is the button
Seat 1: jamesbean1 (2.36€)
Seat 2: hello7585 (1.71€)
Seat 3: Richard Reuk (2.06€)
Seat 4: BMWTPM (3.98€)
Seat 5: slowreplay (2.10€)
Seat 6: Fried Berg (1.82€)
*** ANTE/BLINDS ***
jamesbean1 posts small blind 0.01€
hello7585 posts big blind 0.02€
Dealt to Fried Berg [9s 7d]
*** PRE-FLOP *** 
Richard Reuk folds
BMWTPM folds
slowreplay folds
Fried Berg folds
jamesbean1 calls 0.01€
hello7585 raises 0.04€ to 0.06€
jamesbean1 calls 0.04€
*** FLOP *** [8c Td 8h]
jamesbean1 checks
hello7585 bets 0.08€
jamesbean1 folds
hello7585 collected 0.19€ from pot
*** SUMMARY ***
Total pot 0.19€ | Rake 0.01€
Board: [8c Td 8h]
Seat 2: hello7585 (big blind) won 0.19€


Winamax Poker - HOLD-UP "Colorado" - HandId: #19116069-674841-1701692902 - Holdem no limit (0.01€/0.02€) - 2023/12/04 12:28:22 UTC
Table: 'Colorado' 6-max (real money) Seat #6 is the button
Seat 1: EMBATAA (2.47€)
Seat 2: Fried Berg (1.82€)
Seat 3: Samuelillo07 (2€)
Seat 4: fullawa (0.70€)
Seat 5: Killim (0.93€)
Seat 6: Roberfrk (2.02€)
*** ANTE/BLINDS ***
EMBATAA posts small blind 0.01€
Fried Berg posts big blind 0.02€
Dealt to Fried Berg [5h 4c]
*** PRE-FLOP *** 
Samuelillo07 folds
fullawa folds
Killim folds
Roberfrk raises 0.03€ to 0.05€
EMBATAA folds
Fried Berg folds
Roberfrk collected 0.08€ from pot
*** SUMMARY ***
Total pot 0.08€ | No rake
Seat 6: Roberfrk (button) won 0.08€


Winamax Poker - HOLD-UP "Colorado" - HandId: #19116069-674850-1701692909 - Holdem no limit (0.01€/0.02€) - 2023/12/04 12:28:29 UTC
Table: 'Colorado' 6-max (real money) Seat #6 is the button
Seat 1: Fried Berg (1.80€)
Seat 2: BMWTPM (2.98€)
Seat 3: UnluckyEny (2.05€)
Seat 4: slowreplay (2.10€)
Seat 5: fullawa (0.39€)
Seat 6: JFSredbaron (4.34€)
*** ANTE/BLINDS ***
Fried Berg posts small blind 0.01€
BMWTPM posts big blind 0.02€
Dealt to Fried Berg [Ah 4h]
*** PRE-FLOP *** 
UnluckyEny folds
slowreplay folds
fullawa raises 0.02€ to 0.04€
JFSredbaron folds
Fried Berg calls 0.03€
BMWTPM calls 0.02€
*** FLOP *** [4d 3d Jh]
Fried Berg bets 0.02€
BMWTPM calls 0.02€
fullawa folds
*** TURN *** [4d 3d Jh][6s]
Fried Berg checks
BMWTPM checks
*** RIVER *** [4d 3d Jh 6s][Ac]
Fried Berg bets 0.06€
BMWTPM folds
Fried Berg collected 0.20€ from pot
*** SUMMARY ***
Total pot 0.20€ | Rake 0.02€
Board: [4d 3d Jh 6s Ac]
Seat 1: Fried Berg (small blind) won 0.20€


Winamax Poker - HOLD-UP "Colorado" - HandId: #19116069-674943-1701692986 - Holdem no limit (0.01€/0.02€) - 2023/12/04 12:29:46 UTC
Table: 'Colorado' 6-max (real money) Seat #6 is the button
Seat 1: ilergeta (3.40€)
Seat 2: Roberfrk (1.99€)
Seat 3: jamesbean1 (2.24€)
Seat 4: Ar gaouyat (2.03€)
Seat 5: 14cruyff14 (0.77€)
Seat 6: Fried Berg (1.88€)
*** ANTE/BLINDS ***
ilergeta posts small blind 0.01€
Roberfrk posts big blind 0.02€
Dealt to Fried Berg [9s 5d]
*** PRE-FLOP *** 
jamesbean1 raises 0.02€ to 0.04€
Ar gaouyat raises 0.12€ to 0.16€
14cruyff14 folds
Fried Berg folds
ilergeta folds
Roberfrk folds
jamesbean1 calls 0.12€
*** FLOP *** [Tc Td 3h]
jamesbean1 checks
Ar gaouyat checks
*** TURN *** [Tc Td 3h][Jd]
jamesbean1 bets 0.23€
Ar gaouyat folds
jamesbean1 collected 0.54€ from pot
*** SUMMARY ***
Total pot 0.54€ | Rake 0.04€
Board: [Tc Td 3h Jd]
Seat 3: jamesbean1 won 0.54€


Winamax Poker - HOLD-UP "Colorado" - HandId: #19116069-674948-1701692989 - Holdem no limit (0.01€/0.02€) - 2023/12/04 12:29:49 UTC
Table: 'Colorado' 6-max (real money) Seat #6 is the button
Seat 1: FrappeLourde (0.36€)
Seat 2: Fried Berg (1.88€)
Seat 3: _ilTulipano_ (6.45€)
Seat 4: PwedzaM (3.56€)
Seat 5: Pablopenrais (2.08€)
Seat 6: Samuelillo07 (2.24€)
*** ANTE/BLINDS ***
FrappeLourde posts small blind 0.01€
Fried Berg posts big blind 0.02€
Dealt to Fried Berg [Tc 6s]
*** PRE-FLOP *** 
_ilTulipano_ folds
PwedzaM folds
Pablopenrais folds
Samuelillo07 folds
FrappeLourde folds
Fried Berg collected 0.03€ from pot
*** SUMMARY ***
Total pot 0.03€ | No rake
Seat 2: Fried Berg (big blind) won 0.03€


Winamax Poker - HOLD-UP "Colorado" - HandId: #19116069-674986-1701693021 - Holdem no limit (0.01€/0.02€) - 2023/12/04 12:30:21 UTC
Table: 'Colorado' 6-max (real money) Seat #6 is the button
Seat 1: Samuelillo07 (2.22€)
Seat 2: GTO-Mieko (2€)
Seat 3: Raklur (1.82€)
Seat 4: Ertorko (2.08€)
Seat 5: Fried Berg (1.89€)
Seat 6: Bengers31 (1.76€)
*** ANTE/BLINDS ***
Samuelillo07 posts small blind 0.01€
GTO-Mieko posts big blind 0.02€
Dealt to Fried Berg [2c Qd]
*** PRE-FLOP *** 
Raklur folds
Ertorko folds
Fried Berg folds
Bengers31 calls 0.02€
Samuelillo07 raises 0.08€ to 0.10€
GTO-Mieko folds
Bengers31 calls 0.08€
*** FLOP *** [6d 9d 6s]
Samuelillo07 bets 0.08€
Bengers31 raises 0.08€ to 0.16€
Samuelillo07 folds
Bengers31 collected 0.42€ from pot
*** SUMMARY ***
Total pot 0.42€ | Rake 0.04€
Board: [6d 9d 6s]
Seat 6: Bengers31 (button) won 0.42€


Winamax Poker - HOLD-UP "Colorado" - HandId: #19116069-674993-1701693028 - Holdem no limit (0.01€/0.02€) - 2023/12/04 12:30:28 UTC
Table: 'Colorado' 6-max (real money) Seat #6 is the button
Seat 1: Fried Berg (1.89€)
Seat 2: Raklur (1.46€)
Seat 3: Kryshus (1.98€)
Seat 4: EMBATAA (2.07€)
Seat 5: Hagreed (4.78€)
Seat 6: UnluckyEny (2.09€)
*** ANTE/BLINDS ***
Fried Berg posts small blind 0.01€
Raklur posts big blind 0.02€
Dealt to Fried Berg [8h Qs]
*** PRE-FLOP *** 
Kryshus raises 0.04€ to 0.06€
EMBATAA folds
Hagreed raises 0.09€ to 0.15€
UnluckyEny folds
Fried Berg folds
Raklur folds
Kryshus calls 0.09€
*** FLOP *** [Ah As 5d]
Kryshus checks
Hagreed bets 0.12€
Kryshus calls 0.12€
*** TURN *** [Ah As 5d][6c]
Kryshus checks
Hagreed checks
*** RIVER *** [Ah As 5d 6c][Kc]
Kryshus bets 0.37€
Hagreed folds
Kryshus collected 0.88€ from pot
*** SUMMARY ***
Total pot 0.88€ | Rake 0.06€
Board: [Ah As 5d 6c Kc]
Seat 3: Kryshus won 0.88€


Winamax Poker - HOLD-UP "Colorado" - HandId: #19116069-675019-1701693044 - Holdem no limit (0.01€/0.02€) - 2023/12/04 12:30:44 UTC
Table: 'Colorado' 6-max (real money) Seat #6 is the button
Seat 1: Ertorko (2.05€)
Seat 2: La-Jonquera (0.92€)
Seat 3: Fried Berg (1.88€)
Seat 4: hello7585 (1.74€)
Seat 5: nico033 (4.66€)
Seat 6: ElGringocoke (1.08€)
*** ANTE/BLINDS ***
Ertorko posts small blind 0.01€
La-Jonquera posts big blind 0.02€
Dealt to Fried Berg [9c 2h]
*** PRE-FLOP *** 
Fried Berg folds
hello7585 folds
nico033 raises 0.03€ to 0.05€
ElGringocoke calls 0.05€
Ertorko folds
La-Jonquera folds
*** FLOP *** [9h Td 6h]
nico033 checks
ElGringocoke bets 0.05€
nico033 calls 0.05€
*** TURN *** [9h Td 6h][6c]
nico033 checks
ElGringocoke bets 0.12€
nico033 folds
ElGringocoke collected 0.33€ from pot
*** SUMMARY ***
Total pot 0.33€ | Rake 0.02€
Board: [9h Td 6h 6c]
Seat 6: ElGringocoke (button) won 0.33€


Winamax Poker - HOLD-UP "Colorado" - HandId: #19116069-675024-1701693048 - Holdem no limit (0.01€/0.02€) - 2023/12/04 12:30:48 UTC
Table: 'Colorado' 6-max (real money) Seat #6 is the button
Seat 1: Ar gaouyat (2.14€)
Seat 2: Roberfrk (1.91€)
Seat 3: PwedzaM (3.53€)
Seat 4: 14cruyff14 (0.50€)
Seat 5: ASho-Hai (2.74€)
Seat 6: Fried Berg (1.88€)
*** ANTE/BLINDS ***
Ar gaouyat posts small blind 0.01€
Roberfrk posts big blind 0.02€
Dealt to Fried Berg [6d 8s]
*** PRE-FLOP *** 
PwedzaM folds
14cruyff14 raises 0.04€ to 0.06€
ASho-Hai calls 0.06€
Fried Berg folds
Ar gaouyat folds
Roberfrk folds
*** FLOP *** [Js Qd 3d]
14cruyff14 checks
ASho-Hai bets 0.05€
14cruyff14 folds
ASho-Hai collected 0.18€ from pot
*** SUMMARY ***
Total pot 0.18€ | Rake 0.02€
Board: [Js Qd 3d]
Seat 5: ASho-Hai won 0.18€


Winamax Poker - HOLD-UP "Colorado" - HandId: #19116069-675028-1701693050 - Holdem no limit (0.01€/0.02€) - 2023/12/04 12:30:50 UTC
Table: 'Colorado' 6-max (real money) Seat #6 is the button
Seat 1: Jojo-andros5 (0.45€)
Seat 2: slowreplay (2.19€)
Seat 3: Kekoke (0.72€)
Seat 4: Fried Berg (1.88€)
Seat 5: Jorj-X-McKie (4.88€)
Seat 6: Machiavel- (4.06€)
*** ANTE/BLINDS ***
Jojo-andros5 posts small blind 0.01€
slowreplay posts big blind 0.02€
Dealt to Fried Berg [Qh Jc]
*** PRE-FLOP *** 
Kekoke raises 0.03€ to 0.05€
Fried Berg calls 0.05€
Jorj-X-McKie folds
Machiavel- folds
Jojo-andros5 folds
slowreplay folds
*** FLOP *** [7h Jh Th]
Kekoke checks
Fried Berg bets 0.04€
Kekoke folds
Fried Berg collected 0.16€ from pot
*** SUMMARY ***
Total pot 0.16€ | Rake 0.01€
Board: [7h Jh Th]
Seat 4: Fried Berg won 0.16€


Winamax Poker - HOLD-UP "Colorado" - HandId: #19116069-675053-1701693072 - Holdem no limit (0.01€/0.02€) - 2023/12/04 12:31:12 UTC
Table: 'Colorado' 6-max (real money) Seat #6 is the button
Seat 1: Ertorko (2.45€)
Seat 2: UnluckyEny (2.01€)
Seat 3: Fried Berg (1.95€)
Seat 4: Jorj-X-McKie (2€)
Seat 5: Kekoke (0.67€)
Seat 6: Winico (0.47€)
*** ANTE/BLINDS ***
Ertorko posts small blind 0.01€
UnluckyEny posts big blind 0.02€
Dealt to Fried Berg [2s 9c]
*** PRE-FLOP *** 
Fried Berg folds
Jorj-X-McKie raises 0.02€ to 0.04€
Kekoke folds
Winico folds
Ertorko folds
UnluckyEny folds
Jorj-X-McKie collected 0.07€ from pot
*** SUMMARY ***
Total pot 0.07€ | No rake
Seat 4: Jorj-X-McKie won 0.07€


Winamax Poker - HOLD-UP "Colorado" - HandId: #19116069-675065-1701693082 - Holdem no limit (0.01€/0.02€) - 2023/12/04 12:31:22 UTC
Table: 'Colorado' 6-max (real money) Seat #6 is the button
Seat 1: Pablopenrais (0.84€)
Seat 2: BMWTPM (1.71€)
Seat 3: _Croute_ (1.83€)
Seat 4: Fried Berg (1.95€)
Seat 5: 13-or63100 (0.45€)
Seat 6: Jesperord98 (4.53€)
*** ANTE/BLINDS ***
Pablopenrais posts small blind 0.01€
BMWTPM posts big blind 0.02€
Dealt to Fried Berg [5h Js]
*** PRE-FLOP *** 
_Croute_ folds
Fried Berg folds
13-or63100 folds
Jesperord98 folds
Pablopenrais raises 0.04€ to 0.06€
BMWTPM calls 0.04€
*** FLOP *** [5s 2h 4d]
Pablopenrais checks
BMWTPM checks
*** TURN *** [5s 2h 4d][Qh]
Pablopenrais bets 0.08€
BMWTPM folds
Pablopenrais collected 0.19€ from pot
*** SUMMARY ***
Total pot 0.19€ | Rake 0.01€
Board: [5s 2h 4d Qh]
Seat 1: Pablopenrais (small blind) won 0.19€


Winamax Poker - HOLD-UP "Colorado" - HandId: #19116069-675072-1701693088 - Holdem no limit (0.01€/0.02€) - 2023/12/04 12:31:28 UTC
Table: 'Colorado' 6-max (real money) Seat #6 is the button
Seat 1: Jesperord98 (6.24€)
Seat 2: Jorj-X-McKie (2.03€)
Seat 3: Fried Berg (1.95€)
Seat 4: Raklur (1.43€)
Seat 5: EMBATAA (2.07€)
Seat 6: Jojo-andros5 (0.44€)
*** ANTE/BLINDS ***
Jesperord98 posts small blind 0.01€
Jorj-X-McKie posts big blind 0.02€
Dealt to Fried Berg [7d Kh]
*** PRE-FLOP *** 
Fried Berg folds
Raklur raises 0.02€ to 0.04€
EMBATAA folds
Jojo-andros5 folds
Jesperord98 folds
Jorj-X-McKie folds
Raklur collected 0.07€ from pot
*** SUMMARY ***
Total pot 0.07€ | No rake
Seat 4: Raklur won 0.07€


Winamax Poker - HOLD-UP "Colorado" - HandId: #19116069-675073-1701693090 - Holdem no limit (0.01€/0.02€) - 2023/12/04 12:31:30 UTC
Table: 'Colorado' 6-max (real money) Seat #6 is the button
Seat 1: Fried Berg (1.95€)
Seat 2: lut1dupoivre (0.50€)
Seat 3: fullawa (0.72€)
Seat 4: Roberfrk (1.91€)
Seat 5: _ilTulipano_ (2.88€)
Seat 6: 14cruyff14 (0.50€)
*** ANTE/BLINDS ***
Fried Berg posts small blind 0.01€
lut1dupoivre posts big blind 0.02€
Dealt to Fried Berg [6d 8d]
*** PRE-FLOP *** 
fullawa folds
Roberfrk raises 0.03€ to 0.05€
_ilTulipano_ folds
14cruyff14 folds
Fried Berg calls 0.04€
lut1dupoivre folds
*** FLOP *** [Ks 3c 4h]
Fried Berg checks
Roberfrk bets 0.05€
Fried Berg folds
Roberfrk collected 0.16€ from pot
*** SUMMARY ***
Total pot 0.16€ | Rake 0.01€
Board: [Ks 3c 4h]
Seat 4: Roberfrk won 0.16€


Winamax Poker - HOLD-UP "Colorado" - HandId: #19116069-675127-1701693134 - Holdem no limit (0.01€/0.02€) - 2023/12/04 12:32:14 UTC
Table: 'Colorado' 6-max (real money) Seat #6 is the button
Seat 1: Hobby lagart (1.20€)
Seat 2: Fried Berg (1.90€)
Seat 3: Homer14510 (0.57€)
Seat 4: GTO-Mieko (2€)
Seat 5: 49_3 (0.65€)
Seat 6: muespachois1 (2.21€)
*** ANTE/BLINDS ***
Hobby lagart posts small blind 0.01€
Fried Berg posts big blind 0.02€
Dealt to Fried Berg [6h Ah]
*** PRE-FLOP *** 
Homer14510 folds
GTO-Mieko folds
49_3 folds
muespachois1 folds
Hobby lagart raises 0.03€ to 0.05€
Fried Berg calls 0.03€
*** FLOP *** [9d Ad Jd]
Hobby lagart bets 0.03€
Fried Berg calls 0.03€
*** TURN *** [9d Ad Jd][Qc]
Hobby lagart bets 0.06€
Fried Berg calls 0.06€
*** RIVER *** [9d Ad Jd Qc][6s]
Hobby lagart bets 0.10€
Fried Berg calls 0.10€
*** SHOW DOWN ***
Hobby lagart shows [7c 7d] (One pair : 7)
Fried Berg shows [6h Ah] (Two pairs : Aces and 6)
Fried Berg collected 0.43€ from pot
*** SUMMARY ***
Total pot 0.43€ | Rake 0.05€
Board: [9d Ad Jd Qc 6s]
Seat 1: Hobby lagart (small blind) showed [7c 7d] and lost with One pair : 7
Seat 2: Fried Berg (big blind) showed [6h Ah] and won 0.43€ with Two pairs : Aces and 6


Winamax Poker - HOLD-UP "Colorado" - HandId: #19116069-675285-1701693276 - Holdem no limit (0.01€/0.02€) - 2023/12/04 12:34:36 UTC
Table: 'Colorado' 6-max (real money) Seat #6 is the button
Seat 1: Raklur (2.21€)
Seat 2: Kryshus (1.82€)
Seat 3: Hobby lagart (0.96€)
Seat 4: _ilTulipano_ (3.23€)
Seat 5: Fried Berg (2.09€)
Seat 6: slowreplay (2.25€)
*** ANTE/BLINDS ***
Raklur posts small blind 0.01€
Kryshus posts big blind 0.02€
Dealt to Fried Berg [8s 2d]
*** PRE-FLOP *** 
Hobby lagart folds
_ilTulipano_ folds
Fried Berg folds
slowreplay raises 0.04€ to 0.06€
Raklur folds
Kryshus raises 0.18€ to 0.24€
slowreplay folds
Kryshus collected 0.31€ from pot
*** SUMMARY ***
Total pot 0.31€ | No rake
Seat 2: Kryshus (big blind) won 0.31€


Winamax Poker - HOLD-UP "Colorado" - HandId: #19116069-675296-1701693285 - Holdem no limit (0.01€/0.02€) - 2023/12/04 12:34:45 UTC
Table: 'Colorado' 6-max (real money) Seat #6 is the button
Seat 1: fullawa (0.77€)
Seat 2: Fried Berg (2.09€)
Seat 3: Roberfrk (1.89€)
Seat 4: BMWTPM (3.84€)
Seat 5: Raklur (2.76€)
Seat 6: hello7585 (1.41€)
*** ANTE/BLINDS ***
fullawa posts small blind 0.01€
Fried Berg posts big blind 0.02€
Dealt to Fried Berg [7h 2c]
*** PRE-FLOP *** 
Roberfrk folds
BMWTPM folds
Raklur calls 0.02€
hello7585 folds
fullawa folds
Fried Berg checks
*** FLOP *** [5c 3d Ac]
Fried Berg checks
Raklur bets 0.02€
Fried Berg folds
Raklur collected 0.06€ from pot
*** SUMMARY ***
Total pot 0.06€ | Rake 0.01€
Board: [5c 3d Ac]
Seat 5: Raklur won 0.06€


Winamax Poker - HOLD-UP "Colorado" - HandId: #19116069-675338-1701693319 - Holdem no limit (0.01€/0.02€) - 2023/12/04 12:35:19 UTC
Table: 'Colorado' 6-max (real money) Seat #6 is the button
Seat 1: DieToBorn (4.27€)
Seat 2: AMBM2729 (1.20€)
Seat 3: UnluckyEny (2.47€)
Seat 4: Fried Berg (2.07€)
Seat 5: slowreplay (2€)
Seat 6: Machiavel- (2.33€)
*** ANTE/BLINDS ***
DieToBorn posts small blind 0.01€
AMBM2729 posts big blind 0.02€
Dealt to Fried Berg [6d Ad]
*** PRE-FLOP *** 
UnluckyEny folds
Fried Berg raises 0.02€ to 0.04€
slowreplay folds
Machiavel- folds
DieToBorn folds
AMBM2729 folds
Fried Berg collected 0.07€ from pot
*** SUMMARY ***
Total pot 0.07€ | No rake
Seat 4: Fried Berg won 0.07€


Winamax Poker - HOLD-UP "Colorado" - HandId: #19116069-675381-1701693353 - Holdem no limit (0.01€/0.02€) - 2023/12/04 12:35:53 UTC
Table: 'Colorado' 6-max (real money) Seat #6 is the button
Seat 1: Fried Berg (2.10€)
Seat 2: _ilTulipano_ (3.41€)
Seat 3: Jorj-X-McKie (5.67€)
Seat 4: BMWTPM (3.86€)
Seat 5: Jeje27 (1.92€)
Seat 6: EMBATAA (2€)
*** ANTE/BLINDS ***
Fried Berg posts small blind 0.01€
_ilTulipano_ posts big blind 0.02€
Dealt to Fried Berg [6s 6c]
*** PRE-FLOP *** 
Jorj-X-McKie folds
BMWTPM folds
Jeje27 folds
EMBATAA raises 0.03€ to 0.05€
Fried Berg calls 0.04€
_ilTulipano_ folds
*** FLOP *** [3d 8s 3s]
Fried Berg checks
EMBATAA bets 0.03€
Fried Berg calls 0.03€
*** TURN *** [3d 8s 3s][Td]
Fried Berg checks
EMBATAA bets 0.12€
Fried Berg calls 0.12€
*** RIVER *** [3d 8s 3s Td][6h]
Fried Berg checks
EMBATAA bets 0.42€
Fried Berg calls 0.42€
*** SHOW DOWN ***
EMBATAA shows [Kh Qc] (One pair : 3)
Fried Berg shows [6s 6c] (Full of 6 and 3)
Fried Berg collected 1.13€ from pot
*** SUMMARY ***
Total pot 1.13€ | Rake 0.13€
Board: [3d 8s 3s Td 6h]
Seat 1: Fried Berg (small blind) showed [6s 6c] and won 1.13€ with Full of 6 and 3
Seat 6: EMBATAA (button) showed [Kh Qc] and lost with One pair : 3


Winamax Poker - HOLD-UP "Colorado" - HandId: #19116069-675466-1701693423 - Holdem no limit (0.01€/0.02€) - 2023/12/04 12:37:03 UTC
Table: 'Colorado' 6-max (real money) Seat #6 is the button
Seat 1: UnluckyEny (2.10€)
Seat 2: gbtcorp (2€)
Seat 3: BMWTPM (3.83€)
Seat 4: EMBATAA (2€)
Seat 5: Fried Berg (2.61€)
Seat 6: Enzlola (1.96€)
*** ANTE/BLINDS ***
UnluckyEny posts small blind 0.01€
gbtcorp posts big blind 0.02€
Dealt to Fried Berg [Qh 9d]
*** PRE-FLOP *** 
BMWTPM folds
EMBATAA raises 0.03€ to 0.05€
Fried Berg folds
Enzlola folds
UnluckyEny folds
gbtcorp folds
EMBATAA collected 0.08€ from pot
*** SUMMARY ***
Total pot 0.08€ | No rake
Seat 4: EMBATAA won 0.08€


Winamax Poker - HOLD-UP "Colorado" - HandId: #19116069-675479-1701693434 - Holdem no limit (0.01€/0.02€) - 2023/12/04 12:37:14 UTC
Table: 'Colorado' 6-max (real money) Seat #6 is the button
Seat 1: hello7585 (1.32€)
Seat 2: Enzlola (1.96€)
Seat 3: Fried Berg (2.61€)
Seat 4: UnluckyEny (2.34€)
Seat 5: metamex (1.95€)
Seat 6: boulde34 (2.60€)
*** ANTE/BLINDS ***
hello7585 posts small blind 0.01€
Enzlola posts big blind 0.02€
Dealt to Fried Berg [3c 3s]
*** PRE-FLOP *** 
Fried Berg calls 0.02€
UnluckyEny folds
metamex folds
boulde34 folds
hello7585 folds
Enzlola checks
*** FLOP *** [Ks 6c 8h]
Enzlola checks
Fried Berg bets 0.02€
Enzlola calls 0.02€
*** TURN *** [Ks 6c 8h][6h]
Enzlola checks
Fried Berg checks
*** RIVER *** [Ks 6c 8h 6h][6s]
Enzlola checks
Fried Berg checks
*** SHOW DOWN ***
Enzlola shows [7h 4d] (Trips of 6)
Fried Berg shows [3c 3s] (Full of 6 and 3)
Fried Berg collected 0.08€ from pot
*** SUMMARY ***
Total pot 0.08€ | Rake 0.01€
Board: [Ks 6c 8h 6h 6s]
Seat 2: Enzlola (big blind) showed [7h 4d] and lost with Trips of 6
Seat 3: Fried Berg showed [3c 3s] and won 0.08€ with Full of 6 and 3


Winamax Poker - HOLD-UP "Colorado" - HandId: #19116069-675557-1701693499 - Holdem no limit (0.01€/0.02€) - 2023/12/04 12:38:19 UTC
Table: 'Colorado' 6-max (real money) Seat #6 is the button
Seat 1: Enzlola (1.92€)
Seat 2: Ertorko (4.01€)
Seat 3: antoclem2A (3.02€)
Seat 4: Jorj-X-McKie (2.18€)
Seat 5: Fried Berg (2.65€)
Seat 6: hello7585 (1.41€)
*** ANTE/BLINDS ***
Enzlola posts small blind 0.01€
Ertorko posts big blind 0.02€
Dealt to Fried Berg [7d Ts]
*** PRE-FLOP *** 
antoclem2A folds
Jorj-X-McKie folds
Fried Berg folds
hello7585 folds
Enzlola raises 1.90€ to 1.92€ and is all-in
Ertorko folds
Enzlola collected 1.94€ from pot
*** SUMMARY ***
Total pot 1.94€ | No rake
Seat 1: Enzlola (small blind) won 1.94€


Winamax Poker - HOLD-UP "Colorado" - HandId: #19116069-675561-1701693504 - Holdem no limit (0.01€/0.02€) - 2023/12/04 12:38:24 UTC
Table: 'Colorado' 6-max (real money) Seat #6 is the button
Seat 1: Samuelillo07 (2.09€)
Seat 2: hello7585 (1.41€)
Seat 3: Perf-31 (2.43€)
Seat 4: Fried Berg (2.65€)
Seat 5: Pablopenrais (2.03€)
Seat 6: Hagreed (4.61€)
*** ANTE/BLINDS ***
Samuelillo07 posts small blind 0.01€
hello7585 posts big blind 0.02€
Dealt to Fried Berg [Qd 7s]
*** PRE-FLOP *** 
Perf-31 folds
Fried Berg folds
Pablopenrais folds
Hagreed folds
Samuelillo07 folds
hello7585 collected 0.03€ from pot
*** SUMMARY ***
Total pot 0.03€ | No rake
Seat 2: hello7585 (big blind) won 0.03€


Winamax Poker - HOLD-UP "Colorado" - HandId: #19116069-675562-1701693506 - Holdem no limit (0.01€/0.02€) - 2023/12/04 12:38:26 UTC
Table: 'Colorado' 6-max (real money) Seat #6 is the button
Seat 1: kuma__22 (2.16€)
Seat 2: Perf-31 (2.43€)
Seat 3: Nordsud88 (1.57€)
Seat 4: _ilTulipano_ (3.22€)
Seat 5: EMBATAA (2€)
Seat 6: Fried Berg (2.65€)
*** ANTE/BLINDS ***
kuma__22 posts small blind 0.01€
Perf-31 posts big blind 0.02€
Dealt to Fried Berg [2c Js]
*** PRE-FLOP *** 
Nordsud88 folds
_ilTulipano_ folds
EMBATAA folds
Fried Berg folds
kuma__22 folds
Perf-31 collected 0.03€ from pot
*** SUMMARY ***
Total pot 0.03€ | No rake
Seat 2: Perf-31 (big blind) won 0.03€


Winamax Poker - HOLD-UP "Colorado" - HandId: #19116069-675565-1701693508 - Holdem no limit (0.01€/0.02€) - 2023/12/04 12:38:28 UTC
Table: 'Colorado' 6-max (real money) Seat #6 is the button
Seat 1: Ertorko (3.99€)
Seat 2: Fried Berg (2.65€)
Seat 3: Yvrin (1.95€)
Seat 4: kuma__22 (2.15€)
Seat 5: _ilTulipano_ (3.22€)
Seat 6: Nordsud88 (1.57€)
*** ANTE/BLINDS ***
Ertorko posts small blind 0.01€
Fried Berg posts big blind 0.02€
Dealt to Fried Berg [2s 3s]
*** PRE-FLOP *** 
Yvrin folds
kuma__22 raises 0.04€ to 0.06€
_ilTulipano_ folds
Nordsud88 folds
Ertorko folds
Fried Berg folds
kuma__22 collected 0.09€ from pot
*** SUMMARY ***
Total pot 0.09€ | No rake
Seat 4: kuma__22 won 0.09€


Winamax Poker - HOLD-UP "Colorado" - HandId: #19116069-675578-1701693518 - Holdem no limit (0.01€/0.02€) - 2023/12/04 12:38:38 UTC
Table: 'Colorado' 6-max (real money) Seat #6 is the button
Seat 1: gbtcorp (2.01€)
Seat 2: Machiavel- (2.21€)
Seat 3: fullawa (1.25€)
Seat 4: _ilTulipano_ (7.88€)
Seat 5: Perf-31 (2.43€)
Seat 6: Fried Berg (2.63€)
*** ANTE/BLINDS ***
gbtcorp posts small blind 0.01€
Machiavel- posts big blind 0.02€
Dealt to Fried Berg [6h 9d]
*** PRE-FLOP *** 
fullawa folds
_ilTulipano_ folds
Perf-31 folds
Fried Berg folds
gbtcorp folds
Machiavel- collected 0.03€ from pot
*** SUMMARY ***
Total pot 0.03€ | No rake
Seat 2: Machiavel- (big blind) won 0.03€


Winamax Poker - HOLD-UP "Colorado" - HandId: #19116069-675589-1701693526 - Holdem no limit (0.01€/0.02€) - 2023/12/04 12:38:46 UTC
Table: 'Colorado' 6-max (real money) Seat #6 is the button
Seat 1: AMBM2729 (1.24€)
Seat 2: Jesperord98 (3.59€)
Seat 3: Pablopenrais (2.07€)
Seat 4: boulde34 (2.69€)
Seat 5: EMBATAA (2.10€)
Seat 6: Fried Berg (2.63€)
*** ANTE/BLINDS ***
AMBM2729 posts small blind 0.01€
Jesperord98 posts big blind 0.02€
Dealt to Fried Berg [Jc 9h]
*** PRE-FLOP *** 
Pablopenrais folds
boulde34 raises 0.02€ to 0.04€
EMBATAA folds
Fried Berg calls 0.04€
AMBM2729 folds
Jesperord98 folds
*** FLOP *** [Qs Th 7d]
boulde34 bets 0.06€
Fried Berg calls 0.06€
*** TURN *** [Qs Th 7d][8c]
boulde34 bets 0.06€
Fried Berg calls 0.06€
*** RIVER *** [Qs Th 7d 8c][4h]
boulde34 bets 0.09€
Fried Berg calls 0.09€
*** SHOW DOWN ***
boulde34 shows [Ad Td] (One pair : Tens)
Fried Berg shows [Jc 9h] (Straight Queen high)
Fried Berg collected 0.48€ from pot
*** SUMMARY ***
Total pot 0.48€ | Rake 0.05€
Board: [Qs Th 7d 8c 4h]
Seat 4: boulde34 showed [Ad Td] and lost with One pair : Tens
Seat 6: Fried Berg (button) showed [Jc 9h] and won 0.48€ with Straight Queen high


Winamax Poker - HOLD-UP "Colorado" - HandId: #19116069-675633-1701693566 - Holdem no limit (0.01€/0.02€) - 2023/12/04 12:39:26 UTC
Table: 'Colorado' 6-max (real money) Seat #6 is the button
Seat 1: Fried Berg (2.86€)
Seat 2: Homer14510 (1.88€)
Seat 3: Durantula_6 (2.86€)
Seat 4: ElGringocoke (1.39€)
Seat 5: Nordsud88 (1.68€)
Seat 6: Pablopenrais (2.07€)
*** ANTE/BLINDS ***
Fried Berg posts small blind 0.01€
Homer14510 posts big blind 0.02€
Dealt to Fried Berg [2d 6h]
*** PRE-FLOP *** 
Durantula_6 folds
ElGringocoke folds
Nordsud88 folds
Pablopenrais folds
Fried Berg folds
Homer14510 collected 0.03€ from pot
*** SUMMARY ***
Total pot 0.03€ | No rake
Seat 2: Homer14510 (big blind) won 0.03€


Winamax Poker - HOLD-UP "Colorado" - HandId: #19116069-675642-1701693574 - Holdem no limit (0.01€/0.02€) - 2023/12/04 12:39:34 UTC
Table: 'Colorado' 6-max (real money) Seat #6 is the button
Seat 1: EMBATAA (2.55€)
Seat 2: antoclem2A (2.47€)
Seat 3: CKrello (2.04€)
Seat 4: Jeje27 (1.42€)
Seat 5: PwedzaM (3.09€)
Seat 6: Fried Berg (2.85€)
Hold-up to Pot: total 0.20€
*** ANTE/BLINDS ***
EMBATAA posts small blind 0.01€
antoclem2A posts big blind 0.02€
Dealt to Fried Berg [7s 4h]
*** PRE-FLOP *** 
CKrello folds
Jeje27 calls 0.02€
PwedzaM folds
Fried Berg folds
EMBATAA raises 0.26€ to 0.28€
antoclem2A calls 0.26€
Jeje27 folds
*** FLOP *** [4s Ks Tc]
EMBATAA bets 0.20€
antoclem2A raises 0.70€ to 0.90€
EMBATAA folds
antoclem2A collected 1.78€ from pot
*** SUMMARY ***
Total pot 1.78€ | Rake 0.10€
Board: [4s Ks Tc]
Seat 2: antoclem2A (big blind) won 1.78€


Winamax Poker - HOLD-UP "Colorado" - HandId: #19116069-675659-1701693590 - Holdem no limit (0.01€/0.02€) - 2023/12/04 12:39:50 UTC
Table: 'Colorado' 6-max (real money) Seat #6 is the button
Seat 1: AceOf_Spades (2.05€)
Seat 2: BMWTPM (2.48€)
Seat 3: Fried Berg (2.85€)
Seat 4: Homer14510 (1.89€)
Seat 5: Samuelillo07 (2.08€)
Seat 6: fullawa (1.56€)
*** ANTE/BLINDS ***
AceOf_Spades posts small blind 0.01€
BMWTPM posts big blind 0.02€
Dealt to Fried Berg [Qd 3h]
*** PRE-FLOP *** 
Fried Berg folds
Homer14510 folds
Samuelillo07 raises 0.03€ to 0.05€
fullawa folds
AceOf_Spades folds
BMWTPM folds
Samuelillo07 collected 0.08€ from pot
*** SUMMARY ***
Total pot 0.08€ | No rake
Seat 5: Samuelillo07 won 0.08€


Winamax Poker - HOLD-UP "Colorado" - HandId: #19116069-675662-1701693592 - Holdem no limit (0.01€/0.02€) - 2023/12/04 12:39:52 UTC
Table: 'Colorado' 6-max (real money) Seat #6 is the button
Seat 1: Fried Berg (2.85€)
Seat 2: AMBM2729 (1.20€)
Seat 3: Raklur (1.43€)
Seat 4: Machiavel- (2.25€)
Seat 5: JFSredbaron (2€)
Seat 6: Jorj-X-McKie (2.13€)
*** ANTE/BLINDS ***
Fried Berg posts small blind 0.01€
AMBM2729 posts big blind 0.02€
Dealt to Fried Berg [5h 3s]
*** PRE-FLOP *** 
Raklur folds
Machiavel- folds
JFSredbaron folds
Jorj-X-McKie folds
Fried Berg folds
AMBM2729 collected 0.03€ from pot
*** SUMMARY ***
Total pot 0.03€ | No rake
Seat 2: AMBM2729 (big blind) won 0.03€


Winamax Poker - HOLD-UP "Colorado" - HandId: #19116069-675677-1701693604 - Holdem no limit (0.01€/0.02€) - 2023/12/04 12:40:04 UTC
Table: 'Colorado' 6-max (real money) Seat #6 is the button
Seat 1: gueyf (2.01€)
Seat 2: JFSredbaron (2€)
Seat 3: AceOf_Spades (2.04€)
Seat 4: Fried Berg (2.84€)
Seat 5: CKrello (2€)
Seat 6: SharkAKK (2.07€)
*** ANTE/BLINDS ***
gueyf posts small blind 0.01€
JFSredbaron posts big blind 0.02€
Dealt to Fried Berg [4c Ts]
*** PRE-FLOP *** 
AceOf_Spades folds
Fried Berg folds
CKrello folds
SharkAKK raises 0.04€ to 0.06€
gueyf folds
JFSredbaron folds
SharkAKK collected 0.09€ from pot
*** SUMMARY ***
Total pot 0.09€ | No rake
Seat 6: SharkAKK (button) won 0.09€


Winamax Poker - HOLD-UP "Colorado" - HandId: #19116069-675696-1701693618 - Holdem no limit (0.01€/0.02€) - 2023/12/04 12:40:18 UTC
Table: 'Colorado' 6-max (real money) Seat #6 is the button
Seat 1: Killim (0.90€)
Seat 2: Fried Berg (2.84€)
Seat 3: Samuelillo07 (2.66€)
Seat 4: antoclem2A (3.07€)
Seat 5: stevebalboni (2.63€)
Seat 6: balou10180 (2.78€)
Hold-up to Pot: total 0.10€
*** ANTE/BLINDS ***
Killim posts small blind 0.01€
Fried Berg posts big blind 0.02€
Dealt to Fried Berg [9d 5c]
*** PRE-FLOP *** 
Samuelillo07 folds
antoclem2A raises 0.03€ to 0.05€
stevebalboni calls 0.05€
balou10180 folds
Killim folds
Fried Berg folds
*** FLOP *** [2c 8s As]
antoclem2A checks
stevebalboni checks
*** TURN *** [2c 8s As][Qh]
antoclem2A bets 0.15€
stevebalboni folds
antoclem2A collected 0.37€ from pot
*** SUMMARY ***
Total pot 0.37€ | Rake 0.01€
Board: [2c 8s As Qh]
Seat 4: antoclem2A won 0.37€


Winamax Poker - HOLD-UP "Colorado" - HandId: #19116069-675706-1701693624 - Holdem no limit (0.01€/0.02€) - 2023/12/04 12:40:24 UTC
Table: 'Colorado' 6-max (real money) Seat #6 is the button
Seat 1: CKrello (2.02€)
Seat 2: jamesbean1 (3.82€)
Seat 3: Enzlola (1.48€)
Seat 4: Gros_poisson (2€)
Seat 5: Fried Berg (2.82€)
Seat 6: nico033 (4.38€)
*** ANTE/BLINDS ***
CKrello posts small blind 0.01€
jamesbean1 posts big blind 0.02€
Dealt to Fried Berg [6d 8d]
*** PRE-FLOP *** 
Enzlola raises 1.46€ to 1.48€ and is all-in
Gros_poisson folds
Fried Berg folds
nico033 folds
CKrello folds
jamesbean1 folds
Enzlola collected 1.51€ from pot
*** SUMMARY ***
Total pot 1.51€ | No rake
Seat 3: Enzlola won 1.51€


Winamax Poker - HOLD-UP "Colorado" - HandId: #19116069-675713-1701693629 - Holdem no limit (0.01€/0.02€) - 2023/12/04 12:40:29 UTC
Table: 'Colorado' 6-max (real money) Seat #6 is the button
Seat 1: Lydopen (2€)
Seat 2: AMBM2729 (1.22€)
Seat 3: Fried Berg (2.82€)
Seat 4: UnluckyEny (2.09€)
Seat 5: Hagreed (3.61€)
Seat 6: EMBATAA (2.15€)
*** ANTE/BLINDS ***
Lydopen posts small blind 0.01€
AMBM2729 posts big blind 0.02€
Dealt to Fried Berg [2s 4h]
*** PRE-FLOP *** 
Fried Berg folds
UnluckyEny folds
Hagreed folds
EMBATAA raises 0.03€ to 0.05€
Lydopen folds
AMBM2729 raises 0.10€ to 0.15€
EMBATAA folds
AMBM2729 collected 0.21€ from pot
*** SUMMARY ***
Total pot 0.21€ | No rake
Seat 2: AMBM2729 (big blind) won 0.21€


Winamax Poker - HOLD-UP "Colorado" - HandId: #19116069-675716-1701693631 - Holdem no limit (0.01€/0.02€) - 2023/12/04 12:40:31 UTC
Table: 'Colorado' 6-max (real money) Seat #6 is the button
Seat 1: Fried Berg (2.82€)
Seat 2: Hagreed (3.61€)
Seat 3: stevebalboni (2.58€)
Seat 4: gueyf (2€)
Seat 5: fullawa (1.57€)
Seat 6: Lydopen (2€)
*** ANTE/BLINDS ***
Fried Berg posts small blind 0.01€
Hagreed posts big blind 0.02€
Dealt to Fried Berg [Kc 9c]
*** PRE-FLOP *** 
stevebalboni folds
gueyf folds
fullawa raises 0.05€ to 0.07€
Lydopen folds
Fried Berg calls 0.06€
Hagreed folds
*** FLOP *** [Qc As 2d]
Fried Berg checks
fullawa bets 0.16€
Fried Berg folds
fullawa collected 0.30€ from pot
*** SUMMARY ***
Total pot 0.30€ | Rake 0.02€
Board: [Qc As 2d]
Seat 5: fullawa won 0.30€


Winamax Poker - HOLD-UP "Colorado" - HandId: #19116069-675745-1701693651 - Holdem no limit (0.01€/0.02€) - 2023/12/04 12:40:51 UTC
Table: 'Colorado' 6-max (real money) Seat #6 is the button
Seat 1: SharkAKK (2.13€)
Seat 2: Fried Berg (2.75€)
Seat 3: metamex (1.97€)
Seat 4: Raklur (1.26€)
Seat 5: GTO-Mieko (2€)
Seat 6: gueyf (2€)
*** ANTE/BLINDS ***
SharkAKK posts small blind 0.01€
Fried Berg posts big blind 0.02€
Dealt to Fried Berg [Tc 4s]
*** PRE-FLOP *** 
metamex folds
Raklur calls 0.02€
GTO-Mieko folds
gueyf folds
SharkAKK folds
Fried Berg checks
*** FLOP *** [6d 6c 7s]
Fried Berg checks
Raklur checks
*** TURN *** [6d 6c 7s][7d]
Fried Berg checks
Raklur checks
*** RIVER *** [6d 6c 7s 7d][8s]
Fried Berg checks
Raklur checks
*** SHOW DOWN ***
Fried Berg shows [Tc 4s] (Two pairs : 7 and 6)
Raklur shows [Ts Jc] (Two pairs : 7 and 6)
Raklur collected 0.04€ from pot
*** SUMMARY ***
Total pot 0.04€ | Rake 0.01€
Board: [6d 6c 7s 7d 8s]
Seat 2: Fried Berg (big blind) showed [Tc 4s] and lost with Two pairs : 7 and 6
Seat 4: Raklur showed [Ts Jc] and won 0.04€ with Two pairs : 7 and 6


Winamax Poker - HOLD-UP "Colorado" - HandId: #19116069-675930-1701693779 - Holdem no limit (0.01€/0.02€) - 2023/12/04 12:42:59 UTC
Table: 'Colorado' 6-max (real money) Seat #6 is the button
Seat 1: EMBATAA (2.11€)
Seat 2: Nordsud88 (1.52€)
Seat 3: Homer14510 (1.88€)
Seat 4: Fried Berg (2.73€)
Seat 5: UnluckyEny (2.15€)
Seat 6: Samuelillo07 (2.06€)
*** ANTE/BLINDS ***
EMBATAA posts small blind 0.01€
Nordsud88 posts big blind 0.02€
Dealt to Fried Berg [5c 3d]
*** PRE-FLOP *** 
Homer14510 folds
Fried Berg folds
UnluckyEny folds
Samuelillo07 raises 0.03€ to 0.05€
EMBATAA folds
Nordsud88 folds
Samuelillo07 collected 0.08€ from pot
*** SUMMARY ***
Total pot 0.08€ | No rake
Seat 6: Samuelillo07 (button) won 0.08€


Winamax Poker - HOLD-UP "Colorado" - HandId: #19116069-675933-1701693781 - Holdem no limit (0.01€/0.02€) - 2023/12/04 12:43:01 UTC
Table: 'Colorado' 6-max (real money) Seat #6 is the button
Seat 1: maline666 (1.01€)
Seat 2: Celest&Cirus (0.69€)
Seat 3: GTO-Mieko (2€)
Seat 4: UnluckyEny (2.15€)
Seat 5: Fried Berg (2.73€)
Seat 6: toka30 (2.46€)
*** ANTE/BLINDS ***
maline666 posts small blind 0.01€
Celest&Cirus posts big blind 0.02€
Dealt to Fried Berg [As 9c]
*** PRE-FLOP *** 
GTO-Mieko raises 0.04€ to 0.06€
UnluckyEny folds
Fried Berg calls 0.06€
toka30 folds
maline666 calls 0.05€
Celest&Cirus folds
*** FLOP *** [Kh Jc Th]
maline666 checks
GTO-Mieko bets 0.07€
Fried Berg calls 0.07€
maline666 folds
*** TURN *** [Kh Jc Th][4s]
GTO-Mieko bets 0.12€
Fried Berg calls 0.12€
*** RIVER *** [Kh Jc Th 4s][4c]
GTO-Mieko checks
Fried Berg checks
*** SHOW DOWN ***
Fried Berg shows [As 9c] (One pair : 4)
GTO-Mieko shows [Qs Qd] (Two pairs : Queens and 4)
GTO-Mieko collected 0.52€ from pot
*** SUMMARY ***
Total pot 0.52€ | Rake 0.06€
Board: [Kh Jc Th 4s 4c]
Seat 3: GTO-Mieko showed [Qs Qd] and won 0.52€ with Two pairs : Queens and 4
Seat 5: Fried Berg showed [As 9c] and lost with One pair : 4


Winamax Poker - HOLD-UP "Colorado" - HandId: #19116069-675994-1701693820 - Holdem no limit (0.01€/0.02€) - 2023/12/04 12:43:40 UTC
Table: 'Colorado' 6-max (real money) Seat #6 is the button
Seat 1: Gianni56 (2.04€)
Seat 2: EMBATAA (2.02€)
Seat 3: Gros_poisson (2.03€)
Seat 4: CKrello (2€)
Seat 5: GTO-Mieko (2.27€)
Seat 6: Fried Berg (2.48€)
*** ANTE/BLINDS ***
Gianni56 posts small blind 0.01€
EMBATAA posts big blind 0.02€
Dealt to Fried Berg [4d Ts]
*** PRE-FLOP *** 
Gros_poisson folds
CKrello folds
GTO-Mieko folds
Fried Berg folds
Gianni56 folds
EMBATAA collected 0.03€ from pot
*** SUMMARY ***
Total pot 0.03€ | No rake
Seat 2: EMBATAA (big blind) won 0.03€


Winamax Poker - HOLD-UP "Colorado" - HandId: #19116069-676003-1701693824 - Holdem no limit (0.01€/0.02€) - 2023/12/04 12:43:44 UTC
Table: 'Colorado' 6-max (real money) Seat #6 is the button
Seat 1: Jorj-X-McKie (5.07€)
Seat 2: LaTilteuse (2€)
Seat 3: Hagreed (2.82€)
Seat 4: Ertorko (3.17€)
Seat 5: Fried Berg (2.48€)
Seat 6: GTO-Mieko (2.27€)
*** ANTE/BLINDS ***
Jorj-X-McKie posts small blind 0.01€
LaTilteuse posts big blind 0.02€
Dealt to Fried Berg [2d 4d]
*** PRE-FLOP *** 
Hagreed folds
Ertorko raises 0.03€ to 0.05€
Fried Berg folds
GTO-Mieko raises 0.11€ to 0.16€
Jorj-X-McKie folds
LaTilteuse folds
Ertorko calls 0.11€
*** FLOP *** [7d Qh 7s]
Ertorko checks
GTO-Mieko checks
*** TURN *** [7d Qh 7s][9s]
Ertorko bets 0.20€
GTO-Mieko folds
Ertorko collected 0.51€ from pot
*** SUMMARY ***
Total pot 0.51€ | Rake 0.04€
Board: [7d Qh 7s 9s]
Seat 4: Ertorko won 0.51€


Winamax Poker - HOLD-UP "Colorado" - HandId: #19116069-676006-1701693826 - Holdem no limit (0.01€/0.02€) - 2023/12/04 12:43:46 UTC
Table: 'Colorado' 6-max (real money) Seat #6 is the button
Seat 1: nico033 (4.55€)
Seat 2: BMWTPM (2.40€)
Seat 3: Fried Berg (2.48€)
Seat 4: Jorj-X-McKie (5.06€)
Seat 5: Noe_k17 (1.90€)
Seat 6: Zanghief068 (2.68€)
*** ANTE/BLINDS ***
nico033 posts small blind 0.01€
BMWTPM posts big blind 0.02€
Dealt to Fried Berg [6d Qh]
*** PRE-FLOP *** 
Fried Berg folds
Jorj-X-McKie folds
Noe_k17 folds
Zanghief068 folds
nico033 calls 0.01€
BMWTPM checks
*** FLOP *** [6s 4c 4s]
nico033 checks
BMWTPM checks
*** TURN *** [6s 4c 4s][Td]
nico033 bets 0.03€
BMWTPM folds
nico033 collected 0.07€ from pot
*** SUMMARY ***
Total pot 0.07€ | No rake
Board: [6s 4c 4s Td]
Seat 1: nico033 (small blind) won 0.07€


Winamax Poker - HOLD-UP "Colorado" - HandId: #19116069-676009-1701693828 - Holdem no limit (0.01€/0.02€) - 2023/12/04 12:43:48 UTC
Table: 'Colorado' 6-max (real money) Seat #6 is the button
Seat 1: Jorj-X-McKie (5.06€)
Seat 2: EMBATAA (2.05€)
Seat 3: Fried Berg (2.48€)
Seat 4: MaryAthena (0.78€)
Seat 5: Gros_poisson (2.03€)
Seat 6: DosdeBras (1.59€)
*** ANTE/BLINDS ***
Jorj-X-McKie posts small blind 0.01€
EMBATAA posts big blind 0.02€
Dealt to Fried Berg [Jh Ad]
*** PRE-FLOP *** 
Fried Berg raises 0.02€ to 0.04€
MaryAthena folds
Gros_poisson folds
DosdeBras folds
Jorj-X-McKie folds
EMBATAA folds
Fried Berg collected 0.07€ from pot
*** SUMMARY ***
Total pot 0.07€ | No rake
Seat 3: Fried Berg won 0.07€


Winamax Poker - HOLD-UP "Colorado" - HandId: #19116069-676059-1701693859 - Holdem no limit (0.01€/0.02€) - 2023/12/04 12:44:19 UTC
Table: 'Colorado' 6-max (real money) Seat #6 is the button
Seat 1: Morri7Jack (0.94€)
Seat 2: Fried Berg (2.51€)
Seat 3: LaTilteuse (2€)
Seat 4: Trader2020 (3.42€)
Seat 5: stevebalboni (3.82€)
Seat 6: toka30 (2.28€)
*** ANTE/BLINDS ***
Morri7Jack posts small blind 0.01€
Fried Berg posts big blind 0.02€
Dealt to Fried Berg [2s Ts]
*** PRE-FLOP *** 
LaTilteuse folds
Trader2020 raises 0.04€ to 0.06€
stevebalboni folds
toka30 raises 2.22€ to 2.28€ and is all-in
Morri7Jack folds
Fried Berg folds
Trader2020 folds
toka30 collected 2.37€ from pot
*** SUMMARY ***
Total pot 2.37€ | No rake
Seat 6: toka30 (button) won 2.37€


Winamax Poker - HOLD-UP "Colorado" - HandId: #19116069-676092-1701693879 - Holdem no limit (0.01€/0.02€) - 2023/12/04 12:44:39 UTC
Table: 'Colorado' 6-max (real money) Seat #6 is the button
Seat 1: Fried Berg (2.49€)
Seat 2: Gros_poisson (2.02€)
Seat 3: AceOf_Spades (2.02€)
Seat 4: LaTilteuse (2.02€)
Seat 5: Pablopenrais (1.16€)
Seat 6: JFSredbaron (2€)
*** ANTE/BLINDS ***
Fried Berg posts small blind 0.01€
Gros_poisson posts big blind 0.02€
Dealt to Fried Berg [3s 9s]
*** PRE-FLOP *** 
AceOf_Spades folds
LaTilteuse folds
Pablopenrais folds
JFSredbaron raises 0.04€ to 0.06€
Fried Berg folds
Gros_poisson folds
JFSredbaron collected 0.09€ from pot
*** SUMMARY ***
Total pot 0.09€ | No rake
Seat 6: JFSredbaron (button) won 0.09€


Winamax Poker - HOLD-UP "Colorado" - HandId: #19116069-676113-1701693894 - Holdem no limit (0.01€/0.02€) - 2023/12/04 12:44:54 UTC
Table: 'Colorado' 6-max (real money) Seat #6 is the button
Seat 1: Gros_poisson (2.01€)
Seat 2: Jorj-X-McKie (2.12€)
Seat 3: Fried Berg (2.48€)
Seat 4: Gianni56 (1.94€)
Seat 5: EMBATAA (2.11€)
Seat 6: Jimmy91lenny (2.36€)
*** ANTE/BLINDS ***
Gros_poisson posts small blind 0.01€
Jorj-X-McKie posts big blind 0.02€
Dealt to Fried Berg [7h Js]
*** PRE-FLOP *** 
Fried Berg folds
Gianni56 folds
EMBATAA raises 0.03€ to 0.05€
Jimmy91lenny folds
Gros_poisson folds
Jorj-X-McKie folds
EMBATAA collected 0.08€ from pot
*** SUMMARY ***
Total pot 0.08€ | No rake
Seat 5: EMBATAA won 0.08€


Winamax Poker - HOLD-UP "Colorado" - HandId: #19116069-676123-1701693902 - Holdem no limit (0.01€/0.02€) - 2023/12/04 12:45:02 UTC
Table: 'Colorado' 6-max (real money) Seat #6 is the button
Seat 1: A1pha_B1oCkk (0.39€)
Seat 2: Yvrin (1.70€)
Seat 3: AMBM2729 (1.33€)
Seat 4: Samuelillo07 (2.53€)
Seat 5: Fried Berg (2.48€)
Seat 6: PwedzaM (3.19€)
*** ANTE/BLINDS ***
A1pha_B1oCkk posts small blind 0.01€
Yvrin posts big blind 0.02€
Dealt to Fried Berg [5d 3h]
*** PRE-FLOP *** 
AMBM2729 raises 0.03€ to 0.05€
Samuelillo07 folds
Fried Berg folds
PwedzaM raises 0.13€ to 0.18€
A1pha_B1oCkk folds
Yvrin folds
AMBM2729 folds
PwedzaM collected 0.26€ from pot
*** SUMMARY ***
Total pot 0.26€ | No rake
Seat 6: PwedzaM (button) won 0.26€


Winamax Poker - HOLD-UP "Colorado" - HandId: #19116069-676126-1701693904 - Holdem no limit (0.01€/0.02€) - 2023/12/04 12:45:04 UTC
Table: 'Colorado' 6-max (real money) Seat #6 is the button
Seat 1: Fried Berg (2.48€)
Seat 2: Ertorko (3.14€)
Seat 3: Jeje27 (1.30€)
Seat 4: MCGHansen (2€)
Seat 5: A1pha_B1oCkk (0.38€)
Seat 6: ischia (0.41€)
*** ANTE/BLINDS ***
Fried Berg posts small blind 0.01€
Ertorko posts big blind 0.02€
Dealt to Fried Berg [Ac 2c]
*** PRE-FLOP *** 
Jeje27 folds
MCGHansen folds
A1pha_B1oCkk folds
ischia folds
Fried Berg calls 0.01€
Ertorko checks
*** FLOP *** [8c 8d Td]
Fried Berg checks
Ertorko checks
*** TURN *** [8c 8d Td][9d]
Fried Berg checks
Ertorko bets 0.02€
Fried Berg folds
Ertorko collected 0.06€ from pot
*** SUMMARY ***
Total pot 0.06€ | No rake
Board: [8c 8d Td 9d]
Seat 2: Ertorko (big blind) won 0.06€


Winamax Poker - HOLD-UP "Colorado" - HandId: #19116069-676168-1701693935 - Holdem no limit (0.01€/0.02€) - 2023/12/04 12:45:35 UTC
Table: 'Colorado' 6-max (real money) Seat #6 is the button
Seat 1: Jojo-andros5 (0.91€)
Seat 2: Fried Berg (2.46€)
Seat 3: Hagreed (2.93€)
Seat 4: Annemarie66 (0.84€)
Seat 5: gueyf (2.17€)
Seat 6: LaTilteuse (2€)
*** ANTE/BLINDS ***
Jojo-andros5 posts small blind 0.01€
Fried Berg posts big blind 0.02€
Dealt to Fried Berg [4h 5h]
*** PRE-FLOP *** 
Hagreed folds
Annemarie66 folds
gueyf folds
LaTilteuse folds
Jojo-andros5 folds
Fried Berg collected 0.03€ from pot
*** SUMMARY ***
Total pot 0.03€ | No rake
Seat 2: Fried Berg (big blind) won 0.03€


Winamax Poker - HOLD-UP "Colorado" - HandId: #19116069-676186-1701693946 - Holdem no limit (0.01€/0.02€) - 2023/12/04 12:45:46 UTC
Table: 'Colorado' 6-max (real money) Seat #6 is the button
Seat 1: UnluckyEny (2.57€)
Seat 2: Ertorko (2.36€)
Seat 3: BMWTPM (2.18€)
Seat 4: Fried Berg (2.47€)
Seat 5: galettedesKK (2€)
Seat 6: hello7585 (0.95€)
*** ANTE/BLINDS ***
UnluckyEny posts small blind 0.01€
Ertorko posts big blind 0.02€
Dealt to Fried Berg [Ts 4s]
*** PRE-FLOP *** 
BMWTPM folds
Fried Berg folds
galettedesKK folds
hello7585 raises 0.04€ to 0.06€
UnluckyEny folds
Ertorko calls 0.04€
*** FLOP *** [7s 7c 5s]
Ertorko checks
hello7585 bets 0.13€
Ertorko calls 0.13€
*** TURN *** [7s 7c 5s][8s]
Ertorko checks
hello7585 checks
*** RIVER *** [7s 7c 5s 8s][Qs]
Ertorko checks
hello7585 checks
*** SHOW DOWN ***
Ertorko shows [Ad Qh] (Two pairs : Queens and 7)
hello7585 shows [2d 2s] (Flush Queen high)
hello7585 collected 0.35€ from pot
*** SUMMARY ***
Total pot 0.35€ | Rake 0.04€
Board: [7s 7c 5s 8s Qs]
Seat 2: Ertorko (big blind) showed [Ad Qh] and lost with Two pairs : Queens and 7
Seat 6: hello7585 (button) showed [2d 2s] and won 0.35€ with Flush Queen high


Winamax Poker - HOLD-UP "Colorado" - HandId: #19116069-676212-1701693967 - Holdem no limit (0.01€/0.02€) - 2023/12/04 12:46:07 UTC
Table: 'Colorado' 6-max (real money) Seat #6 is the button
Seat 1: SharkAKK (2.04€)
Seat 2: Gros_poisson (2.09€)
Seat 3: Fried Berg (2.47€)
Seat 4: Homer14510 (1.87€)
Seat 5: ischia (0.37€)
Seat 6: Pablopenrais (2.20€)
*** ANTE/BLINDS ***
SharkAKK posts small blind 0.01€
Gros_poisson posts big blind 0.02€
Dealt to Fried Berg [8c Th]
*** PRE-FLOP *** 
Fried Berg folds
Homer14510 raises 0.05€ to 0.07€
ischia folds
Pablopenrais folds
SharkAKK folds
Gros_poisson folds
Homer14510 collected 0.10€ from pot
*** SUMMARY ***
Total pot 0.10€ | No rake
Seat 4: Homer14510 won 0.10€


Winamax Poker - HOLD-UP "Colorado" - HandId: #19116069-676216-1701693970 - Holdem no limit (0.01€/0.02€) - 2023/12/04 12:46:10 UTC
Table: 'Colorado' 6-max (real money) Seat #6 is the button
Seat 1: GTO-Mieko (2€)
Seat 2: Trader2020 (3.29€)
Seat 3: fullawa (1.18€)
Seat 4: Fried Berg (2.47€)
Seat 5: Jesperord98 (4.31€)
Seat 6: BMWTPM (2.62€)
*** ANTE/BLINDS ***
GTO-Mieko posts small blind 0.01€
Trader2020 posts big blind 0.02€
Dealt to Fried Berg [Ad 9d]
*** PRE-FLOP *** 
fullawa folds
Fried Berg raises 0.02€ to 0.04€
Jesperord98 folds
BMWTPM folds
GTO-Mieko folds
Trader2020 folds
Fried Berg collected 0.07€ from pot
*** SUMMARY ***
Total pot 0.07€ | No rake
Seat 4: Fried Berg won 0.07€


Winamax Poker - HOLD-UP "Colorado" - HandId: #19116069-676252-1701693995 - Holdem no limit (0.01€/0.02€) - 2023/12/04 12:46:35 UTC
Table: 'Colorado' 6-max (real money) Seat #6 is the button
Seat 1: Killim (1.70€)
Seat 2: Yvrin (1.67€)
Seat 3: gueyf (1.86€)
Seat 4: Jesperord98 (4.31€)
Seat 5: Fried Berg (2.50€)
Seat 6: LaTilteuse (2.42€)
*** ANTE/BLINDS ***
Killim posts small blind 0.01€
Yvrin posts big blind 0.02€
Dealt to Fried Berg [4d Jd]
*** PRE-FLOP *** 
gueyf folds
Jesperord98 folds
Fried Berg raises 0.02€ to 0.04€
LaTilteuse folds
Killim folds
Yvrin folds
Fried Berg collected 0.07€ from pot
*** SUMMARY ***
Total pot 0.07€ | No rake
Seat 5: Fried Berg won 0.07€


Winamax Poker - HOLD-UP "Colorado" - HandId: #19116069-676318-1701694036 - Holdem no limit (0.01€/0.02€) - 2023/12/04 12:47:16 UTC
Table: 'Colorado' 6-max (real money) Seat #6 is the button
Seat 1: paupaumgn5 (1.95€)
Seat 2: Jesperord98 (2€)
Seat 3: Samuelillo07 (2.33€)
Seat 4: Fried Berg (2.53€)
Seat 5: Pablopenrais (2.57€)
Seat 6: DONpere (1.61€)
*** ANTE/BLINDS ***
paupaumgn5 posts small blind 0.01€
Jesperord98 posts big blind 0.02€
Dealt to Fried Berg [5c 3s]
*** PRE-FLOP *** 
Samuelillo07 folds
Fried Berg folds
Pablopenrais folds
DONpere folds
paupaumgn5 folds
Jesperord98 collected 0.03€ from pot
*** SUMMARY ***
Total pot 0.03€ | No rake
Seat 2: Jesperord98 (big blind) won 0.03€


Winamax Poker - HOLD-UP "Colorado" - HandId: #19116069-676337-1701694050 - Holdem no limit (0.01€/0.02€) - 2023/12/04 12:47:30 UTC
Table: 'Colorado' 6-max (real money) Seat #6 is the button
Seat 1: Jorj-X-McKie (4.87€)
Seat 2: Fried Berg (2.53€)
Seat 3: ischia (0.63€)
Seat 4: Jeje27 (1.33€)
Seat 5: CKrello (2.11€)
Seat 6: SergioAK (1.81€)
*** ANTE/BLINDS ***
Jorj-X-McKie posts small blind 0.01€
Fried Berg posts big blind 0.02€
Dealt to Fried Berg [Tc 2h]
*** PRE-FLOP *** 
ischia folds
Jeje27 folds
CKrello folds
SergioAK folds
Jorj-X-McKie folds
Fried Berg collected 0.03€ from pot
*** SUMMARY ***
Total pot 0.03€ | No rake
Seat 2: Fried Berg (big blind) won 0.03€


Winamax Poker - HOLD-UP "Colorado" - HandId: #19116069-676369-1701694073 - Holdem no limit (0.01€/0.02€) - 2023/12/04 12:47:53 UTC
Table: 'Colorado' 6-max (real money) Seat #6 is the button
Seat 1: Pablopenrais (2.53€)
Seat 2: packymaitre (1.54€)
Seat 3: LaTilteuse (2.39€)
Seat 4: Fried Berg (2.54€)
Seat 5: hello7585 (2.29€)
Seat 6: toka30 (3.23€)
Hold-up to Pot: total 0.20€
*** ANTE/BLINDS ***
Pablopenrais posts small blind 0.01€
packymaitre posts big blind 0.02€
Dealt to Fried Berg [Jd 8d]
*** PRE-FLOP *** 
LaTilteuse folds
Fried Berg raises 0.02€ to 0.04€
hello7585 folds
toka30 raises 0.08€ to 0.12€
Pablopenrais calls 0.11€
packymaitre calls 0.10€
Fried Berg calls 0.08€
*** FLOP *** [Jh 2h 7d]
Pablopenrais checks
packymaitre bets 0.68€
Fried Berg calls 0.68€
toka30 folds
Pablopenrais folds
*** TURN *** [Jh 2h 7d][8s]
packymaitre bets 0.74€ and is all-in
Fried Berg calls 0.74€
*** RIVER *** [Jh 2h 7d 8s][9h]
*** SHOW DOWN ***
packymaitre shows [8c Js] (Two pairs : Jacks and 8)
Fried Berg shows [Jd 8d] (Two pairs : Jacks and 8)
Fried Berg collected 1.60€ from pot
packymaitre collected 1.59€ from pot
*** SUMMARY ***
Total pot 3.19€ | Rake 0.33€
Board: [Jh 2h 7d 8s 9h]
Seat 2: packymaitre (big blind) showed [8c Js] and won 1.59€ with Two pairs : Jacks and 8
Seat 4: Fried Berg showed [Jd 8d] and won 1.60€ with Two pairs : Jacks and 8


Winamax Poker - HOLD-UP "Colorado" - HandId: #19116069-676488-1701694155 - Holdem no limit (0.01€/0.02€) - 2023/12/04 12:49:15 UTC
Table: 'Colorado' 6-max (real money) Seat #6 is the button
Seat 1: Fried Berg (2.60€)
Seat 2: LaPerfectvie (3.97€)
Seat 3: BMWTPM (2.10€)
Seat 4: Samuelillo07 (2.04€)
Seat 5: Gros_poisson (2.07€)
Seat 6: Ertorko (2.15€)
*** ANTE/BLINDS ***
Fried Berg posts small blind 0.01€
LaPerfectvie posts big blind 0.02€
Dealt to Fried Berg [6c 5d]
*** PRE-FLOP *** 
BMWTPM folds
Samuelillo07 raises 0.03€ to 0.05€
Gros_poisson folds
Ertorko calls 0.05€
Fried Berg folds
LaPerfectvie folds
*** FLOP *** [7c 8h 5s]
Samuelillo07 checks
Ertorko bets 0.08€
Samuelillo07 folds
Ertorko collected 0.20€ from pot
*** SUMMARY ***
Total pot 0.20€ | Rake 0.01€
Board: [7c 8h 5s]
Seat 6: Ertorko (button) won 0.20€


Winamax Poker - HOLD-UP "Colorado" - HandId: #19116069-676503-1701694164 - Holdem no limit (0.01€/0.02€) - 2023/12/04 12:49:24 UTC
Table: 'Colorado' 6-max (real money) Seat #6 is the button
Seat 1: stevebalboni (3.39€)
Seat 2: metamex (1.11€)
Seat 3: Hagreed (4.51€)
Seat 4: Gros_poisson (2.07€)
Seat 5: Fried Berg (2.59€)
Seat 6: TIRAMELas (2.42€)
*** ANTE/BLINDS ***
stevebalboni posts small blind 0.01€
metamex posts big blind 0.02€
Dealt to Fried Berg [7h Jc]
*** PRE-FLOP *** 
Hagreed folds
Gros_poisson folds
Fried Berg folds
TIRAMELas raises 0.04€ to 0.06€
stevebalboni folds
metamex calls 0.04€
*** FLOP *** [Ks Ah 5c]
metamex checks
TIRAMELas checks
*** TURN *** [Ks Ah 5c][Jh]
metamex checks
TIRAMELas checks
*** RIVER *** [Ks Ah 5c Jh][Ad]
metamex bets 0.07€
TIRAMELas folds
metamex collected 0.19€ from pot
*** SUMMARY ***
Total pot 0.19€ | Rake 0.01€
Board: [Ks Ah 5c Jh Ad]
Seat 2: metamex (big blind) won 0.19€


Winamax Poker - HOLD-UP "Colorado" - HandId: #19116069-676505-1701694166 - Holdem no limit (0.01€/0.02€) - 2023/12/04 12:49:26 UTC
Table: 'Colorado' 6-max (real money) Seat #6 is the button
Seat 1: Gros_poisson (2.07€)
Seat 2: stevebalboni (3.38€)
Seat 3: Fried Berg (2.59€)
Seat 4: iban72 (1.03€)
Seat 5: Gsxr20thanni (1.90€)
Seat 6: Morri7Jack (1.65€)
*** ANTE/BLINDS ***
Gros_poisson posts small blind 0.01€
stevebalboni posts big blind 0.02€
Dealt to Fried Berg [6s 2s]
*** PRE-FLOP *** 
Fried Berg folds
iban72 raises 0.02€ to 0.04€
Gsxr20thanni folds
Morri7Jack folds
Gros_poisson folds
stevebalboni calls 0.02€
*** FLOP *** [Kd 5c 9d]
stevebalboni checks
iban72 checks
*** TURN *** [Kd 5c 9d][Jd]
stevebalboni checks
iban72 bets 0.09€
stevebalboni folds
iban72 collected 0.17€ from pot
*** SUMMARY ***
Total pot 0.17€ | Rake 0.01€
Board: [Kd 5c 9d Jd]
Seat 4: iban72 won 0.17€


Winamax Poker - HOLD-UP "Colorado" - HandId: #19116069-676508-1701694169 - Holdem no limit (0.01€/0.02€) - 2023/12/04 12:49:29 UTC
Table: 'Colorado' 6-max (real money) Seat #6 is the button
Seat 1: LSMister523 (0.45€)
Seat 2: Gros_poisson (2.06€)
Seat 3: AMBM2729 (1.20€)
Seat 4: EMBATAA (2.56€)
Seat 5: hello7585 (1.10€)
Seat 6: Fried Berg (2.59€)
*** ANTE/BLINDS ***
LSMister523 posts small blind 0.01€
Gros_poisson posts big blind 0.02€
Dealt to Fried Berg [6h Td]
*** PRE-FLOP *** 
AMBM2729 folds
EMBATAA raises 0.03€ to 0.05€
hello7585 folds
Fried Berg folds
LSMister523 folds
Gros_poisson folds
EMBATAA collected 0.08€ from pot
*** SUMMARY ***
Total pot 0.08€ | No rake
Seat 4: EMBATAA won 0.08€


Winamax Poker - HOLD-UP "Colorado" - HandId: #19116069-676510-1701694170 - Holdem no limit (0.01€/0.02€) - 2023/12/04 12:49:30 UTC
Table: 'Colorado' 6-max (real money) Seat #6 is the button
Seat 1: LaPerfectvie (3.95€)
Seat 2: bounty.2 (0.84€)
Seat 3: LSMister523 (0.44€)
Seat 4: packymaitre (1.58€)
Seat 5: Fried Berg (2.59€)
Seat 6: Homer14510 (1.86€)
*** ANTE/BLINDS ***
LaPerfectvie posts small blind 0.01€
bounty.2 posts big blind 0.02€
Dealt to Fried Berg [Ah 2d]
*** PRE-FLOP *** 
LSMister523 folds
packymaitre folds
Fried Berg folds
Homer14510 folds
LaPerfectvie raises 3.93€ to 3.95€ and is all-in
bounty.2 folds
LaPerfectvie collected 3.97€ from pot
*** SUMMARY ***
Total pot 3.97€ | No rake
Seat 1: LaPerfectvie (small blind) won 3.97€


Winamax Poker - HOLD-UP "Colorado" - HandId: #19116069-676515-1701694173 - Holdem no limit (0.01€/0.02€) - 2023/12/04 12:49:33 UTC
Table: 'Colorado' 6-max (real money) Seat #6 is the button
Seat 1: Fried Berg (2.59€)
Seat 2: gueyf (2.19€)
Seat 3: Pablopenrais (2.07€)
Seat 4: SergioAK (2.06€)
Seat 5: nico033 (4.50€)
Seat 6: Noe_k17 (2.06€)
*** ANTE/BLINDS ***
Fried Berg posts small blind 0.01€
gueyf posts big blind 0.02€
Dealt to Fried Berg [Ah Tc]
*** PRE-FLOP *** 
Pablopenrais raises 0.04€ to 0.06€
SergioAK folds
nico033 folds
Noe_k17 folds
Fried Berg calls 0.05€
gueyf folds
*** FLOP *** [9c Js 2c]
Fried Berg bets 0.06€
Pablopenrais calls 0.06€
*** TURN *** [9c Js 2c][8h]
Fried Berg bets 0.12€
Pablopenrais calls 0.12€
*** RIVER *** [9c Js 2c 8h][5d]
Fried Berg checks
Pablopenrais checks
*** SHOW DOWN ***
Fried Berg shows [Ah Tc] (High card : Ace)
Pablopenrais shows [9h Th] (One pair : 9)
Pablopenrais collected 0.45€ from pot
*** SUMMARY ***
Total pot 0.45€ | Rake 0.05€
Board: [9c Js 2c 8h 5d]
Seat 1: Fried Berg (small blind) showed [Ah Tc] and lost with High card : Ace
Seat 3: Pablopenrais showed [9h Th] and won 0.45€ with One pair : 9


Winamax Poker - HOLD-UP "Colorado" - HandId: #19116069-676592-1701694231 - Holdem no limit (0.01€/0.02€) - 2023/12/04 12:50:31 UTC
Table: 'Colorado' 6-max (real money) Seat #6 is the button
Seat 1: EMBATAA (2.54€)
Seat 2: packymaitre (2.51€)
Seat 3: gbtcorp (2.06€)
Seat 4: Fried Berg (2.35€)
Seat 5: CKrello (2.82€)
Seat 6: Jesperord98 (2.54€)
*** ANTE/BLINDS ***
EMBATAA posts small blind 0.01€
packymaitre posts big blind 0.02€
Dealt to Fried Berg [2d Kd]
*** PRE-FLOP *** 
gbtcorp folds
Fried Berg folds
CKrello folds
Jesperord98 raises 0.04€ to 0.06€
EMBATAA folds
packymaitre calls 0.04€
*** FLOP *** [Kc 6d 3d]
packymaitre checks
Jesperord98 bets 0.04€
packymaitre calls 0.04€
*** TURN *** [Kc 6d 3d][9s]
packymaitre checks
Jesperord98 checks
*** RIVER *** [Kc 6d 3d 9s][8h]
packymaitre checks
Jesperord98 checks
*** SHOW DOWN ***
Jesperord98 shows [As Ts] (High card : Ace)
packymaitre shows [3h Ah] (One pair : 3)
packymaitre collected 0.19€ from pot
*** SUMMARY ***
Total pot 0.19€ | Rake 0.02€
Board: [Kc 6d 3d 9s 8h]
Seat 2: packymaitre (big blind) showed [3h Ah] and won 0.19€ with One pair : 3
Seat 6: Jesperord98 (button) showed [As Ts] and lost with High card : Ace


Winamax Poker - HOLD-UP "Colorado" - HandId: #19116069-676596-1701694234 - Holdem no limit (0.01€/0.02€) - 2023/12/04 12:50:34 UTC
Table: 'Colorado' 6-max (real money) Seat #6 is the button
Seat 1: D_A_R_K_ (2.46€)
Seat 2: AVALARDO (2€)
Seat 3: PwedzaM (3.38€)
Seat 4: Gros_poisson (2.25€)
Seat 5: Fried Berg (2.35€)
Seat 6: RSA_TO_VEGAS (2€)
Hold-up to Pot: total 0.10€
*** ANTE/BLINDS ***
D_A_R_K_ posts small blind 0.01€
AVALARDO posts big blind 0.02€
Dealt to Fried Berg [Td 9c]
*** PRE-FLOP *** 
PwedzaM folds
Gros_poisson folds
Fried Berg folds
RSA_TO_VEGAS folds
D_A_R_K_ folds
AVALARDO collected 0.13€ from pot
*** SUMMARY ***
Total pot 0.13€ | No rake
Seat 2: AVALARDO (big blind) won 0.13€


Winamax Poker - HOLD-UP "Colorado" - HandId: #19116069-677010-1701694528 - Holdem no limit (0.01€/0.02€) - 2023/12/04 12:55:28 UTC
Table: 'Colorado' 6-max (real money) Seat #6 is the button
Seat 1: Perf-31 (2.88€)
Seat 2: Fried Berg (0.50€)
Seat 3: gbtcorp (1.71€)
Seat 4: D_A_R_K_ (2.03€)
Seat 5: Piexxxe10 (1.62€)
Seat 6: hello7585 (2.19€)
*** ANTE/BLINDS ***
Perf-31 posts small blind 0.01€
Fried Berg posts big blind 0.02€
Dealt to Fried Berg [9h Jh]
*** PRE-FLOP *** 
gbtcorp folds
D_A_R_K_ folds
Piexxxe10 folds
hello7585 folds
Perf-31 folds
Fried Berg collected 0.03€ from pot
*** SUMMARY ***
Total pot 0.03€ | No rake
Seat 2: Fried Berg (big blind) won 0.03€


Winamax Poker - HOLD-UP "Colorado" - HandId: #19116069-677026-1701694537 - Holdem no limit (0.01€/0.02€) - 2023/12/04 12:55:37 UTC
Table: 'Colorado' 6-max (real money) Seat #6 is the button
Seat 1: Fried Berg (0.51€)
Seat 2: Yvrin (1.86€)
Seat 3: BMWTPM (2.90€)
Seat 4: Perf-31 (2.87€)
Seat 5: hello7585 (1.70€)
Seat 6: TIRAMELas (2.14€)
*** ANTE/BLINDS ***
Fried Berg posts small blind 0.01€
Yvrin posts big blind 0.02€
Dealt to Fried Berg [Jd Qh]
*** PRE-FLOP *** 
BMWTPM folds
Perf-31 folds
hello7585 folds
TIRAMELas folds
Fried Berg raises 0.02€ to 0.04€
Yvrin folds
Fried Berg collected 0.06€ from pot
*** SUMMARY ***
Total pot 0.06€ | No rake
Seat 1: Fried Berg (small blind) won 0.06€


Winamax Poker - HOLD-UP "Colorado" - HandId: #19116069-677065-1701694566 - Holdem no limit (0.01€/0.02€) - 2023/12/04 12:56:06 UTC
Table: 'Colorado' 6-max (real money) Seat #6 is the button
Seat 1: Samuelillo07 (2.35€)
Seat 2: curiouz dje (2.03€)
Seat 3: Fried Berg (0.53€)
Seat 4: Erenox (1.97€)
Seat 5: UnluckyEny (2€)
Seat 6: GTO-Mieko (2.54€)
*** ANTE/BLINDS ***
Samuelillo07 posts small blind 0.01€
curiouz dje posts big blind 0.02€
Dealt to Fried Berg [7d 2h]
*** PRE-FLOP *** 
Fried Berg folds
Erenox raises 0.04€ to 0.06€
UnluckyEny raises 0.12€ to 0.18€
GTO-Mieko folds
Samuelillo07 folds
curiouz dje folds
Erenox folds
UnluckyEny collected 0.27€ from pot
*** SUMMARY ***
Total pot 0.27€ | No rake
Seat 5: UnluckyEny won 0.27€


Winamax Poker - HOLD-UP "Colorado" - HandId: #19116069-677068-1701694568 - Holdem no limit (0.01€/0.02€) - 2023/12/04 12:56:08 UTC
Table: 'Colorado' 6-max (real money) Seat #6 is the button
Seat 1: Jeje27 (0.29€)
Seat 2: lefraisier (1.83€)
Seat 3: EMBATAA (2.14€)
Seat 4: Fried Berg (0.53€)
Seat 5: Jesperord98 (6.37€)
Seat 6: hello7585 (1.70€)
*** ANTE/BLINDS ***
Jeje27 posts small blind 0.01€
lefraisier posts big blind 0.02€
Dealt to Fried Berg [3s Qh]
*** PRE-FLOP *** 
EMBATAA folds
Fried Berg folds
Jesperord98 raises 0.04€ to 0.06€
hello7585 folds
Jeje27 folds
lefraisier folds
Jesperord98 collected 0.09€ from pot
*** SUMMARY ***
Total pot 0.09€ | No rake
Seat 5: Jesperord98 won 0.09€


Winamax Poker - HOLD-UP "Colorado" - HandId: #19116069-677075-1701694572 - Holdem no limit (0.01€/0.02€) - 2023/12/04 12:56:12 UTC
Table: 'Colorado' 6-max (real money) Seat #6 is the button
Seat 1: PwedzaM (3.09€)
Seat 2: Adame199623 (2€)
Seat 3: Gros_poisson (2.52€)
Seat 4: LaTilteuse (2.82€)
Seat 5: Fried Berg (0.53€)
Seat 6: Franck f42 (2.60€)
*** ANTE/BLINDS ***
PwedzaM posts small blind 0.01€
Adame199623 posts big blind 0.02€
Dealt to Fried Berg [4h 7s]
*** PRE-FLOP *** 
Gros_poisson folds
LaTilteuse folds
Fried Berg folds
Franck f42 folds
PwedzaM folds
Adame199623 collected 0.03€ from pot
*** SUMMARY ***
Total pot 0.03€ | No rake
Seat 2: Adame199623 (big blind) won 0.03€


Winamax Poker - HOLD-UP "Colorado" - HandId: #19116069-677078-1701694574 - Holdem no limit (0.01€/0.02€) - 2023/12/04 12:56:14 UTC
Table: 'Colorado' 6-max (real money) Seat #6 is the button
Seat 1: dryer (1.94€)
Seat 2: jamesbean1 (1.18€)
Seat 3: Homer14510 (1.90€)
Seat 4: AMBM2729 (1.20€)
Seat 5: Gsxr20thanni (0.37€)
Seat 6: Fried Berg (0.53€)
*** ANTE/BLINDS ***
dryer posts small blind 0.01€
jamesbean1 posts big blind 0.02€
Dealt to Fried Berg [5s 9c]
*** PRE-FLOP *** 
Homer14510 folds
AMBM2729 folds
Gsxr20thanni folds
Fried Berg folds
dryer folds
jamesbean1 collected 0.03€ from pot
*** SUMMARY ***
Total pot 0.03€ | No rake
Seat 2: jamesbean1 (big blind) won 0.03€


Winamax Poker - HOLD-UP "Colorado" - HandId: #19116069-677086-1701694579 - Holdem no limit (0.01€/0.02€) - 2023/12/04 12:56:19 UTC
Table: 'Colorado' 6-max (real money) Seat #6 is the button
Seat 1: Fried Berg (0.53€)
Seat 2: Samuelillo07 (2.05€)
Seat 3: AMBM2729 (1.20€)
Seat 4: dryer (1.93€)
Seat 5: Erenox (1.91€)
Seat 6: RSA_TO_VEGAS (2.64€)
*** ANTE/BLINDS ***
Fried Berg posts small blind 0.01€
Samuelillo07 posts big blind 0.02€
Dealt to Fried Berg [5h 2s]
*** PRE-FLOP *** 
AMBM2729 folds
dryer calls 0.02€
Erenox folds
RSA_TO_VEGAS folds
Fried Berg folds
Samuelillo07 checks
*** FLOP *** [Th Ah 4h]
Samuelillo07 checks
dryer bets 0.05€
Samuelillo07 folds
dryer collected 0.09€ from pot
*** SUMMARY ***
Total pot 0.09€ | Rake 0.01€
Board: [Th Ah 4h]
Seat 4: dryer won 0.09€


Winamax Poker - HOLD-UP "Colorado" - HandId: #19116069-677089-1701694581 - Holdem no limit (0.01€/0.02€) - 2023/12/04 12:56:21 UTC
Table: 'Colorado' 6-max (real money) Seat #6 is the button
Seat 1: Adame199623 (2.01€)
Seat 2: Fried Berg (0.52€)
Seat 3: hello7585 (2.24€)
Seat 4: Ertorko (2€)
Seat 5: DieToBorn (4.86€)
Seat 6: metamex (1.65€)
*** ANTE/BLINDS ***
Adame199623 posts small blind 0.01€
Fried Berg posts big blind 0.02€
Dealt to Fried Berg [8c Kd]
*** PRE-FLOP *** 
hello7585 folds
Ertorko raises 0.03€ to 0.05€
DieToBorn folds
metamex folds
Adame199623 folds
Fried Berg folds
Ertorko collected 0.08€ from pot
*** SUMMARY ***
Total pot 0.08€ | No rake
Seat 4: Ertorko won 0.08€


Winamax Poker - HOLD-UP "Colorado" - HandId: #19116069-677096-1701694585 - Holdem no limit (0.01€/0.02€) - 2023/12/04 12:56:25 UTC
Table: 'Colorado' 6-max (real money) Seat #6 is the button
Seat 1: TIRAMELas (2.09€)
Seat 2: toka30 (2€)
Seat 3: Fried Berg (0.50€)
Seat 4: a3onsaute (0.97€)
Seat 5: curiouz dje (2€)
Seat 6: BMWTPM (2.89€)
*** ANTE/BLINDS ***
TIRAMELas posts small blind 0.01€
toka30 posts big blind 0.02€
Dealt to Fried Berg [6c 4h]
*** PRE-FLOP *** 
Fried Berg folds
a3onsaute folds
curiouz dje folds
BMWTPM folds
TIRAMELas raises 0.05€ to 0.07€
toka30 folds
TIRAMELas collected 0.09€ from pot
*** SUMMARY ***
Total pot 0.09€ | No rake
Seat 1: TIRAMELas (small blind) won 0.09€


Winamax Poker - HOLD-UP "Colorado" - HandId: #19116069-677099-1701694587 - Holdem no limit (0.01€/0.02€) - 2023/12/04 12:56:27 UTC
Table: 'Colorado' 6-max (real money) Seat #6 is the button
Seat 1: Pablopenrais (1.30€)
Seat 2: a3onsaute (0.97€)
Seat 3: Javi_esc (0.73€)
Seat 4: Fried Berg (0.50€)
Seat 5: AMBM2729 (1.20€)
Seat 6: UnluckyEny (2.09€)
*** ANTE/BLINDS ***
Pablopenrais posts small blind 0.01€
a3onsaute posts big blind 0.02€
Dealt to Fried Berg [6h Ts]
*** PRE-FLOP *** 
Javi_esc folds
Fried Berg folds
AMBM2729 raises 0.02€ to 0.04€
UnluckyEny folds
Pablopenrais folds
a3onsaute folds
AMBM2729 collected 0.07€ from pot
*** SUMMARY ***
Total pot 0.07€ | No rake
Seat 5: AMBM2729 won 0.07€


Winamax Poker - HOLD-UP "Colorado" - HandId: #19116069-677102-1701694590 - Holdem no limit (0.01€/0.02€) - 2023/12/04 12:56:30 UTC
Table: 'Colorado' 6-max (real money) Seat #6 is the button
Seat 1: Okapi_Poli29 (3.17€)
Seat 2: Pablopenrais (1.29€)
Seat 3: SergioAK (2.61€)
Seat 4: Le_zigauto (1.62€)
Seat 5: Fried Berg (0.50€)
Seat 6: Erenox (2.10€)
*** ANTE/BLINDS ***
Okapi_Poli29 posts small blind 0.01€
Pablopenrais posts big blind 0.02€
Dealt to Fried Berg [5c Jd]
*** PRE-FLOP *** 
SergioAK folds
Le_zigauto raises 0.03€ to 0.05€
Fried Berg folds
Erenox folds
Okapi_Poli29 calls 0.04€
Pablopenrais folds
*** FLOP *** [7d 9d 2h]
Okapi_Poli29 checks
Le_zigauto bets 0.08€
Okapi_Poli29 calls 0.08€
*** TURN *** [7d 9d 2h][Jc]
Okapi_Poli29 checks
Le_zigauto checks
*** RIVER *** [7d 9d 2h Jc][As]
Okapi_Poli29 checks
Le_zigauto checks
*** SHOW DOWN ***
Le_zigauto shows [5d 5s] (One pair : 5)
Okapi_Poli29 shows [6c 6d] (One pair : 6)
Okapi_Poli29 collected 0.25€ from pot
*** SUMMARY ***
Total pot 0.25€ | Rake 0.03€
Board: [7d 9d 2h Jc As]
Seat 1: Okapi_Poli29 (small blind) showed [6c 6d] and won 0.25€ with One pair : 6
Seat 4: Le_zigauto showed [5d 5s] and lost with One pair : 5


Winamax Poker - HOLD-UP "Colorado" - HandId: #19116069-677104-1701694593 - Holdem no limit (0.01€/0.02€) - 2023/12/04 12:56:33 UTC
Table: 'Colorado' 6-max (real money) Seat #6 is the button
Seat 1: Annemarie66 (1.33€)
Seat 2: SharkAKK (2.17€)
Seat 3: Adame199623 (2€)
Seat 4: SergioAK (2.61€)
Seat 5: LaPerfectvie (2.86€)
Seat 6: Fried Berg (0.50€)
*** ANTE/BLINDS ***
Annemarie66 posts small blind 0.01€
SharkAKK posts big blind 0.02€
Dealt to Fried Berg [6h Ad]
*** PRE-FLOP *** 
Adame199623 folds
SergioAK raises 0.03€ to 0.05€
LaPerfectvie calls 0.05€
Fried Berg calls 0.05€
Annemarie66 folds
SharkAKK folds
*** FLOP *** [8h 3c Kc]
SergioAK bets 0.06€
LaPerfectvie folds
Fried Berg folds
SergioAK collected 0.22€ from pot
*** SUMMARY ***
Total pot 0.22€ | Rake 0.02€
Board: [8h 3c Kc]
Seat 4: SergioAK won 0.22€


Winamax Poker - HOLD-UP "Colorado" - HandId: #19116069-677276-1701694714 - Holdem no limit (0.01€/0.02€) - 2023/12/04 12:58:34 UTC
Table: 'Colorado' 6-max (real money) Seat #6 is the button
Seat 1: Fried Berg (0.45€)
Seat 2: Gijonl (2€)
Seat 3: EMBATAA (2€)
Seat 4: Gros_poisson (2.86€)
Seat 5: daminapastor (2€)
Seat 6: BMWTPM (3.22€)
*** ANTE/BLINDS ***
Fried Berg posts small blind 0.01€
Gijonl posts big blind 0.02€
Dealt to Fried Berg [As Kd]
*** PRE-FLOP *** 
EMBATAA folds
Gros_poisson folds
daminapastor raises 0.02€ to 0.04€
BMWTPM calls 0.04€
Fried Berg calls 0.03€
Gijonl calls 0.02€
*** FLOP *** [9d Ac 3d]
Fried Berg bets 0.04€
Gijonl folds
daminapastor raises 0.06€ to 0.10€
BMWTPM folds
Fried Berg calls 0.06€
*** TURN *** [9d Ac 3d][5d]
Fried Berg checks
daminapastor bets 0.18€
Fried Berg calls 0.18€
*** RIVER *** [9d Ac 3d 5d][2s]
Fried Berg checks
daminapastor bets 0.36€
Fried Berg calls 0.13€ and is all-in
*** SHOW DOWN ***
Fried Berg shows [As Kd] (One pair : Aces)
daminapastor shows [Ah Kh] (One pair : Aces)
daminapastor collected 0.67€ from side pot 1
Fried Berg collected 0.44€ from main pot
*** SUMMARY ***
Total pot 1.11€ | Rake 0.10€
Board: [9d Ac 3d 5d 2s]
Seat 1: Fried Berg (small blind) showed [As Kd] and won 0.44€ with One pair : Aces
Seat 5: daminapastor showed [Ah Kh] and won 0.67€ with One pair : Aces


Winamax Poker - HOLD-UP "Colorado" - HandId: #19116069-677394-1701694800 - Holdem no limit (0.01€/0.02€) - 2023/12/04 13:00:00 UTC
Table: 'Colorado' 6-max (real money) Seat #6 is the button
Seat 1: Gros_poisson (2.28€)
Seat 2: Fried Berg (0.44€)
Seat 3: CKrello (2.93€)
Seat 4: EMBATAA (2.19€)
Seat 5: curiouz dje (2.76€)
Seat 6: gbtcorp (0.91€)
*** ANTE/BLINDS ***
Gros_poisson posts small blind 0.01€
Fried Berg posts big blind 0.02€
Dealt to Fried Berg [9c Jc]
*** PRE-FLOP *** 
CKrello folds
EMBATAA folds
curiouz dje folds
gbtcorp raises 0.04€ to 0.06€
Gros_poisson calls 0.05€
Fried Berg calls 0.04€
*** FLOP *** [Kd 6c Ks]
Gros_poisson checks
Fried Berg bets 0.38€ and is all-in
gbtcorp calls 0.38€
Gros_poisson folds
*** TURN *** [Kd 6c Ks][Ah]
*** RIVER *** [Kd 6c Ks Ah][8c]
*** SHOW DOWN ***
Fried Berg shows [9c Jc] (One pair : Kings)
gbtcorp shows [Kc 4s] (Trips of Kings)
gbtcorp collected 0.85€ from pot
*** SUMMARY ***
Total pot 0.85€ | Rake 0.09€
Board: [Kd 6c Ks Ah 8c]
Seat 2: Fried Berg (big blind) showed [9c Jc] and lost with One pair : Kings
Seat 6: gbtcorp (button) showed [Kc 4s] and won 0.85€ with Trips of Kings


Winamax Poker - HOLD-UP "Colorado" - HandId: #19116069-677497-1701694870 - Holdem no limit (0.01€/0.02€) - 2023/12/04 13:01:10 UTC
Table: 'Colorado' 6-max (real money) Seat #6 is the button
Seat 1: pasquale202a (2.03€)
Seat 2: Gros_poisson (2.08€)
Seat 3: Fried Berg (0.50€)
Seat 4: lesombre4 (2€)
Seat 5: Kryshus (1.48€)
Seat 6: Le_zigauto (3.36€)
*** ANTE/BLINDS ***
pasquale202a posts small blind 0.01€
Gros_poisson posts big blind 0.02€
Dealt to Fried Berg [8d 6c]
*** PRE-FLOP *** 
Fried Berg folds
lesombre4 folds
Kryshus raises 0.04€ to 0.06€
Le_zigauto folds
pasquale202a folds
Gros_poisson folds
Kryshus collected 0.09€ from pot
*** SUMMARY ***
Total pot 0.09€ | No rake
Seat 5: Kryshus won 0.09€


Winamax Poker - HOLD-UP "Colorado" - HandId: #19116069-677501-1701694873 - Holdem no limit (0.01€/0.02€) - 2023/12/04 13:01:13 UTC
Table: 'Colorado' 6-max (real money) Seat #6 is the button
Seat 1: Hagreed (3.30€)
Seat 2: Adame199623 (2.03€)
Seat 3: JFSredbaron (2.30€)
Seat 4: Fried Berg (0.50€)
Seat 5: BMWTPM (3.14€)
Seat 6: HardAsStone (1.24€)
*** ANTE/BLINDS ***
Hagreed posts small blind 0.01€
Adame199623 posts big blind 0.02€
Dealt to Fried Berg [Js Jd]
*** PRE-FLOP *** 
JFSredbaron folds
Fried Berg raises 0.04€ to 0.06€
BMWTPM folds
HardAsStone folds
Hagreed folds
Adame199623 folds
Fried Berg collected 0.09€ from pot
*** SUMMARY ***
Total pot 0.09€ | No rake
Seat 4: Fried Berg won 0.09€


Winamax Poker - HOLD-UP "Colorado" - HandId: #19116069-677534-1701694896 - Holdem no limit (0.01€/0.02€) - 2023/12/04 13:01:36 UTC
Table: 'Colorado' 6-max (real money) Seat #6 is the button
Seat 1: TIRAMELas (2.09€)
Seat 2: Adame199623 (2€)
Seat 3: LaPerfectvie (2€)
Seat 4: RSA_TO_VEGAS (2.90€)
Seat 5: Estrelita91 (2.14€)
Seat 6: Fried Berg (0.53€)
*** ANTE/BLINDS ***
TIRAMELas posts small blind 0.01€
Adame199623 posts big blind 0.02€
Dealt to Fried Berg [2d Jh]
*** PRE-FLOP *** 
LaPerfectvie folds
RSA_TO_VEGAS folds
Estrelita91 calls 0.02€
Fried Berg folds
TIRAMELas folds
Adame199623 checks
*** FLOP *** [As 5c 3c]
Adame199623 checks
Estrelita91 bets 0.02€
Adame199623 folds
Estrelita91 collected 0.06€ from pot
*** SUMMARY ***
Total pot 0.06€ | Rake 0.01€
Board: [As 5c 3c]
Seat 5: Estrelita91 won 0.06€


Winamax Poker - HOLD-UP "Colorado" - HandId: #19116069-677546-1701694911 - Holdem no limit (0.01€/0.02€) - 2023/12/04 13:01:51 UTC
Table: 'Colorado' 6-max (real money) Seat #6 is the button
Seat 1: D_A_R_K_ (2.63€)
Seat 2: CKrello (2.49€)
Seat 3: curiouz dje (2€)
Seat 4: Samuelillo07 (2€)
Seat 5: LaPerfectvie (2€)
Seat 6: Fried Berg (0.53€)
*** ANTE/BLINDS ***
D_A_R_K_ posts small blind 0.01€
CKrello posts big blind 0.02€
Dealt to Fried Berg [9s Qs]
*** PRE-FLOP *** 
curiouz dje folds
Samuelillo07 folds
LaPerfectvie folds
Fried Berg raises 0.02€ to 0.04€
D_A_R_K_ folds
CKrello folds
Fried Berg collected 0.07€ from pot
*** SUMMARY ***
Total pot 0.07€ | No rake
Seat 6: Fried Berg (button) won 0.07€


Winamax Poker - HOLD-UP "Colorado" - HandId: #19116069-677565-1701694926 - Holdem no limit (0.01€/0.02€) - 2023/12/04 13:02:06 UTC
Table: 'Colorado' 6-max (real money) Seat #6 is the button
Seat 1: PoKKer_sAAn (2€)
Seat 2: Erenox (2.64€)
Seat 3: SergioAK (3.40€)
Seat 4: Adame199623 (2€)
Seat 5: Fried Berg (0.56€)
Seat 6: BMWTPM (5.20€)
*** ANTE/BLINDS ***
PoKKer_sAAn posts small blind 0.01€
Erenox posts big blind 0.02€
Dealt to Fried Berg [8s 9h]
*** PRE-FLOP *** 
SergioAK folds
Adame199623 folds
Fried Berg folds
BMWTPM folds
PoKKer_sAAn folds
Erenox collected 0.03€ from pot
*** SUMMARY ***
Total pot 0.03€ | No rake
Seat 2: Erenox (big blind) won 0.03€


Winamax Poker - HOLD-UP "Colorado" - HandId: #19116069-677576-1701694934 - Holdem no limit (0.01€/0.02€) - 2023/12/04 13:02:14 UTC
Table: 'Colorado' 6-max (real money) Seat #6 is the button
Seat 1: Fried Berg (0.56€)
Seat 2: kamclo (2.15€)
Seat 3: D_A_R_K_ (2.20€)
Seat 4: pasquale202a (2.21€)
Seat 5: LaPerfectvie (2.03€)
Seat 6: SergioAK (3.40€)
*** ANTE/BLINDS ***
Fried Berg posts small blind 0.01€
kamclo posts big blind 0.02€
Dealt to Fried Berg [8s 8d]
*** PRE-FLOP *** 
D_A_R_K_ folds
pasquale202a folds
LaPerfectvie folds
SergioAK folds
Fried Berg raises 0.02€ to 0.04€
kamclo folds
Fried Berg collected 0.06€ from pot
*** SUMMARY ***
Total pot 0.06€ | No rake
Seat 1: Fried Berg (small blind) won 0.06€


Winamax Poker - HOLD-UP "Colorado" - HandId: #19116069-677605-1701694954 - Holdem no limit (0.01€/0.02€) - 2023/12/04 13:02:34 UTC
Table: 'Colorado' 6-max (real money) Seat #6 is the button
Seat 1: Samuelillo07 (3.29€)
Seat 2: Fried Berg (0.58€)
Seat 3: packymaitre (0.52€)
Seat 4: LaTilteuse (2.76€)
Seat 5: Gros_poisson (2.11€)
Seat 6: TIRAMELas (2.19€)
*** ANTE/BLINDS ***
Samuelillo07 posts small blind 0.01€
Fried Berg posts big blind 0.02€
Dealt to Fried Berg [3h Ks]
*** PRE-FLOP *** 
packymaitre folds
LaTilteuse folds
Gros_poisson folds
TIRAMELas folds
Samuelillo07 raises 0.03€ to 0.05€
Fried Berg folds
Samuelillo07 collected 0.07€ from pot
*** SUMMARY ***
Total pot 0.07€ | No rake
Seat 1: Samuelillo07 (small blind) won 0.07€


Winamax Poker - HOLD-UP "Colorado" - HandId: #19116069-677620-1701694966 - Holdem no limit (0.01€/0.02€) - 2023/12/04 13:02:46 UTC
Table: 'Colorado' 6-max (real money) Seat #6 is the button
Seat 1: Perf-31 (2.93€)
Seat 2: Erenox (2.58€)
Seat 3: Fried Berg (0.56€)
Seat 4: gbtcorp (1.52€)
Seat 5: nicky_poker (2€)
Seat 6: curiouz dje (2€)
*** ANTE/BLINDS ***
Perf-31 posts small blind 0.01€
Erenox posts big blind 0.02€
Dealt to Fried Berg [7s 6h]
*** PRE-FLOP *** 
Fried Berg folds
gbtcorp folds
nicky_poker folds
curiouz dje folds
Perf-31 raises 0.04€ to 0.06€
Erenox raises 0.04€ to 0.10€
Perf-31 calls 0.04€
*** FLOP *** [Qd Jh 3s]
Perf-31 checks
Erenox bets 0.10€
Perf-31 calls 0.10€
*** TURN *** [Qd Jh 3s][Ac]
Perf-31 checks
Erenox checks
*** RIVER *** [Qd Jh 3s Ac][7d]
Perf-31 bets 0.10€
Erenox folds
Perf-31 collected 0.46€ from pot
*** SUMMARY ***
Total pot 0.46€ | Rake 0.04€
Board: [Qd Jh 3s Ac 7d]
Seat 1: Perf-31 (small blind) won 0.46€


Winamax Poker - HOLD-UP "Colorado" - HandId: #19116069-677622-1701694969 - Holdem no limit (0.01€/0.02€) - 2023/12/04 13:02:49 UTC
Table: 'Colorado' 6-max (real money) Seat #6 is the button
Seat 1: Samuelillo07 (2.54€)
Seat 2: Adame199623 (2.12€)
Seat 3: Le_zigauto (3.28€)
Seat 4: Fried Berg (0.56€)
Seat 5: LaPerfectvie (2€)
Seat 6: packymaitre (4.87€)
*** ANTE/BLINDS ***
Samuelillo07 posts small blind 0.01€
Adame199623 posts big blind 0.02€
Dealt to Fried Berg [9s Ks]
*** PRE-FLOP *** 
Le_zigauto folds
Fried Berg raises 0.02€ to 0.04€
LaPerfectvie folds
packymaitre folds
Samuelillo07 folds
Adame199623 folds
Fried Berg collected 0.07€ from pot
*** SUMMARY ***
Total pot 0.07€ | No rake
Seat 4: Fried Berg won 0.07€


Winamax Poker - HOLD-UP "Colorado" - HandId: #19116069-677646-1701694985 - Holdem no limit (0.01€/0.02€) - 2023/12/04 13:03:05 UTC
Table: 'Colorado' 6-max (real money) Seat #6 is the button
Seat 1: Homer14510 (0.43€)
Seat 2: Killim (1.05€)
Seat 3: Kryshus (1.66€)
Seat 4: ricki64 (0.50€)
Seat 5: Fried Berg (0.59€)
Seat 6: Samuelillo07 (3.33€)
Hold-up to Pot: total 0.10€
*** ANTE/BLINDS ***
Homer14510 posts small blind 0.01€
Killim posts big blind 0.02€
Dealt to Fried Berg [4c As]
*** PRE-FLOP *** 
Kryshus folds
ricki64 folds
Fried Berg folds
Samuelillo07 raises 0.03€ to 0.05€
Homer14510 folds
Killim calls 0.03€
*** FLOP *** [6d 7d Qc]
Killim checks
Samuelillo07 checks
*** TURN *** [6d 7d Qc][6s]
Killim checks
Samuelillo07 checks
*** RIVER *** [6d 7d Qc 6s][9d]
Killim bets 0.17€
Samuelillo07 calls 0.17€
*** SHOW DOWN ***
Killim shows [8c Jd] (One pair : 6)
Samuelillo07 shows [Th 9h] (Two pairs : 9 and 6)
Samuelillo07 collected 0.50€ from pot
*** SUMMARY ***
Total pot 0.50€ | Rake 0.05€
Board: [6d 7d Qc 6s 9d]
Seat 2: Killim (big blind) showed [8c Jd] and lost with One pair : 6
Seat 6: Samuelillo07 (button) showed [Th 9h] and won 0.50€ with Two pairs : 9 and 6


Winamax Poker - HOLD-UP "Colorado" - HandId: #19116069-677676-1701695010 - Holdem no limit (0.01€/0.02€) - 2023/12/04 13:03:30 UTC
Table: 'Colorado' 6-max (real money) Seat #6 is the button
Seat 1: EMBATAA (4.58€)
Seat 2: Pwinpwin (2€)
Seat 3: gbtcorp (1.09€)
Seat 4: LaTilteuse (2.02€)
Seat 5: Fried Berg (0.59€)
Seat 6: Samapiker (1€)
*** ANTE/BLINDS ***
EMBATAA posts small blind 0.01€
Pwinpwin posts big blind 0.02€
Dealt to Fried Berg [7c 6s]
*** PRE-FLOP *** 
gbtcorp folds
LaTilteuse folds
Fried Berg folds
Samapiker folds
EMBATAA raises 0.05€ to 0.07€
Pwinpwin folds
EMBATAA collected 0.09€ from pot
*** SUMMARY ***
Total pot 0.09€ | No rake
Seat 1: EMBATAA (small blind) won 0.09€


Winamax Poker - HOLD-UP "Colorado" - HandId: #19116069-677695-1701695026 - Holdem no limit (0.01€/0.02€) - 2023/12/04 13:03:46 UTC
Table: 'Colorado' 6-max (real money) Seat #6 is the button
Seat 1: Fried Berg (0.59€)
Seat 2: nicky_poker (2€)
Seat 3: lesombre4 (2€)
Seat 4: AAgecanonix (2€)
Seat 5: daminapastor (2€)
Seat 6: Gijonl (3.11€)
*** ANTE/BLINDS ***
Fried Berg posts small blind 0.01€
nicky_poker posts big blind 0.02€
Dealt to Fried Berg [5h Kd]
*** PRE-FLOP *** 
lesombre4 folds
AAgecanonix folds
daminapastor raises 0.02€ to 0.04€
Gijonl calls 0.04€
Fried Berg folds
nicky_poker folds
*** FLOP *** [Js Ad 7h]
daminapastor checks
Gijonl checks
*** TURN *** [Js Ad 7h][2d]
daminapastor checks
Gijonl bets 0.05€
daminapastor calls 0.05€
*** RIVER *** [Js Ad 7h 2d][7d]
daminapastor checks
Gijonl bets 0.07€
daminapastor folds
Gijonl collected 0.26€ from pot
*** SUMMARY ***
Total pot 0.26€ | Rake 0.02€
Board: [Js Ad 7h 2d 7d]
Seat 6: Gijonl (button) won 0.26€


Winamax Poker - HOLD-UP "Colorado" - HandId: #19116069-677722-1701695044 - Holdem no limit (0.01€/0.02€) - 2023/12/04 13:04:04 UTC
Table: 'Colorado' 6-max (real money) Seat #6 is the button
Seat 1: packymaitre (0.31€)
Seat 2: swag-Morue73 (0.76€)
Seat 3: AAgecanonix (2€)
Seat 4: kamclo (3.71€)
Seat 5: Gsxr20thanni (1.21€)
Seat 6: Fried Berg (0.58€)
*** ANTE/BLINDS ***
packymaitre posts small blind 0.01€
swag-Morue73 posts big blind 0.02€
Dealt to Fried Berg [Th Td]
*** PRE-FLOP *** 
AAgecanonix folds
kamclo raises 0.03€ to 0.05€
Gsxr20thanni calls 0.05€
Fried Berg raises 0.10€ to 0.15€
packymaitre folds
swag-Morue73 folds
kamclo folds
Gsxr20thanni calls 0.10€
*** FLOP *** [Kc Jh 7d]
Gsxr20thanni checks
Fried Berg bets 0.08€
Gsxr20thanni calls 0.08€
*** TURN *** [Kc Jh 7d][Ts]
Gsxr20thanni checks
Fried Berg bets 0.16€
Gsxr20thanni calls 0.16€
*** RIVER *** [Kc Jh 7d Ts][4s]
Gsxr20thanni bets 0.56€
Fried Berg calls 0.19€ and is all-in
*** SHOW DOWN ***
Gsxr20thanni shows [Ah 3h] (High card : Ace)
Fried Berg shows [Th Td] (Trips of Tens)
Fried Berg collected 1.12€ from main pot
Gsxr20thanni collected 0.37€ from side pot 1
*** SUMMARY ***
Total pot 1.49€ | Rake 0.12€
Board: [Kc Jh 7d Ts 4s]
Seat 5: Gsxr20thanni showed [Ah 3h] and won 0.37€ with High card : Ace
Seat 6: Fried Berg (button) showed [Th Td] and won 1.12€ with Trips of Tens


Winamax Poker - HOLD-UP "Colorado" - HandId: #19116069-677790-1701695091 - Holdem no limit (0.01€/0.02€) - 2023/12/04 13:04:51 UTC
Table: 'Colorado' 6-max (real money) Seat #6 is the button
Seat 1: ricki64 (0.50€)
Seat 2: Homer14510 (2€)
Seat 3: Thequeen1205 (2.21€)
Seat 4: Fried Berg (1.12€)
Seat 5: EMBATAA (2.03€)
Seat 6: kamclo (3.64€)
Hold-up to Pot: total 0.10€
*** ANTE/BLINDS ***
ricki64 posts small blind 0.01€
Homer14510 posts big blind 0.02€
Dealt to Fried Berg [Jh 8s]
*** PRE-FLOP *** 
Thequeen1205 raises 0.03€ to 0.05€
Fried Berg folds
EMBATAA folds
kamclo folds
ricki64 raises 0.22€ to 0.27€
Homer14510 folds
Thequeen1205 raises 0.22€ to 0.49€
ricki64 raises 0.01€ to 0.50€ and is all-in
Thequeen1205 calls 0.01€
*** FLOP *** [Td Jd Ts]
*** TURN *** [Td Jd Ts][5h]
*** RIVER *** [Td Jd Ts 5h][Th]
*** SHOW DOWN ***
Thequeen1205 shows [9h 9c] (Full of Tens and 9)
ricki64 shows [Tc Ac] (Quads of Tens)
ricki64 collected 1.02€ from pot
*** SUMMARY ***
Total pot 1.02€ | Rake 0.10€
Board: [Td Jd Ts 5h Th]
Seat 1: ricki64 (small blind) showed [Tc Ac] and won 1.02€ with Quads of Tens
Seat 3: Thequeen1205 showed [9h 9c] and lost with Full of Tens and 9


Winamax Poker - HOLD-UP "Colorado" - HandId: #19116069-677801-1701695099 - Holdem no limit (0.01€/0.02€) - 2023/12/04 13:04:59 UTC
Table: 'Colorado' 6-max (real money) Seat #6 is the button
Seat 1: LaTilteuse (4.46€)
Seat 2: Fried Berg (1.12€)
Seat 3: EMBATAA (2.13€)
Seat 4: Perf-31 (3.13€)
Seat 5: ChtiPongiste (2.24€)
Seat 6: JFSredbaron (2.83€)
*** ANTE/BLINDS ***
LaTilteuse posts small blind 0.01€
Fried Berg posts big blind 0.02€
Dealt to Fried Berg [Td 3c]
*** PRE-FLOP *** 
EMBATAA folds
Perf-31 folds
ChtiPongiste folds
JFSredbaron folds
LaTilteuse folds
Fried Berg collected 0.03€ from pot
*** SUMMARY ***
Total pot 0.03€ | No rake
Seat 2: Fried Berg (big blind) won 0.03€


Winamax Poker - HOLD-UP "Colorado" - HandId: #19116069-677814-1701695108 - Holdem no limit (0.01€/0.02€) - 2023/12/04 13:05:08 UTC
Table: 'Colorado' 6-max (real money) Seat #6 is the button
Seat 1: D_A_R_K_ (2.65€)
Seat 2: Erenox (1.77€)
Seat 3: Fried Berg (1.13€)
Seat 4: RSA_TO_VEGAS (2€)
Seat 5: JFSredbaron (2.83€)
Seat 6: EMBATAA (2.12€)
*** ANTE/BLINDS ***
D_A_R_K_ posts small blind 0.01€
Erenox posts big blind 0.02€
Dealt to Fried Berg [4h 6c]
*** PRE-FLOP *** 
Fried Berg folds
RSA_TO_VEGAS folds
JFSredbaron raises 0.04€ to 0.06€
EMBATAA folds
D_A_R_K_ folds
Erenox calls 0.04€
*** FLOP *** [4c 9s 5d]
Erenox checks
JFSredbaron bets 0.08€
Erenox folds
JFSredbaron collected 0.20€ from pot
*** SUMMARY ***
Total pot 0.20€ | Rake 0.01€
Board: [4c 9s 5d]
Seat 5: JFSredbaron won 0.20€


Winamax Poker - HOLD-UP "Colorado" - HandId: #19116069-677816-1701695111 - Holdem no limit (0.01€/0.02€) - 2023/12/04 13:05:11 UTC
Table: 'Colorado' 6-max (real money) Seat #6 is the button
Seat 1: Adame199623 (2€)
Seat 2: TIRAMELas (2.17€)
Seat 3: MaryAthena (1.27€)
Seat 4: daminapastor (2€)
Seat 5: Fried Berg (1.13€)
Seat 6: AAgecanonix (2€)
*** ANTE/BLINDS ***
Adame199623 posts small blind 0.01€
TIRAMELas posts big blind 0.02€
Dealt to Fried Berg [Jc 7d]
*** PRE-FLOP *** 
MaryAthena calls 0.02€
daminapastor folds
Fried Berg folds
AAgecanonix folds
Adame199623 folds
TIRAMELas checks
*** FLOP *** [Ac 3d Th]
TIRAMELas checks
MaryAthena bets 0.02€
TIRAMELas calls 0.02€
*** TURN *** [Ac 3d Th][Tc]
TIRAMELas checks
MaryAthena bets 0.06€
TIRAMELas folds
MaryAthena collected 0.14€ from pot
*** SUMMARY ***
Total pot 0.14€ | Rake 0.01€
Board: [Ac 3d Th Tc]
Seat 3: MaryAthena won 0.14€


Winamax Poker - HOLD-UP "Colorado" - HandId: #19116069-677827-1701695121 - Holdem no limit (0.01€/0.02€) - 2023/12/04 13:05:21 UTC
Table: 'Colorado' 6-max (real money) Seat #6 is the button
Seat 1: Fried Berg (1.13€)
Seat 2: daminapastor (2€)
Seat 3: LaTilteuse (4.47€)
Seat 4: kamclo (2€)
Seat 5: Zanghief068 (3.24€)
Seat 6: CKrello (2.87€)
*** ANTE/BLINDS ***
Fried Berg posts small blind 0.01€
daminapastor posts big blind 0.02€
Dealt to Fried Berg [8h Ts]
*** PRE-FLOP *** 
LaTilteuse raises 0.04€ to 0.06€
kamclo calls 0.06€
Zanghief068 folds
CKrello calls 0.06€
Fried Berg folds
daminapastor folds
*** FLOP *** [7s Qc 4c]
LaTilteuse bets 0.11€
kamclo calls 0.11€
CKrello folds
*** TURN *** [7s Qc 4c][3d]
LaTilteuse bets 0.32€
kamclo folds
LaTilteuse collected 0.71€ from pot
*** SUMMARY ***
Total pot 0.71€ | Rake 0.04€
Board: [7s Qc 4c 3d]
Seat 3: LaTilteuse won 0.71€


Winamax Poker - HOLD-UP "Colorado" - HandId: #19116069-677841-1701695133 - Holdem no limit (0.01€/0.02€) - 2023/12/04 13:05:33 UTC
Table: 'Colorado' 6-max (real money) Seat #6 is the button
Seat 1: dryer (1.99€)
Seat 2: Fried Berg (1.12€)
Seat 3: Fabuenoooo (2.26€)
Seat 4: AVALARDO (4.62€)
Seat 5: gbtcorp (1.05€)
Seat 6: Gros_poisson (2.01€)
*** ANTE/BLINDS ***
dryer posts small blind 0.01€
Fried Berg posts big blind 0.02€
Dealt to Fried Berg [5c Ad]
*** PRE-FLOP *** 
Fabuenoooo raises 0.04€ to 0.06€
AVALARDO folds
gbtcorp folds
Gros_poisson folds
dryer folds
Fried Berg folds
Fabuenoooo collected 0.09€ from pot
*** SUMMARY ***
Total pot 0.09€ | No rake
Seat 3: Fabuenoooo won 0.09€


Winamax Poker - HOLD-UP "Colorado" - HandId: #19116069-677883-1701695158 - Holdem no limit (0.01€/0.02€) - 2023/12/04 13:05:58 UTC
Table: 'Colorado' 6-max (real money) Seat #6 is the button
Seat 1: Samuelillo07 (3.35€)
Seat 2: Adame199623 (2.11€)
Seat 3: Fried Berg (1.10€)
Seat 4: pasquale202a (0.38€)
Seat 5: LaTilteuse (4.69€)
Seat 6: Franck f42 (2.07€)
*** ANTE/BLINDS ***
Samuelillo07 posts small blind 0.01€
Adame199623 posts big blind 0.02€
Dealt to Fried Berg [Kd 3h]
*** PRE-FLOP *** 
Fried Berg folds
pasquale202a raises 0.05€ to 0.07€
LaTilteuse folds
Franck f42 folds
Samuelillo07 folds
Adame199623 folds
pasquale202a collected 0.10€ from pot
*** SUMMARY ***
Total pot 0.10€ | No rake
Seat 4: pasquale202a won 0.10€


Winamax Poker - HOLD-UP "Colorado" - HandId: #19116069-677885-1701695160 - Holdem no limit (0.01€/0.02€) - 2023/12/04 13:06:00 UTC
Table: 'Colorado' 6-max (real money) Seat #6 is the button
Seat 1: packymaitre (1.21€)
Seat 2: gueyf (2€)
Seat 3: Samuelillo07 (2.34€)
Seat 4: Fried Berg (1.10€)
Seat 5: curiouz dje (2.48€)
Seat 6: The Qualm (2.10€)
*** ANTE/BLINDS ***
packymaitre posts small blind 0.01€
gueyf posts big blind 0.02€
Dealt to Fried Berg [Kd 9d]
*** PRE-FLOP *** 
Samuelillo07 raises 0.04€ to 0.06€
Fried Berg folds
curiouz dje calls 0.06€
The Qualm folds
packymaitre folds
gueyf folds
*** FLOP *** [6h Td Js]
Samuelillo07 checks
curiouz dje bets 0.08€
Samuelillo07 calls 0.08€
*** TURN *** [6h Td Js][8c]
Samuelillo07 checks
curiouz dje checks
*** RIVER *** [6h Td Js 8c][4s]
Samuelillo07 checks
curiouz dje checks
*** SHOW DOWN ***
Samuelillo07 shows [Ad Qh] (High card : Ace)
curiouz dje shows [7h 7c] (One pair : 7)
curiouz dje collected 0.28€ from pot
*** SUMMARY ***
Total pot 0.28€ | Rake 0.03€
Board: [6h Td Js 8c 4s]
Seat 3: Samuelillo07 showed [Ad Qh] and lost with High card : Ace
Seat 5: curiouz dje showed [7h 7c] and won 0.28€ with One pair : 7


Winamax Poker - HOLD-UP "Colorado" - HandId: #19116069-677899-1701695171 - Holdem no limit (0.01€/0.02€) - 2023/12/04 13:06:11 UTC
Table: 'Colorado' 6-max (real money) Seat #6 is the button
Seat 1: AAgecanonix (2.02€)
Seat 2: LaTilteuse (2.58€)
Seat 3: RSA_TO_VEGAS (2.02€)
Seat 4: MaryAthena (1.32€)
Seat 5: Fried Berg (1.10€)
Seat 6: pasquale202a (0.41€)
*** ANTE/BLINDS ***
AAgecanonix posts small blind 0.01€
LaTilteuse posts big blind 0.02€
Dealt to Fried Berg [5h 5c]
*** PRE-FLOP *** 
RSA_TO_VEGAS folds
MaryAthena folds
Fried Berg raises 0.02€ to 0.04€
pasquale202a calls 0.04€
AAgecanonix folds
LaTilteuse folds
*** FLOP *** [9c Jd Ad]
Fried Berg bets 0.04€
pasquale202a folds
Fried Berg collected 0.14€ from pot
*** SUMMARY ***
Total pot 0.14€ | Rake 0.01€
Board: [9c Jd Ad]
Seat 5: Fried Berg won 0.14€


Winamax Poker - HOLD-UP "Colorado" - HandId: #19116069-677952-1701695216 - Holdem no limit (0.01€/0.02€) - 2023/12/04 13:06:56 UTC
Table: 'Colorado' 6-max (real money) Seat #6 is the button
Seat 1: LAG0URMANDE (2.33€)
Seat 2: LaTilteuse (4.69€)
Seat 3: Berig (2.30€)
Seat 4: Adame199623 (2€)
Seat 5: Pwinpwin (2.50€)
Seat 6: Fried Berg (1.16€)
*** ANTE/BLINDS ***
LAG0URMANDE posts small blind 0.01€
LaTilteuse posts big blind 0.02€
Dealt to Fried Berg [7s Kc]
*** PRE-FLOP *** 
Berig folds
Adame199623 folds
Pwinpwin folds
Fried Berg raises 0.02€ to 0.04€
LAG0URMANDE folds
LaTilteuse folds
Fried Berg collected 0.07€ from pot
*** SUMMARY ***
Total pot 0.07€ | No rake
Seat 6: Fried Berg (button) won 0.07€


Winamax Poker - HOLD-UP "Colorado" - HandId: #19116069-677973-1701695235 - Holdem no limit (0.01€/0.02€) - 2023/12/04 13:07:15 UTC
Table: 'Colorado' 6-max (real money) Seat #6 is the button
Seat 1: Gros_poisson (3.80€)
Seat 2: Fried Berg (1.19€)
Seat 3: polak02 (0.51€)
Seat 4: Mametzien (1.90€)
Seat 5: Fabr80 (1.71€)
Seat 6: nicky_poker (2.56€)
*** ANTE/BLINDS ***
Gros_poisson posts small blind 0.01€
Fried Berg posts big blind 0.02€
Dealt to Fried Berg [7h 9c]
*** PRE-FLOP *** 
polak02 folds
Mametzien calls 0.02€
Fabr80 folds
nicky_poker folds
Gros_poisson folds
Fried Berg checks
*** FLOP *** [Kd Tc Js]
Fried Berg checks
Mametzien checks
*** TURN *** [Kd Tc Js][Ac]
Fried Berg checks
Mametzien bets 0.03€
Fried Berg folds
Mametzien collected 0.07€ from pot
*** SUMMARY ***
Total pot 0.07€ | Rake 0.01€
Board: [Kd Tc Js Ac]
Seat 4: Mametzien won 0.07€


Winamax Poker - HOLD-UP "Colorado" - HandId: #19116069-678033-1701695283 - Holdem no limit (0.01€/0.02€) - 2023/12/04 13:08:03 UTC
Table: 'Colorado' 6-max (real money) Seat #6 is the button
Seat 1: Fried Berg (1.17€)
Seat 2: packymaitre (1.20€)
Seat 3: Bengers31 (1.64€)
Seat 4: nicky_poker (2€)
Seat 5: Adame199623 (2.12€)
Seat 6: AAgecanonix (2€)
*** ANTE/BLINDS ***
Fried Berg posts small blind 0.01€
packymaitre posts big blind 0.02€
Dealt to Fried Berg [6d 2d]
*** PRE-FLOP *** 
Bengers31 calls 0.02€
nicky_poker folds
Adame199623 raises 0.06€ to 0.08€
AAgecanonix folds
Fried Berg folds
packymaitre folds
Bengers31 folds
Adame199623 collected 0.13€ from pot
*** SUMMARY ***
Total pot 0.13€ | No rake
Seat 5: Adame199623 won 0.13€


Winamax Poker - HOLD-UP "Colorado" - HandId: #19116069-678044-1701695292 - Holdem no limit (0.01€/0.02€) - 2023/12/04 13:08:12 UTC
Table: 'Colorado' 6-max (real money) Seat #6 is the button
Seat 1: AAgecanonix (2.59€)
Seat 2: MaryAthena (1.19€)
Seat 3: Fried Berg (1.16€)
Seat 4: DeX70 (1.91€)
Seat 5: Pwinpwin (2€)
Seat 6: daminapastor (3.05€)
*** ANTE/BLINDS ***
AAgecanonix posts small blind 0.01€
MaryAthena posts big blind 0.02€
Dealt to Fried Berg [Kh Jh]
*** PRE-FLOP *** 
Fried Berg raises 0.02€ to 0.04€
DeX70 folds
Pwinpwin folds
daminapastor folds
AAgecanonix folds
MaryAthena folds
Fried Berg collected 0.07€ from pot
*** SUMMARY ***
Total pot 0.07€ | No rake
Seat 3: Fried Berg won 0.07€


Winamax Poker - HOLD-UP "Colorado" - HandId: #19116069-678062-1701695309 - Holdem no limit (0.01€/0.02€) - 2023/12/04 13:08:29 UTC
Table: 'Colorado' 6-max (real money) Seat #6 is the button
Seat 1: Gros_poisson (2€)
Seat 2: G-UN-BO-JEU (5.09€)
Seat 3: TIRAMELas (2.23€)
Seat 4: Fried Berg (1.19€)
Seat 5: wmx-6ooqtz9 (2.11€)
Seat 6: gueyf (1.94€)
*** ANTE/BLINDS ***
Gros_poisson posts small blind 0.01€
G-UN-BO-JEU posts big blind 0.02€
Dealt to Fried Berg [7h 4d]
*** PRE-FLOP *** 
TIRAMELas raises 0.04€ to 0.06€
Fried Berg folds
wmx-6ooqtz9 folds
gueyf folds
Gros_poisson folds
G-UN-BO-JEU calls 0.04€
*** FLOP *** [Kc 9d 4c]
G-UN-BO-JEU checks
TIRAMELas bets 0.07€
G-UN-BO-JEU calls 0.07€
*** TURN *** [Kc 9d 4c][Js]
G-UN-BO-JEU checks
TIRAMELas bets 0.18€
G-UN-BO-JEU folds
TIRAMELas collected 0.42€ from pot
*** SUMMARY ***
Total pot 0.42€ | Rake 0.03€
Board: [Kc 9d 4c Js]
Seat 3: TIRAMELas won 0.42€


Winamax Poker - HOLD-UP "Colorado" - HandId: #19116069-678082-1701695323 - Holdem no limit (0.01€/0.02€) - 2023/12/04 13:08:43 UTC
Table: 'Colorado' 6-max (real money) Seat #6 is the button
Seat 1: JFSredbaron (2.93€)
Seat 2: Fabuenoooo (2.29€)
Seat 3: SharkAKK (2€)
Seat 4: The Qualm (2.01€)
Seat 5: daminapastor (2.02€)
Seat 6: Fried Berg (1.19€)
*** ANTE/BLINDS ***
JFSredbaron posts small blind 0.01€
Fabuenoooo posts big blind 0.02€
Dealt to Fried Berg [4h 5d]
*** PRE-FLOP *** 
SharkAKK folds
The Qualm folds
daminapastor folds
Fried Berg folds
JFSredbaron raises 0.04€ to 0.06€
Fabuenoooo calls 0.04€
*** FLOP *** [Tc 5h 9s]
JFSredbaron bets 0.08€
Fabuenoooo raises 0.17€ to 0.25€
JFSredbaron calls 0.17€
*** TURN *** [Tc 5h 9s][7s]
JFSredbaron checks
Fabuenoooo bets 0.30€
JFSredbaron calls 0.30€
*** RIVER *** [Tc 5h 9s 7s][9d]
JFSredbaron checks
Fabuenoooo bets 0.70€
JFSredbaron folds
Fabuenoooo collected 1.80€ from pot
*** SUMMARY ***
Total pot 1.80€ | Rake 0.12€
Board: [Tc 5h 9s 7s 9d]
Seat 2: Fabuenoooo (big blind) won 1.80€


Winamax Poker - HOLD-UP "Colorado" - HandId: #19116069-678093-1701695331 - Holdem no limit (0.01€/0.02€) - 2023/12/04 13:08:51 UTC
Table: 'Colorado' 6-max (real money) Seat #6 is the button
Seat 1: The Qualm (2.25€)
Seat 2: Pwinpwin (2.25€)
Seat 3: DeX70 (1.97€)
Seat 4: Fried Berg (1.19€)
Seat 5: RSA_TO_VEGAS (2.03€)
Seat 6: nicky_poker (2.44€)
*** ANTE/BLINDS ***
The Qualm posts small blind 0.01€
Pwinpwin posts big blind 0.02€
Dealt to Fried Berg [Ac 2c]
*** PRE-FLOP *** 
DeX70 folds
Fried Berg raises 0.02€ to 0.04€
RSA_TO_VEGAS folds
nicky_poker folds
The Qualm folds
Pwinpwin folds
Fried Berg collected 0.07€ from pot
*** SUMMARY ***
Total pot 0.07€ | No rake
Seat 4: Fried Berg won 0.07€


Winamax Poker - HOLD-UP "Colorado" - HandId: #19116069-678114-1701695346 - Holdem no limit (0.01€/0.02€) - 2023/12/04 13:09:06 UTC
Table: 'Colorado' 6-max (real money) Seat #6 is the button
Seat 1: Franck f42 (1.93€)
Seat 2: Gijonl (4.04€)
Seat 3: Fried Berg (1.22€)
Seat 4: _MasterYoda_ (0.42€)
Seat 5: Thequeen1205 (2€)
Seat 6: Pwinpwin (2.37€)
*** ANTE/BLINDS ***
Franck f42 posts small blind 0.01€
Gijonl posts big blind 0.02€
Dealt to Fried Berg [6d 6h]
*** PRE-FLOP *** 
Fried Berg raises 0.02€ to 0.04€
_MasterYoda_ folds
Thequeen1205 folds
Pwinpwin folds
Franck f42 calls 0.03€
Gijonl folds
*** FLOP *** [3s 4s 9h]
Franck f42 checks
Fried Berg bets 0.08€
Franck f42 calls 0.08€
*** TURN *** [3s 4s 9h][As]
Franck f42 checks
Fried Berg checks
*** RIVER *** [3s 4s 9h As][Ks]
Franck f42 checks
Fried Berg checks
*** SHOW DOWN ***
Fried Berg shows [6d 6h] (One pair : 6)
Franck f42 shows [3h Kh] (Two pairs : Kings and 3)
Franck f42 collected 0.23€ from pot
*** SUMMARY ***
Total pot 0.23€ | Rake 0.03€
Board: [3s 4s 9h As Ks]
Seat 1: Franck f42 (small blind) showed [3h Kh] and won 0.23€ with Two pairs : Kings and 3
Seat 3: Fried Berg showed [6d 6h] and lost with One pair : 6


Winamax Poker - HOLD-UP "Colorado" - HandId: #19116069-678158-1701695377 - Holdem no limit (0.01€/0.02€) - 2023/12/04 13:09:37 UTC
Table: 'Colorado' 6-max (real money) Seat #6 is the button
Seat 1: kamclo (2€)
Seat 2: Fried Berg (1.10€)
Seat 3: Franck f42 (2.04€)
Seat 4: gueyf (1.95€)
Seat 5: The Qualm (2.30€)
Seat 6: CKrello (2€)
*** ANTE/BLINDS ***
kamclo posts small blind 0.01€
Fried Berg posts big blind 0.02€
Dealt to Fried Berg [7c 6c]
*** PRE-FLOP *** 
Franck f42 folds
gueyf raises 0.04€ to 0.06€
The Qualm folds
CKrello folds
kamclo folds
Fried Berg calls 0.04€
*** FLOP *** [Js Kc 2s]
Fried Berg checks
gueyf checks
*** TURN *** [Js Kc 2s][Qs]
Fried Berg checks
gueyf checks
*** RIVER *** [Js Kc 2s Qs][Tc]
Fried Berg checks
gueyf bets 0.05€
Fried Berg folds
gueyf collected 0.17€ from pot
*** SUMMARY ***
Total pot 0.17€ | Rake 0.01€
Board: [Js Kc 2s Qs Tc]
Seat 4: gueyf won 0.17€


Winamax Poker - HOLD-UP "Colorado" - HandId: #19116069-678208-1701695419 - Holdem no limit (0.01€/0.02€) - 2023/12/04 13:10:19 UTC
Table: 'Colorado' 6-max (real money) Seat #6 is the button
Seat 1: Fried Berg (1.04€)
Seat 2: packymaitre (1.19€)
Seat 3: Thequeen1205 (2€)
Seat 4: LaTilteuse (4.67€)
Seat 5: pasquale202a (1.29€)
Seat 6: RSA_TO_VEGAS (2.38€)
*** ANTE/BLINDS ***
Fried Berg posts small blind 0.01€
packymaitre posts big blind 0.02€
Dealt to Fried Berg [3s Tc]
*** PRE-FLOP *** 
Thequeen1205 folds
LaTilteuse folds
pasquale202a folds
RSA_TO_VEGAS raises 0.04€ to 0.06€
Fried Berg folds
packymaitre folds
RSA_TO_VEGAS collected 0.09€ from pot
*** SUMMARY ***
Total pot 0.09€ | No rake
Seat 6: RSA_TO_VEGAS (button) won 0.09€


Winamax Poker - HOLD-UP "Colorado" - HandId: #19116069-678225-1701695429 - Holdem no limit (0.01€/0.02€) - 2023/12/04 13:10:29 UTC
Table: 'Colorado' 6-max (real money) Seat #6 is the button
Seat 1: packymaitre (1.60€)
Seat 2: curiouz dje (2€)
Seat 3: nicky_poker (2.52€)
Seat 4: Pwinpwin (2.21€)
Seat 5: Fried Berg (1.03€)
Seat 6: CKrello (2.85€)
*** ANTE/BLINDS ***
packymaitre posts small blind 0.01€
curiouz dje posts big blind 0.02€
Dealt to Fried Berg [7s Tc]
*** PRE-FLOP *** 
nicky_poker folds
Pwinpwin folds
Fried Berg folds
CKrello folds
packymaitre folds
curiouz dje collected 0.03€ from pot
*** SUMMARY ***
Total pot 0.03€ | No rake
Seat 2: curiouz dje (big blind) won 0.03€


Winamax Poker - HOLD-UP "Colorado" - HandId: #19116069-678229-1701695431 - Holdem no limit (0.01€/0.02€) - 2023/12/04 13:10:31 UTC
Table: 'Colorado' 6-max (real money) Seat #6 is the button
Seat 1: Pwinpwin (2.21€)
Seat 2: TIRAMELas (4.04€)
Seat 3: gbtcorp (1.02€)
Seat 4: leosommelier (1.43€)
Seat 5: CKrello (2.85€)
Seat 6: Fried Berg (1.03€)
*** ANTE/BLINDS ***
Pwinpwin posts small blind 0.01€
TIRAMELas posts big blind 0.02€
Dealt to Fried Berg [7c Tc]
*** PRE-FLOP *** 
gbtcorp folds
leosommelier folds
CKrello folds
Fried Berg raises 0.02€ to 0.04€
Pwinpwin folds
TIRAMELas calls 0.02€
*** FLOP *** [9s Th 7h]
TIRAMELas checks
Fried Berg bets 0.08€
TIRAMELas folds
Fried Berg collected 0.16€ from pot
*** SUMMARY ***
Total pot 0.16€ | Rake 0.01€
Board: [9s Th 7h]
Seat 6: Fried Berg (button) won 0.16€


Winamax Poker - HOLD-UP "Colorado" - HandId: #19116069-678269-1701695452 - Holdem no limit (0.01€/0.02€) - 2023/12/04 13:10:52 UTC
Table: 'Colorado' 6-max (real money) Seat #6 is the button
Seat 1: Mametzien (2.17€)
Seat 2: curiouz dje (2€)
Seat 3: wmx-6ooqtz9 (2.02€)
Seat 4: gueyf (3.05€)
Seat 5: Kryshus (1.67€)
Seat 6: Fried Berg (1.07€)
*** ANTE/BLINDS ***
Mametzien posts small blind 0.01€
curiouz dje posts big blind 0.02€
Dealt to Fried Berg [Jc 5s]
*** PRE-FLOP *** 
wmx-6ooqtz9 folds
gueyf folds
Kryshus folds
Fried Berg folds
Mametzien raises 0.02€ to 0.04€
curiouz dje folds
Mametzien collected 0.06€ from pot
*** SUMMARY ***
Total pot 0.06€ | No rake
Seat 1: Mametzien (small blind) won 0.06€


Winamax Poker - HOLD-UP "Colorado" - HandId: #19116069-678281-1701695461 - Holdem no limit (0.01€/0.02€) - 2023/12/04 13:11:01 UTC
Table: 'Colorado' 6-max (real money) Seat #6 is the button
Seat 1: Thequeen1205 (2€)
Seat 2: shaka004 (2€)
Seat 3: CKrello (3.55€)
Seat 4: daminapastor (2.03€)
Seat 5: iboo28 (2.77€)
Seat 6: Fried Berg (1.07€)
*** ANTE/BLINDS ***
Thequeen1205 posts small blind 0.01€
shaka004 posts big blind 0.02€
Dealt to Fried Berg [Qh 2s]
*** PRE-FLOP *** 
CKrello folds
daminapastor raises 0.02€ to 0.04€
iboo28 calls 0.04€
Fried Berg folds
Thequeen1205 folds
shaka004 calls 0.02€
*** FLOP *** [Ts 7d 2c]
shaka004 checks
daminapastor checks
iboo28 checks
*** TURN *** [Ts 7d 2c][5h]
shaka004 checks
daminapastor bets 0.05€
iboo28 calls 0.05€
shaka004 folds
*** RIVER *** [Ts 7d 2c 5h][Ac]
daminapastor checks
iboo28 checks
*** SHOW DOWN ***
iboo28 shows [5c Qd] (One pair : 5)
daminapastor shows [8d 8h] (One pair : 8)
daminapastor collected 0.21€ from pot
*** SUMMARY ***
Total pot 0.21€ | Rake 0.02€
Board: [Ts 7d 2c 5h Ac]
Seat 4: daminapastor showed [8d 8h] and won 0.21€ with One pair : 8
Seat 5: iboo28 showed [5c Qd] and lost with One pair : 5


Winamax Poker - HOLD-UP "Colorado" - HandId: #19116069-678285-1701695463 - Holdem no limit (0.01€/0.02€) - 2023/12/04 13:11:03 UTC
Table: 'Colorado' 6-max (real money) Seat #6 is the button
Seat 1: CKrello (3.55€)
Seat 2: Fried Berg (1.07€)
Seat 3: packymaitre (0.81€)
Seat 4: LaTilteuse (4.64€)
Seat 5: ricki64 (0.60€)
Seat 6: Adame199623 (2.26€)
*** ANTE/BLINDS ***
CKrello posts small blind 0.01€
Fried Berg posts big blind 0.02€
Dealt to Fried Berg [Js 7c]
*** PRE-FLOP *** 
packymaitre folds
LaTilteuse folds
ricki64 folds
Adame199623 folds
CKrello folds
Fried Berg collected 0.03€ from pot
*** SUMMARY ***
Total pot 0.03€ | No rake
Seat 2: Fried Berg (big blind) won 0.03€


Winamax Poker - HOLD-UP "Colorado" - HandId: #19116069-678294-1701695470 - Holdem no limit (0.01€/0.02€) - 2023/12/04 13:11:10 UTC
Table: 'Colorado' 6-max (real money) Seat #6 is the button
Seat 1: Fried Berg (1.08€)
Seat 2: DeX70 (1.55€)
Seat 3: JFSredbaron (2.41€)
Seat 4: kamclo (5.28€)
Seat 5: gueyf (1.96€)
Seat 6: Erenox (2.75€)
*** ANTE/BLINDS ***
Fried Berg posts small blind 0.01€
DeX70 posts big blind 0.02€
Dealt to Fried Berg [Kd Qd]
*** PRE-FLOP *** 
JFSredbaron raises 0.04€ to 0.06€
kamclo folds
gueyf folds
Erenox calls 0.06€
Fried Berg raises 0.12€ to 0.18€
DeX70 folds
JFSredbaron calls 0.12€
Erenox folds
*** FLOP *** [7s Ah Qh]
Fried Berg bets 0.08€
JFSredbaron calls 0.08€
*** TURN *** [7s Ah Qh][2d]
Fried Berg checks
JFSredbaron checks
*** RIVER *** [7s Ah Qh 2d][7c]
Fried Berg checks
JFSredbaron bets 0.21€
Fried Berg calls 0.21€
*** SHOW DOWN ***
Fried Berg shows [Kd Qd] (Two pairs : Queens and 7)
JFSredbaron shows [Ac 9c] (Two pairs : Aces and 7)
JFSredbaron collected 0.92€ from pot
*** SUMMARY ***
Total pot 0.92€ | Rake 0.10€
Board: [7s Ah Qh 2d 7c]
Seat 1: Fried Berg (small blind) showed [Kd Qd] and lost with Two pairs : Queens and 7
Seat 3: JFSredbaron showed [Ac 9c] and won 0.92€ with Two pairs : Aces and 7


Winamax Poker - HOLD-UP "Colorado" - HandId: #19116069-678424-1701695561 - Holdem no limit (0.01€/0.02€) - 2023/12/04 13:12:41 UTC
Table: 'Colorado' 6-max (real money) Seat #6 is the button
Seat 1: Pwinpwin (2.24€)
Seat 2: LaTilteuse (2.59€)
Seat 3: Fried Berg (0.61€)
Seat 4: nicky_poker (2.28€)
Seat 5: JFSredbaron (2.86€)
Seat 6: Erenox (1.19€)
*** ANTE/BLINDS ***
Pwinpwin posts small blind 0.01€
LaTilteuse posts big blind 0.02€
Dealt to Fried Berg [Kc 9s]
*** PRE-FLOP *** 
Fried Berg folds
nicky_poker folds
JFSredbaron folds
Erenox folds
Pwinpwin folds
LaTilteuse collected 0.03€ from pot
*** SUMMARY ***
Total pot 0.03€ | No rake
Seat 2: LaTilteuse (big blind) won 0.03€


Winamax Poker - HOLD-UP "Colorado" - HandId: #19116069-678437-1701695570 - Holdem no limit (0.01€/0.02€) - 2023/12/04 13:12:50 UTC
Table: 'Colorado' 6-max (real money) Seat #6 is the button
Seat 1: Gros_poisson (2€)
Seat 2: DeX70 (2.62€)
Seat 3: ChtiPongiste (1.68€)
Seat 4: Fried Berg (0.61€)
Seat 5: gbtcorp (4.12€)
Seat 6: Erenox (1.19€)
*** ANTE/BLINDS ***
Gros_poisson posts small blind 0.01€
DeX70 posts big blind 0.02€
Dealt to Fried Berg [9c Td]
*** PRE-FLOP *** 
ChtiPongiste folds
Fried Berg folds
gbtcorp folds
Erenox folds
Gros_poisson folds
DeX70 collected 0.03€ from pot
*** SUMMARY ***
Total pot 0.03€ | No rake
Seat 2: DeX70 (big blind) won 0.03€


Winamax Poker - HOLD-UP "Colorado" - HandId: #19116069-678441-1701695573 - Holdem no limit (0.01€/0.02€) - 2023/12/04 13:12:53 UTC
Table: 'Colorado' 6-max (real money) Seat #6 is the button
Seat 1: Fried Berg (0.61€)
Seat 2: Amazigh 78 (3.64€)
Seat 3: Weed-men34 (2.38€)
Seat 4: Adame199623 (2€)
Seat 5: Fabuenoooo (3.12€)
Seat 6: daminapastor (3€)
*** ANTE/BLINDS ***
Fried Berg posts small blind 0.01€
Amazigh 78 posts big blind 0.02€
Dealt to Fried Berg [3h 3d]
*** PRE-FLOP *** 
Weed-men34 folds
Adame199623 raises 0.06€ to 0.08€
Fabuenoooo folds
daminapastor folds
Fried Berg calls 0.07€
Amazigh 78 calls 0.06€
*** FLOP *** [2d 9h Qh]
Fried Berg bets 0.12€
Amazigh 78 calls 0.12€
Adame199623 folds
*** TURN *** [2d 9h Qh][Td]
Fried Berg checks
Amazigh 78 bets 0.17€
Fried Berg folds
Amazigh 78 collected 0.60€ from pot
*** SUMMARY ***
Total pot 0.60€ | Rake 0.05€
Board: [2d 9h Qh Td]
Seat 2: Amazigh 78 (big blind) won 0.60€


Winamax Poker - HOLD-UP "Colorado" - HandId: #19116069-678501-1701695617 - Holdem no limit (0.01€/0.02€) - 2023/12/04 13:13:37 UTC
Table: 'Colorado' 6-max (real money) Seat #6 is the button
Seat 1: gueyf (2.94€)
Seat 2: wmx-6ooqtz9 (2€)
Seat 3: vuesurmer (2€)
Seat 4: Fried Berg (0.41€)
Seat 5: DeX70 (2.62€)
Seat 6: Pwinpwin (2.75€)
*** ANTE/BLINDS ***
gueyf posts small blind 0.01€
wmx-6ooqtz9 posts big blind 0.02€
Dealt to Fried Berg [Td Th]
*** PRE-FLOP *** 
vuesurmer folds
Fried Berg raises 0.06€ to 0.08€
DeX70 folds
Pwinpwin folds
gueyf folds
wmx-6ooqtz9 folds
Fried Berg collected 0.11€ from pot
*** SUMMARY ***
Total pot 0.11€ | No rake
Seat 4: Fried Berg won 0.11€


Winamax Poker - HOLD-UP "Colorado" - HandId: #19116069-678522-1701695633 - Holdem no limit (0.01€/0.02€) - 2023/12/04 13:13:53 UTC
Table: 'Colorado' 6-max (real money) Seat #6 is the button
Seat 1: AAgecanonix (2€)
Seat 2: samAaK (2€)
Seat 3: Pwinpwin (2.03€)
Seat 4: Franck f42 (2.17€)
Seat 5: Fried Berg (0.44€)
Seat 6: Kryshus (1.58€)
*** ANTE/BLINDS ***
AAgecanonix posts small blind 0.01€
samAaK posts big blind 0.02€
Dealt to Fried Berg [3s Jc]
*** PRE-FLOP *** 
Pwinpwin folds
Franck f42 folds
Fried Berg folds
Kryshus folds
AAgecanonix raises 0.04€ to 0.06€
samAaK calls 0.04€
*** FLOP *** [5h Ts Qc]
AAgecanonix bets 0.04€
samAaK calls 0.04€
*** TURN *** [5h Ts Qc][8d]
AAgecanonix bets 0.13€
samAaK calls 0.13€
*** RIVER *** [5h Ts Qc 8d][Tc]
AAgecanonix checks
samAaK bets 0.25€
AAgecanonix folds
samAaK collected 0.66€ from pot
*** SUMMARY ***
Total pot 0.66€ | Rake 0.05€
Board: [5h Ts Qc 8d Tc]
Seat 2: samAaK (big blind) won 0.66€


Winamax Poker - HOLD-UP "Colorado" - HandId: #19116069-678526-1701695637 - Holdem no limit (0.01€/0.02€) - 2023/12/04 13:13:57 UTC
Table: 'Colorado' 6-max (real money) Seat #6 is the button
Seat 1: Pwinpwin (2.03€)
Seat 2: Fried Berg (0.44€)
Seat 3: Lorenzo1 (0.56€)
Seat 4: Fabuenoooo (3.13€)
Seat 5: pilour59 (0.49€)
Seat 6: pasquale202a (1.48€)
*** ANTE/BLINDS ***
Pwinpwin posts small blind 0.01€
Fried Berg posts big blind 0.02€
Dealt to Fried Berg [9h 3h]
*** PRE-FLOP *** 
Lorenzo1 raises 0.02€ to 0.04€
Fabuenoooo folds
pilour59 calls 0.04€
pasquale202a folds
Pwinpwin raises 0.19€ to 0.23€
Fried Berg folds
Lorenzo1 calls 0.19€
pilour59 folds
*** FLOP *** [Jd 7h 8h]
Pwinpwin checks
Lorenzo1 bets 0.33€ and is all-in
Pwinpwin calls 0.33€
*** TURN *** [Jd 7h 8h][9s]
*** RIVER *** [Jd 7h 8h 9s][7c]
*** SHOW DOWN ***
Lorenzo1 shows [Ts Ks] (Straight Jack high)
Pwinpwin shows [Jc Jh] (Full of Jacks and 7)
Pwinpwin collected 1.06€ from pot
*** SUMMARY ***
Total pot 1.06€ | Rake 0.12€
Board: [Jd 7h 8h 9s 7c]
Seat 1: Pwinpwin (small blind) showed [Jc Jh] and won 1.06€ with Full of Jacks and 7
Seat 3: Lorenzo1 showed [Ts Ks] and lost with Straight Jack high


Winamax Poker - HOLD-UP "Colorado" - HandId: #19116069-678531-1701695639 - Holdem no limit (0.01€/0.02€) - 2023/12/04 13:13:59 UTC
Table: 'Colorado' 6-max (real money) Seat #6 is the button
Seat 1: dryer (1.97€)
Seat 2: LaTilteuse (3.39€)
Seat 3: Eddy Agricol (2€)
Seat 4: SlaBroLunAki (2.06€)
Seat 5: Fried Berg (0.42€)
Seat 6: JFSredbaron (2€)
*** ANTE/BLINDS ***
dryer posts small blind 0.01€
LaTilteuse posts big blind 0.02€
Dealt to Fried Berg [6h 2c]
*** PRE-FLOP *** 
Eddy Agricol folds
SlaBroLunAki folds
Fried Berg folds
JFSredbaron folds
dryer raises 0.02€ to 0.04€
LaTilteuse calls 0.02€
*** FLOP *** [4d 2s 4h]
dryer checks
LaTilteuse checks
*** TURN *** [4d 2s 4h][5s]
dryer bets 0.02€
LaTilteuse folds
dryer collected 0.09€ from pot
*** SUMMARY ***
Total pot 0.09€ | Rake 0.01€
Board: [4d 2s 4h 5s]
Seat 1: dryer (small blind) won 0.09€


Winamax Poker - HOLD-UP "Colorado" - HandId: #19116069-678536-1701695643 - Holdem no limit (0.01€/0.02€) - 2023/12/04 13:14:03 UTC
Table: 'Colorado' 6-max (real money) Seat #6 is the button
Seat 1: RSA_TO_VEGAS (2€)
Seat 2: BrokBroken (2€)
Seat 3: Fried Berg (0.42€)
Seat 4: EMBATAA (2€)
Seat 5: Eddy Agricol (2€)
Seat 6: CKrello (2€)
*** ANTE/BLINDS ***
RSA_TO_VEGAS posts small blind 0.01€
BrokBroken posts big blind 0.02€
Dealt to Fried Berg [7d 7s]
*** PRE-FLOP *** 
Fried Berg raises 0.02€ to 0.04€
EMBATAA folds
Eddy Agricol folds
CKrello folds
RSA_TO_VEGAS folds
BrokBroken calls 0.02€
*** FLOP *** [Kh 2c 3d]
BrokBroken checks
Fried Berg bets 0.08€
BrokBroken calls 0.08€
*** TURN *** [Kh 2c 3d][Ac]
BrokBroken checks
Fried Berg checks
*** RIVER *** [Kh 2c 3d Ac][Th]
BrokBroken checks
Fried Berg checks
*** SHOW DOWN ***
BrokBroken shows [Qh 2h] (One pair : 2)
Fried Berg shows [7d 7s] (One pair : 7)
Fried Berg collected 0.22€ from pot
*** SUMMARY ***
Total pot 0.22€ | Rake 0.03€
Board: [Kh 2c 3d Ac Th]
Seat 2: BrokBroken (big blind) showed [Qh 2h] and lost with One pair : 2
Seat 3: Fried Berg showed [7d 7s] and won 0.22€ with One pair : 7


Winamax Poker - HOLD-UP "Colorado" - HandId: #19116069-678582-1701695682 - Holdem no limit (0.01€/0.02€) - 2023/12/04 13:14:42 UTC
Table: 'Colorado' 6-max (real money) Seat #6 is the button
Seat 1: BrokBroken (2€)
Seat 2: crossRiver (2.11€)
Seat 3: Fabuenoooo (2.53€)
Seat 4: lesombre4 (2.47€)
Seat 5: kamclo (7.34€)
Seat 6: Fried Berg (0.52€)
*** ANTE/BLINDS ***
BrokBroken posts small blind 0.01€
crossRiver posts big blind 0.02€
Dealt to Fried Berg [5s Js]
*** PRE-FLOP *** 
Fabuenoooo folds
lesombre4 folds
kamclo folds
Fried Berg raises 0.02€ to 0.04€
BrokBroken calls 0.03€
crossRiver calls 0.02€
*** FLOP *** [Jh 5c Jd]
BrokBroken checks
crossRiver checks
Fried Berg bets 0.06€
BrokBroken folds
crossRiver calls 0.06€
*** TURN *** [Jh 5c Jd][6h]
crossRiver checks
Fried Berg bets 0.12€
crossRiver calls 0.12€
*** RIVER *** [Jh 5c Jd 6h][3c]
crossRiver checks
Fried Berg bets 0.24€
crossRiver calls 0.24€
*** SHOW DOWN ***
crossRiver shows [3h 5h] (Two pairs : Jacks and 5)
Fried Berg shows [5s Js] (Full of Jacks and 5)
Fried Berg collected 0.86€ from pot
*** SUMMARY ***
Total pot 0.86€ | Rake 0.10€
Board: [Jh 5c Jd 6h 3c]
Seat 2: crossRiver (big blind) showed [3h 5h] and lost with Two pairs : Jacks and 5
Seat 6: Fried Berg (button) showed [5s Js] and won 0.86€ with Full of Jacks and 5


Winamax Poker - HOLD-UP "Colorado" - HandId: #19116069-678684-1701695751 - Holdem no limit (0.01€/0.02€) - 2023/12/04 13:15:51 UTC
Table: 'Colorado' 6-max (real money) Seat #6 is the button
Seat 1: crossRiver (2€)
Seat 2: Fried Berg (0.92€)
Seat 3: daminapastor (2.02€)
Seat 4: leosommelier (1.49€)
Seat 5: curiouz dje (2.54€)
Seat 6: Pwinpwin (2.77€)
Hold-up to Pot: total 0.10€
*** ANTE/BLINDS ***
crossRiver posts small blind 0.01€
Fried Berg posts big blind 0.02€
Dealt to Fried Berg [9d Kh]
*** PRE-FLOP *** 
daminapastor folds
leosommelier folds
curiouz dje raises 0.04€ to 0.06€
Pwinpwin folds
crossRiver calls 0.05€
Fried Berg calls 0.04€
*** FLOP *** [Kd 3d 8d]
crossRiver checks
Fried Berg bets 0.12€
curiouz dje folds
crossRiver folds
Fried Berg collected 0.38€ from pot
*** SUMMARY ***
Total pot 0.38€ | Rake 0.02€
Board: [Kd 3d 8d]
Seat 2: Fried Berg (big blind) won 0.38€


Winamax Poker - HOLD-UP "Colorado" - HandId: #19116069-678746-1701695799 - Holdem no limit (0.01€/0.02€) - 2023/12/04 13:16:39 UTC
Table: 'Colorado' 6-max (real money) Seat #6 is the button
Seat 1: Fried Berg (1.12€)
Seat 2: JFSredbaron (2€)
Seat 3: daminapastor (2.16€)
Seat 4: BrokBroken (2.87€)
Seat 5: Gros_poisson (3.50€)
Seat 6: Franck f42 (2.37€)
*** ANTE/BLINDS ***
Fried Berg posts small blind 0.01€
JFSredbaron posts big blind 0.02€
Dealt to Fried Berg [7h 7c]
*** PRE-FLOP *** 
daminapastor folds
BrokBroken folds
Gros_poisson folds
Franck f42 folds
Fried Berg raises 0.02€ to 0.04€
JFSredbaron raises 0.14€ to 0.18€
Fried Berg calls 0.14€
*** FLOP *** [Js 9h 6c]
Fried Berg bets 0.12€
JFSredbaron calls 0.12€
*** TURN *** [Js 9h 6c][Jd]
Fried Berg checks
JFSredbaron bets 0.21€
Fried Berg calls 0.21€
*** RIVER *** [Js 9h 6c Jd][Ts]
Fried Berg checks
JFSredbaron checks
*** SHOW DOWN ***
JFSredbaron shows [Ah Ks] (One pair : Jacks)
Fried Berg shows [7h 7c] (Two pairs : Jacks and 7)
Fried Berg collected 0.92€ from pot
*** SUMMARY ***
Total pot 0.92€ | Rake 0.10€
Board: [Js 9h 6c Jd Ts]
Seat 1: Fried Berg (small blind) showed [7h 7c] and won 0.92€ with Two pairs : Jacks and 7
Seat 2: JFSredbaron (big blind) showed [Ah Ks] and lost with One pair : Jacks


Winamax Poker - HOLD-UP "Colorado" - HandId: #19116069-678832-1701695863 - Holdem no limit (0.01€/0.02€) - 2023/12/04 13:17:43 UTC
Table: 'Colorado' 6-max (real money) Seat #6 is the button
Seat 1: CKrello (2.14€)
Seat 2: Eddy Agricol (2.01€)
Seat 3: Fried Berg (1.53€)
Seat 4: Gros_poisson (2.09€)
Seat 5: JFSredbaron (2€)
Seat 6: TIRAMELas (3.98€)
*** ANTE/BLINDS ***
CKrello posts small blind 0.01€
Eddy Agricol posts big blind 0.02€
Dealt to Fried Berg [Ah 4s]
*** PRE-FLOP *** 
Fried Berg folds
Gros_poisson raises 0.03€ to 0.05€
JFSredbaron raises 0.13€ to 0.18€
TIRAMELas folds
CKrello folds
Eddy Agricol calls 0.16€
Gros_poisson folds
*** FLOP *** [Tc 4d 2s]
Eddy Agricol checks
JFSredbaron bets 0.27€
Eddy Agricol calls 0.27€
*** TURN *** [Tc 4d 2s][9s]
Eddy Agricol checks
JFSredbaron bets 0.62€
Eddy Agricol calls 0.62€
*** RIVER *** [Tc 4d 2s 9s][3s]
Eddy Agricol checks
JFSredbaron bets 0.93€ and is all-in
Eddy Agricol calls 0.93€
*** SHOW DOWN ***
Eddy Agricol shows [Kd Ac] (High card : Ace)
JFSredbaron shows [Qh Qd] (One pair : Queens)
JFSredbaron collected 3.65€ from pot
*** SUMMARY ***
Total pot 3.65€ | Rake 0.41€
Board: [Tc 4d 2s 9s 3s]
Seat 2: Eddy Agricol (big blind) showed [Kd Ac] and lost with High card : Ace
Seat 5: JFSredbaron showed [Qh Qd] and won 3.65€ with One pair : Queens


Winamax Poker - HOLD-UP "Colorado" - HandId: #19116069-678839-1701695868 - Holdem no limit (0.01€/0.02€) - 2023/12/04 13:17:48 UTC
Table: 'Colorado' 6-max (real money) Seat #6 is the button
Seat 1: ChtiPongiste (2€)
Seat 2: TIRAMELas (2.60€)
Seat 3: thatsasd (0.47€)
Seat 4: packymaitre (1.91€)
Seat 5: Kryshus (2.11€)
Seat 6: Fried Berg (1.53€)
*** ANTE/BLINDS ***
ChtiPongiste posts small blind 0.01€
TIRAMELas posts big blind 0.02€
Dealt to Fried Berg [As 9h]
*** PRE-FLOP *** 
thatsasd folds
packymaitre raises 0.04€ to 0.06€
Kryshus raises 0.16€ to 0.22€
Fried Berg folds
ChtiPongiste folds
TIRAMELas folds
packymaitre calls 0.16€
*** FLOP *** [Td 9c 3d]
packymaitre checks
Kryshus bets 0.16€
packymaitre calls 0.16€
*** TURN *** [Td 9c 3d][Tc]
packymaitre checks
Kryshus bets 0.51€
packymaitre calls 0.51€
*** RIVER *** [Td 9c 3d Tc][8s]
packymaitre checks
Kryshus bets 1.22€ and is all-in
packymaitre calls 1.02€ and is all-in
*** SHOW DOWN ***
packymaitre shows [Ad 9d] (Two pairs : Tens and 9)
Kryshus shows [Ks Kc] (Two pairs : Kings and Tens)
Kryshus collected 3.66€ from pot
*** SUMMARY ***
Total pot 3.66€ | Rake 0.39€
Board: [Td 9c 3d Tc 8s]
Seat 4: packymaitre showed [Ad 9d] and lost with Two pairs : Tens and 9
Seat 5: Kryshus showed [Ks Kc] and won 3.66€ with Two pairs : Kings and Tens


Winamax Poker - HOLD-UP "Colorado" - HandId: #19116069-678871-1701695894 - Holdem no limit (0.01€/0.02€) - 2023/12/04 13:18:14 UTC
Table: 'Colorado' 6-max (real money) Seat #6 is the button
Seat 1: kamclo (2.80€)
Seat 2: Pwinpwin (5.80€)
Seat 3: curiouz dje (4.24€)
Seat 4: Fried Berg (1.53€)
Seat 5: AAgecanonix (2.74€)
Seat 6: elAfiliado (0.41€)
*** ANTE/BLINDS ***
kamclo posts small blind 0.01€
Pwinpwin posts big blind 0.02€
Dealt to Fried Berg [Qh Jh]
*** PRE-FLOP *** 
curiouz dje folds
Fried Berg raises 0.02€ to 0.04€
AAgecanonix folds
elAfiliado folds
kamclo folds
Pwinpwin folds
Fried Berg collected 0.07€ from pot
*** SUMMARY ***
Total pot 0.07€ | No rake
Seat 4: Fried Berg won 0.07€


Winamax Poker - HOLD-UP "Colorado" - HandId: #19116069-678882-1701695901 - Holdem no limit (0.01€/0.02€) - 2023/12/04 13:18:21 UTC
Table: 'Colorado' 6-max (real money) Seat #6 is the button
Seat 1: Killim (0.76€)
Seat 2: LaTilteuse (3.09€)
Seat 3: wmx-6ooqtz9 (2€)
Seat 4: Fried Berg (1.56€)
Seat 5: Gros_poisson (2€)
Seat 6: ilergeta (2€)
*** ANTE/BLINDS ***
Killim posts small blind 0.01€
LaTilteuse posts big blind 0.02€
Dealt to Fried Berg [9d Ah]
*** PRE-FLOP *** 
wmx-6ooqtz9 folds
Fried Berg raises 0.02€ to 0.04€
Gros_poisson folds
ilergeta calls 0.04€
Killim folds
LaTilteuse calls 0.02€
*** FLOP *** [Ac 5h 6d]
LaTilteuse checks
Fried Berg bets 0.08€
ilergeta folds
LaTilteuse calls 0.08€
*** TURN *** [Ac 5h 6d][4c]
LaTilteuse checks
Fried Berg checks
*** RIVER *** [Ac 5h 6d 4c][9s]
LaTilteuse bets 0.22€
Fried Berg calls 0.22€
*** SHOW DOWN ***
LaTilteuse shows [4s As] (Two pairs : Aces and 4)
Fried Berg shows [9d Ah] (Two pairs : Aces and 9)
Fried Berg collected 0.66€ from pot
*** SUMMARY ***
Total pot 0.66€ | Rake 0.07€
Board: [Ac 5h 6d 4c 9s]
Seat 2: LaTilteuse (big blind) showed [4s As] and lost with Two pairs : Aces and 4
Seat 4: Fried Berg showed [9d Ah] and won 0.66€ with Two pairs : Aces and 9


Winamax Poker - HOLD-UP "Colorado" - HandId: #19116069-678928-1701695935 - Holdem no limit (0.01€/0.02€) - 2023/12/04 13:18:55 UTC
Table: 'Colorado' 6-max (real money) Seat #6 is the button
Seat 1: Pwinpwin (5.72€)
Seat 2: EMBATAA (2.79€)
Seat 3: Snake arc (0.46€)
Seat 4: Adame199623 (2€)
Seat 5: Fried Berg (1.88€)
Seat 6: Gros_poisson (3.71€)
Hold-up to Pot: total 0.10€
*** ANTE/BLINDS ***
Pwinpwin posts small blind 0.01€
EMBATAA posts big blind 0.02€
Dealt to Fried Berg [Ks 7c]
*** PRE-FLOP *** 
Snake arc folds
Adame199623 folds
Fried Berg folds
Gros_poisson raises 0.04€ to 0.06€
Pwinpwin folds
EMBATAA calls 0.04€
*** FLOP *** [Ts 4s 6c]
EMBATAA checks
Gros_poisson bets 0.08€
EMBATAA folds
Gros_poisson collected 0.30€ from pot
*** SUMMARY ***
Total pot 0.30€ | Rake 0.01€
Board: [Ts 4s 6c]
Seat 6: Gros_poisson (button) won 0.30€


Winamax Poker - HOLD-UP "Colorado" - HandId: #19116069-678939-1701695944 - Holdem no limit (0.01€/0.02€) - 2023/12/04 13:19:04 UTC
Table: 'Colorado' 6-max (real money) Seat #6 is the button
Seat 1: Thequeen1205 (2.08€)
Seat 2: Fried Berg (1.88€)
Seat 3: gueyf (1.95€)
Seat 4: JFSredbaron (2.92€)
Seat 5: Kryshus (3.66€)
Seat 6: SharkAKK (3.53€)
*** ANTE/BLINDS ***
Thequeen1205 posts small blind 0.01€
Fried Berg posts big blind 0.02€
Dealt to Fried Berg [7d As]
*** PRE-FLOP *** 
gueyf folds
JFSredbaron folds
Kryshus raises 0.04€ to 0.06€
SharkAKK folds
Thequeen1205 folds
Fried Berg calls 0.04€
*** FLOP *** [2d 4d Tc]
Fried Berg checks
Kryshus checks
*** TURN *** [2d 4d Tc][Ah]
Fried Berg checks
Kryshus bets 0.05€
Fried Berg calls 0.05€
*** RIVER *** [2d 4d Tc Ah][Ac]
Fried Berg checks
Kryshus bets 0.15€
Fried Berg raises 0.15€ to 0.30€
Kryshus folds
Fried Berg collected 0.63€ from pot
*** SUMMARY ***
Total pot 0.63€ | Rake 0.05€
Board: [2d 4d Tc Ah Ac]
Seat 2: Fried Berg (big blind) won 0.63€


Winamax Poker - HOLD-UP "Colorado" - HandId: #19116069-678986-1701695983 - Holdem no limit (0.01€/0.02€) - 2023/12/04 13:19:43 UTC
Table: 'Colorado' 6-max (real money) Seat #6 is the button
Seat 1: Fried Berg (2.10€)
Seat 2: Flo83601 (2€)
Seat 3: curiouz dje (2.32€)
Seat 4: nicky_poker (2€)
Seat 5: Eddy Agricol (2€)
Seat 6: st34r (0.54€)
*** ANTE/BLINDS ***
Fried Berg posts small blind 0.01€
Flo83601 posts big blind 0.02€
Dealt to Fried Berg [4s 2s]
*** PRE-FLOP *** 
curiouz dje folds
nicky_poker folds
Eddy Agricol raises 0.04€ to 0.06€
st34r folds
Fried Berg folds
Flo83601 calls 0.04€
*** FLOP *** [4d Th 8c]
Flo83601 checks
Eddy Agricol bets 0.05€
Flo83601 calls 0.05€
*** TURN *** [4d Th 8c][Kd]
Flo83601 checks
Eddy Agricol bets 0.08€
Flo83601 calls 0.08€
*** RIVER *** [4d Th 8c Kd][Tc]
Flo83601 checks
Eddy Agricol checks
*** SHOW DOWN ***
Flo83601 shows [7c Js] (One pair : Tens)
Eddy Agricol shows [Ad Qc] (One pair : Tens)
Eddy Agricol collected 0.35€ from pot
*** SUMMARY ***
Total pot 0.35€ | Rake 0.04€
Board: [4d Th 8c Kd Tc]
Seat 2: Flo83601 (big blind) showed [7c Js] and lost with One pair : Tens
Seat 5: Eddy Agricol showed [Ad Qc] and won 0.35€ with One pair : Tens


Winamax Poker - HOLD-UP "Colorado" - HandId: #19116069-678994-1701695990 - Holdem no limit (0.01€/0.02€) - 2023/12/04 13:19:50 UTC
Table: 'Colorado' 6-max (real money) Seat #6 is the button
Seat 1: Thequeen1205 (2€)
Seat 2: badou29 (2€)
Seat 3: Fried Berg (2.09€)
Seat 4: JFSredbaron (2.89€)
Seat 5: Franck f42 (2.40€)
Seat 6: Polanskii (2€)
*** ANTE/BLINDS ***
Thequeen1205 posts small blind 0.01€
badou29 posts big blind 0.02€
Dealt to Fried Berg [4c 7h]
*** PRE-FLOP *** 
Fried Berg folds
JFSredbaron folds
Franck f42 folds
Polanskii raises 0.05€ to 0.07€
Thequeen1205 folds
badou29 folds
Polanskii collected 0.10€ from pot
*** SUMMARY ***
Total pot 0.10€ | No rake
Seat 6: Polanskii (button) won 0.10€


Winamax Poker - HOLD-UP "Colorado" - HandId: #19116069-678997-1701695992 - Holdem no limit (0.01€/0.02€) - 2023/12/04 13:19:52 UTC
Table: 'Colorado' 6-max (real money) Seat #6 is the button
Seat 1: Scr.squirrel (2€)
Seat 2: Gros_poisson (3.86€)
Seat 3: Franck f42 (2.40€)
Seat 4: lesombre4 (2.24€)
Seat 5: Fried Berg (2.09€)
Seat 6: curiouz dje (3.35€)
Hold-up to Pot: total 0.10€
*** ANTE/BLINDS ***
Scr.squirrel posts small blind 0.01€
Gros_poisson posts big blind 0.02€
Dealt to Fried Berg [Jh 7h]
*** PRE-FLOP *** 
Franck f42 calls 0.02€
lesombre4 folds
Fried Berg calls 0.02€
curiouz dje calls 0.02€
Scr.squirrel folds
Gros_poisson checks
*** FLOP *** [Ad 2h Qc]
Gros_poisson checks
Franck f42 checks
Fried Berg checks
curiouz dje checks
*** TURN *** [Ad 2h Qc][5d]
Gros_poisson checks
Franck f42 checks
Fried Berg checks
curiouz dje checks
*** RIVER *** [Ad 2h Qc 5d][4c]
Gros_poisson checks
Franck f42 bets 0.07€
Fried Berg folds
curiouz dje calls 0.07€
Gros_poisson folds
*** SHOW DOWN ***
Franck f42 shows [7d 8h] (High card : Ace)
curiouz dje shows [Qd Jc] (One pair : Queens)
curiouz dje collected 0.31€ from pot
*** SUMMARY ***
Total pot 0.31€ | Rake 0.02€
Board: [Ad 2h Qc 5d 4c]
Seat 3: Franck f42 showed [7d 8h] and lost with High card : Ace
Seat 6: curiouz dje (button) showed [Qd Jc] and won 0.31€ with One pair : Queens


Winamax Poker - HOLD-UP "Colorado" - HandId: #19116069-679056-1701696042 - Holdem no limit (0.01€/0.02€) - 2023/12/04 13:20:42 UTC
Table: 'Colorado' 6-max (real money) Seat #6 is the button
Seat 1: SergioAK (3.47€)
Seat 2: kamclo (2.64€)
Seat 3: Erenox (0.57€)
Seat 4: Fried Berg (2.07€)
Seat 5: Thequeen1205 (2.28€)
Seat 6: CKrello (2.14€)
*** ANTE/BLINDS ***
SergioAK posts small blind 0.01€
kamclo posts big blind 0.02€
Dealt to Fried Berg [Jc 7s]
*** PRE-FLOP *** 
Erenox raises 0.04€ to 0.06€
Fried Berg folds
Thequeen1205 folds
CKrello folds
SergioAK calls 0.05€
kamclo folds
*** FLOP *** [5s Ad 8h]
SergioAK checks
Erenox checks
*** TURN *** [5s Ad 8h][Td]
SergioAK checks
Erenox checks
*** RIVER *** [5s Ad 8h Td][9s]
SergioAK checks
Erenox bets 0.02€
SergioAK folds
Erenox collected 0.15€ from pot
*** SUMMARY ***
Total pot 0.15€ | Rake 0.01€
Board: [5s Ad 8h Td 9s]
Seat 3: Erenox won 0.15€


Winamax Poker - HOLD-UP "Colorado" - HandId: #19116069-679060-1701696044 - Holdem no limit (0.01€/0.02€) - 2023/12/04 13:20:44 UTC
Table: 'Colorado' 6-max (real money) Seat #6 is the button
Seat 1: Polanskii (2.16€)
Seat 2: Pwinpwin (2.47€)
Seat 3: biguglia2b (2€)
Seat 4: Pa_digue (1.93€)
Seat 5: nicky_poker (2€)
Seat 6: Fried Berg (2.07€)
*** ANTE/BLINDS ***
Polanskii posts small blind 0.01€
Pwinpwin posts big blind 0.02€
Dealt to Fried Berg [6c 2c]
*** PRE-FLOP *** 
biguglia2b folds
Pa_digue calls 0.02€
nicky_poker raises 0.07€ to 0.09€
Fried Berg folds
Polanskii calls 0.08€
Pwinpwin folds
Pa_digue folds
*** FLOP *** [7s 4s 4d]
Polanskii checks
nicky_poker bets 0.06€
Polanskii raises 2.01€ to 2.07€ and is all-in
nicky_poker folds
Polanskii collected 2.32€ from pot
*** SUMMARY ***
Total pot 2.32€ | Rake 0.03€
Board: [7s 4s 4d]
Seat 1: Polanskii (small blind) won 2.32€


Winamax Poker - HOLD-UP "Colorado" - HandId: #19116069-679071-1701696053 - Holdem no limit (0.01€/0.02€) - 2023/12/04 13:20:53 UTC
Table: 'Colorado' 6-max (real money) Seat #6 is the button
Seat 1: JFSredbaron (3.64€)
Seat 2: Fried Berg (2.07€)
Seat 3: Thequeen1205 (2.27€)
Seat 4: _Croute_ (2.41€)
Seat 5: lesombre4 (2.18€)
Seat 6: st34r (0.67€)
*** ANTE/BLINDS ***
JFSredbaron posts small blind 0.01€
Fried Berg posts big blind 0.02€
Dealt to Fried Berg [5s 2c]
*** PRE-FLOP *** 
Thequeen1205 folds
_Croute_ folds
lesombre4 folds
st34r folds
JFSredbaron raises 0.04€ to 0.06€
Fried Berg folds
JFSredbaron collected 0.08€ from pot
*** SUMMARY ***
Total pot 0.08€ | No rake
Seat 1: JFSredbaron (small blind) won 0.08€


Winamax Poker - HOLD-UP "Colorado" - HandId: #19116069-679083-1701696062 - Holdem no limit (0.01€/0.02€) - 2023/12/04 13:21:02 UTC
Table: 'Colorado' 6-max (real money) Seat #6 is the button
Seat 1: shaka004 (1.83€)
Seat 2: SashaTDouss (2.30€)
Seat 3: Fried Berg (2.05€)
Seat 4: gbtcorp (0.94€)
Seat 5: CKrello (3.11€)
Seat 6: Pwinpwin (2.45€)
*** ANTE/BLINDS ***
shaka004 posts small blind 0.01€
SashaTDouss posts big blind 0.02€
Dealt to Fried Berg [7h Ad]
*** PRE-FLOP *** 
Fried Berg raises 0.02€ to 0.04€
gbtcorp folds
CKrello folds
Pwinpwin folds
shaka004 folds
SashaTDouss calls 0.02€
*** FLOP *** [3h 9d Qd]
SashaTDouss checks
Fried Berg checks
*** TURN *** [3h 9d Qd][5s]
SashaTDouss bets 0.06€
Fried Berg folds
SashaTDouss collected 0.14€ from pot
*** SUMMARY ***
Total pot 0.14€ | Rake 0.01€
Board: [3h 9d Qd 5s]
Seat 2: SashaTDouss (big blind) won 0.14€


Winamax Poker - HOLD-UP "Colorado" - HandId: #19116069-679124-1701696092 - Holdem no limit (0.01€/0.02€) - 2023/12/04 13:21:32 UTC
Table: 'Colorado' 6-max (real money) Seat #6 is the button
Seat 1: Fried Berg (2.01€)
Seat 2: Mametzien (3.11€)
Seat 3: Erenox (3.36€)
Seat 4: gbtcorp (4.33€)
Seat 5: Thequeen1205 (2.02€)
Seat 6: CKrello (2.20€)
*** ANTE/BLINDS ***
Fried Berg posts small blind 0.01€
Mametzien posts big blind 0.02€
Dealt to Fried Berg [3s Jc]
*** PRE-FLOP *** 
Erenox folds
gbtcorp folds
Thequeen1205 folds
CKrello folds
Fried Berg folds
Mametzien collected 0.03€ from pot
*** SUMMARY ***
Total pot 0.03€ | No rake
Seat 2: Mametzien (big blind) won 0.03€


Winamax Poker - HOLD-UP "Colorado" - HandId: #19116069-679131-1701696098 - Holdem no limit (0.01€/0.02€) - 2023/12/04 13:21:38 UTC
Table: 'Colorado' 6-max (real money) Seat #6 is the button
Seat 1: gbtcorp (4.33€)
Seat 2: Thequeen1205 (2.02€)
Seat 3: JFSredbaron (2.46€)
Seat 4: kamclo (4.13€)
Seat 5: Fried Berg (2€)
Seat 6: Homer14510 (3.65€)
*** ANTE/BLINDS ***
gbtcorp posts small blind 0.01€
Thequeen1205 posts big blind 0.02€
Dealt to Fried Berg [Ts Qh]
*** PRE-FLOP *** 
JFSredbaron folds
kamclo folds
Fried Berg raises 0.02€ to 0.04€
Homer14510 folds
gbtcorp folds
Thequeen1205 folds
Fried Berg collected 0.07€ from pot
*** SUMMARY ***
Total pot 0.07€ | No rake
Seat 5: Fried Berg won 0.07€


Winamax Poker - HOLD-UP "Colorado" - HandId: #19116069-679146-1701696111 - Holdem no limit (0.01€/0.02€) - 2023/12/04 13:21:51 UTC
Table: 'Colorado' 6-max (real money) Seat #6 is the button
Seat 1: packymaitre (3.44€)
Seat 2: Kryshus (1.11€)
Seat 3: Franck f42 (2.33€)
Seat 4: TIRAMELas (2.03€)
Seat 5: Fried Berg (2.03€)
Seat 6: n13tless (2.29€)
*** ANTE/BLINDS ***
packymaitre posts small blind 0.01€
Kryshus posts big blind 0.02€
Dealt to Fried Berg [9s 2h]
*** PRE-FLOP *** 
Franck f42 folds
TIRAMELas folds
Fried Berg folds
n13tless folds
packymaitre folds
Kryshus collected 0.03€ from pot
*** SUMMARY ***
Total pot 0.03€ | No rake
Seat 2: Kryshus (big blind) won 0.03€


Winamax Poker - HOLD-UP "Colorado" - HandId: #19116069-679151-1701696115 - Holdem no limit (0.01€/0.02€) - 2023/12/04 13:21:55 UTC
Table: 'Colorado' 6-max (real money) Seat #6 is the button
Seat 1: Mametzien (1.88€)
Seat 2: Kangourou589 (2€)
Seat 3: _Croute_ (2.33€)
Seat 4: Erenox (0.51€)
Seat 5: CKrello (2.20€)
Seat 6: Fried Berg (2.03€)
*** ANTE/BLINDS ***
Mametzien posts small blind 0.01€
Kangourou589 posts big blind 0.02€
Dealt to Fried Berg [Ac 2c]
*** PRE-FLOP *** 
_Croute_ folds
Erenox folds
CKrello folds
Fried Berg raises 0.02€ to 0.04€
Mametzien calls 0.03€
Kangourou589 calls 0.02€
*** FLOP *** [As 5s 4d]
Mametzien checks
Kangourou589 checks
Fried Berg bets 0.02€
Mametzien folds
Kangourou589 calls 0.02€
*** TURN *** [As 5s 4d][Tc]
Kangourou589 checks
Fried Berg bets 0.02€
Kangourou589 calls 0.02€
*** RIVER *** [As 5s 4d Tc][2h]
Kangourou589 checks
Fried Berg bets 0.08€
Kangourou589 calls 0.08€
*** SHOW DOWN ***
Kangourou589 shows [8s Ts] (One pair : Tens)
Fried Berg shows [Ac 2c] (Two pairs : Aces and 2)
Fried Berg collected 0.32€ from pot
*** SUMMARY ***
Total pot 0.32€ | Rake 0.04€
Board: [As 5s 4d Tc 2h]
Seat 2: Kangourou589 (big blind) showed [8s Ts] and lost with One pair : Tens
Seat 6: Fried Berg (button) showed [Ac 2c] and won 0.32€ with Two pairs : Aces and 2


Winamax Poker - HOLD-UP "Colorado" - HandId: #19116069-679198-1701696158 - Holdem no limit (0.01€/0.02€) - 2023/12/04 13:22:38 UTC
Table: 'Colorado' 6-max (real money) Seat #6 is the button
Seat 1: Kangourou589 (1.84€)
Seat 2: Fried Berg (2.19€)
Seat 3: packymaitre (0.65€)
Seat 4: floflo31490 (0.73€)
Seat 5: Piexxxe10 (2.05€)
Seat 6: Thequeen1205 (2.11€)
*** ANTE/BLINDS ***
Kangourou589 posts small blind 0.01€
Fried Berg posts big blind 0.02€
Dealt to Fried Berg [Jh Kc]
*** PRE-FLOP *** 
packymaitre folds
floflo31490 folds
Piexxxe10 folds
Thequeen1205 folds
Kangourou589 calls 0.01€
Fried Berg checks
*** FLOP *** [9d 7s 8c]
Kangourou589 bets 0.03€
Fried Berg calls 0.03€
*** TURN *** [9d 7s 8c][Jd]
Kangourou589 checks
Fried Berg checks
*** RIVER *** [9d 7s 8c Jd][3h]
Kangourou589 bets 0.07€
Fried Berg calls 0.07€
*** SHOW DOWN ***
Kangourou589 shows [8s 4s] (One pair : 8)
Fried Berg shows [Jh Kc] (One pair : Jacks)
Fried Berg collected 0.22€ from pot
*** SUMMARY ***
Total pot 0.22€ | Rake 0.02€
Board: [9d 7s 8c Jd 3h]
Seat 1: Kangourou589 (small blind) showed [8s 4s] and lost with One pair : 8
Seat 2: Fried Berg (big blind) showed [Jh Kc] and won 0.22€ with One pair : Jacks


Winamax Poker - HOLD-UP "Colorado" - HandId: #19116069-679228-1701696183 - Holdem no limit (0.01€/0.02€) - 2023/12/04 13:23:03 UTC
Table: 'Colorado' 6-max (real money) Seat #6 is the button
Seat 1: Fried Berg (2.29€)
Seat 2: nicky_poker (4.66€)
Seat 3: Kangourou589 (1.72€)
Seat 4: Thequeen1205 (2.08€)
Seat 5: kamclo (2.25€)
Seat 6: Erenox (3.26€)
*** ANTE/BLINDS ***
Fried Berg posts small blind 0.01€
nicky_poker posts big blind 0.02€
Dealt to Fried Berg [Jc 7s]
*** PRE-FLOP *** 
Kangourou589 folds
Thequeen1205 folds
kamclo folds
Erenox folds
Fried Berg folds
nicky_poker collected 0.03€ from pot
*** SUMMARY ***
Total pot 0.03€ | No rake
Seat 2: nicky_poker (big blind) won 0.03€


Winamax Poker - HOLD-UP "Colorado" - HandId: #19116069-679244-1701696195 - Holdem no limit (0.01€/0.02€) - 2023/12/04 13:23:15 UTC
Table: 'Colorado' 6-max (real money) Seat #6 is the button
Seat 1: Thequeen1205 (2.24€)
Seat 2: curiouz dje (3.47€)
Seat 3: HardAsStone (6.46€)
Seat 4: Killim (0.83€)
Seat 5: Franck f42 (2.37€)
Seat 6: Fried Berg (2.28€)
*** ANTE/BLINDS ***
Thequeen1205 posts small blind 0.01€
curiouz dje posts big blind 0.02€
Dealt to Fried Berg [4d 4h]
*** PRE-FLOP *** 
HardAsStone folds
Killim folds
Franck f42 folds
Fried Berg raises 0.02€ to 0.04€
Thequeen1205 folds
curiouz dje calls 0.02€
*** FLOP *** [Td 6h 3d]
curiouz dje checks
Fried Berg checks
*** TURN *** [Td 6h 3d][Jd]
curiouz dje checks
Fried Berg checks
*** RIVER *** [Td 6h 3d Jd][2c]
curiouz dje checks
Fried Berg bets 0.04€
curiouz dje folds
Fried Berg collected 0.12€ from pot
*** SUMMARY ***
Total pot 0.12€ | Rake 0.01€
Board: [Td 6h 3d Jd 2c]
Seat 6: Fried Berg (button) won 0.12€


Winamax Poker - HOLD-UP "Colorado" - HandId: #19116069-679304-1701696250 - Holdem no limit (0.01€/0.02€) - 2023/12/04 13:24:10 UTC
Table: 'Colorado' 6-max (real money) Seat #6 is the button
Seat 1: generois (1.11€)
Seat 2: Tofini (2€)
Seat 3: Fried Berg (2.32€)
Seat 4: n13tless (2.77€)
Seat 5: CKrello (2.13€)
Seat 6: Mametzien (3.44€)
*** ANTE/BLINDS ***
generois posts small blind 0.01€
Tofini posts big blind 0.02€
Dealt to Fried Berg [5c 7s]
*** PRE-FLOP *** 
Fried Berg folds
n13tless folds
CKrello folds
Mametzien calls 0.02€
generois raises 0.04€ to 0.06€
Tofini folds
Mametzien calls 0.04€
*** FLOP *** [Tc 3c Th]
generois bets 0.09€
Mametzien folds
generois collected 0.22€ from pot
*** SUMMARY ***
Total pot 0.22€ | Rake 0.01€
Board: [Tc 3c Th]
Seat 1: generois (small blind) won 0.22€


Winamax Poker - HOLD-UP "Colorado" - HandId: #19116069-679311-1701696254 - Holdem no limit (0.01€/0.02€) - 2023/12/04 13:24:14 UTC
Table: 'Colorado' 6-max (real money) Seat #6 is the button
Seat 1: Rpggrd (0.58€)
Seat 2: packymaitre (3.43€)
Seat 3: kamclo (2.53€)
Seat 4: Fried Berg (2.32€)
Seat 5: robertvali20 (2.71€)
Seat 6: gbtcorp (0.86€)
*** ANTE/BLINDS ***
Rpggrd posts small blind 0.01€
packymaitre posts big blind 0.02€
Dealt to Fried Berg [3c Ac]
*** PRE-FLOP *** 
kamclo raises 0.05€ to 0.07€
Fried Berg calls 0.07€
robertvali20 folds
gbtcorp folds
Rpggrd folds
packymaitre raises 0.14€ to 0.21€
kamclo calls 0.14€
Fried Berg folds
*** FLOP *** [Th 8h Kd]
packymaitre bets 0.50€
kamclo folds
packymaitre collected 0.95€ from pot
*** SUMMARY ***
Total pot 0.95€ | Rake 0.05€
Board: [Th 8h Kd]
Seat 2: packymaitre (big blind) won 0.95€


Winamax Poker - HOLD-UP "Colorado" - HandId: #19116069-679362-1701696292 - Holdem no limit (0.01€/0.02€) - 2023/12/04 13:24:52 UTC
Table: 'Colorado' 6-max (real money) Seat #6 is the button
Seat 1: Fried Berg (2.25€)
Seat 2: Mathislgt31 (2.85€)
Seat 3: DaniRama (2€)
Seat 4: generois (1.18€)
Seat 5: pasquale202a (3.46€)
Seat 6: curiouz dje (4.25€)
*** ANTE/BLINDS ***
Fried Berg posts small blind 0.01€
Mathislgt31 posts big blind 0.02€
Dealt to Fried Berg [6s Ad]
*** PRE-FLOP *** 
DaniRama raises 0.03€ to 0.05€
generois folds
pasquale202a folds
curiouz dje folds
Fried Berg folds
Mathislgt31 calls 0.03€
*** FLOP *** [5h 7h 6h]
Mathislgt31 bets 0.02€
DaniRama calls 0.02€
*** TURN *** [5h 7h 6h][Ts]
Mathislgt31 bets 0.10€
DaniRama calls 0.10€
*** RIVER *** [5h 7h 6h Ts][Jc]
Mathislgt31 bets 0.23€
DaniRama calls 0.23€
*** SHOW DOWN ***
DaniRama shows [Js Kh] (One pair : Jacks)
Mathislgt31 shows [Qd Qc] (One pair : Queens)
Mathislgt31 collected 0.73€ from pot
*** SUMMARY ***
Total pot 0.73€ | Rake 0.08€
Board: [5h 7h 6h Ts Jc]
Seat 2: Mathislgt31 (big blind) showed [Qd Qc] and won 0.73€ with One pair : Queens
Seat 3: DaniRama showed [Js Kh] and lost with One pair : Jacks


Winamax Poker - HOLD-UP "Colorado" - HandId: #19116069-679366-1701696294 - Holdem no limit (0.01€/0.02€) - 2023/12/04 13:24:54 UTC
Table: 'Colorado' 6-max (real money) Seat #6 is the button
Seat 1: Thequeen1205 (2.02€)
Seat 2: Fried Berg (2.24€)
Seat 3: Erenox (2.98€)
Seat 4: Gros_poisson (2.30€)
Seat 5: Killim (0.55€)
Seat 6: Pa_digue (1.58€)
*** ANTE/BLINDS ***
Thequeen1205 posts small blind 0.01€
Fried Berg posts big blind 0.02€
Dealt to Fried Berg [5h 4d]
*** PRE-FLOP *** 
Erenox raises 0.04€ to 0.06€
Gros_poisson folds
Killim folds
Pa_digue raises 0.09€ to 0.15€
Thequeen1205 folds
Fried Berg folds
Erenox calls 0.09€
*** FLOP *** [7h As 3c]
Erenox bets 0.17€
Pa_digue calls 0.17€
*** TURN *** [7h As 3c][2d]
Erenox bets 0.17€
Pa_digue raises 0.17€ to 0.34€
Erenox folds
Pa_digue collected 1.08€ from pot
*** SUMMARY ***
Total pot 1.08€ | Rake 0.10€
Board: [7h As 3c 2d]
Seat 6: Pa_digue (button) won 1.08€


Winamax Poker - HOLD-UP "Colorado" - HandId: #19116069-679370-1701696297 - Holdem no limit (0.01€/0.02€) - 2023/12/04 13:24:57 UTC
Table: 'Colorado' 6-max (real money) Seat #6 is the button
Seat 1: Scr.squirrel (2.08€)
Seat 2: Thequeen1205 (2.01€)
Seat 3: Fried Berg (2.22€)
Seat 4: Tofini (2€)
Seat 5: nicky_poker (2.52€)
Seat 6: gueyf (0.84€)
*** ANTE/BLINDS ***
Scr.squirrel posts small blind 0.01€
Thequeen1205 posts big blind 0.02€
Dealt to Fried Berg [2h 5s]
*** PRE-FLOP *** 
Fried Berg folds
Tofini raises 0.03€ to 0.05€
nicky_poker raises 0.12€ to 0.17€
gueyf folds
Scr.squirrel calls 0.16€
Thequeen1205 folds
Tofini raises 0.29€ to 0.46€
nicky_poker folds
Scr.squirrel calls 0.29€
*** FLOP *** [Ts As 8s]
Scr.squirrel checks
Tofini bets 0.39€
Scr.squirrel raises 1.23€ to 1.62€ and is all-in
Tofini calls 1.15€ and is all-in
*** TURN *** [Ts As 8s][Kh]
*** RIVER *** [Ts As 8s Kh][Qc]
*** SHOW DOWN ***
Scr.squirrel shows [8d 8h] (Trips of 8)
Tofini shows [Ah Ad] (Trips of Aces)
Tofini collected 3.77€ from main pot
Scr.squirrel collected 0.08€ from side pot 1
*** SUMMARY ***
Total pot 3.85€ | Rake 0.42€
Board: [Ts As 8s Kh Qc]
Seat 1: Scr.squirrel (small blind) showed [8d 8h] and won 0.08€ with Trips of 8
Seat 4: Tofini showed [Ah Ad] and won 3.77€ with Trips of Aces


Winamax Poker - HOLD-UP "Colorado" - HandId: #19116069-679374-1701696299 - Holdem no limit (0.01€/0.02€) - 2023/12/04 13:24:59 UTC
Table: 'Colorado' 6-max (real money) Seat #6 is the button
Seat 1: Kryshus (1.22€)
Seat 2: gbtcorp (4.03€)
Seat 3: slimzzr (0.50€)
Seat 4: Fried Berg (2.22€)
Seat 5: TIRAMELas (3.78€)
Seat 6: Gros_poisson (3.35€)
*** ANTE/BLINDS ***
Kryshus posts small blind 0.01€
gbtcorp posts big blind 0.02€
Dealt to Fried Berg [6d As]
*** PRE-FLOP *** 
slimzzr folds
Fried Berg folds
TIRAMELas raises 0.04€ to 0.06€
Gros_poisson folds
Kryshus folds
gbtcorp folds
TIRAMELas collected 0.09€ from pot
*** SUMMARY ***
Total pot 0.09€ | No rake
Seat 5: TIRAMELas won 0.09€


Winamax Poker - HOLD-UP "Colorado" - HandId: #19116069-679379-1701696303 - Holdem no limit (0.01€/0.02€) - 2023/12/04 13:25:03 UTC
Table: 'Colorado' 6-max (real money) Seat #6 is the button
Seat 1: JFSredbaron (2.80€)
Seat 2: Gros_poisson (3.35€)
Seat 3: CKrello (2.87€)
Seat 4: slimzzr (0.50€)
Seat 5: Fried Berg (2.22€)
Seat 6: Mametzien (2.09€)
*** ANTE/BLINDS ***
JFSredbaron posts small blind 0.01€
Gros_poisson posts big blind 0.02€
Dealt to Fried Berg [5d 9d]
*** PRE-FLOP *** 
CKrello folds
slimzzr raises 0.03€ to 0.05€
Fried Berg folds
Mametzien calls 0.05€
JFSredbaron folds
Gros_poisson raises 0.15€ to 0.20€
slimzzr folds
Mametzien calls 0.15€
*** FLOP *** [Ks 6h 8s]
Gros_poisson checks
Mametzien checks
*** TURN *** [Ks 6h 8s][7s]
Gros_poisson bets 0.16€
Mametzien calls 0.16€
*** RIVER *** [Ks 6h 8s 7s][Kc]
Gros_poisson checks
Mametzien bets 0.27€
Gros_poisson folds
Mametzien collected 0.97€ from pot
*** SUMMARY ***
Total pot 0.97€ | Rake 0.08€
Board: [Ks 6h 8s 7s Kc]
Seat 6: Mametzien (button) won 0.97€


Winamax Poker - HOLD-UP "Colorado" - HandId: #19116069-679385-1701696309 - Holdem no limit (0.01€/0.02€) - 2023/12/04 13:25:09 UTC
Table: 'Colorado' 6-max (real money) Seat #6 is the button
Seat 1: metamex (1.98€)
Seat 2: Kryshus (1.21€)
Seat 3: SergioAK (4.97€)
Seat 4: CKrello (2.87€)
Seat 5: gbtcorp (4.01€)
Seat 6: Fried Berg (2.22€)
*** ANTE/BLINDS ***
metamex posts small blind 0.01€
Kryshus posts big blind 0.02€
Dealt to Fried Berg [3h Jd]
*** PRE-FLOP *** 
SergioAK folds
CKrello folds
gbtcorp folds
Fried Berg raises 0.02€ to 0.04€
metamex raises 0.12€ to 0.16€
Kryshus folds
Fried Berg folds
metamex collected 0.22€ from pot
*** SUMMARY ***
Total pot 0.22€ | No rake
Seat 1: metamex (small blind) won 0.22€


Winamax Poker - HOLD-UP "Colorado" - HandId: #19116069-679412-1701696329 - Holdem no limit (0.01€/0.02€) - 2023/12/04 13:25:29 UTC
Table: 'Colorado' 6-max (real money) Seat #6 is the button
Seat 1: st34r (0.56€)
Seat 2: Thequeen1205 (2.82€)
Seat 3: badou29 (2.15€)
Seat 4: CKrello (2.58€)
Seat 5: Fried Berg (2.18€)
Seat 6: curiouz dje (3.19€)
*** ANTE/BLINDS ***
st34r posts small blind 0.01€
Thequeen1205 posts big blind 0.02€
Dealt to Fried Berg [4s 4c]
*** PRE-FLOP *** 
badou29 folds
CKrello folds
Fried Berg raises 0.02€ to 0.04€
curiouz dje folds
st34r calls 0.03€
Thequeen1205 calls 0.02€
*** FLOP *** [Tc Qc 9c]
st34r checks
Thequeen1205 checks
Fried Berg bets 0.12€
st34r folds
Thequeen1205 folds
Fried Berg collected 0.23€ from pot
*** SUMMARY ***
Total pot 0.23€ | Rake 0.01€
Board: [Tc Qc 9c]
Seat 5: Fried Berg won 0.23€


Winamax Poker - HOLD-UP "Colorado" - HandId: #19116069-679464-1701696373 - Holdem no limit (0.01€/0.02€) - 2023/12/04 13:26:13 UTC
Table: 'Colorado' 6-max (real money) Seat #6 is the button
Seat 1: Gros_poisson (2.99€)
Seat 2: SergioAK (3.95€)
Seat 3: curiouz dje (2.28€)
Seat 4: _Croute_ (2.94€)
Seat 5: gbtcorp (4.06€)
Seat 6: Fried Berg (2.25€)
*** ANTE/BLINDS ***
Gros_poisson posts small blind 0.01€
SergioAK posts big blind 0.02€
Dealt to Fried Berg [9c 9h]
*** PRE-FLOP *** 
curiouz dje folds
_Croute_ folds
gbtcorp folds
Fried Berg raises 0.02€ to 0.04€
Gros_poisson folds
SergioAK folds
Fried Berg collected 0.07€ from pot
*** SUMMARY ***
Total pot 0.07€ | No rake
Seat 6: Fried Berg (button) won 0.07€


Winamax Poker - HOLD-UP "Colorado" - HandId: #19116069-679494-1701696394 - Holdem no limit (0.01€/0.02€) - 2023/12/04 13:26:34 UTC
Table: 'Colorado' 6-max (real money) Seat #6 is the button
Seat 1: nicky_poker (4.23€)
Seat 2: _ilTulipano_ (2€)
Seat 3: Fried Berg (2.28€)
Seat 4: Eddy Agricol (2€)
Seat 5: wmx-6ooqtz9 (2€)
Seat 6: Pwinpwin (2.25€)
*** ANTE/BLINDS ***
nicky_poker posts small blind 0.01€
_ilTulipano_ posts big blind 0.02€
Dealt to Fried Berg [2h Ad]
*** PRE-FLOP *** 
Fried Berg folds
Eddy Agricol raises 0.04€ to 0.06€
wmx-6ooqtz9 folds
Pwinpwin folds
nicky_poker folds
_ilTulipano_ folds
Eddy Agricol collected 0.09€ from pot
*** SUMMARY ***
Total pot 0.09€ | No rake
Seat 4: Eddy Agricol won 0.09€


Winamax Poker - HOLD-UP "Colorado" - HandId: #19116069-679501-1701696398 - Holdem no limit (0.01€/0.02€) - 2023/12/04 13:26:38 UTC
Table: 'Colorado' 6-max (real money) Seat #6 is the button
Seat 1: Fried Berg (2.28€)
Seat 2: Thequeen1205 (2.77€)
Seat 3: n13tless (2.52€)
Seat 4: Pwinpwin (3.85€)
Seat 5: st34r (0.53€)
Seat 6: packymaitre (1.48€)
*** ANTE/BLINDS ***
Fried Berg posts small blind 0.01€
Thequeen1205 posts big blind 0.02€
Dealt to Fried Berg [5c Th]
*** PRE-FLOP *** 
n13tless folds
Pwinpwin folds
st34r folds
packymaitre raises 0.04€ to 0.06€
Fried Berg folds
Thequeen1205 folds
packymaitre collected 0.09€ from pot
*** SUMMARY ***
Total pot 0.09€ | No rake
Seat 6: packymaitre (button) won 0.09€


Winamax Poker - HOLD-UP "Colorado" - HandId: #19116069-679516-1701696406 - Holdem no limit (0.01€/0.02€) - 2023/12/04 13:26:46 UTC
Table: 'Colorado' 6-max (real money) Seat #6 is the button
Seat 1: x spoony (2€)
Seat 2: Fried Berg (2.27€)
Seat 3: SharkAKK (3.58€)
Seat 4: kamclo (2.89€)
Seat 5: samAaK (3.91€)
Seat 6: Killim (0.77€)
*** ANTE/BLINDS ***
x spoony posts small blind 0.01€
Fried Berg posts big blind 0.02€
Dealt to Fried Berg [Jd 2d]
*** PRE-FLOP *** 
SharkAKK folds
kamclo folds
samAaK raises 0.03€ to 0.05€
Killim folds
x spoony folds
Fried Berg calls 0.03€
*** FLOP *** [Ts 9d Qs]
Fried Berg checks
samAaK bets 0.06€
Fried Berg calls 0.06€
*** TURN *** [Ts 9d Qs][6d]
Fried Berg checks
samAaK bets 0.15€
Fried Berg calls 0.15€
*** RIVER *** [Ts 9d Qs 6d][Qh]
Fried Berg checks
samAaK bets 0.53€
Fried Berg folds
samAaK collected 1.01€ from pot
*** SUMMARY ***
Total pot 1.01€ | Rake 0.05€
Board: [Ts 9d Qs 6d Qh]
Seat 5: samAaK won 1.01€


Winamax Poker - HOLD-UP "Colorado" - HandId: #19116069-679653-1701696489 - Holdem no limit (0.01€/0.02€) - 2023/12/04 13:28:09 UTC
Table: 'Colorado' 6-max (real money) Seat #6 is the button
Seat 1: _Croute_ (2.89€)
Seat 2: Pwinpwin (4.03€)
Seat 3: Fried Berg (2.01€)
Seat 4: Thequeen1205 (2.69€)
Seat 5: JFSredbaron (2.70€)
Seat 6: TIRAMELas (2.08€)
*** ANTE/BLINDS ***
_Croute_ posts small blind 0.01€
Pwinpwin posts big blind 0.02€
Dealt to Fried Berg [Kd 2s]
*** PRE-FLOP *** 
Fried Berg folds
Thequeen1205 folds
JFSredbaron folds
TIRAMELas folds
_Croute_ folds
Pwinpwin collected 0.03€ from pot
*** SUMMARY ***
Total pot 0.03€ | No rake
Seat 2: Pwinpwin (big blind) won 0.03€


Winamax Poker - HOLD-UP "Colorado" - HandId: #19116069-679663-1701696497 - Holdem no limit (0.01€/0.02€) - 2023/12/04 13:28:17 UTC
Table: 'Colorado' 6-max (real money) Seat #6 is the button
Seat 1: wmx-6ooqtz9 (2.60€)
Seat 2: The Qualm (2.15€)
Seat 3: packymaitre (0.20€)
Seat 4: Fried Berg (2.01€)
Seat 5: Erenox (1.54€)
Seat 6: x spoony (2€)
*** ANTE/BLINDS ***
wmx-6ooqtz9 posts small blind 0.01€
The Qualm posts big blind 0.02€
Dealt to Fried Berg [2h Qc]
*** PRE-FLOP *** 
packymaitre folds
Fried Berg folds
Erenox raises 0.04€ to 0.06€
x spoony folds
wmx-6ooqtz9 folds
The Qualm calls 0.04€
*** FLOP *** [Jh 8h Ac]
The Qualm checks
Erenox checks
*** TURN *** [Jh 8h Ac][Ts]
The Qualm checks
Erenox checks
*** RIVER *** [Jh 8h Ac Ts][9h]
The Qualm bets 0.20€
Erenox folds
The Qualm collected 0.32€ from pot
*** SUMMARY ***
Total pot 0.32€ | Rake 0.01€
Board: [Jh 8h Ac Ts 9h]
Seat 2: The Qualm (big blind) won 0.32€


Winamax Poker - HOLD-UP "Colorado" - HandId: #19116069-679670-1701696502 - Holdem no limit (0.01€/0.02€) - 2023/12/04 13:28:22 UTC
Table: 'Colorado' 6-max (real money) Seat #6 is the button
Seat 1: Richard Reuk (2.21€)
Seat 2: Fried Berg (2.01€)
Seat 3: Pa_digue (2.28€)
Seat 4: am 21 (0.75€)
Seat 5: kamclo (9.26€)
Seat 6: CKrello (2€)
*** ANTE/BLINDS ***
Richard Reuk posts small blind 0.01€
Fried Berg posts big blind 0.02€
Dealt to Fried Berg [6s 5d]
*** PRE-FLOP *** 
Pa_digue folds
am 21 calls 0.02€
kamclo raises 0.05€ to 0.07€
CKrello folds
Richard Reuk folds
Fried Berg folds
am 21 calls 0.05€
*** FLOP *** [7h Ks Ac]
am 21 checks
kamclo checks
*** TURN *** [7h Ks Ac][8h]
am 21 checks
kamclo checks
*** RIVER *** [7h Ks Ac 8h][Qh]
am 21 bets 0.02€
kamclo calls 0.02€
*** SHOW DOWN ***
kamclo shows [Tc Th] (One pair : Tens)
am 21 shows [3s Qc] (One pair : Queens)
am 21 collected 0.19€ from pot
*** SUMMARY ***
Total pot 0.19€ | Rake 0.02€
Board: [7h Ks Ac 8h Qh]
Seat 4: am 21 showed [3s Qc] and won 0.19€ with One pair : Queens
Seat 5: kamclo showed [Tc Th] and lost with One pair : Tens


Winamax Poker - HOLD-UP "Colorado" - HandId: #19116069-679684-1701696516 - Holdem no limit (0.01€/0.02€) - 2023/12/04 13:28:36 UTC
Table: 'Colorado' 6-max (real money) Seat #6 is the button
Seat 1: Fried Berg (1.99€)
Seat 2: Eddy Agricol (2.03€)
Seat 3: Fabr80 (1.69€)
Seat 4: Yvrin (0.79€)
Seat 5: pasquale202a (3.44€)
Seat 6: packymaitre (1.52€)
*** ANTE/BLINDS ***
Fried Berg posts small blind 0.01€
Eddy Agricol posts big blind 0.02€
Dealt to Fried Berg [Kd As]
*** PRE-FLOP *** 
Fabr80 raises 0.05€ to 0.07€
Yvrin calls 0.07€
pasquale202a folds
packymaitre calls 0.07€
Fried Berg raises 0.14€ to 0.21€
Eddy Agricol folds
Fabr80 calls 0.14€
Yvrin raises 0.58€ to 0.79€ and is all-in
packymaitre calls 0.72€
Fried Berg calls 0.58€
Fabr80 calls 0.58€
*** FLOP *** [Ac Jh 9d]
Fried Berg checks
Fabr80 checks
packymaitre bets 0.73€ and is all-in
Fried Berg calls 0.73€
Fabr80 calls 0.73€
*** TURN *** [Ac Jh 9d][Jd]
Fried Berg checks
Fabr80 bets 0.17€ and is all-in
Fried Berg calls 0.17€
*** RIVER *** [Ac Jh 9d Jd][8d]
*** SHOW DOWN ***
Fabr80 shows [Th Tc] (Two pairs : Jacks and Tens)
packymaitre shows [Ah 2h] (Two pairs : Aces and Jacks)
Fried Berg shows [Kd As] (Two pairs : Aces and Jacks)
Yvrin shows [Kh Ad] (Two pairs : Aces and Jacks)
Yvrin collected 1.43€ from main pot
Fried Berg collected 3.71€ from side pot 1
*** SUMMARY ***
Total pot 5.14€ | Rake 0.57€
Board: [Ac Jh 9d Jd 8d]
Seat 1: Fried Berg (small blind) showed [Kd As] and won 3.71€ with Two pairs : Aces and Jacks
Seat 3: Fabr80 showed [Th Tc] and lost with Two pairs : Jacks and Tens
Seat 4: Yvrin showed [Kh Ad] and won 1.43€ with Two pairs : Aces and Jacks
Seat 6: packymaitre (button) showed [Ah 2h] and lost with Two pairs : Aces and Jacks


Winamax Poker - HOLD-UP "Colorado" - HandId: #19116069-679832-1701696614 - Holdem no limit (0.01€/0.02€) - 2023/12/04 13:30:14 UTC
Table: 'Colorado' 6-max (real money) Seat #6 is the button
Seat 1: Eddy Agricol (2€)
Seat 2: curiouz dje (3.13€)
Seat 3: T.REx. (1.97€)
Seat 4: Fried Berg (4.01€)
Seat 5: Yvrin (1.43€)
Seat 6: TIRAMELas (3.76€)
*** ANTE/BLINDS ***
Eddy Agricol posts small blind 0.01€
curiouz dje posts big blind 0.02€
Dealt to Fried Berg [2h 2s]
*** PRE-FLOP *** 
T.REx. folds
Fried Berg raises 0.02€ to 0.04€
Yvrin calls 0.04€
TIRAMELas raises 0.18€ to 0.22€
Eddy Agricol folds
curiouz dje folds
Fried Berg folds
Yvrin folds
TIRAMELas collected 0.33€ from pot
*** SUMMARY ***
Total pot 0.33€ | No rake
Seat 6: TIRAMELas (button) won 0.33€


Winamax Poker - HOLD-UP "Colorado" - HandId: #19116069-679899-1701696668 - Holdem no limit (0.01€/0.02€) - 2023/12/04 13:31:08 UTC
Table: 'Colorado' 6-max (real money) Seat #6 is the button
Seat 1: Erenox (1.93€)
Seat 2: CKrello (2.82€)
Seat 3: Fried Berg (3.97€)
Seat 4: Richard Reuk (2.78€)
Seat 5: Kangourou589 (1.35€)
Seat 6: DaniRama (2.36€)
Hold-up to Pot: total 0.10€
*** ANTE/BLINDS ***
Erenox posts small blind 0.01€
CKrello posts big blind 0.02€
Dealt to Fried Berg [6s 4c]
*** PRE-FLOP *** 
Fried Berg folds
Richard Reuk folds
Kangourou589 folds
DaniRama raises 0.15€ to 0.17€
Erenox folds
CKrello folds
DaniRama collected 0.30€ from pot
*** SUMMARY ***
Total pot 0.30€ | No rake
Seat 6: DaniRama (button) won 0.30€


Winamax Poker - HOLD-UP "Colorado" - HandId: #19116069-679909-1701696674 - Holdem no limit (0.01€/0.02€) - 2023/12/04 13:31:14 UTC
Table: 'Colorado' 6-max (real money) Seat #6 is the button
Seat 1: Lucky_Donkey (2.64€)
Seat 2: Polanskii (2.52€)
Seat 3: Mametzien (3.92€)
Seat 4: JFSredbaron (3€)
Seat 5: Fried Berg (3.97€)
Seat 6: nicky_poker (2.70€)
Hold-up to Pot: total 0.20€
*** ANTE/BLINDS ***
Lucky_Donkey posts small blind 0.01€
Polanskii posts big blind 0.02€
Dealt to Fried Berg [6d 7d]
*** PRE-FLOP *** 
Mametzien calls 0.02€
JFSredbaron raises 0.27€ to 0.29€
Fried Berg calls 0.29€
nicky_poker folds
Lucky_Donkey folds
Polanskii calls 0.27€
Mametzien folds
*** FLOP *** [2h 6c 3d]
Polanskii checks
JFSredbaron bets 0.39€
Fried Berg folds
Polanskii calls 0.39€
*** TURN *** [2h 6c 3d][5d]
Polanskii checks
JFSredbaron checks
*** RIVER *** [2h 6c 3d 5d][7s]
Polanskii bets 1.84€ and is all-in
JFSredbaron folds
Polanskii collected 3.55€ from pot
*** SUMMARY ***
Total pot 3.55€ | Rake 0.17€
Board: [2h 6c 3d 5d 7s]
Seat 2: Polanskii (big blind) won 3.55€


Winamax Poker - HOLD-UP "Colorado" - HandId: #19116069-680017-1701696745 - Holdem no limit (0.01€/0.02€) - 2023/12/04 13:32:25 UTC
Table: 'Colorado' 6-max (real money) Seat #6 is the button
Seat 1: Richard Reuk (2€)
Seat 2: CKrello (2.93€)
Seat 3: Pang0lin13 (2.12€)
Seat 4: SergioAK (6.21€)
Seat 5: Hasko_2801 (3.69€)
Seat 6: Fried Berg (3.68€)
*** ANTE/BLINDS ***
Richard Reuk posts small blind 0.01€
CKrello posts big blind 0.02€
Dealt to Fried Berg [Qc 5s]
*** PRE-FLOP *** 
Pang0lin13 folds
SergioAK folds
Hasko_2801 raises 0.04€ to 0.06€
Fried Berg folds
Richard Reuk folds
CKrello calls 0.04€
*** FLOP *** [Kh Tc 2h]
CKrello checks
Hasko_2801 checks
*** TURN *** [Kh Tc 2h][5h]
CKrello bets 0.05€
Hasko_2801 folds
CKrello collected 0.17€ from pot
*** SUMMARY ***
Total pot 0.17€ | Rake 0.01€
Board: [Kh Tc 2h 5h]
Seat 2: CKrello (big blind) won 0.17€


Winamax Poker - HOLD-UP "Colorado" - HandId: #19116069-680022-1701696752 - Holdem no limit (0.01€/0.02€) - 2023/12/04 13:32:32 UTC
Table: 'Colorado' 6-max (real money) Seat #6 is the button
Seat 1: Fried Berg (3.68€)
Seat 2: x spoony (2.05€)
Seat 3: Pwinpwin (2.25€)
Seat 4: Lapin_Brun95 (2.74€)
Seat 5: Piexxxe10 (1.21€)
Seat 6: _ilTulipano_ (2.88€)
*** ANTE/BLINDS ***
Fried Berg posts small blind 0.01€
x spoony posts big blind 0.02€
Dealt to Fried Berg [Jh Qh]
*** PRE-FLOP *** 
Pwinpwin folds
Lapin_Brun95 folds
Piexxxe10 folds
_ilTulipano_ folds
Fried Berg raises 0.02€ to 0.04€
x spoony folds
Fried Berg collected 0.06€ from pot
*** SUMMARY ***
Total pot 0.06€ | No rake
Seat 1: Fried Berg (small blind) won 0.06€


Winamax Poker - HOLD-UP "Colorado" - HandId: #19116069-680042-1701696770 - Holdem no limit (0.01€/0.02€) - 2023/12/04 13:32:50 UTC
Table: 'Colorado' 6-max (real money) Seat #6 is the button
Seat 1: Roberfrk (2.52€)
Seat 2: KhakiField (2€)
Seat 3: badou29 (2.72€)
Seat 4: Fried Berg (3.70€)
Seat 5: Pwinpwin (4.01€)
Seat 6: Thequeen1205 (2€)
*** ANTE/BLINDS ***
Roberfrk posts small blind 0.01€
KhakiField posts big blind 0.02€
Dealt to Fried Berg [4s 5h]
*** PRE-FLOP *** 
badou29 raises 0.03€ to 0.05€
Fried Berg folds
Pwinpwin folds
Thequeen1205 folds
Roberfrk folds
KhakiField folds
badou29 collected 0.08€ from pot
*** SUMMARY ***
Total pot 0.08€ | No rake
Seat 3: badou29 won 0.08€


Winamax Poker - HOLD-UP "Colorado" - HandId: #19116069-680049-1701696775 - Holdem no limit (0.01€/0.02€) - 2023/12/04 13:32:55 UTC
Table: 'Colorado' 6-max (real money) Seat #6 is the button
Seat 1: Killim (0.93€)
Seat 2: Fried Berg (3.70€)
Seat 3: nicky_poker (2.26€)
Seat 4: Franck f42 (1.85€)
Seat 5: Thequeen1205 (2.99€)
Seat 6: Pwinpwin (4.01€)
*** ANTE/BLINDS ***
Killim posts small blind 0.01€
Fried Berg posts big blind 0.02€
Dealt to Fried Berg [6c 9h]
*** PRE-FLOP *** 
nicky_poker folds
Franck f42 folds
Thequeen1205 folds
Pwinpwin folds
Killim folds
Fried Berg collected 0.03€ from pot
*** SUMMARY ***
Total pot 0.03€ | No rake
Seat 2: Fried Berg (big blind) won 0.03€


Winamax Poker - HOLD-UP "Colorado" - HandId: #19116069-680061-1701696788 - Holdem no limit (0.01€/0.02€) - 2023/12/04 13:33:08 UTC
Table: 'Colorado' 6-max (real money) Seat #6 is the button
Seat 1: am 21 (0.52€)
Seat 2: Mametzien (2.93€)
Seat 3: Flo83601 (1.96€)
Seat 4: Tiken04 (2.03€)
Seat 5: Fried Berg (3.71€)
Seat 6: SteveJobs (2.07€)
*** ANTE/BLINDS ***
am 21 posts small blind 0.01€
Mametzien posts big blind 0.02€
Dealt to Fried Berg [7h 8h]
*** PRE-FLOP *** 
Flo83601 raises 0.03€ to 0.05€
Tiken04 folds
Fried Berg calls 0.05€
SteveJobs calls 0.05€
am 21 folds
Mametzien calls 0.03€
*** FLOP *** [3d 4s 5c]
Mametzien checks
Flo83601 bets 0.07€
Fried Berg calls 0.07€
SteveJobs folds
Mametzien calls 0.07€
*** TURN *** [3d 4s 5c][As]
Mametzien checks
Flo83601 bets 0.15€
Fried Berg folds
Mametzien calls 0.15€
*** RIVER *** [3d 4s 5c As][8d]
Mametzien checks
Flo83601 checks
*** SHOW DOWN ***
Flo83601 shows [Kc Ad] (One pair : Aces)
Mametzien shows [5s 4d] (Two pairs : 5 and 4)
Mametzien collected 0.65€ from pot
*** SUMMARY ***
Total pot 0.65€ | Rake 0.07€
Board: [3d 4s 5c As 8d]
Seat 2: Mametzien (big blind) showed [5s 4d] and won 0.65€ with Two pairs : 5 and 4
Seat 3: Flo83601 showed [Kc Ad] and lost with One pair : Aces


Winamax Poker - HOLD-UP "Colorado" - HandId: #19116069-680123-1701696839 - Holdem no limit (0.01€/0.02€) - 2023/12/04 13:33:59 UTC
Table: 'Colorado' 6-max (real money) Seat #6 is the button
Seat 1: The Qualm (2.06€)
Seat 2: KhakiField (2€)
Seat 3: SergioAK (6.15€)
Seat 4: Kangourou589 (1.46€)
Seat 5: wmx-6ooqtz9 (2.17€)
Seat 6: Fried Berg (3.59€)
*** ANTE/BLINDS ***
The Qualm posts small blind 0.01€
KhakiField posts big blind 0.02€
Dealt to Fried Berg [Ah 4d]
*** PRE-FLOP *** 
SergioAK folds
Kangourou589 folds
wmx-6ooqtz9 folds
Fried Berg raises 0.02€ to 0.04€
The Qualm folds
KhakiField calls 0.02€
*** FLOP *** [6c 7d 5h]
KhakiField checks
Fried Berg checks
*** TURN *** [6c 7d 5h][9c]
KhakiField checks
Fried Berg checks
*** RIVER *** [6c 7d 5h 9c][Qd]
KhakiField checks
Fried Berg checks
*** SHOW DOWN ***
Fried Berg shows [Ah 4d] (High card : Ace)
KhakiField shows [4s 5s] (One pair : 5)
KhakiField collected 0.08€ from pot
*** SUMMARY ***
Total pot 0.08€ | Rake 0.01€
Board: [6c 7d 5h 9c Qd]
Seat 2: KhakiField (big blind) showed [4s 5s] and won 0.08€ with One pair : 5
Seat 6: Fried Berg (button) showed [Ah 4d] and lost with High card : Ace


Winamax Poker - HOLD-UP "Colorado" - HandId: #19116069-680169-1701696875 - Holdem no limit (0.01€/0.02€) - 2023/12/04 13:34:35 UTC
Table: 'Colorado' 6-max (real money) Seat #6 is the button
Seat 1: Pwinpwin (2.19€)
Seat 2: HH-Titan9811 (2.32€)
Seat 3: LaTricheBaba (2.24€)
Seat 4: Fried Berg (3.55€)
Seat 5: Scr.squirrel (2.43€)
Seat 6: Piexxxe10 (3.39€)
*** ANTE/BLINDS ***
Pwinpwin posts small blind 0.01€
HH-Titan9811 posts big blind 0.02€
Dealt to Fried Berg [3c Kc]
*** PRE-FLOP *** 
LaTricheBaba folds
Fried Berg folds
Scr.squirrel folds
Piexxxe10 raises 0.02€ to 0.04€
Pwinpwin folds
HH-Titan9811 calls 0.02€
*** FLOP *** [5h 4s Qd]
HH-Titan9811 checks
Piexxxe10 checks
*** TURN *** [5h 4s Qd][7s]
HH-Titan9811 checks
Piexxxe10 bets 0.04€
HH-Titan9811 calls 0.04€
*** RIVER *** [5h 4s Qd 7s][7d]
HH-Titan9811 checks
Piexxxe10 checks
*** SHOW DOWN ***
HH-Titan9811 shows [9d 6d] (One pair : 7)
Piexxxe10 shows [Ks 9s] (One pair : 7)
Piexxxe10 collected 0.15€ from pot
*** SUMMARY ***
Total pot 0.15€ | Rake 0.02€
Board: [5h 4s Qd 7s 7d]
Seat 2: HH-Titan9811 (big blind) showed [9d 6d] and lost with One pair : 7
Seat 6: Piexxxe10 (button) showed [Ks 9s] and won 0.15€ with One pair : 7


Winamax Poker - HOLD-UP "Colorado" - HandId: #19116069-680177-1701696881 - Holdem no limit (0.01€/0.02€) - 2023/12/04 13:34:41 UTC
Table: 'Colorado' 6-max (real money) Seat #6 is the button
Seat 1: DaniRama (2.02€)
Seat 2: Thequeen1205 (2.03€)
Seat 3: Lucky_Donkey (2.62€)
Seat 4: AceOf_Spades (1.39€)
Seat 5: Snake arc (1.99€)
Seat 6: Fried Berg (3.55€)
*** ANTE/BLINDS ***
DaniRama posts small blind 0.01€
Thequeen1205 posts big blind 0.02€
Dealt to Fried Berg [Ks Kc]
*** PRE-FLOP *** 
Lucky_Donkey folds
AceOf_Spades folds
Snake arc calls 0.02€
Fried Berg raises 0.02€ to 0.04€
DaniRama calls 0.03€
Thequeen1205 folds
Snake arc calls 0.02€
*** FLOP *** [Kd 6h 2h]
DaniRama checks
Snake arc checks
Fried Berg bets 0.08€
DaniRama raises 0.15€ to 0.23€
Snake arc calls 0.23€
Fried Berg calls 0.15€
*** TURN *** [Kd 6h 2h][Ts]
DaniRama bets 0.42€
Snake arc folds
Fried Berg calls 0.42€
*** RIVER *** [Kd 6h 2h Ts][9d]
DaniRama bets 1.33€ and is all-in
Fried Berg calls 1.33€
*** SHOW DOWN ***
DaniRama shows [6c 6s] (Trips of 6)
Fried Berg shows [Ks Kc] (Trips of Kings)
Fried Berg collected 3.90€ from pot
*** SUMMARY ***
Total pot 3.90€ | Rake 0.43€
Board: [Kd 6h 2h Ts 9d]
Seat 1: DaniRama (small blind) showed [6c 6s] and lost with Trips of 6
Seat 6: Fried Berg (button) showed [Ks Kc] and won 3.90€ with Trips of Kings


Winamax Poker - HOLD-UP "Colorado" - HandId: #19116069-680264-1701696952 - Holdem no limit (0.01€/0.02€) - 2023/12/04 13:35:52 UTC
Table: 'Colorado' 6-max (real money) Seat #6 is the button
Seat 1: Scr.squirrel (2.69€)
Seat 2: fun2raise (2.02€)
Seat 3: DaniRama (2€)
Seat 4: Tofini (2.38€)
Seat 5: LaTricheBaba (2.22€)
Seat 6: Fried Berg (5.43€)
*** ANTE/BLINDS ***
Scr.squirrel posts small blind 0.01€
fun2raise posts big blind 0.02€
Dealt to Fried Berg [As Kc]
*** PRE-FLOP *** 
DaniRama folds
Tofini folds
LaTricheBaba folds
Fried Berg raises 0.02€ to 0.04€
Scr.squirrel folds
fun2raise calls 0.02€
*** FLOP *** [7d Qc 9h]
fun2raise checks
Fried Berg bets 0.04€
fun2raise folds
Fried Berg collected 0.12€ from pot
*** SUMMARY ***
Total pot 0.12€ | Rake 0.01€
Board: [7d Qc 9h]
Seat 6: Fried Berg (button) won 0.12€


Winamax Poker - HOLD-UP "Colorado" - HandId: #19116069-680323-1701697001 - Holdem no limit (0.01€/0.02€) - 2023/12/04 13:36:41 UTC
Table: 'Colorado' 6-max (real money) Seat #6 is the button
Seat 1: Pwinpwin (2€)
Seat 2: Fried Berg (5.47€)
Seat 3: Tofini (2.61€)
Seat 4: wmx-6ooqtz9 (5.01€)
Seat 5: packymaitre (1.95€)
Seat 6: rick26 (1.75€)
*** ANTE/BLINDS ***
Pwinpwin posts small blind 0.01€
Fried Berg posts big blind 0.02€
Dealt to Fried Berg [Jd 6h]
*** PRE-FLOP *** 
Tofini folds
wmx-6ooqtz9 folds
packymaitre folds
rick26 folds
Pwinpwin raises 0.04€ to 0.06€
Fried Berg folds
Pwinpwin collected 0.08€ from pot
*** SUMMARY ***
Total pot 0.08€ | No rake
Seat 1: Pwinpwin (small blind) won 0.08€


Winamax Poker - HOLD-UP "Colorado" - HandId: #19116069-680356-1701697026 - Holdem no limit (0.01€/0.02€) - 2023/12/04 13:37:06 UTC
Table: 'Colorado' 6-max (real money) Seat #6 is the button
Seat 1: Fried Berg (5.45€)
Seat 2: rick26 (1.53€)
Seat 3: x spoony (3.95€)
Seat 4: Tiken04 (2.05€)
Seat 5: CKrello (2.40€)
Seat 6: DaniRama (2.76€)
*** ANTE/BLINDS ***
Fried Berg posts small blind 0.01€
rick26 posts big blind 0.02€
Dealt to Fried Berg [9c Qh]
*** PRE-FLOP *** 
x spoony folds
Tiken04 folds
CKrello folds
DaniRama raises 0.03€ to 0.05€
Fried Berg calls 0.04€
rick26 folds
*** FLOP *** [3h Ts Ah]
Fried Berg checks
DaniRama checks
*** TURN *** [3h Ts Ah][Kh]
Fried Berg checks
DaniRama checks
*** RIVER *** [3h Ts Ah Kh][9h]
Fried Berg bets 0.08€
DaniRama folds
Fried Berg collected 0.19€ from pot
*** SUMMARY ***
Total pot 0.19€ | Rake 0.01€
Board: [3h Ts Ah Kh 9h]
Seat 1: Fried Berg (small blind) won 0.19€


Winamax Poker - HOLD-UP "Colorado" - HandId: #19116069-680408-1701697065 - Holdem no limit (0.01€/0.02€) - 2023/12/04 13:37:45 UTC
Table: 'Colorado' 6-max (real money) Seat #6 is the button
Seat 1: HH-Titan9811 (2.69€)
Seat 2: bastos2525 (2€)
Seat 3: x spoony (2.37€)
Seat 4: Tofini (2.31€)
Seat 5: Fried Berg (5.51€)
Seat 6: rick26 (1.74€)
*** ANTE/BLINDS ***
HH-Titan9811 posts small blind 0.01€
bastos2525 posts big blind 0.02€
Dealt to Fried Berg [2h Th]
*** PRE-FLOP *** 
x spoony folds
Tofini raises 0.02€ to 0.04€
Fried Berg folds
rick26 folds
HH-Titan9811 calls 0.03€
bastos2525 calls 0.02€
*** FLOP *** [3d 2d 9d]
HH-Titan9811 checks
bastos2525 bets 0.04€
Tofini folds
HH-Titan9811 calls 0.04€
*** TURN *** [3d 2d 9d][Qd]
HH-Titan9811 checks
bastos2525 bets 0.07€
HH-Titan9811 folds
bastos2525 collected 0.25€ from pot
*** SUMMARY ***
Total pot 0.25€ | Rake 0.02€
Board: [3d 2d 9d Qd]
Seat 2: bastos2525 (big blind) won 0.25€


Winamax Poker - HOLD-UP "Colorado" - HandId: #19116069-686366-1701700814 - Holdem no limit (0.01€/0.02€) - 2023/12/04 14:40:14 UTC
Table: 'Colorado' 6-max (real money) Seat #6 is the button
Seat 1: Eddy Agricol (2.44€)
Seat 2: Fried Berg (0.50€)
Seat 3: LakeLouise (2.62€)
Seat 4: melijomia (2€)
Seat 5: Thequeen1205 (2.80€)
Seat 6: C.S Hey Hey (2.11€)
*** ANTE/BLINDS ***
Eddy Agricol posts small blind 0.01€
Fried Berg posts big blind 0.02€
Dealt to Fried Berg [3s Tc]
*** PRE-FLOP *** 
LakeLouise raises 0.05€ to 0.07€
melijomia folds
Thequeen1205 folds
C.S Hey Hey folds
Eddy Agricol folds
Fried Berg folds
LakeLouise collected 0.10€ from pot
*** SUMMARY ***
Total pot 0.10€ | No rake
Seat 3: LakeLouise won 0.10€


Winamax Poker - HOLD-UP "Colorado" - HandId: #19116069-686375-1701700819 - Holdem no limit (0.01€/0.02€) - 2023/12/04 14:40:19 UTC
Table: 'Colorado' 6-max (real money) Seat #6 is the button
Seat 1: Fried Berg (0.48€)
Seat 2: Stackbystack (2.84€)
Seat 3: fun2raise (2.47€)
Seat 4: Kiff9180 (0.32€)
Seat 5: bananAsSplit (2.93€)
Seat 6: Thequeen1205 (2.80€)
*** ANTE/BLINDS ***
Fried Berg posts small blind 0.01€
Stackbystack posts big blind 0.02€
Dealt to Fried Berg [Ks 9c]
*** PRE-FLOP *** 
fun2raise folds
Kiff9180 folds
bananAsSplit folds
Thequeen1205 folds
Fried Berg folds
Stackbystack collected 0.03€ from pot
*** SUMMARY ***
Total pot 0.03€ | No rake
Seat 2: Stackbystack (big blind) won 0.03€


Winamax Poker - HOLD-UP "Colorado" - HandId: #19116069-686389-1701700826 - Holdem no limit (0.01€/0.02€) - 2023/12/04 14:40:26 UTC
Table: 'Colorado' 6-max (real money) Seat #6 is the button
Seat 1: xavatar92 (2.11€)
Seat 2: Thequeen1205 (4.81€)
Seat 3: Fried Berg (0.47€)
Seat 4: -pokeriste- (5.10€)
Seat 5: Eddy Agricol (2.18€)
Seat 6: Bardock23m (3.10€)
*** ANTE/BLINDS ***
xavatar92 posts small blind 0.01€
Thequeen1205 posts big blind 0.02€
Dealt to Fried Berg [Ac 8d]
*** PRE-FLOP *** 
Fried Berg raises 0.02€ to 0.04€
-pokeriste- folds
Eddy Agricol calls 0.04€
Bardock23m raises 0.18€ to 0.22€
xavatar92 folds
Thequeen1205 folds
Fried Berg calls 0.18€
Eddy Agricol folds
*** FLOP *** [6c 4s Qs]
Fried Berg checks
Bardock23m bets 0.18€
Fried Berg raises 0.07€ to 0.25€ and is all-in
Bardock23m calls 0.07€
*** TURN *** [6c 4s Qs][7c]
*** RIVER *** [6c 4s Qs 7c][4c]
*** SHOW DOWN ***
Fried Berg shows [Ac 8d] (One pair : 4)
Bardock23m shows [Kd Kh] (Two pairs : Kings and 4)
Bardock23m collected 0.91€ from pot
*** SUMMARY ***
Total pot 0.91€ | Rake 0.10€
Board: [6c 4s Qs 7c 4c]
Seat 3: Fried Berg showed [Ac 8d] and lost with One pair : 4
Seat 6: Bardock23m (button) showed [Kd Kh] and won 0.91€ with Two pairs : Kings and 4


Winamax Poker - HOLD-UP "Colorado" - HandId: #19116069-686597-1701700939 - Holdem no limit (0.01€/0.02€) - 2023/12/04 14:42:19 UTC
Table: 'Colorado' 6-max (real money) Seat #6 is the button
Seat 1: Eddy Agricol (2.56€)
Seat 2: Kangourou_JJ (2.06€)
Seat 3: David Boring (4.35€)
Seat 4: Fried Berg (0.50€)
Seat 5: Kangourou589 (4.16€)
Seat 6: LakeLouise (2.82€)
*** ANTE/BLINDS ***
Eddy Agricol posts small blind 0.01€
Kangourou_JJ posts big blind 0.02€
Dealt to Fried Berg [8s Ah]
*** PRE-FLOP *** 
David Boring folds
Fried Berg raises 0.02€ to 0.04€
Kangourou589 folds
LakeLouise folds
Eddy Agricol raises 0.12€ to 0.16€
Kangourou_JJ folds
Fried Berg calls 0.12€
*** FLOP *** [5c Jh 2c]
Eddy Agricol bets 0.17€
Fried Berg folds
Eddy Agricol collected 0.48€ from pot
*** SUMMARY ***
Total pot 0.48€ | Rake 0.03€
Board: [5c Jh 2c]
Seat 1: Eddy Agricol (small blind) won 0.48€


Winamax Poker - HOLD-UP "Colorado" - HandId: #19116069-686665-1701700971 - Holdem no limit (0.01€/0.02€) - 2023/12/04 14:42:51 UTC
Table: 'Colorado' 6-max (real money) Seat #6 is the button
Seat 1: BAAC0 (1.52€)
Seat 2: Raggamin (5.50€)
Seat 3: CrazyRoxx (0.65€)
Seat 4: xavatar92 (2.01€)
Seat 5: Fried Berg (0.34€)
Seat 6: nunsuka69 (2.14€)
*** ANTE/BLINDS ***
BAAC0 posts small blind 0.01€
Raggamin posts big blind 0.02€
Dealt to Fried Berg [3c 7c]
*** PRE-FLOP *** 
CrazyRoxx folds
xavatar92 folds
Fried Berg folds
nunsuka69 raises 0.03€ to 0.05€
BAAC0 folds
Raggamin folds
nunsuka69 collected 0.08€ from pot
*** SUMMARY ***
Total pot 0.08€ | No rake
Seat 6: nunsuka69 (button) won 0.08€


Winamax Poker - HOLD-UP "Colorado" - HandId: #19116069-686675-1701700975 - Holdem no limit (0.01€/0.02€) - 2023/12/04 14:42:55 UTC
Table: 'Colorado' 6-max (real money) Seat #6 is the button
Seat 1: Coconutz242 (3.89€)
Seat 2: Tofini (2€)
Seat 3: Mouaxx (4.13€)
Seat 4: tichettede3 (3.36€)
Seat 5: bananAsSplit (2.14€)
Seat 6: Fried Berg (0.34€)
*** ANTE/BLINDS ***
Coconutz242 posts small blind 0.01€
Tofini posts big blind 0.02€
Dealt to Fried Berg [3c 6h]
*** PRE-FLOP *** 
Mouaxx folds
tichettede3 folds
bananAsSplit folds
Fried Berg folds
Coconutz242 raises 0.04€ to 0.06€
Tofini folds
Coconutz242 collected 0.08€ from pot
*** SUMMARY ***
Total pot 0.08€ | No rake
Seat 1: Coconutz242 (small blind) won 0.08€


Winamax Poker - HOLD-UP "Colorado" - HandId: #19116069-686681-1701700978 - Holdem no limit (0.01€/0.02€) - 2023/12/04 14:42:58 UTC
Table: 'Colorado' 6-max (real money) Seat #6 is the button
Seat 1: C.S Hey Hey (2€)
Seat 2: curiouz dje (2.01€)
Seat 3: OTE BABA (2.33€)
Seat 4: Fried Berg (0.34€)
Seat 5: xavatar92 (2.01€)
Seat 6: SirX (5.06€)
*** ANTE/BLINDS ***
C.S Hey Hey posts small blind 0.01€
curiouz dje posts big blind 0.02€
Dealt to Fried Berg [6s 8h]
*** PRE-FLOP *** 
OTE BABA folds
Fried Berg folds
xavatar92 raises 0.03€ to 0.05€
SirX raises 5.01€ to 5.06€ and is all-in
C.S Hey Hey folds
curiouz dje folds
xavatar92 folds
SirX collected 5.14€ from pot
*** SUMMARY ***
Total pot 5.14€ | No rake
Seat 6: SirX (button) won 5.14€


Winamax Poker - HOLD-UP "Colorado" - HandId: #19116069-686692-1701700984 - Holdem no limit (0.01€/0.02€) - 2023/12/04 14:43:04 UTC
Table: 'Colorado' 6-max (real money) Seat #6 is the button
Seat 1: Fried Berg (0.34€)
Seat 2: MC keke (2.03€)
Seat 3: Brut2pok (2.03€)
Seat 4: Vanight (2.48€)
Seat 5: D_A_R_K_ (2€)
Seat 6: Stackbystack (5.14€)
*** ANTE/BLINDS ***
Fried Berg posts small blind 0.01€
MC keke posts big blind 0.02€
Dealt to Fried Berg [3d 2d]
*** PRE-FLOP *** 
Brut2pok folds
Vanight calls 0.02€
D_A_R_K_ folds
Stackbystack folds
Fried Berg calls 0.01€
MC keke checks
*** FLOP *** [6c Tc 2s]
Fried Berg checks
MC keke checks
Vanight checks
*** TURN *** [6c Tc 2s][8s]
Fried Berg checks
MC keke checks
Vanight checks
*** RIVER *** [6c Tc 2s 8s][Ah]
Fried Berg checks
MC keke checks
Vanight checks
*** SHOW DOWN ***
Fried Berg shows [3d 2d] (One pair : 2)
Vanight shows [Kh 7s] (High card : Ace)
MC keke shows [2c Qd] (One pair : 2)
MC keke collected 0.05€ from pot
*** SUMMARY ***
Total pot 0.05€ | Rake 0.01€
Board: [6c Tc 2s 8s Ah]
Seat 1: Fried Berg (small blind) showed [3d 2d] and lost with One pair : 2
Seat 2: MC keke (big blind) showed [2c Qd] and won 0.05€ with One pair : 2
Seat 4: Vanight showed [Kh 7s] and lost with High card : Ace


Winamax Poker - HOLD-UP "Colorado" - HandId: #19116069-686786-1701701034 - Holdem no limit (0.01€/0.02€) - 2023/12/04 14:43:54 UTC
Table: 'Colorado' 6-max (real money) Seat #6 is the button
Seat 1: MC keke (2.06€)
Seat 2: Fried Berg (0.32€)
Seat 3: Vanight (2.46€)
Seat 4: JFSredbaron (2.31€)
Seat 5: xavatar92 (7.07€)
Seat 6: Scr.squirrel (2.01€)
*** ANTE/BLINDS ***
MC keke posts small blind 0.01€
Fried Berg posts big blind 0.02€
Dealt to Fried Berg [2h 7c]
*** PRE-FLOP *** 
Vanight calls 0.02€
JFSredbaron raises 0.04€ to 0.06€
xavatar92 folds
Scr.squirrel folds
MC keke calls 0.05€
Fried Berg folds
Vanight calls 0.04€
*** FLOP *** [Jh Th 7s]
MC keke checks
Vanight checks
JFSredbaron bets 0.13€
MC keke folds
Vanight folds
JFSredbaron collected 0.31€ from pot
*** SUMMARY ***
Total pot 0.31€ | Rake 0.02€
Board: [Jh Th 7s]
Seat 4: JFSredbaron won 0.31€


Winamax Poker - HOLD-UP "Colorado" - HandId: #19116069-686804-1701701044 - Holdem no limit (0.01€/0.02€) - 2023/12/04 14:44:04 UTC
Table: 'Colorado' 6-max (real money) Seat #6 is the button
Seat 1: TopManiac (2.30€)
Seat 2: fun2raise (3.95€)
Seat 3: Fried Berg (0.30€)
Seat 4: Dario 365 (2.10€)
Seat 5: bananAsSplit (2.69€)
Seat 6: jesuskippy (1.66€)
*** ANTE/BLINDS ***
TopManiac posts small blind 0.01€
fun2raise posts big blind 0.02€
Dealt to Fried Berg [2s Ks]
*** PRE-FLOP *** 
Fried Berg folds
Dario 365 folds
bananAsSplit folds
jesuskippy folds
TopManiac raises 0.04€ to 0.06€
fun2raise calls 0.04€
*** FLOP *** [Ad 2c Ah]
TopManiac bets 0.04€
fun2raise folds
TopManiac collected 0.15€ from pot
*** SUMMARY ***
Total pot 0.15€ | Rake 0.01€
Board: [Ad 2c Ah]
Seat 1: TopManiac (small blind) won 0.15€


Winamax Poker - HOLD-UP "Colorado" - HandId: #19116069-686812-1701701048 - Holdem no limit (0.01€/0.02€) - 2023/12/04 14:44:08 UTC
Table: 'Colorado' 6-max (real money) Seat #6 is the button
Seat 1: D_A_R_K_ (1.98€)
Seat 2: LakeLouise (2.02€)
Seat 3: ASho-Hai (1.75€)
Seat 4: damz69 (0.81€)
Seat 5: Fried Berg (0.30€)
Seat 6: David Boring (4.34€)
*** ANTE/BLINDS ***
D_A_R_K_ posts small blind 0.01€
LakeLouise posts big blind 0.02€
Dealt to Fried Berg [Kc 2d]
*** PRE-FLOP *** 
ASho-Hai raises 0.04€ to 0.06€
damz69 folds
Fried Berg folds
David Boring calls 0.06€
D_A_R_K_ folds
LakeLouise calls 0.04€
*** FLOP *** [As 9c 8h]
LakeLouise checks
ASho-Hai bets 0.06€
David Boring folds
LakeLouise calls 0.06€
*** TURN *** [As 9c 8h][5h]
LakeLouise checks
ASho-Hai bets 0.14€
LakeLouise folds
ASho-Hai collected 0.42€ from pot
*** SUMMARY ***
Total pot 0.42€ | Rake 0.03€
Board: [As 9c 8h 5h]
Seat 3: ASho-Hai won 0.42€


Winamax Poker - HOLD-UP "Colorado" - HandId: #19116069-686821-1701701053 - Holdem no limit (0.01€/0.02€) - 2023/12/04 14:44:13 UTC
Table: 'Colorado' 6-max (real money) Seat #6 is the button
Seat 1: melijomia (2.46€)
Seat 2: Karinecokine (0.58€)
Seat 3: curiouz dje (2.09€)
Seat 4: MaDjiK57 (2€)
Seat 5: HH-Titan9811 (4.02€)
Seat 6: Fried Berg (0.30€)
*** ANTE/BLINDS ***
melijomia posts small blind 0.01€
Karinecokine posts big blind 0.02€
Dealt to Fried Berg [3s 6d]
*** PRE-FLOP *** 
curiouz dje folds
MaDjiK57 raises 0.04€ to 0.06€
HH-Titan9811 folds
Fried Berg folds
melijomia folds
Karinecokine folds
MaDjiK57 collected 0.09€ from pot
*** SUMMARY ***
Total pot 0.09€ | No rake
Seat 4: MaDjiK57 won 0.09€


Winamax Poker - HOLD-UP "Colorado" - HandId: #19116069-686824-1701701054 - Holdem no limit (0.01€/0.02€) - 2023/12/04 14:44:14 UTC
Table: 'Colorado' 6-max (real money) Seat #6 is the button
Seat 1: curiouz dje (2.09€)
Seat 2: SirX (4.74€)
Seat 3: MIKATRANKIL (1.17€)
Seat 4: Thequeen1205 (5.44€)
Seat 5: xavatar92 (2.09€)
Seat 6: Fried Berg (0.30€)
*** ANTE/BLINDS ***
curiouz dje posts small blind 0.01€
SirX posts big blind 0.02€
Dealt to Fried Berg [Ac 9c]
*** PRE-FLOP *** 
MIKATRANKIL folds
Thequeen1205 folds
xavatar92 folds
Fried Berg raises 0.28€ to 0.30€ and is all-in
curiouz dje folds
SirX raises 4.44€ to 4.74€ and is all-in
*** FLOP *** [Ts 3c 8c]
*** TURN *** [Ts 3c 8c][4d]
*** RIVER *** [Ts 3c 8c 4d][6h]
*** SHOW DOWN ***
SirX shows [9s Kh] (High card : King)
Fried Berg shows [Ac 9c] (High card : Ace)
Fried Berg collected 0.55€ from main pot
SirX collected 4.44€ from side pot 1
*** SUMMARY ***
Total pot 4.99€ | Rake 0.06€
Board: [Ts 3c 8c 4d 6h]
Seat 2: SirX (big blind) showed [9s Kh] and won 4.44€ with High card : King
Seat 6: Fried Berg (button) showed [Ac 9c] and won 0.55€ with High card : Ace


Winamax Poker - HOLD-UP "Colorado" - HandId: #19116069-686869-1701701076 - Holdem no limit (0.01€/0.02€) - 2023/12/04 14:44:36 UTC
Table: 'Colorado' 6-max (real money) Seat #6 is the button
Seat 1: Gros_poisson (2.44€)
Seat 2: Fried Berg (0.55€)
Seat 3: Kiff9180 (0.48€)
Seat 4: jesuskippy (1.66€)
Seat 5: gil95100 (1.81€)
Seat 6: SirX (4.44€)
*** ANTE/BLINDS ***
Gros_poisson posts small blind 0.01€
Fried Berg posts big blind 0.02€
Dealt to Fried Berg [7d Jc]
*** PRE-FLOP *** 
Kiff9180 folds
jesuskippy folds
gil95100 folds
SirX folds
Gros_poisson folds
Fried Berg collected 0.03€ from pot
*** SUMMARY ***
Total pot 0.03€ | No rake
Seat 2: Fried Berg (big blind) won 0.03€


Winamax Poker - HOLD-UP "Colorado" - HandId: #19116069-686917-1701701099 - Holdem no limit (0.01€/0.02€) - 2023/12/04 14:44:59 UTC
Table: 'Colorado' 6-max (real money) Seat #6 is the button
Seat 1: JFSredbaron (3.03€)
Seat 2: Karinecokine (0.49€)
Seat 3: Fried Berg (0.56€)
Seat 4: David Boring (2.13€)
Seat 5: Brut2pok (3.59€)
Seat 6: D_A_R_K_ (2€)
Hold-up to Pot: total 0.20€
*** ANTE/BLINDS ***
JFSredbaron posts small blind 0.01€
Karinecokine posts big blind 0.02€
Dealt to Fried Berg [Td 6c]
*** PRE-FLOP *** 
Fried Berg folds
David Boring folds
Brut2pok folds
D_A_R_K_ folds
JFSredbaron folds
Karinecokine collected 0.23€ from pot
*** SUMMARY ***
Total pot 0.23€ | No rake
Seat 2: Karinecokine (big blind) won 0.23€


Winamax Poker - HOLD-UP "Colorado" - HandId: #19116069-686933-1701701106 - Holdem no limit (0.01€/0.02€) - 2023/12/04 14:45:06 UTC
Table: 'Colorado' 6-max (real money) Seat #6 is the button
Seat 1: Fried Berg (0.56€)
Seat 2: T.REx. (2.39€)
Seat 3: Thequeen1205 (3.28€)
Seat 4: Ju89400 (1.90€)
Seat 5: Eddy Agricol (2.57€)
Seat 6: melijomia (2.58€)
*** ANTE/BLINDS ***
Fried Berg posts small blind 0.01€
T.REx. posts big blind 0.02€
Dealt to Fried Berg [3c Th]
*** PRE-FLOP *** 
Thequeen1205 folds
Ju89400 folds
Eddy Agricol folds
melijomia raises 0.04€ to 0.06€
Fried Berg folds
T.REx. folds
melijomia collected 0.09€ from pot
*** SUMMARY ***
Total pot 0.09€ | No rake
Seat 6: melijomia (button) won 0.09€


Winamax Poker - HOLD-UP "Colorado" - HandId: #19116069-686947-1701701113 - Holdem no limit (0.01€/0.02€) - 2023/12/04 14:45:13 UTC
Table: 'Colorado' 6-max (real money) Seat #6 is the button
Seat 1: kellyludo (0.42€)
Seat 2: curiouz dje (2.14€)
Seat 3: xavatar92 (7€)
Seat 4: Fried Berg (0.55€)
Seat 5: Dario 365 (2.08€)
Seat 6: Ricco6229 (1.83€)
*** ANTE/BLINDS ***
kellyludo posts small blind 0.01€
curiouz dje posts big blind 0.02€
Dealt to Fried Berg [Td Qc]
*** PRE-FLOP *** 
xavatar92 folds
Fried Berg raises 0.02€ to 0.04€
Dario 365 folds
Ricco6229 folds
kellyludo folds
curiouz dje folds
Fried Berg collected 0.07€ from pot
*** SUMMARY ***
Total pot 0.07€ | No rake
Seat 4: Fried Berg won 0.07€


Winamax Poker - HOLD-UP "Colorado" - HandId: #19116069-686982-1701701130 - Holdem no limit (0.01€/0.02€) - 2023/12/04 14:45:30 UTC
Table: 'Colorado' 6-max (real money) Seat #6 is the button
Seat 1: Eddy Agricol (2.65€)
Seat 2: taishimaster (4.10€)
Seat 3: curiouz dje (2.11€)
Seat 4: Zile741 (2.15€)
Seat 5: Fried Berg (0.58€)
Seat 6: fun2raise (3.88€)
*** ANTE/BLINDS ***
Eddy Agricol posts small blind 0.01€
taishimaster posts big blind 0.02€
Dealt to Fried Berg [9h Qh]
*** PRE-FLOP *** 
curiouz dje folds
Zile741 folds
Fried Berg raises 0.02€ to 0.04€
fun2raise folds
Eddy Agricol raises 0.12€ to 0.16€
taishimaster folds
Fried Berg calls 0.12€
*** FLOP *** [Ac Ts 3s]
Eddy Agricol bets 0.12€
Fried Berg calls 0.12€
*** TURN *** [Ac Ts 3s][Ad]
Eddy Agricol bets 0.20€
Fried Berg calls 0.20€
*** RIVER *** [Ac Ts 3s Ad][9c]
Eddy Agricol checks
Fried Berg checks
*** SHOW DOWN ***
Fried Berg shows [9h Qh] (Two pairs : Aces and 9)
Eddy Agricol shows [Jd Jh] (Two pairs : Aces and Jacks)
Eddy Agricol collected 0.88€ from pot
*** SUMMARY ***
Total pot 0.88€ | Rake 0.10€
Board: [Ac Ts 3s Ad 9c]
Seat 1: Eddy Agricol (small blind) showed [Jd Jh] and won 0.88€ with Two pairs : Aces and Jacks
Seat 5: Fried Berg showed [9h Qh] and lost with Two pairs : Aces and 9


Winamax Poker - HOLD-UP "Colorado" - HandId: #19116069-687095-1701701189 - Holdem no limit (0.01€/0.02€) - 2023/12/04 14:46:29 UTC
Table: 'Colorado' 6-max (real money) Seat #6 is the button
Seat 1: bananAsSplit (2.84€)
Seat 2: TopManiac (2.30€)
Seat 3: Fried Berg (0.10€)
Seat 4: Eddy Agricol (3.05€)
Seat 5: Migu-Mas (2€)
Seat 6: Elyotony57 (0.47€)
*** ANTE/BLINDS ***
bananAsSplit posts small blind 0.01€
TopManiac posts big blind 0.02€
Dealt to Fried Berg [8s Jh]
*** PRE-FLOP *** 
Fried Berg folds
Eddy Agricol raises 0.04€ to 0.06€
Migu-Mas raises 0.12€ to 0.18€
Elyotony57 folds
bananAsSplit folds
TopManiac folds
Eddy Agricol folds
Migu-Mas collected 0.27€ from pot
*** SUMMARY ***
Total pot 0.27€ | No rake
Seat 5: Migu-Mas won 0.27€


Winamax Poker - HOLD-UP "Colorado" - HandId: #19116069-687103-1701701193 - Holdem no limit (0.01€/0.02€) - 2023/12/04 14:46:33 UTC
Table: 'Colorado' 6-max (real money) Seat #6 is the button
Seat 1: Fried Berg (0.10€)
Seat 2: Elyotony57 (0.47€)
Seat 3: Kangourou589 (4.13€)
Seat 4: MIKATRANKIL (1.17€)
Seat 5: Jorj-X-McKie (2.58€)
Seat 6: MC keke (2.42€)
*** ANTE/BLINDS ***
Fried Berg posts small blind 0.01€
Elyotony57 posts big blind 0.02€
Dealt to Fried Berg [Th Jh]
*** PRE-FLOP *** 
Kangourou589 folds
MIKATRANKIL folds
Jorj-X-McKie folds
MC keke folds
Fried Berg raises 0.08€ to 0.10€ and is all-in
Elyotony57 folds
Fried Berg collected 0.12€ from pot
*** SUMMARY ***
Total pot 0.12€ | No rake
Seat 1: Fried Berg (small blind) won 0.12€


Winamax Poker - HOLD-UP "Colorado" - HandId: #19116069-687142-1701701215 - Holdem no limit (0.01€/0.02€) - 2023/12/04 14:46:55 UTC
Table: 'Colorado' 6-max (real money) Seat #6 is the button
Seat 1: MIKATRANKIL (1.17€)
Seat 2: Fried Berg (0.12€)
Seat 3: JAWIKE1 (0.83€)
Seat 4: Tofini (2.05€)
Seat 5: David Boring (3.76€)
Seat 6: TopManiac (3.25€)
*** ANTE/BLINDS ***
MIKATRANKIL posts small blind 0.01€
Fried Berg posts big blind 0.02€
Dealt to Fried Berg [7s 8d]
*** PRE-FLOP *** 
JAWIKE1 folds
Tofini folds
David Boring folds
TopManiac raises 0.04€ to 0.06€
MIKATRANKIL folds
Fried Berg folds
TopManiac collected 0.09€ from pot
*** SUMMARY ***
Total pot 0.09€ | No rake
Seat 6: TopManiac (button) won 0.09€


Winamax Poker - HOLD-UP "Colorado" - HandId: #19116069-687171-1701701232 - Holdem no limit (0.01€/0.02€) - 2023/12/04 14:47:12 UTC
Table: 'Colorado' 6-max (real money) Seat #6 is the button
Seat 1: Weediiz30 (3.69€)
Seat 2: Homer14510 (1.93€)
Seat 3: JFSredbaron (2.01€)
Seat 4: cmpburought (0.47€)
Seat 5: Fried Berg (0.10€)
Seat 6: ZenoidZ (2.11€)
Hold-up to Pot: total 0.10€
*** ANTE/BLINDS ***
Weediiz30 posts small blind 0.01€
Homer14510 posts big blind 0.02€
Dealt to Fried Berg [8h 7h]
*** PRE-FLOP *** 
JFSredbaron folds
cmpburought raises 0.02€ to 0.04€
Fried Berg raises 0.06€ to 0.10€ and is all-in
ZenoidZ folds
Weediiz30 folds
Homer14510 calls 0.08€
cmpburought calls 0.06€
*** FLOP *** [9d 2c Jd]
Homer14510 checks
cmpburought bets 0.37€ and is all-in
Homer14510 folds
*** TURN *** [9d 2c Jd][2s]
*** RIVER *** [9d 2c Jd 2s][8c]
*** SHOW DOWN ***
Fried Berg shows [8h 7h] (Two pairs : 8 and 2)
cmpburought shows [Qh Tc] (Straight Queen high)
cmpburought collected 0.75€ from pot
*** SUMMARY ***
Total pot 0.75€ | Rake 0.03€
Board: [9d 2c Jd 2s 8c]
Seat 4: cmpburought showed [Qh Tc] and won 0.75€ with Straight Queen high
Seat 5: Fried Berg showed [8h 7h] and lost with Two pairs : 8 and 2


Winamax Poker - HOLD-UP "Colorado" - HandId: #19116069-687308-1701701301 - Holdem no limit (0.01€/0.02€) - 2023/12/04 14:48:21 UTC
Table: 'Colorado' 6-max (real money) Seat #6 is the button
Seat 1: kellyludo (0.43€)
Seat 2: skrr (1.93€)
Seat 3: jesuskippy (1.70€)
Seat 4: Fried Berg (0.50€)
Seat 5: Dario 365 (3.08€)
Seat 6: HH-Titan9811 (3.80€)
*** ANTE/BLINDS ***
kellyludo posts small blind 0.01€
skrr posts big blind 0.02€
Dealt to Fried Berg [4d 6c]
*** PRE-FLOP *** 
jesuskippy calls 0.02€
Fried Berg folds
Dario 365 raises 0.07€ to 0.09€
HH-Titan9811 folds
kellyludo calls 0.08€
skrr folds
jesuskippy folds
*** FLOP *** [7h Td Ad]
kellyludo checks
Dario 365 bets 0.22€
kellyludo folds
Dario 365 collected 0.42€ from pot
*** SUMMARY ***
Total pot 0.42€ | Rake 0.02€
Board: [7h Td Ad]
Seat 5: Dario 365 won 0.42€


Winamax Poker - HOLD-UP "Colorado" - HandId: #19116069-687315-1701701305 - Holdem no limit (0.01€/0.02€) - 2023/12/04 14:48:25 UTC
Table: 'Colorado' 6-max (real money) Seat #6 is the button
Seat 1: tichettede3 (2.52€)
Seat 2: Ertorko (3.52€)
Seat 3: Migu-Mas (2.09€)
Seat 4: Coconutz242 (3.28€)
Seat 5: fun2raise (10.21€)
Seat 6: Fried Berg (0.50€)
*** ANTE/BLINDS ***
tichettede3 posts small blind 0.01€
Ertorko posts big blind 0.02€
Dealt to Fried Berg [Ks 2d]
*** PRE-FLOP *** 
Migu-Mas folds
Coconutz242 folds
fun2raise folds
Fried Berg folds
tichettede3 folds
Ertorko collected 0.03€ from pot
*** SUMMARY ***
Total pot 0.03€ | No rake
Seat 2: Ertorko (big blind) won 0.03€


Winamax Poker - HOLD-UP "Colorado" - HandId: #19116069-687321-1701701308 - Holdem no limit (0.01€/0.02€) - 2023/12/04 14:48:28 UTC
Table: 'Colorado' 6-max (real money) Seat #6 is the button
Seat 1: Homer14510 (0.93€)
Seat 2: curiouz dje (2.21€)
Seat 3: xavatar92 (2.29€)
Seat 4: Fried Berg (0.50€)
Seat 5: MaDjiK57 (2.06€)
Seat 6: Migu-Mas (2.09€)
*** ANTE/BLINDS ***
Homer14510 posts small blind 0.01€
curiouz dje posts big blind 0.02€
Dealt to Fried Berg [7h 4s]
*** PRE-FLOP *** 
xavatar92 folds
Fried Berg folds
MaDjiK57 raises 0.04€ to 0.06€
Migu-Mas folds
Homer14510 calls 0.05€
curiouz dje folds
*** FLOP *** [8s 8h 5d]
Homer14510 checks
MaDjiK57 checks
*** TURN *** [8s 8h 5d][Th]
Homer14510 checks
MaDjiK57 bets 0.11€
Homer14510 folds
MaDjiK57 collected 0.24€ from pot
*** SUMMARY ***
Total pot 0.24€ | Rake 0.01€
Board: [8s 8h 5d Th]
Seat 5: MaDjiK57 won 0.24€


Winamax Poker - HOLD-UP "Colorado" - HandId: #19116069-687323-1701701310 - Holdem no limit (0.01€/0.02€) - 2023/12/04 14:48:30 UTC
Table: 'Colorado' 6-max (real money) Seat #6 is the button
Seat 1: Fried Berg (0.50€)
Seat 2: GTO toilette (0.60€)
Seat 3: Mouaxx (1.94€)
Seat 4: TopManiac (2€)
Seat 5: Thequeen1205 (2.49€)
Seat 6: HH-Titan9811 (2€)
*** ANTE/BLINDS ***
Fried Berg posts small blind 0.01€
GTO toilette posts big blind 0.02€
Dealt to Fried Berg [As 7d]
*** PRE-FLOP *** 
Mouaxx folds
TopManiac folds
Thequeen1205 folds
HH-Titan9811 calls 0.02€
Fried Berg calls 0.01€
GTO toilette checks
*** FLOP *** [6c 4d Qc]
Fried Berg checks
GTO toilette checks
HH-Titan9811 checks
*** TURN *** [6c 4d Qc][8h]
Fried Berg checks
GTO toilette checks
HH-Titan9811 checks
*** RIVER *** [6c 4d Qc 8h][4s]
Fried Berg checks
GTO toilette checks
HH-Titan9811 checks
*** SHOW DOWN ***
Fried Berg shows [As 7d] (One pair : 4)
HH-Titan9811 shows [Ah Th] (One pair : 4)
GTO toilette shows [8d 3c] (Two pairs : 8 and 4)
GTO toilette collected 0.05€ from pot
*** SUMMARY ***
Total pot 0.05€ | Rake 0.01€
Board: [6c 4d Qc 8h 4s]
Seat 1: Fried Berg (small blind) showed [As 7d] and lost with One pair : 4
Seat 2: GTO toilette (big blind) showed [8d 3c] and won 0.05€ with Two pairs : 8 and 4
Seat 6: HH-Titan9811 (button) showed [Ah Th] and lost with One pair : 4


Winamax Poker - HOLD-UP "Colorado" - HandId: #19116069-687393-1701701350 - Holdem no limit (0.01€/0.02€) - 2023/12/04 14:49:10 UTC
Table: 'Colorado' 6-max (real money) Seat #6 is the button
Seat 1: GTO toilette (0.63€)
Seat 2: Fried Berg (0.48€)
Seat 3: Ricco6229 (1.88€)
Seat 4: Homer14510 (0.87€)
Seat 5: MrFlash9 (4.06€)
Seat 6: HH-Titan9811 (2€)
*** ANTE/BLINDS ***
GTO toilette posts small blind 0.01€
Fried Berg posts big blind 0.02€
Dealt to Fried Berg [6c As]
*** PRE-FLOP *** 
Ricco6229 folds
Homer14510 folds
MrFlash9 folds
HH-Titan9811 calls 0.02€
GTO toilette raises 0.02€ to 0.04€
Fried Berg calls 0.02€
HH-Titan9811 calls 0.02€
*** FLOP *** [Ad 4s 3c]
GTO toilette bets 0.08€
Fried Berg raises 0.08€ to 0.16€
HH-Titan9811 folds
GTO toilette folds
Fried Berg collected 0.33€ from pot
*** SUMMARY ***
Total pot 0.33€ | Rake 0.03€
Board: [Ad 4s 3c]
Seat 2: Fried Berg (big blind) won 0.33€


Winamax Poker - HOLD-UP "Colorado" - HandId: #19116069-687545-1701701428 - Holdem no limit (0.01€/0.02€) - 2023/12/04 14:50:28 UTC
Table: 'Colorado' 6-max (real money) Seat #6 is the button
Seat 1: LAG0URMANDE (1.98€)
Seat 2: HH-Titan9811 (2€)
Seat 3: Pls-33 (0.40€)
Seat 4: Eddy Agricol (2.90€)
Seat 5: Fried Berg (0.61€)
Seat 6: MrFlash9 (3.93€)
*** ANTE/BLINDS ***
LAG0URMANDE posts small blind 0.01€
HH-Titan9811 posts big blind 0.02€
Dealt to Fried Berg [Kc 5d]
*** PRE-FLOP *** 
Pls-33 folds
Eddy Agricol folds
Fried Berg folds
MrFlash9 folds
LAG0URMANDE folds
HH-Titan9811 collected 0.03€ from pot
*** SUMMARY ***
Total pot 0.03€ | No rake
Seat 2: HH-Titan9811 (big blind) won 0.03€


Winamax Poker - HOLD-UP "Colorado" - HandId: #19116069-687557-1701701436 - Holdem no limit (0.01€/0.02€) - 2023/12/04 14:50:36 UTC
Table: 'Colorado' 6-max (real money) Seat #6 is the button
Seat 1: tAAkeuchi (2.07€)
Seat 2: Brut2pok (2€)
Seat 3: Fried Berg (0.61€)
Seat 4: bananAsSplit (2.27€)
Seat 5: David Boring (3.90€)
Seat 6: Elyotony57 (0.41€)
*** ANTE/BLINDS ***
tAAkeuchi posts small blind 0.01€
Brut2pok posts big blind 0.02€
Dealt to Fried Berg [4h 6c]
*** PRE-FLOP *** 
Fried Berg folds
bananAsSplit folds
David Boring raises 0.04€ to 0.06€
Elyotony57 folds
tAAkeuchi folds
Brut2pok folds
David Boring collected 0.09€ from pot
*** SUMMARY ***
Total pot 0.09€ | No rake
Seat 5: David Boring won 0.09€


Winamax Poker - HOLD-UP "Colorado" - HandId: #19116069-687562-1701701438 - Holdem no limit (0.01€/0.02€) - 2023/12/04 14:50:38 UTC
Table: 'Colorado' 6-max (real money) Seat #6 is the button
Seat 1: bananAsSplit (2.48€)
Seat 2: Pang0lin13 (2.15€)
Seat 3: Fried Berg (0.61€)
Seat 4: Moi4716 (2.09€)
Seat 5: Karinecokine (0.78€)
Seat 6: Jorj-X-McKie (1.81€)
*** ANTE/BLINDS ***
bananAsSplit posts small blind 0.01€
Pang0lin13 posts big blind 0.02€
Dealt to Fried Berg [Jd Kc]
*** PRE-FLOP *** 
Fried Berg raises 0.02€ to 0.04€
Moi4716 calls 0.04€
Karinecokine folds
Jorj-X-McKie folds
bananAsSplit folds
Pang0lin13 folds
*** FLOP *** [Js 2s Qc]
Fried Berg bets 0.04€
Moi4716 calls 0.04€
*** TURN *** [Js 2s Qc][3s]
Fried Berg checks
Moi4716 checks
*** RIVER *** [Js 2s Qc 3s][7s]
Fried Berg bets 0.04€
Moi4716 folds
Fried Berg collected 0.21€ from pot
*** SUMMARY ***
Total pot 0.21€ | Rake 0.02€
Board: [Js 2s Qc 3s 7s]
Seat 3: Fried Berg won 0.21€


Winamax Poker - HOLD-UP "Colorado" - HandId: #19116069-687714-1701701534 - Holdem no limit (0.01€/0.02€) - 2023/12/04 14:52:14 UTC
Table: 'Colorado' 6-max (real money) Seat #6 is the button
Seat 1: Tofini (4.29€)
Seat 2: SirX (6.68€)
Seat 3: Eddy Agricol (2.89€)
Seat 4: Blackmamba06 (2€)
Seat 5: Fried Berg (0.70€)
Seat 6: _ilTulipano_ (2.21€)
*** ANTE/BLINDS ***
Tofini posts small blind 0.01€
SirX posts big blind 0.02€
Dealt to Fried Berg [Kd 5c]
*** PRE-FLOP *** 
Eddy Agricol folds
Blackmamba06 folds
Fried Berg folds
_ilTulipano_ folds
Tofini folds
SirX collected 0.03€ from pot
*** SUMMARY ***
Total pot 0.03€ | No rake
Seat 2: SirX (big blind) won 0.03€


Winamax Poker - HOLD-UP "Colorado" - HandId: #19116069-687726-1701701542 - Holdem no limit (0.01€/0.02€) - 2023/12/04 14:52:22 UTC
Table: 'Colorado' 6-max (real money) Seat #6 is the button
Seat 1: bastos2525 (2.56€)
Seat 2: Fried Berg (0.70€)
Seat 3: Coconutz242 (3.59€)
Seat 4: Thequeen1205 (3.22€)
Seat 5: C.S Hey Hey (2.23€)
Seat 6: Raggamin (5.21€)
*** ANTE/BLINDS ***
bastos2525 posts small blind 0.01€
Fried Berg posts big blind 0.02€
Dealt to Fried Berg [8d 8c]
*** PRE-FLOP *** 
Coconutz242 folds
Thequeen1205 raises 0.03€ to 0.05€
C.S Hey Hey folds
Raggamin folds
bastos2525 folds
Fried Berg calls 0.03€
*** FLOP *** [2s Ah 3h]
Fried Berg bets 0.08€
Thequeen1205 folds
Fried Berg collected 0.18€ from pot
*** SUMMARY ***
Total pot 0.18€ | Rake 0.01€
Board: [2s Ah 3h]
Seat 2: Fried Berg (big blind) won 0.18€


Winamax Poker - HOLD-UP "Colorado" - HandId: #19116069-687761-1701701564 - Holdem no limit (0.01€/0.02€) - 2023/12/04 14:52:44 UTC
Table: 'Colorado' 6-max (real money) Seat #6 is the button
Seat 1: Fried Berg (0.75€)
Seat 2: Elyotony57 (0.46€)
Seat 3: xavatar92 (2€)
Seat 4: curiouz dje (2.11€)
Seat 5: Zile741 (2.33€)
Seat 6: antoclem2A (2.37€)
*** ANTE/BLINDS ***
Fried Berg posts small blind 0.01€
Elyotony57 posts big blind 0.02€
Dealt to Fried Berg [Js Kh]
*** PRE-FLOP *** 
xavatar92 folds
curiouz dje folds
Zile741 folds
antoclem2A folds
Fried Berg raises 0.02€ to 0.04€
Elyotony57 folds
Fried Berg collected 0.06€ from pot
*** SUMMARY ***
Total pot 0.06€ | No rake
Seat 1: Fried Berg (small blind) won 0.06€


Winamax Poker - HOLD-UP "Colorado" - HandId: #19116069-687782-1701701577 - Holdem no limit (0.01€/0.02€) - 2023/12/04 14:52:57 UTC
Table: 'Colorado' 6-max (real money) Seat #6 is the button
Seat 1: LakeLouise (3.77€)
Seat 2: Mainge1078 (2€)
Seat 3: MC keke (2.17€)
Seat 4: Fried Berg (0.77€)
Seat 5: curiouz dje (2.09€)
Seat 6: relaxalex27 (2.06€)
*** ANTE/BLINDS ***
LakeLouise posts small blind 0.01€
Mainge1078 posts big blind 0.02€
Dealt to Fried Berg [Tc 9h]
*** PRE-FLOP *** 
MC keke folds
Fried Berg folds
curiouz dje folds
relaxalex27 raises 0.03€ to 0.05€
LakeLouise folds
Mainge1078 folds
relaxalex27 collected 0.08€ from pot
*** SUMMARY ***
Total pot 0.08€ | No rake
Seat 6: relaxalex27 (button) won 0.08€


Winamax Poker - HOLD-UP "Colorado" - HandId: #19116069-687795-1701701584 - Holdem no limit (0.01€/0.02€) - 2023/12/04 14:53:04 UTC
Table: 'Colorado' 6-max (real money) Seat #6 is the button
Seat 1: GTO toilette (0.42€)
Seat 2: damz69 (0.50€)
Seat 3: LAG0URMANDE (2.39€)
Seat 4: HH-Titan9811 (3.52€)
Seat 5: megalithe (2.01€)
Seat 6: Fried Berg (0.77€)
*** ANTE/BLINDS ***
GTO toilette posts small blind 0.01€
damz69 posts big blind 0.02€
Dealt to Fried Berg [Kh 4s]
*** PRE-FLOP *** 
LAG0URMANDE folds
HH-Titan9811 folds
megalithe folds
Fried Berg folds
GTO toilette raises 0.02€ to 0.04€
damz69 folds
GTO toilette collected 0.06€ from pot
*** SUMMARY ***
Total pot 0.06€ | No rake
Seat 1: GTO toilette (small blind) won 0.06€


Winamax Poker - HOLD-UP "Colorado" - HandId: #19116069-687819-1701701599 - Holdem no limit (0.01€/0.02€) - 2023/12/04 14:53:19 UTC
Table: 'Colorado' 6-max (real money) Seat #6 is the button
Seat 1: LilRun (3.52€)
Seat 2: Mizoun2.0 (2€)
Seat 3: bananAsSplit (3.03€)
Seat 4: nunsuka69 (2.15€)
Seat 5: LAG0URMANDE (2.38€)
Seat 6: Fried Berg (0.77€)
*** ANTE/BLINDS ***
LilRun posts small blind 0.01€
Mizoun2.0 posts big blind 0.02€
Dealt to Fried Berg [3s Ts]
*** PRE-FLOP *** 
bananAsSplit folds
nunsuka69 folds
LAG0URMANDE raises 0.03€ to 0.05€
Fried Berg folds
LilRun folds
Mizoun2.0 folds
LAG0URMANDE collected 0.08€ from pot
*** SUMMARY ***
Total pot 0.08€ | No rake
Seat 5: LAG0URMANDE won 0.08€


Winamax Poker - HOLD-UP "Colorado" - HandId: #19116069-687835-1701701608 - Holdem no limit (0.01€/0.02€) - 2023/12/04 14:53:28 UTC
Table: 'Colorado' 6-max (real money) Seat #6 is the button
Seat 1: Eddy Agricol (2.19€)
Seat 2: xavatar92 (2.70€)
Seat 3: Fried Berg (0.77€)
Seat 4: taishimaster (4.06€)
Seat 5: rnachoc (2.30€)
Seat 6: ZenoidZ (2.72€)
*** ANTE/BLINDS ***
Eddy Agricol posts small blind 0.01€
xavatar92 posts big blind 0.02€
Dealt to Fried Berg [Th 3s]
*** PRE-FLOP *** 
Fried Berg folds
taishimaster folds
rnachoc folds
ZenoidZ raises 0.02€ to 0.04€
Eddy Agricol calls 0.03€
xavatar92 folds
*** FLOP *** [5s 8d Kc]
Eddy Agricol checks
ZenoidZ bets 0.05€
Eddy Agricol folds
ZenoidZ collected 0.14€ from pot
*** SUMMARY ***
Total pot 0.14€ | Rake 0.01€
Board: [5s 8d Kc]
Seat 6: ZenoidZ (button) won 0.14€


Winamax Poker - HOLD-UP "Colorado" - HandId: #19116069-687843-1701701613 - Holdem no limit (0.01€/0.02€) - 2023/12/04 14:53:33 UTC
Table: 'Colorado' 6-max (real money) Seat #6 is the button
Seat 1: Fried Berg (0.77€)
Seat 2: -pokeriste- (2.27€)
Seat 3: MC keke (2.98€)
Seat 4: Mouaxx (4.60€)
Seat 5: nunsuka69 (2.15€)
Seat 6: C.S Hey Hey (2.58€)
*** ANTE/BLINDS ***
Fried Berg posts small blind 0.01€
-pokeriste- posts big blind 0.02€
Dealt to Fried Berg [As 2s]
*** PRE-FLOP *** 
MC keke folds
Mouaxx folds
nunsuka69 folds
C.S Hey Hey raises 0.03€ to 0.05€
Fried Berg calls 0.04€
-pokeriste- folds
*** FLOP *** [5d 7s 7c]
Fried Berg checks
C.S Hey Hey checks
*** TURN *** [5d 7s 7c][2d]
Fried Berg checks
C.S Hey Hey bets 0.07€
Fried Berg calls 0.07€
*** RIVER *** [5d 7s 7c 2d][4c]
Fried Berg checks
C.S Hey Hey checks
*** SHOW DOWN ***
C.S Hey Hey shows [Qs Kh] (One pair : 7)
Fried Berg shows [As 2s] (Two pairs : 7 and 2)
Fried Berg collected 0.23€ from pot
*** SUMMARY ***
Total pot 0.23€ | Rake 0.03€
Board: [5d 7s 7c 2d 4c]
Seat 1: Fried Berg (small blind) showed [As 2s] and won 0.23€ with Two pairs : 7 and 2
Seat 6: C.S Hey Hey (button) showed [Qs Kh] and lost with One pair : 7


Winamax Poker - HOLD-UP "Colorado" - HandId: #19116069-688004-1701701723 - Holdem no limit (0.01€/0.02€) - 2023/12/04 14:55:23 UTC
Table: 'Colorado' 6-max (real money) Seat #6 is the button
Seat 1: _ilTulipano_ (2.17€)
Seat 2: C.S Hey Hey (2.46€)
Seat 3: Zile741 (2.23€)
Seat 4: Fried Berg (0.88€)
Seat 5: MrFlash9 (2.76€)
Seat 6: V.N.T.M (1.60€)
*** ANTE/BLINDS ***
_ilTulipano_ posts small blind 0.01€
C.S Hey Hey posts big blind 0.02€
Dealt to Fried Berg [5h Ts]
*** PRE-FLOP *** 
Zile741 folds
Fried Berg folds
MrFlash9 folds
V.N.T.M raises 0.02€ to 0.04€
_ilTulipano_ raises 0.10€ to 0.14€
C.S Hey Hey folds
V.N.T.M raises 1.46€ to 1.60€ and is all-in
_ilTulipano_ folds
V.N.T.M collected 1.76€ from pot
*** SUMMARY ***
Total pot 1.76€ | No rake
Seat 6: V.N.T.M (button) won 1.76€


Winamax Poker - HOLD-UP "Colorado" - HandId: #19116069-688013-1701701730 - Holdem no limit (0.01€/0.02€) - 2023/12/04 14:55:30 UTC
Table: 'Colorado' 6-max (real money) Seat #6 is the button
Seat 1: fishkingbull (2.11€)
Seat 2: Fried Berg (0.88€)
Seat 3: xavatar92 (2.14€)
Seat 4: Zile741 (2.23€)
Seat 5: nico033 (1.94€)
Seat 6: David Boring (3.60€)
*** ANTE/BLINDS ***
fishkingbull posts small blind 0.01€
Fried Berg posts big blind 0.02€
Dealt to Fried Berg [7s 4h]
*** PRE-FLOP *** 
xavatar92 folds
Zile741 folds
nico033 folds
David Boring folds
fishkingbull folds
Fried Berg collected 0.03€ from pot
*** SUMMARY ***
Total pot 0.03€ | No rake
Seat 2: Fried Berg (big blind) won 0.03€


Winamax Poker - HOLD-UP "Colorado" - HandId: #19116069-688030-1701701741 - Holdem no limit (0.01€/0.02€) - 2023/12/04 14:55:41 UTC
Table: 'Colorado' 6-max (real money) Seat #6 is the button
Seat 1: megalithe (1.82€)
Seat 2: bastos2525 (2.52€)
Seat 3: MrFlash9 (3.46€)
Seat 4: fishkingbull (2.10€)
Seat 5: T.REx. (1.94€)
Seat 6: Fried Berg (0.89€)
*** ANTE/BLINDS ***
megalithe posts small blind 0.01€
bastos2525 posts big blind 0.02€
Dealt to Fried Berg [9s 7h]
*** PRE-FLOP *** 
MrFlash9 folds
fishkingbull folds
T.REx. folds
Fried Berg raises 0.02€ to 0.04€
megalithe calls 0.03€
bastos2525 folds
*** FLOP *** [8c 2s 6h]
megalithe checks
Fried Berg checks
*** TURN *** [8c 2s 6h][7c]
megalithe checks
Fried Berg checks
*** RIVER *** [8c 2s 6h 7c][4c]
megalithe checks
Fried Berg checks
*** SHOW DOWN ***
Fried Berg shows [9s 7h] (One pair : 7)
megalithe shows [5h Jh] (Straight 8 high)
megalithe collected 0.09€ from pot
*** SUMMARY ***
Total pot 0.09€ | Rake 0.01€
Board: [8c 2s 6h 7c 4c]
Seat 1: megalithe (small blind) showed [5h Jh] and won 0.09€ with Straight 8 high
Seat 6: Fried Berg (button) showed [9s 7h] and lost with One pair : 7


Winamax Poker - HOLD-UP "Colorado" - HandId: #19116069-688079-1701701768 - Holdem no limit (0.01€/0.02€) - 2023/12/04 14:56:08 UTC
Table: 'Colorado' 6-max (real money) Seat #6 is the button
Seat 1: Thequeen1205 (3.17€)
Seat 2: T.REx. (1.91€)
Seat 3: Fried Berg (0.85€)
Seat 4: megalithe (1.87€)
Seat 5: Blackmamba06 (2.32€)
Seat 6: Karinecokine (0.46€)
*** ANTE/BLINDS ***
Thequeen1205 posts small blind 0.01€
T.REx. posts big blind 0.02€
Dealt to Fried Berg [3d 4d]
*** PRE-FLOP *** 
Fried Berg raises 0.02€ to 0.04€
megalithe calls 0.04€
Blackmamba06 folds
Karinecokine folds
Thequeen1205 folds
T.REx. folds
*** FLOP *** [7s 5h Ts]
Fried Berg checks
megalithe bets 0.09€
Fried Berg folds
megalithe collected 0.19€ from pot
*** SUMMARY ***
Total pot 0.19€ | Rake 0.01€
Board: [7s 5h Ts]
Seat 4: megalithe won 0.19€


Winamax Poker - HOLD-UP "Colorado" - HandId: #19116069-688165-1701701825 - Holdem no limit (0.01€/0.02€) - 2023/12/04 14:57:05 UTC
Table: 'Colorado' 6-max (real money) Seat #6 is the button
Seat 1: bastos2525 (0.36€)
Seat 2: Brut2pok (2€)
Seat 3: nunsuka69 (2.40€)
Seat 4: xavatar92 (6.95€)
Seat 5: Fried Berg (0.81€)
Seat 6: David Boring (2.12€)
*** ANTE/BLINDS ***
bastos2525 posts small blind 0.01€
Brut2pok posts big blind 0.02€
Dealt to Fried Berg [7c 6h]
*** PRE-FLOP *** 
nunsuka69 folds
xavatar92 folds
Fried Berg folds
David Boring calls 0.02€
bastos2525 calls 0.01€
Brut2pok checks
*** FLOP *** [9h 2c Jc]
bastos2525 bets 0.06€
Brut2pok folds
David Boring folds
bastos2525 collected 0.11€ from pot
*** SUMMARY ***
Total pot 0.11€ | Rake 0.01€
Board: [9h 2c Jc]
Seat 1: bastos2525 (small blind) won 0.11€


Winamax Poker - HOLD-UP "Colorado" - HandId: #19116069-688179-1701701834 - Holdem no limit (0.01€/0.02€) - 2023/12/04 14:57:14 UTC
Table: 'Colorado' 6-max (real money) Seat #6 is the button
Seat 1: Keep Solving (2€)
Seat 2: Tofini (2€)
Seat 3: kaikuji (2.01€)
Seat 4: LMG22_23 (1.93€)
Seat 5: Dario 365 (2€)
Seat 6: Fried Berg (0.81€)
*** ANTE/BLINDS ***
Keep Solving posts small blind 0.01€
Tofini posts big blind 0.02€
Dealt to Fried Berg [Jc Tc]
*** PRE-FLOP *** 
kaikuji raises 0.04€ to 0.06€
LMG22_23 folds
Dario 365 folds
Fried Berg calls 0.06€
Keep Solving folds
Tofini raises 0.19€ to 0.25€
kaikuji calls 0.19€
Fried Berg calls 0.19€
*** FLOP *** [5c 7d Qs]
Tofini bets 0.27€
kaikuji folds
Fried Berg folds
Tofini collected 0.95€ from pot
*** SUMMARY ***
Total pot 0.95€ | Rake 0.08€
Board: [5c 7d Qs]
Seat 2: Tofini (big blind) won 0.95€


Winamax Poker - HOLD-UP "Colorado" - HandId: #19116069-688268-1701701883 - Holdem no limit (0.01€/0.02€) - 2023/12/04 14:58:03 UTC
Table: 'Colorado' 6-max (real money) Seat #6 is the button
Seat 1: Eddy Agricol (5.85€)
Seat 2: Fried Berg (0.56€)
Seat 3: Ertorko (4.98€)
Seat 4: badou29 (5.03€)
Seat 5: Queenrat (2.55€)
Seat 6: MC keke (2.24€)
*** ANTE/BLINDS ***
Eddy Agricol posts small blind 0.01€
Fried Berg posts big blind 0.02€
Dealt to Fried Berg [Th Js]
*** PRE-FLOP *** 
Ertorko raises 0.03€ to 0.05€
badou29 folds
Queenrat folds
MC keke folds
Eddy Agricol folds
Fried Berg calls 0.03€
*** FLOP *** [5s 4h 6c]
Fried Berg checks
Ertorko checks
*** TURN *** [5s 4h 6c][Kd]
Fried Berg checks
Ertorko bets 0.07€
Fried Berg folds
Ertorko collected 0.17€ from pot
*** SUMMARY ***
Total pot 0.17€ | Rake 0.01€
Board: [5s 4h 6c Kd]
Seat 3: Ertorko won 0.17€


Winamax Poker - HOLD-UP "Colorado" - HandId: #19116069-688329-1701701914 - Holdem no limit (0.01€/0.02€) - 2023/12/04 14:58:34 UTC
Table: 'Colorado' 6-max (real money) Seat #6 is the button
Seat 1: Fried Berg (0.51€)
Seat 2: David Boring (2.21€)
Seat 3: Brut2pok (2.01€)
Seat 4: King river62 (2.16€)
Seat 5: megalithe (1.77€)
Seat 6: OTE BABA (2.13€)
Hold-up to Pot: total 0.10€
*** ANTE/BLINDS ***
Fried Berg posts small blind 0.01€
David Boring posts big blind 0.02€
Dealt to Fried Berg [Ad 5d]
*** PRE-FLOP *** 
Brut2pok folds
King river62 folds
megalithe raises 0.02€ to 0.04€
OTE BABA raises 0.08€ to 0.12€
Fried Berg raises 0.39€ to 0.51€ and is all-in
David Boring folds
megalithe raises 1.26€ to 1.77€ and is all-in
OTE BABA folds
*** FLOP *** [Js Jc 7c]
*** TURN *** [Js Jc 7c][As]
*** RIVER *** [Js Jc 7c As][Td]
*** SHOW DOWN ***
Fried Berg shows [Ad 5d] (Two pairs : Aces and Jacks)
megalithe shows [Kh Kc] (Two pairs : Kings and Jacks)
megalithe collected 1.26€ from side pot 1
Fried Berg collected 1.14€ from main pot
*** SUMMARY ***
Total pot 2.40€ | Rake 0.12€
Board: [Js Jc 7c As Td]
Seat 1: Fried Berg (small blind) showed [Ad 5d] and won 1.14€ with Two pairs : Aces and Jacks
Seat 5: megalithe showed [Kh Kc] and won 1.26€ with Two pairs : Kings and Jacks


Winamax Poker - HOLD-UP "Colorado" - HandId: #19116069-688383-1701701944 - Holdem no limit (0.01€/0.02€) - 2023/12/04 14:59:04 UTC
Table: 'Colorado' 6-max (real money) Seat #6 is the button
Seat 1: Sharkpoker80 (2.34€)
Seat 2: OTE BABA (2.01€)
Seat 3: bastos2525 (1.18€)
Seat 4: Fried Berg (1.14€)
Seat 5: Kangourou589 (3.79€)
Seat 6: Lorenzo1 (0.68€)
*** ANTE/BLINDS ***
Sharkpoker80 posts small blind 0.01€
OTE BABA posts big blind 0.02€
Dealt to Fried Berg [5d 9d]
*** PRE-FLOP *** 
bastos2525 raises 0.05€ to 0.07€
Fried Berg folds
Kangourou589 calls 0.07€
Lorenzo1 folds
Sharkpoker80 folds
OTE BABA calls 0.05€
*** FLOP *** [3h 3s Ad]
OTE BABA checks
bastos2525 bets 0.08€
Kangourou589 calls 0.08€
OTE BABA folds
*** TURN *** [3h 3s Ad][Qc]
bastos2525 bets 0.13€
Kangourou589 folds
bastos2525 collected 0.47€ from pot
*** SUMMARY ***
Total pot 0.47€ | Rake 0.04€
Board: [3h 3s Ad Qc]
Seat 3: bastos2525 won 0.47€


Winamax Poker - HOLD-UP "Colorado" - HandId: #19116069-688395-1701701950 - Holdem no limit (0.01€/0.02€) - 2023/12/04 14:59:10 UTC
Table: 'Colorado' 6-max (real money) Seat #6 is the button
Seat 1: gil95100 (2.73€)
Seat 2: Volympio (2€)
Seat 3: T.REx. (1.94€)
Seat 4: Brut2pok (5.55€)
Seat 5: Fried Berg (1.14€)
Seat 6: Jorj-X-McKie (1.66€)
*** ANTE/BLINDS ***
gil95100 posts small blind 0.01€
Volympio posts big blind 0.02€
Dealt to Fried Berg [2c 3h]
*** PRE-FLOP *** 
T.REx. folds
Brut2pok folds
Fried Berg folds
Jorj-X-McKie folds
gil95100 folds
Volympio collected 0.03€ from pot
*** SUMMARY ***
Total pot 0.03€ | No rake
Seat 2: Volympio (big blind) won 0.03€


Winamax Poker - HOLD-UP "Colorado" - HandId: #19116069-688406-1701701955 - Holdem no limit (0.01€/0.02€) - 2023/12/04 14:59:15 UTC
Table: 'Colorado' 6-max (real money) Seat #6 is the button
Seat 1: RamottttoTW (2€)
Seat 2: xavatar92 (7.14€)
Seat 3: Fried Berg (1.14€)
Seat 4: Le_Pictavien (2.15€)
Seat 5: Dario 365 (2€)
Seat 6: Moi4716 (1.86€)
*** ANTE/BLINDS ***
RamottttoTW posts small blind 0.01€
xavatar92 posts big blind 0.02€
Dealt to Fried Berg [7h 3c]
*** PRE-FLOP *** 
Fried Berg folds
Le_Pictavien folds
Dario 365 raises 0.05€ to 0.07€
Moi4716 folds
RamottttoTW folds
xavatar92 calls 0.05€
*** FLOP *** [8h 6d Qh]
xavatar92 checks
Dario 365 bets 0.15€
xavatar92 folds
Dario 365 collected 0.28€ from pot
*** SUMMARY ***
Total pot 0.28€ | Rake 0.02€
Board: [8h 6d Qh]
Seat 5: Dario 365 won 0.28€


Winamax Poker - HOLD-UP "Colorado" - HandId: #19116069-688411-1701701957 - Holdem no limit (0.01€/0.02€) - 2023/12/04 14:59:17 UTC
Table: 'Colorado' 6-max (real money) Seat #6 is the button
Seat 1: Volympio (2.01€)
Seat 2: kellyludo (1.65€)
Seat 3: Thequeen1205 (1.93€)
Seat 4: Fried Berg (1.14€)
Seat 5: _ilTulipano_ (4.10€)
Seat 6: Brut2pok (5.55€)
*** ANTE/BLINDS ***
Volympio posts small blind 0.01€
kellyludo posts big blind 0.02€
Dealt to Fried Berg [Qs Ks]
*** PRE-FLOP *** 
Thequeen1205 raises 0.03€ to 0.05€
Fried Berg raises 0.10€ to 0.15€
_ilTulipano_ folds
Brut2pok folds
Volympio folds
kellyludo folds
Thequeen1205 calls 0.10€
*** FLOP *** [3d Ad 7h]
Thequeen1205 checks
Fried Berg bets 0.04€
Thequeen1205 calls 0.04€
*** TURN *** [3d Ad 7h][5h]
Thequeen1205 bets 0.21€
Fried Berg folds
Thequeen1205 collected 0.58€ from pot
*** SUMMARY ***
Total pot 0.58€ | Rake 0.04€
Board: [3d Ad 7h 5h]
Seat 3: Thequeen1205 won 0.58€


Winamax Poker - HOLD-UP "Colorado" - HandId: #19116069-688501-1701702003 - Holdem no limit (0.01€/0.02€) - 2023/12/04 15:00:03 UTC
Table: 'Colorado' 6-max (real money) Seat #6 is the button
Seat 1: OTE BABA (2.13€)
Seat 2: Fried Berg (0.95€)
Seat 3: David Boring (3.40€)
Seat 4: HH-Titan9811 (3.63€)
Seat 5: Mouaxx (3.23€)
Seat 6: Blackmamba06 (2€)
*** ANTE/BLINDS ***
OTE BABA posts small blind 0.01€
Fried Berg posts big blind 0.02€
Dealt to Fried Berg [9c Ad]
*** PRE-FLOP *** 
David Boring folds
HH-Titan9811 calls 0.02€
Mouaxx folds
Blackmamba06 calls 0.02€
OTE BABA folds
Fried Berg checks
*** FLOP *** [Js 2h 8s]
Fried Berg checks
HH-Titan9811 checks
Blackmamba06 bets 0.05€
Fried Berg folds
HH-Titan9811 folds
Blackmamba06 collected 0.11€ from pot
*** SUMMARY ***
Total pot 0.11€ | Rake 0.01€
Board: [Js 2h 8s]
Seat 6: Blackmamba06 (button) won 0.11€


Winamax Poker - HOLD-UP "Colorado" - HandId: #19116069-688568-1701702041 - Holdem no limit (0.01€/0.02€) - 2023/12/04 15:00:41 UTC
Table: 'Colorado' 6-max (real money) Seat #6 is the button
Seat 1: Fried Berg (0.93€)
Seat 2: xavatar92 (3.01€)
Seat 3: Thequeen1205 (2€)
Seat 4: LilRun (3.06€)
Seat 5: kellyludo (1.78€)
Seat 6: PabloRio (0.80€)
*** ANTE/BLINDS ***
Fried Berg posts small blind 0.01€
xavatar92 posts big blind 0.02€
Dealt to Fried Berg [Ac Kh]
*** PRE-FLOP *** 
Thequeen1205 folds
LilRun folds
kellyludo calls 0.02€
PabloRio folds
Fried Berg raises 0.02€ to 0.04€
xavatar92 folds
kellyludo calls 0.02€
*** FLOP *** [3s 5s 6d]
Fried Berg checks
kellyludo checks
*** TURN *** [3s 5s 6d][Th]
Fried Berg checks
kellyludo checks
*** RIVER *** [3s 5s 6d Th][Ks]
Fried Berg bets 0.04€
kellyludo folds
Fried Berg collected 0.13€ from pot
*** SUMMARY ***
Total pot 0.13€ | Rake 0.01€
Board: [3s 5s 6d Th Ks]
Seat 1: Fried Berg (small blind) won 0.13€


Winamax Poker - HOLD-UP "Colorado" - HandId: #19116069-688638-1701702080 - Holdem no limit (0.01€/0.02€) - 2023/12/04 15:01:20 UTC
Table: 'Colorado' 6-max (real money) Seat #6 is the button
Seat 1: tAAkeuchi (1.27€)
Seat 2: Thequeen1205 (2€)
Seat 3: Raggamin (5.09€)
Seat 4: nunsuka69 (2.42€)
Seat 5: Fried Berg (0.98€)
Seat 6: curiouz dje (2.23€)
*** ANTE/BLINDS ***
tAAkeuchi posts small blind 0.01€
Thequeen1205 posts big blind 0.02€
Dealt to Fried Berg [8c 7s]
*** PRE-FLOP *** 
Raggamin folds
nunsuka69 folds
Fried Berg folds
curiouz dje folds
tAAkeuchi raises 0.04€ to 0.06€
Thequeen1205 calls 0.04€
*** FLOP *** [Ac 4d 6d]
tAAkeuchi bets 0.09€
Thequeen1205 folds
tAAkeuchi collected 0.20€ from pot
*** SUMMARY ***
Total pot 0.20€ | Rake 0.01€
Board: [Ac 4d 6d]
Seat 1: tAAkeuchi (small blind) won 0.20€


Winamax Poker - HOLD-UP "Colorado" - HandId: #19116069-688668-1701702099 - Holdem no limit (0.01€/0.02€) - 2023/12/04 15:01:39 UTC
Table: 'Colorado' 6-max (real money) Seat #6 is the button
Seat 1: aspen dust7 (2.13€)
Seat 2: megalithe (1.66€)
Seat 3: Brut2pok (5.66€)
Seat 4: MartZRD (0.58€)
Seat 5: Eddy Agricol (5.28€)
Seat 6: Fried Berg (0.98€)
*** ANTE/BLINDS ***
aspen dust7 posts small blind 0.01€
megalithe posts big blind 0.02€
Dealt to Fried Berg [4c 2s]
*** PRE-FLOP *** 
Brut2pok folds
MartZRD folds
Eddy Agricol folds
Fried Berg folds
aspen dust7 folds
megalithe collected 0.03€ from pot
*** SUMMARY ***
Total pot 0.03€ | No rake
Seat 2: megalithe (big blind) won 0.03€


Winamax Poker - HOLD-UP "Colorado" - HandId: #19116069-688674-1701702104 - Holdem no limit (0.01€/0.02€) - 2023/12/04 15:01:44 UTC
Table: 'Colorado' 6-max (real money) Seat #6 is the button
Seat 1: kellyludo (1.89€)
Seat 2: nunsuka69 (2.79€)
Seat 3: Keep Solving (2.10€)
Seat 4: LakeLouise (5.99€)
Seat 5: Fried Berg (0.98€)
Seat 6: Eddy Agricol (5.28€)
*** ANTE/BLINDS ***
kellyludo posts small blind 0.01€
nunsuka69 posts big blind 0.02€
Dealt to Fried Berg [8s Tc]
*** PRE-FLOP *** 
Keep Solving raises 0.03€ to 0.05€
LakeLouise folds
Fried Berg folds
Eddy Agricol folds
kellyludo calls 0.04€
nunsuka69 folds
*** FLOP *** [9h Js Kh]
kellyludo checks
Keep Solving bets 0.04€
kellyludo folds
Keep Solving collected 0.15€ from pot
*** SUMMARY ***
Total pot 0.15€ | Rake 0.01€
Board: [9h Js Kh]
Seat 3: Keep Solving won 0.15€


Winamax Poker - HOLD-UP "Colorado" - HandId: #19116069-688684-1701702110 - Holdem no limit (0.01€/0.02€) - 2023/12/04 15:01:50 UTC
Table: 'Colorado' 6-max (real money) Seat #6 is the button
Seat 1: relaxalex27 (2.55€)
Seat 2: Fried Berg (0.98€)
Seat 3: Poironer (2.80€)
Seat 4: dragon2776 (1.76€)
Seat 5: megalithe (1.66€)
Seat 6: curiouz dje (2€)
*** ANTE/BLINDS ***
relaxalex27 posts small blind 0.01€
Fried Berg posts big blind 0.02€
Dealt to Fried Berg [9d 6s]
*** PRE-FLOP *** 
Poironer folds
dragon2776 raises 0.02€ to 0.04€
megalithe folds
curiouz dje folds
relaxalex27 raises 0.09€ to 0.13€
Fried Berg folds
dragon2776 calls 0.09€
*** FLOP *** [2s 2d Js]
relaxalex27 bets 0.10€
dragon2776 calls 0.10€
*** TURN *** [2s 2d Js][4d]
relaxalex27 checks
dragon2776 checks
*** RIVER *** [2s 2d Js 4d][Qh]
relaxalex27 checks
dragon2776 checks
*** SHOW DOWN ***
dragon2776 shows [9h Kh] (One pair : 2)
relaxalex27 shows [Tc Ts] (Two pairs : Tens and 2)
relaxalex27 collected 0.43€ from pot
*** SUMMARY ***
Total pot 0.43€ | Rake 0.05€
Board: [2s 2d Js 4d Qh]
Seat 1: relaxalex27 (small blind) showed [Tc Ts] and won 0.43€ with Two pairs : Tens and 2
Seat 4: dragon2776 showed [9h Kh] and lost with One pair : 2


Winamax Poker - HOLD-UP "Colorado" - HandId: #19116069-688705-1701702124 - Holdem no limit (0.01€/0.02€) - 2023/12/04 15:02:04 UTC
Table: 'Colorado' 6-max (real money) Seat #6 is the button
Seat 1: Fried Berg (0.96€)
Seat 2: MC keke (3.94€)
Seat 3: badou29 (5.10€)
Seat 4: Le_Pictavien (1.23€)
Seat 5: Brut2pok (3.29€)
Seat 6: GokuClan (2.53€)
*** ANTE/BLINDS ***
Fried Berg posts small blind 0.01€
MC keke posts big blind 0.02€
Dealt to Fried Berg [8h Th]
*** PRE-FLOP *** 
badou29 folds
Le_Pictavien folds
Brut2pok folds
GokuClan folds
Fried Berg raises 0.02€ to 0.04€
MC keke calls 0.02€
*** FLOP *** [2s 5d 4h]
Fried Berg checks
MC keke bets 0.06€
Fried Berg folds
MC keke collected 0.13€ from pot
*** SUMMARY ***
Total pot 0.13€ | Rake 0.01€
Board: [2s 5d 4h]
Seat 2: MC keke (big blind) won 0.13€


Winamax Poker - HOLD-UP "Colorado" - HandId: #19116069-688745-1701702149 - Holdem no limit (0.01€/0.02€) - 2023/12/04 15:02:29 UTC
Table: 'Colorado' 6-max (real money) Seat #6 is the button
Seat 1: Le_Pictavien (1.94€)
Seat 2: Blackmamba06 (3.49€)
Seat 3: Fried Berg (0.92€)
Seat 4: Thequeen1205 (4.05€)
Seat 5: Raggamin (4.14€)
Seat 6: King river62 (3.89€)
*** ANTE/BLINDS ***
Le_Pictavien posts small blind 0.01€
Blackmamba06 posts big blind 0.02€
Dealt to Fried Berg [4c Ac]
*** PRE-FLOP *** 
Fried Berg raises 0.02€ to 0.04€
Thequeen1205 calls 0.04€
Raggamin folds
King river62 raises 0.15€ to 0.19€
Le_Pictavien folds
Blackmamba06 folds
Fried Berg calls 0.15€
Thequeen1205 folds
*** FLOP *** [Js 2h 6h]
Fried Berg bets 0.08€
King river62 raises 3.62€ to 3.70€ and is all-in
Fried Berg folds
King river62 collected 4.17€ from pot
*** SUMMARY ***
Total pot 4.17€ | Rake 0.06€
Board: [Js 2h 6h]
Seat 6: King river62 (button) won 4.17€


Winamax Poker - HOLD-UP "Colorado" - HandId: #19116069-688811-1701702189 - Holdem no limit (0.01€/0.02€) - 2023/12/04 15:03:09 UTC
Table: 'Colorado' 6-max (real money) Seat #6 is the button
Seat 1: damz69 (0.50€)
Seat 2: Direct Oli (1.70€)
Seat 3: curiouz dje (2€)
Seat 4: Fried Berg (0.65€)
Seat 5: Ertorko (4.21€)
Seat 6: kenzowil31 (2.02€)
Hold-up to Pot: total 0.10€
*** ANTE/BLINDS ***
damz69 posts small blind 0.01€
Direct Oli posts big blind 0.02€
Dealt to Fried Berg [5s Td]
*** PRE-FLOP *** 
curiouz dje folds
Fried Berg folds
Ertorko raises 0.05€ to 0.07€
kenzowil31 calls 0.07€
damz69 folds
Direct Oli calls 0.05€
*** FLOP *** [Kd 7c 3h]
Direct Oli checks
Ertorko bets 0.11€
kenzowil31 raises 0.11€ to 0.22€
Direct Oli raises 1.41€ to 1.63€ and is all-in
Ertorko folds
kenzowil31 calls 1.41€
*** TURN *** [Kd 7c 3h][3c]
*** RIVER *** [Kd 7c 3h 3c][Qd]
*** SHOW DOWN ***
kenzowil31 shows [Kh 8s] (Two pairs : Kings and 3)
Direct Oli shows [Ad Kc] (Two pairs : Kings and 3)
Direct Oli collected 3.33€ from pot
*** SUMMARY ***
Total pot 3.33€ | Rake 0.36€
Board: [Kd 7c 3h 3c Qd]
Seat 2: Direct Oli (big blind) showed [Ad Kc] and won 3.33€ with Two pairs : Kings and 3
Seat 6: kenzowil31 (button) showed [Kh 8s] and lost with Two pairs : Kings and 3


Winamax Poker - HOLD-UP "Colorado" - HandId: #19116069-688820-1701702194 - Holdem no limit (0.01€/0.02€) - 2023/12/04 15:03:14 UTC
Table: 'Colorado' 6-max (real money) Seat #6 is the button
Seat 1: _Croute_ (6.53€)
Seat 2: nunsuka69 (2.30€)
Seat 3: damz69 (0.49€)
Seat 4: JFSredbaron (3.11€)
Seat 5: Tofini (2.04€)
Seat 6: Fried Berg (0.65€)
*** ANTE/BLINDS ***
_Croute_ posts small blind 0.01€
nunsuka69 posts big blind 0.02€
Dealt to Fried Berg [3s Js]
*** PRE-FLOP *** 
damz69 folds
JFSredbaron folds
Tofini folds
Fried Berg folds
_Croute_ folds
nunsuka69 collected 0.03€ from pot
*** SUMMARY ***
Total pot 0.03€ | No rake
Seat 2: nunsuka69 (big blind) won 0.03€


Winamax Poker - HOLD-UP "Colorado" - HandId: #19116069-688832-1701702201 - Holdem no limit (0.01€/0.02€) - 2023/12/04 15:03:21 UTC
Table: 'Colorado' 6-max (real money) Seat #6 is the button
Seat 1: MrFlash9 (3.05€)
Seat 2: thonyo 88 (1.99€)
Seat 3: Raggamin (5€)
Seat 4: _ilTulipano_ (2.43€)
Seat 5: Fried Berg (0.65€)
Seat 6: HH-Titan9811 (2.21€)
*** ANTE/BLINDS ***
MrFlash9 posts small blind 0.01€
thonyo 88 posts big blind 0.02€
Dealt to Fried Berg [5s 6s]
*** PRE-FLOP *** 
Raggamin folds
_ilTulipano_ raises 0.04€ to 0.06€
Fried Berg calls 0.06€
HH-Titan9811 calls 0.06€
MrFlash9 folds
thonyo 88 folds
*** FLOP *** [Jh Kd 4c]
_ilTulipano_ checks
Fried Berg checks
HH-Titan9811 checks
*** TURN *** [Jh Kd 4c][6d]
_ilTulipano_ checks
Fried Berg checks
HH-Titan9811 checks
*** RIVER *** [Jh Kd 4c 6d][Jd]
_ilTulipano_ checks
Fried Berg checks
HH-Titan9811 checks
*** SHOW DOWN ***
Fried Berg shows [5s 6s] (Two pairs : Jacks and 6)
HH-Titan9811 shows [Ac 5c] (One pair : Jacks)
_ilTulipano_ shows [7c 7h] (Two pairs : Jacks and 7)
_ilTulipano_ collected 0.19€ from pot
*** SUMMARY ***
Total pot 0.19€ | Rake 0.02€
Board: [Jh Kd 4c 6d Jd]
Seat 4: _ilTulipano_ showed [7c 7h] and won 0.19€ with Two pairs : Jacks and 7
Seat 5: Fried Berg showed [5s 6s] and lost with Two pairs : Jacks and 6
Seat 6: HH-Titan9811 (button) showed [Ac 5c] and lost with One pair : Jacks


Winamax Poker - HOLD-UP "Colorado" - HandId: #19116069-688997-1701702294 - Holdem no limit (0.01€/0.02€) - 2023/12/04 15:04:54 UTC
Table: 'Colorado' 6-max (real money) Seat #6 is the button
Seat 1: HH-Titan9811 (2.15€)
Seat 2: Tofini (2.22€)
Seat 3: RamottttoTW (3.31€)
Seat 4: Fried Berg (0.59€)
Seat 5: Thequeen1205 (4.33€)
Seat 6: bananAsSplit (2.69€)
*** ANTE/BLINDS ***
HH-Titan9811 posts small blind 0.01€
Tofini posts big blind 0.02€
Dealt to Fried Berg [8s 5c]
*** PRE-FLOP *** 
RamottttoTW folds
Fried Berg folds
Thequeen1205 folds
bananAsSplit folds
HH-Titan9811 folds
Tofini collected 0.03€ from pot
*** SUMMARY ***
Total pot 0.03€ | No rake
Seat 2: Tofini (big blind) won 0.03€


Winamax Poker - HOLD-UP "Colorado" - HandId: #19116069-689003-1701702298 - Holdem no limit (0.01€/0.02€) - 2023/12/04 15:04:58 UTC
Table: 'Colorado' 6-max (real money) Seat #6 is the button
Seat 1: _ilTulipano_ (4.39€)
Seat 2: Fried Berg (0.59€)
Seat 3: JFSredbaron (3.10€)
Seat 4: MC keke (2.49€)
Seat 5: Eddy Agricol (5.06€)
Seat 6: bananAsSplit (2.69€)
*** ANTE/BLINDS ***
_ilTulipano_ posts small blind 0.01€
Fried Berg posts big blind 0.02€
Dealt to Fried Berg [2s 5s]
*** PRE-FLOP *** 
JFSredbaron folds
MC keke folds
Eddy Agricol folds
bananAsSplit folds
_ilTulipano_ folds
Fried Berg collected 0.03€ from pot
*** SUMMARY ***
Total pot 0.03€ | No rake
Seat 2: Fried Berg (big blind) won 0.03€


Winamax Poker - HOLD-UP "Colorado" - HandId: #19116069-689051-1701702324 - Holdem no limit (0.01€/0.02€) - 2023/12/04 15:05:24 UTC
Table: 'Colorado' 6-max (real money) Seat #6 is the button
Seat 1: Fried Berg (0.60€)
Seat 2: Volympio (3.18€)
Seat 3: RamottttoTW (2.25€)
Seat 4: Killim (0.29€)
Seat 5: Ertorko (3.91€)
Seat 6: skrr (1.86€)
*** ANTE/BLINDS ***
Fried Berg posts small blind 0.01€
Volympio posts big blind 0.02€
Dealt to Fried Berg [5d As]
*** PRE-FLOP *** 
RamottttoTW folds
Killim folds
Ertorko folds
skrr calls 0.02€
Fried Berg calls 0.01€
Volympio checks
*** FLOP *** [Th 8s Qc]
Fried Berg checks
Volympio bets 0.06€
skrr calls 0.06€
Fried Berg folds
*** TURN *** [Th 8s Qc][Jh]
Volympio bets 0.06€
skrr folds
Volympio collected 0.22€ from pot
*** SUMMARY ***
Total pot 0.22€ | Rake 0.02€
Board: [Th 8s Qc Jh]
Seat 2: Volympio (big blind) won 0.22€


Winamax Poker - HOLD-UP "Colorado" - HandId: #19116069-689087-1701702343 - Holdem no limit (0.01€/0.02€) - 2023/12/04 15:05:43 UTC
Table: 'Colorado' 6-max (real money) Seat #6 is the button
Seat 1: _ilTulipano_ (6.14€)
Seat 2: Thequeen1205 (4.30€)
Seat 3: Fried Berg (0.58€)
Seat 4: MC keke (2.11€)
Seat 5: curiouz dje (2.03€)
Seat 6: Lou Bourrin (1.57€)
*** ANTE/BLINDS ***
_ilTulipano_ posts small blind 0.01€
Thequeen1205 posts big blind 0.02€
Dealt to Fried Berg [Ac 9s]
*** PRE-FLOP *** 
Fried Berg raises 0.02€ to 0.04€
MC keke folds
curiouz dje calls 0.04€
Lou Bourrin folds
_ilTulipano_ raises 0.16€ to 0.20€
Thequeen1205 folds
Fried Berg folds
curiouz dje folds
_ilTulipano_ collected 0.30€ from pot
*** SUMMARY ***
Total pot 0.30€ | No rake
Seat 1: _ilTulipano_ (small blind) won 0.30€


Winamax Poker - HOLD-UP "Colorado" - HandId: #19116069-689130-1701702366 - Holdem no limit (0.01€/0.02€) - 2023/12/04 15:06:06 UTC
Table: 'Colorado' 6-max (real money) Seat #6 is the button
Seat 1: packymaitre (0.96€)
Seat 2: Le_Pictavien (1€)
Seat 3: tichettede3 (5.15€)
Seat 4: LakeLouise (4.17€)
Seat 5: Raggamin (2.01€)
Seat 6: Fried Berg (0.54€)
*** ANTE/BLINDS ***
packymaitre posts small blind 0.01€
Le_Pictavien posts big blind 0.02€
Dealt to Fried Berg [3h Kd]
*** PRE-FLOP *** 
tichettede3 folds
LakeLouise folds
Raggamin raises 0.04€ to 0.06€
Fried Berg folds
packymaitre raises 0.12€ to 0.18€
Le_Pictavien folds
Raggamin folds
packymaitre collected 0.26€ from pot
*** SUMMARY ***
Total pot 0.26€ | No rake
Seat 1: packymaitre (small blind) won 0.26€


Winamax Poker - HOLD-UP "Colorado" - HandId: #19116069-689145-1701702375 - Holdem no limit (0.01€/0.02€) - 2023/12/04 15:06:15 UTC
Table: 'Colorado' 6-max (real money) Seat #6 is the button
Seat 1: MC keke (2.53€)
Seat 2: nunsuka69 (2.08€)
Seat 3: taishimaster (2.07€)
Seat 4: Fried Berg (0.54€)
Seat 5: wmx-kmgw88p (1.22€)
Seat 6: KhakiField (2€)
*** ANTE/BLINDS ***
MC keke posts small blind 0.01€
nunsuka69 posts big blind 0.02€
Dealt to Fried Berg [3s 8h]
*** PRE-FLOP *** 
taishimaster raises 0.03€ to 0.05€
Fried Berg folds
wmx-kmgw88p folds
KhakiField folds
MC keke folds
nunsuka69 folds
taishimaster collected 0.08€ from pot
*** SUMMARY ***
Total pot 0.08€ | No rake
Seat 3: taishimaster won 0.08€


Winamax Poker - HOLD-UP "Colorado" - HandId: #19116069-691611-1701703981 - Holdem no limit (0.01€/0.02€) - 2023/12/04 15:33:01 UTC
Table: 'Colorado' 6-max (real money) Seat #6 is the button
Seat 1: El BuRbUjO (2.01€)
Seat 2: Fried Berg (0.50€)
Seat 3: packymaitre (3.07€)
Seat 4: DocteurSplit (2.06€)
Seat 5: Killim (1.66€)
Seat 6: Raggamin (4.24€)
*** ANTE/BLINDS ***
El BuRbUjO posts small blind 0.01€
Fried Berg posts big blind 0.02€
Dealt to Fried Berg [Jh 6h]
*** PRE-FLOP *** 
packymaitre folds
DocteurSplit folds
Killim folds
Raggamin raises 0.03€ to 0.05€
El BuRbUjO folds
Fried Berg calls 0.03€
*** FLOP *** [2c 7d 7c]
Fried Berg checks
Raggamin bets 0.07€
Fried Berg folds
Raggamin collected 0.17€ from pot
*** SUMMARY ***
Total pot 0.17€ | Rake 0.01€
Board: [2c 7d 7c]
Seat 6: Raggamin (button) won 0.17€


Winamax Poker - HOLD-UP "Colorado" - HandId: #19116069-691689-1701704030 - Holdem no limit (0.01€/0.02€) - 2023/12/04 15:33:50 UTC
Table: 'Colorado' 6-max (real money) Seat #6 is the button
Seat 1: Fried Berg (0.45€)
Seat 2: GTO-Mieko (2.52€)
Seat 3: g8o8k8u (2.28€)
Seat 4: CTMieuxAvant (3.30€)
Seat 5: jesuskippy (1.57€)
Seat 6: packymaitre (2.81€)
*** ANTE/BLINDS ***
Fried Berg posts small blind 0.01€
GTO-Mieko posts big blind 0.02€
Dealt to Fried Berg [Kh 4h]
*** PRE-FLOP *** 
g8o8k8u folds
CTMieuxAvant folds
jesuskippy folds
packymaitre folds
Fried Berg raises 0.02€ to 0.04€
GTO-Mieko folds
Fried Berg collected 0.06€ from pot
*** SUMMARY ***
Total pot 0.06€ | No rake
Seat 1: Fried Berg (small blind) won 0.06€


Winamax Poker - HOLD-UP "Colorado" - HandId: #19116069-691726-1701704050 - Holdem no limit (0.01€/0.02€) - 2023/12/04 15:34:10 UTC
Table: 'Colorado' 6-max (real money) Seat #6 is the button
Seat 1: Gildus44 (2.12€)
Seat 2: nunsuka69 (2.66€)
Seat 3: Fried Berg (0.47€)
Seat 4: El BuRbUjO (2.03€)
Seat 5: bananAsSplit (2.72€)
Seat 6: Estrelita91 (0.77€)
*** ANTE/BLINDS ***
Gildus44 posts small blind 0.01€
nunsuka69 posts big blind 0.02€
Dealt to Fried Berg [4h Qh]
*** PRE-FLOP *** 
Fried Berg folds
El BuRbUjO folds
bananAsSplit folds
Estrelita91 calls 0.02€
Gildus44 folds
nunsuka69 checks
*** FLOP *** [Ah 2c 3d]
nunsuka69 checks
Estrelita91 checks
*** TURN *** [Ah 2c 3d][9c]
nunsuka69 checks
Estrelita91 checks
*** RIVER *** [Ah 2c 3d 9c][Kc]
nunsuka69 checks
Estrelita91 checks
*** SHOW DOWN ***
Estrelita91 shows [Td 6h] (High card : Ace)
nunsuka69 shows [3h 8s] (One pair : 3)
nunsuka69 collected 0.04€ from pot
*** SUMMARY ***
Total pot 0.04€ | Rake 0.01€
Board: [Ah 2c 3d 9c Kc]
Seat 2: nunsuka69 (big blind) showed [3h 8s] and won 0.04€ with One pair : 3
Seat 6: Estrelita91 (button) showed [Td 6h] and lost with High card : Ace


Winamax Poker - HOLD-UP "Colorado" - HandId: #19116069-691734-1701704053 - Holdem no limit (0.01€/0.02€) - 2023/12/04 15:34:13 UTC
Table: 'Colorado' 6-max (real money) Seat #6 is the button
Seat 1: CTMieuxAvant (2.32€)
Seat 2: MANU2019 (0.82€)
Seat 3: tichettede3 (7.16€)
Seat 4: Fried Berg (0.47€)
Seat 5: David Boring (6.58€)
Seat 6: sse92 (2.10€)
*** ANTE/BLINDS ***
CTMieuxAvant posts small blind 0.01€
MANU2019 posts big blind 0.02€
Dealt to Fried Berg [Ad Kd]
*** PRE-FLOP *** 
tichettede3 folds
Fried Berg raises 0.04€ to 0.06€
David Boring folds
sse92 folds
CTMieuxAvant folds
MANU2019 folds
Fried Berg collected 0.09€ from pot
*** SUMMARY ***
Total pot 0.09€ | No rake
Seat 4: Fried Berg won 0.09€


Winamax Poker - HOLD-UP "Colorado" - HandId: #19116069-691758-1701704065 - Holdem no limit (0.01€/0.02€) - 2023/12/04 15:34:25 UTC
Table: 'Colorado' 6-max (real money) Seat #6 is the button
Seat 1: -BrokenSmile (2.17€)
Seat 2: Le_Pictavien (1.68€)
Seat 3: CTMieuxAvant (1.61€)
Seat 4: tichettede3 (7.15€)
Seat 5: Fried Berg (0.50€)
Seat 6: DocteurSplit (2€)
*** ANTE/BLINDS ***
-BrokenSmile posts small blind 0.01€
Le_Pictavien posts big blind 0.02€
Dealt to Fried Berg [7h Kh]
*** PRE-FLOP *** 
CTMieuxAvant folds
tichettede3 raises 0.03€ to 0.05€
Fried Berg calls 0.05€
DocteurSplit folds
-BrokenSmile folds
Le_Pictavien calls 0.03€
*** FLOP *** [7d 3d 9d]
Le_Pictavien checks
tichettede3 bets 0.10€
Fried Berg folds
Le_Pictavien folds
tichettede3 collected 0.24€ from pot
*** SUMMARY ***
Total pot 0.24€ | Rake 0.02€
Board: [7d 3d 9d]
Seat 4: tichettede3 won 0.24€


Winamax Poker - HOLD-UP "Colorado" - HandId: #19116069-691820-1701704107 - Holdem no limit (0.01€/0.02€) - 2023/12/04 15:35:07 UTC
Table: 'Colorado' 6-max (real money) Seat #6 is the button
Seat 1: packymaitre (2.73€)
Seat 2: _Croute_ (7.67€)
Seat 3: nunsuka69 (2.68€)
Seat 4: fishkingbull (2.87€)
Seat 5: Itashi.95 (1.73€)
Seat 6: Fried Berg (0.45€)
*** ANTE/BLINDS ***
packymaitre posts small blind 0.01€
_Croute_ posts big blind 0.02€
Dealt to Fried Berg [8s 6c]
*** PRE-FLOP *** 
nunsuka69 folds
fishkingbull folds
Itashi.95 folds
Fried Berg folds
packymaitre folds
_Croute_ collected 0.03€ from pot
*** SUMMARY ***
Total pot 0.03€ | No rake
Seat 2: _Croute_ (big blind) won 0.03€


Winamax Poker - HOLD-UP "Colorado" - HandId: #19116069-691824-1701704109 - Holdem no limit (0.01€/0.02€) - 2023/12/04 15:35:09 UTC
Table: 'Colorado' 6-max (real money) Seat #6 is the button
Seat 1: Tofini (2€)
Seat 2: baradoz29 (1.56€)
Seat 3: Le_Pictavien (1.62€)
Seat 4: Fried Berg (0.45€)
Seat 5: MrFlash9 (2€)
Seat 6: nico033 (4.33€)
*** ANTE/BLINDS ***
Tofini posts small blind 0.01€
baradoz29 posts big blind 0.02€
Dealt to Fried Berg [Jc Kh]
*** PRE-FLOP *** 
Le_Pictavien folds
Fried Berg raises 0.02€ to 0.04€
MrFlash9 raises 0.14€ to 0.18€
nico033 folds
Tofini folds
baradoz29 folds
Fried Berg calls 0.14€
*** FLOP *** [9s 9d 5s]
Fried Berg checks
MrFlash9 bets 0.14€
Fried Berg calls 0.14€
*** TURN *** [9s 9d 5s][6s]
Fried Berg checks
MrFlash9 checks
*** RIVER *** [9s 9d 5s 6s][2d]
Fried Berg checks
MrFlash9 checks
*** SHOW DOWN ***
Fried Berg shows [Jc Kh] (One pair : 9)
MrFlash9 shows [Jd Js] (Two pairs : Jacks and 9)
MrFlash9 collected 0.60€ from pot
*** SUMMARY ***
Total pot 0.60€ | Rake 0.07€
Board: [9s 9d 5s 6s 2d]
Seat 4: Fried Berg showed [Jc Kh] and lost with One pair : 9
Seat 5: MrFlash9 showed [Jd Js] and won 0.60€ with Two pairs : Jacks and 9


Winamax Poker - HOLD-UP "Colorado" - HandId: #19116069-691918-1701704158 - Holdem no limit (0.01€/0.02€) - 2023/12/04 15:35:58 UTC
Table: 'Colorado' 6-max (real money) Seat #6 is the button
Seat 1: kaikuji (2.44€)
Seat 2: Fried Berg (0.13€)
Seat 3: Ertorko (3.62€)
Seat 4: NL_as40 (3.27€)
Seat 5: Syssy43 (6.94€)
Seat 6: Raggamin (4.08€)
*** ANTE/BLINDS ***
kaikuji posts small blind 0.01€
Fried Berg posts big blind 0.02€
Dealt to Fried Berg [8h Kd]
*** PRE-FLOP *** 
Ertorko folds
NL_as40 folds
Syssy43 folds
Raggamin folds
kaikuji folds
Fried Berg collected 0.03€ from pot
*** SUMMARY ***
Total pot 0.03€ | No rake
Seat 2: Fried Berg (big blind) won 0.03€


Winamax Poker - HOLD-UP "Colorado" - HandId: #19116069-691927-1701704164 - Holdem no limit (0.01€/0.02€) - 2023/12/04 15:36:04 UTC
Table: 'Colorado' 6-max (real money) Seat #6 is the button
Seat 1: Fried Berg (0.14€)
Seat 2: Ertorko (9.54€)
Seat 3: D_A_R_K_ (2.49€)
Seat 4: Blackmamba06 (3.29€)
Seat 5: DocteurSplit (2.36€)
Seat 6: sse92 (2.79€)
*** ANTE/BLINDS ***
Fried Berg posts small blind 0.01€
Ertorko posts big blind 0.02€
Dealt to Fried Berg [Ts 6s]
*** PRE-FLOP *** 
D_A_R_K_ folds
Blackmamba06 folds
DocteurSplit folds
sse92 raises 0.02€ to 0.04€
Fried Berg folds
Ertorko calls 0.02€
*** FLOP *** [7d Qd 6h]
Ertorko checks
sse92 checks
*** TURN *** [7d Qd 6h][4d]
Ertorko checks
sse92 checks
*** RIVER *** [7d Qd 6h 4d][Tc]
Ertorko checks
sse92 checks
*** SHOW DOWN ***
Ertorko shows [Kc 8h] (High card : King)
sse92 shows [9c Kd] (High card : King)
sse92 collected 0.08€ from pot
*** SUMMARY ***
Total pot 0.08€ | Rake 0.01€
Board: [7d Qd 6h 4d Tc]
Seat 2: Ertorko (big blind) showed [Kc 8h] and lost with High card : King
Seat 6: sse92 (button) showed [9c Kd] and won 0.08€ with High card : King


Winamax Poker - HOLD-UP "Colorado" - HandId: #19116069-691934-1701704168 - Holdem no limit (0.01€/0.02€) - 2023/12/04 15:36:08 UTC
Table: 'Colorado' 6-max (real money) Seat #6 is the button
Seat 1: ezkk (2.33€)
Seat 2: baradoz29 (1.57€)
Seat 3: Fried Berg (0.13€)
Seat 4: _Croute_ (7.65€)
Seat 5: Adame199623 (2.02€)
Seat 6: N-22194 (2€)
*** ANTE/BLINDS ***
ezkk posts small blind 0.01€
baradoz29 posts big blind 0.02€
Dealt to Fried Berg [Jd Qd]
*** PRE-FLOP *** 
Fried Berg raises 0.11€ to 0.13€ and is all-in
_Croute_ folds
Adame199623 folds
N-22194 folds
ezkk folds
baradoz29 folds
Fried Berg collected 0.16€ from pot
*** SUMMARY ***
Total pot 0.16€ | No rake
Seat 3: Fried Berg won 0.16€


Winamax Poker - HOLD-UP "Colorado" - HandId: #19116069-691953-1701704176 - Holdem no limit (0.01€/0.02€) - 2023/12/04 15:36:16 UTC
Table: 'Colorado' 6-max (real money) Seat #6 is the button
Seat 1: MrFlash9 (4.15€)
Seat 2: -BrokenSmile (2.13€)
Seat 3: g8o8k8u (2€)
Seat 4: matteito (2.30€)
Seat 5: Fried Berg (0.16€)
Seat 6: GTO-Mieko (2.82€)
*** ANTE/BLINDS ***
MrFlash9 posts small blind 0.01€
-BrokenSmile posts big blind 0.02€
Dealt to Fried Berg [6s 7c]
*** PRE-FLOP *** 
g8o8k8u folds
matteito folds
Fried Berg folds
GTO-Mieko folds
MrFlash9 raises 0.04€ to 0.06€
-BrokenSmile folds
MrFlash9 collected 0.08€ from pot
*** SUMMARY ***
Total pot 0.08€ | No rake
Seat 1: MrFlash9 (small blind) won 0.08€


Winamax Poker - HOLD-UP "Colorado" - HandId: #19116069-691962-1701704180 - Holdem no limit (0.01€/0.02€) - 2023/12/04 15:36:20 UTC
Table: 'Colorado' 6-max (real money) Seat #6 is the button
Seat 1: curiouz dje (2.01€)
Seat 2: Raggamin (4.08€)
Seat 3: MCGHansen (2.03€)
Seat 4: g8o8k8u (2€)
Seat 5: packymaitre (4.80€)
Seat 6: Fried Berg (0.16€)
*** ANTE/BLINDS ***
curiouz dje posts small blind 0.01€
Raggamin posts big blind 0.02€
Dealt to Fried Berg [Qc Ad]
*** PRE-FLOP *** 
MCGHansen folds
g8o8k8u folds
packymaitre folds
Fried Berg raises 0.14€ to 0.16€ and is all-in
curiouz dje folds
Raggamin folds
Fried Berg collected 0.19€ from pot
*** SUMMARY ***
Total pot 0.19€ | No rake
Seat 6: Fried Berg (button) won 0.19€


Winamax Poker - HOLD-UP "Colorado" - HandId: #19116069-692007-1701704199 - Holdem no limit (0.01€/0.02€) - 2023/12/04 15:36:39 UTC
Table: 'Colorado' 6-max (real money) Seat #6 is the button
Seat 1: smpadrino (2.02€)
Seat 2: Ga31k (2.55€)
Seat 3: Thor99 (1.30€)
Seat 4: Fried Berg (0.19€)
Seat 5: Lego-AAs (0.87€)
Seat 6: curiouz dje (2€)
*** ANTE/BLINDS ***
smpadrino posts small blind 0.01€
Ga31k posts big blind 0.02€
Dealt to Fried Berg [9h 4d]
*** PRE-FLOP *** 
Thor99 folds
Fried Berg folds
Lego-AAs folds
curiouz dje folds
smpadrino calls 0.01€
Ga31k checks
*** FLOP *** [8d 8c Qd]
smpadrino checks
Ga31k checks
*** TURN *** [8d 8c Qd][Ks]
smpadrino checks
Ga31k checks
*** RIVER *** [8d 8c Qd Ks][2h]
smpadrino bets 0.04€
Ga31k folds
smpadrino collected 0.08€ from pot
*** SUMMARY ***
Total pot 0.08€ | No rake
Board: [8d 8c Qd Ks 2h]
Seat 1: smpadrino (small blind) won 0.08€


Winamax Poker - HOLD-UP "Colorado" - HandId: #19116069-692012-1701704201 - Holdem no limit (0.01€/0.02€) - 2023/12/04 15:36:41 UTC
Table: 'Colorado' 6-max (real money) Seat #6 is the button
Seat 1: GTO-Mieko (2.39€)
Seat 2: Fried Berg (0.19€)
Seat 3: nico033 (4.46€)
Seat 4: JTL22 (2€)
Seat 5: DocteurSplit (2.33€)
Seat 6: Pas2bowl (2.10€)
*** ANTE/BLINDS ***
GTO-Mieko posts small blind 0.01€
Fried Berg posts big blind 0.02€
Dealt to Fried Berg [Jd Jh]
*** PRE-FLOP *** 
nico033 raises 0.03€ to 0.05€
JTL22 folds
DocteurSplit folds
Pas2bowl folds
GTO-Mieko folds
Fried Berg raises 0.14€ to 0.19€ and is all-in
nico033 calls 0.14€
*** FLOP *** [Kc 5d 4s]
*** TURN *** [Kc 5d 4s][7c]
*** RIVER *** [Kc 5d 4s 7c][4d]
*** SHOW DOWN ***
nico033 shows [2h 2c] (Two pairs : 4 and 2)
Fried Berg shows [Jd Jh] (Two pairs : Jacks and 4)
Fried Berg collected 0.35€ from pot
*** SUMMARY ***
Total pot 0.35€ | Rake 0.04€
Board: [Kc 5d 4s 7c 4d]
Seat 2: Fried Berg (big blind) showed [Jd Jh] and won 0.35€ with Two pairs : Jacks and 4
Seat 3: nico033 showed [2h 2c] and lost with Two pairs : 4 and 2


Winamax Poker - HOLD-UP "Colorado" - HandId: #19116069-692068-1701704231 - Holdem no limit (0.01€/0.02€) - 2023/12/04 15:37:11 UTC
Table: 'Colorado' 6-max (real money) Seat #6 is the button
Seat 1: Fried Berg (0.35€)
Seat 2: El BuRbUjO (2.34€)
Seat 3: _Croute_ (7.53€)
Seat 4: bananAsSplit (2.88€)
Seat 5: g8o8k8u (2.78€)
Seat 6: nico033 (4.27€)
*** ANTE/BLINDS ***
Fried Berg posts small blind 0.01€
El BuRbUjO posts big blind 0.02€
Dealt to Fried Berg [8h 8s]
*** PRE-FLOP *** 
_Croute_ folds
bananAsSplit folds
g8o8k8u folds
nico033 folds
Fried Berg raises 0.04€ to 0.06€
El BuRbUjO folds
Fried Berg collected 0.08€ from pot
*** SUMMARY ***
Total pot 0.08€ | No rake
Seat 1: Fried Berg (small blind) won 0.08€


Winamax Poker - HOLD-UP "Colorado" - HandId: #19116069-692121-1701704259 - Holdem no limit (0.01€/0.02€) - 2023/12/04 15:37:39 UTC
Table: 'Colorado' 6-max (real money) Seat #6 is the button
Seat 1: OTE BABA (2€)
Seat 2: MCGHansen (2€)
Seat 3: Fried Berg (0.37€)
Seat 4: Le_Pictavien (1.91€)
Seat 5: Adame199623 (2.02€)
Seat 6: nunsuka69 (2.58€)
Hold-up to Pot: total 0.10€
*** ANTE/BLINDS ***
OTE BABA posts small blind 0.01€
MCGHansen posts big blind 0.02€
Dealt to Fried Berg [8h 3s]
*** PRE-FLOP *** 
Fried Berg folds
Le_Pictavien folds
Adame199623 folds
nunsuka69 folds
OTE BABA raises 0.05€ to 0.07€
MCGHansen raises 0.14€ to 0.21€
OTE BABA calls 0.14€
*** FLOP *** [4s 2c 2h]
OTE BABA checks
MCGHansen bets 0.26€
OTE BABA folds
MCGHansen collected 0.74€ from pot
*** SUMMARY ***
Total pot 0.74€ | Rake 0.04€
Board: [4s 2c 2h]
Seat 2: MCGHansen (big blind) won 0.74€


Winamax Poker - HOLD-UP "Colorado" - HandId: #19116069-692132-1701704265 - Holdem no limit (0.01€/0.02€) - 2023/12/04 15:37:45 UTC
Table: 'Colorado' 6-max (real money) Seat #6 is the button
Seat 1: g8o8k8u (2€)
Seat 2: curiouz dje (2€)
Seat 3: PIQSOU (2€)
Seat 4: fishkingbull (3.03€)
Seat 5: Fried Berg (0.37€)
Seat 6: packymaitre (4.30€)
*** ANTE/BLINDS ***
g8o8k8u posts small blind 0.01€
curiouz dje posts big blind 0.02€
Dealt to Fried Berg [3h Th]
*** PRE-FLOP *** 
PIQSOU folds
fishkingbull folds
Fried Berg folds
packymaitre folds
g8o8k8u folds
curiouz dje collected 0.03€ from pot
*** SUMMARY ***
Total pot 0.03€ | No rake
Seat 2: curiouz dje (big blind) won 0.03€


Winamax Poker - HOLD-UP "Colorado" - HandId: #19116069-692142-1701704271 - Holdem no limit (0.01€/0.02€) - 2023/12/04 15:37:51 UTC
Table: 'Colorado' 6-max (real money) Seat #6 is the button
Seat 1: Raggamin (2€)
Seat 2: Ga31k (2.52€)
Seat 3: Baston57 (1.56€)
Seat 4: LilRun (1.27€)
Seat 5: Fried Berg (0.37€)
Seat 6: fishkingbull (3.03€)
*** ANTE/BLINDS ***
Raggamin posts small blind 0.01€
Ga31k posts big blind 0.02€
Dealt to Fried Berg [5c Kd]
*** PRE-FLOP *** 
Baston57 folds
LilRun folds
Fried Berg folds
fishkingbull raises 0.03€ to 0.05€
Raggamin folds
Ga31k calls 0.03€
*** FLOP *** [3s Ts Ad]
Ga31k checks
fishkingbull checks
*** TURN *** [3s Ts Ad][Qs]
Ga31k checks
fishkingbull checks
*** RIVER *** [3s Ts Ad Qs][2h]
Ga31k checks
fishkingbull checks
*** SHOW DOWN ***
fishkingbull shows [6d 8d] (High card : Ace)
Ga31k shows [Td Jh] (One pair : Tens)
Ga31k collected 0.10€ from pot
*** SUMMARY ***
Total pot 0.10€ | Rake 0.01€
Board: [3s Ts Ad Qs 2h]
Seat 2: Ga31k (big blind) showed [Td Jh] and won 0.10€ with One pair : Tens
Seat 6: fishkingbull (button) showed [6d 8d] and lost with High card : Ace


Winamax Poker - HOLD-UP "Colorado" - HandId: #19116069-692145-1701704274 - Holdem no limit (0.01€/0.02€) - 2023/12/04 15:37:54 UTC
Table: 'Colorado' 6-max (real money) Seat #6 is the button
Seat 1: bananAsSplit (2.60€)
Seat 2: David Boring (2.12€)
Seat 3: Keep Solving (2€)
Seat 4: Baston57 (1.56€)
Seat 5: MOTORBREATH (2.51€)
Seat 6: Fried Berg (0.37€)
*** ANTE/BLINDS ***
bananAsSplit posts small blind 0.01€
David Boring posts big blind 0.02€
Dealt to Fried Berg [6s 9h]
*** PRE-FLOP *** 
Keep Solving folds
Baston57 folds
MOTORBREATH raises 0.03€ to 0.05€
Fried Berg folds
bananAsSplit folds
David Boring raises 0.10€ to 0.15€
MOTORBREATH folds
David Boring collected 0.21€ from pot
*** SUMMARY ***
Total pot 0.21€ | No rake
Seat 2: David Boring (big blind) won 0.21€


Winamax Poker - HOLD-UP "Colorado" - HandId: #19116069-692153-1701704279 - Holdem no limit (0.01€/0.02€) - 2023/12/04 15:37:59 UTC
Table: 'Colorado' 6-max (real money) Seat #6 is the button
Seat 1: Niabag (0.32€)
Seat 2: Fried Berg (0.37€)
Seat 3: PIQSOU (2€)
Seat 4: Keep Solving (2.05€)
Seat 5: Gildus44 (2.63€)
Seat 6: pongo75 (0.89€)
Hold-up to Pot: total 0.20€
*** ANTE/BLINDS ***
Niabag posts small blind 0.01€
Fried Berg posts big blind 0.02€
Dealt to Fried Berg [7s 4h]
*** PRE-FLOP *** 
PIQSOU folds
Keep Solving raises 0.03€ to 0.05€
Gildus44 folds
pongo75 calls 0.05€
Niabag calls 0.04€
Fried Berg folds
*** FLOP *** [Jh Ad As]
Niabag checks
Keep Solving checks
pongo75 bets 0.19€
Niabag folds
Keep Solving calls 0.19€
*** TURN *** [Jh Ad As][Jd]
Keep Solving checks
pongo75 bets 0.65€ and is all-in
Keep Solving calls 0.65€
*** RIVER *** [Jh Ad As Jd][Kc]
*** SHOW DOWN ***
Keep Solving shows [Qc Jc] (Full of Jacks and Aces)
pongo75 shows [Ac 7d] (Full of Aces and Jacks)
pongo75 collected 1.86€ from pot
*** SUMMARY ***
Total pot 1.86€ | Rake 0.19€
Board: [Jh Ad As Jd Kc]
Seat 4: Keep Solving showed [Qc Jc] and lost with Full of Jacks and Aces
Seat 6: pongo75 (button) showed [Ac 7d] and won 1.86€ with Full of Aces and Jacks


Winamax Poker - HOLD-UP "Colorado" - HandId: #19116069-692169-1701704289 - Holdem no limit (0.01€/0.02€) - 2023/12/04 15:38:09 UTC
Table: 'Colorado' 6-max (real money) Seat #6 is the button
Seat 1: Fried Berg (0.35€)
Seat 2: GTO-Mieko (2.38€)
Seat 3: jimsid (1.97€)
Seat 4: CaptainSpok (1.92€)
Seat 5: Killim (0.71€)
Seat 6: g8o8k8u (2€)
*** ANTE/BLINDS ***
Fried Berg posts small blind 0.01€
GTO-Mieko posts big blind 0.02€
Dealt to Fried Berg [Kh 5s]
*** PRE-FLOP *** 
jimsid raises 0.02€ to 0.04€
CaptainSpok folds
Killim folds
g8o8k8u folds
Fried Berg folds
GTO-Mieko folds
jimsid collected 0.07€ from pot
*** SUMMARY ***
Total pot 0.07€ | No rake
Seat 3: jimsid won 0.07€


Winamax Poker - HOLD-UP "Colorado" - HandId: #19116069-692178-1701704293 - Holdem no limit (0.01€/0.02€) - 2023/12/04 15:38:13 UTC
Table: 'Colorado' 6-max (real money) Seat #6 is the button
Seat 1: bananAsSplit (6.79€)
Seat 2: yodacrusher (2€)
Seat 3: Pac_Man13 (1.04€)
Seat 4: Fried Berg (0.34€)
Seat 5: bandarra8520 (2.25€)
Seat 6: Thor99 (1.57€)
*** ANTE/BLINDS ***
bananAsSplit posts small blind 0.01€
yodacrusher posts big blind 0.02€
Dealt to Fried Berg [Td Ts]
*** PRE-FLOP *** 
Pac_Man13 folds
Fried Berg raises 0.04€ to 0.06€
bandarra8520 folds
Thor99 folds
bananAsSplit folds
yodacrusher folds
Fried Berg collected 0.09€ from pot
*** SUMMARY ***
Total pot 0.09€ | No rake
Seat 4: Fried Berg won 0.09€


Winamax Poker - HOLD-UP "Colorado" - HandId: #19116069-692221-1701704317 - Holdem no limit (0.01€/0.02€) - 2023/12/04 15:38:37 UTC
Table: 'Colorado' 6-max (real money) Seat #6 is the button
Seat 1: Blackmamba06 (2.81€)
Seat 2: Ertorko (3.72€)
Seat 3: Fried Berg (0.37€)
Seat 4: g8o8k8u (2.13€)
Seat 5: MrFlash9 (4.07€)
Seat 6: bananAsSplit (2.86€)
*** ANTE/BLINDS ***
Blackmamba06 posts small blind 0.01€
Ertorko posts big blind 0.02€
Dealt to Fried Berg [7s Tc]
*** PRE-FLOP *** 
Fried Berg folds
g8o8k8u folds
MrFlash9 raises 0.03€ to 0.05€
bananAsSplit folds
Blackmamba06 calls 0.04€
Ertorko calls 0.03€
*** FLOP *** [7d Qh Js]
Blackmamba06 checks
Ertorko checks
MrFlash9 checks
*** TURN *** [7d Qh Js][2s]
Blackmamba06 checks
Ertorko checks
MrFlash9 checks
*** RIVER *** [7d Qh Js 2s][3s]
Blackmamba06 checks
Ertorko bets 0.11€
MrFlash9 folds
Blackmamba06 folds
Ertorko collected 0.24€ from pot
*** SUMMARY ***
Total pot 0.24€ | Rake 0.02€
Board: [7d Qh Js 2s 3s]
Seat 2: Ertorko (big blind) won 0.24€


Winamax Poker - HOLD-UP "Colorado" - HandId: #19116069-692226-1701704319 - Holdem no limit (0.01€/0.02€) - 2023/12/04 15:38:39 UTC
Table: 'Colorado' 6-max (real money) Seat #6 is the button
Seat 1: kostia35 (2.02€)
Seat 2: muespachois1 (1.21€)
Seat 3: curiouz dje (2.02€)
Seat 4: Ga31k (2.05€)
Seat 5: g8o8k8u (2.13€)
Seat 6: Fried Berg (0.37€)
*** ANTE/BLINDS ***
kostia35 posts small blind 0.01€
muespachois1 posts big blind 0.02€
Dealt to Fried Berg [2c Ts]
*** PRE-FLOP *** 
curiouz dje folds
Ga31k raises 0.04€ to 0.06€
g8o8k8u folds
Fried Berg folds
kostia35 folds
muespachois1 folds
Ga31k collected 0.09€ from pot
*** SUMMARY ***
Total pot 0.09€ | No rake
Seat 4: Ga31k won 0.09€


Winamax Poker - HOLD-UP "Colorado" - HandId: #19116069-692242-1701704327 - Holdem no limit (0.01€/0.02€) - 2023/12/04 15:38:47 UTC
Table: 'Colorado' 6-max (real money) Seat #6 is the button
Seat 1: GERMINALE (0.79€)
Seat 2: NL_as40 (3.05€)
Seat 3: Carlos_Jugon (1.60€)
Seat 4: Fried Berg (0.37€)
Seat 5: N-22194 (3.69€)
Seat 6: DocteurSplit (3.04€)
*** ANTE/BLINDS ***
GERMINALE posts small blind 0.01€
NL_as40 posts big blind 0.02€
Dealt to Fried Berg [9c 5h]
*** PRE-FLOP *** 
Carlos_Jugon folds
Fried Berg folds
N-22194 raises 0.03€ to 0.05€
DocteurSplit folds
GERMINALE folds
NL_as40 folds
N-22194 collected 0.08€ from pot
*** SUMMARY ***
Total pot 0.08€ | No rake
Seat 5: N-22194 won 0.08€


Winamax Poker - HOLD-UP "Colorado" - HandId: #19116069-692248-1701704330 - Holdem no limit (0.01€/0.02€) - 2023/12/04 15:38:50 UTC
Table: 'Colorado' 6-max (real money) Seat #6 is the button
Seat 1: Estrelita91 (0.62€)
Seat 2: Fried Berg (0.37€)
Seat 3: tichettede3 (3.65€)
Seat 4: Carlos_Jugon (1.60€)
Seat 5: BKO86 (0.53€)
Seat 6: Adame199623 (2.03€)
*** ANTE/BLINDS ***
Estrelita91 posts small blind 0.01€
Fried Berg posts big blind 0.02€
Dealt to Fried Berg [Jc Tc]
*** PRE-FLOP *** 
tichettede3 folds
Carlos_Jugon raises 0.03€ to 0.05€
BKO86 folds
Adame199623 folds
Estrelita91 calls 0.04€
Fried Berg calls 0.03€
*** FLOP *** [5s Jh 4h]
Estrelita91 checks
Fried Berg bets 0.08€
Carlos_Jugon folds
Estrelita91 calls 0.08€
*** TURN *** [5s Jh 4h][6s]
Estrelita91 checks
Fried Berg bets 0.16€
Estrelita91 folds
Fried Berg collected 0.44€ from pot
*** SUMMARY ***
Total pot 0.44€ | Rake 0.03€
Board: [5s Jh 4h 6s]
Seat 2: Fried Berg (big blind) won 0.44€


Winamax Poker - HOLD-UP "Colorado" - HandId: #19116069-692311-1701704365 - Holdem no limit (0.01€/0.02€) - 2023/12/04 15:39:25 UTC
Table: 'Colorado' 6-max (real money) Seat #6 is the button
Seat 1: Fried Berg (0.52€)
Seat 2: N-22194 (3.74€)
Seat 3: MCGHansen (2€)
Seat 4: GERMINALE (0.74€)
Seat 5: Richard Reuk (2.96€)
Seat 6: Killim (0.60€)
*** ANTE/BLINDS ***
Fried Berg posts small blind 0.01€
N-22194 posts big blind 0.02€
Dealt to Fried Berg [4c 8d]
*** PRE-FLOP *** 
MCGHansen folds
GERMINALE folds
Richard Reuk folds
Killim raises 0.03€ to 0.05€
Fried Berg folds
N-22194 folds
Killim collected 0.08€ from pot
*** SUMMARY ***
Total pot 0.08€ | No rake
Seat 6: Killim (button) won 0.08€


Winamax Poker - HOLD-UP "Colorado" - HandId: #19116069-692328-1701704372 - Holdem no limit (0.01€/0.02€) - 2023/12/04 15:39:32 UTC
Table: 'Colorado' 6-max (real money) Seat #6 is the button
Seat 1: Tofini (2.19€)
Seat 2: muespachois1 (1.19€)
Seat 3: Fried Berg (0.51€)
Seat 4: damz69 (0.88€)
Seat 5: TONETONE510 (1.57€)
Seat 6: tichettede3 (6.96€)
*** ANTE/BLINDS ***
Tofini posts small blind 0.01€
muespachois1 posts big blind 0.02€
Dealt to Fried Berg [Jh 9h]
*** PRE-FLOP *** 
Fried Berg folds
damz69 raises 0.05€ to 0.07€
TONETONE510 folds
tichettede3 folds
Tofini folds
muespachois1 folds
damz69 collected 0.10€ from pot
*** SUMMARY ***
Total pot 0.10€ | No rake
Seat 4: damz69 won 0.10€


Winamax Poker - HOLD-UP "Colorado" - HandId: #19116069-692335-1701704377 - Holdem no limit (0.01€/0.02€) - 2023/12/04 15:39:37 UTC
Table: 'Colorado' 6-max (real money) Seat #6 is the button
Seat 1: bananAsSplit (2€)
Seat 2: tichettede3 (6.96€)
Seat 3: Niabag (0.25€)
Seat 4: g8o8k8u (2.39€)
Seat 5: Fried Berg (0.51€)
Seat 6: MCGHansen (2€)
*** ANTE/BLINDS ***
bananAsSplit posts small blind 0.01€
tichettede3 posts big blind 0.02€
Dealt to Fried Berg [5c Kd]
*** PRE-FLOP *** 
Niabag folds
g8o8k8u folds
Fried Berg folds
MCGHansen raises 0.04€ to 0.06€
bananAsSplit folds
tichettede3 folds
MCGHansen collected 0.09€ from pot
*** SUMMARY ***
Total pot 0.09€ | No rake
Seat 6: MCGHansen (button) won 0.09€


Winamax Poker - HOLD-UP "Colorado" - HandId: #19116069-692342-1701704382 - Holdem no limit (0.01€/0.02€) - 2023/12/04 15:39:42 UTC
Table: 'Colorado' 6-max (real money) Seat #6 is the button
Seat 1: -BrokenSmile (2.32€)
Seat 2: DocteurSplit (2.16€)
Seat 3: g8o8k8u (2.39€)
Seat 4: Fried Berg (0.51€)
Seat 5: King river62 (2.03€)
Seat 6: pongo75 (0.81€)
*** ANTE/BLINDS ***
-BrokenSmile posts small blind 0.01€
DocteurSplit posts big blind 0.02€
Dealt to Fried Berg [Jc 8h]
*** PRE-FLOP *** 
g8o8k8u folds
Fried Berg folds
King river62 raises 0.02€ to 0.04€
pongo75 folds
-BrokenSmile folds
DocteurSplit folds
King river62 collected 0.07€ from pot
*** SUMMARY ***
Total pot 0.07€ | No rake
Seat 5: King river62 won 0.07€


Winamax Poker - HOLD-UP "Colorado" - HandId: #19116069-692346-1701704383 - Holdem no limit (0.01€/0.02€) - 2023/12/04 15:39:43 UTC
Table: 'Colorado' 6-max (real money) Seat #6 is the button
Seat 1: matteito (2.36€)
Seat 2: NiggRice (1.28€)
Seat 3: Carlos_Jugon (1.56€)
Seat 4: smpadrino (2.12€)
Seat 5: El BuRbUjO (2.35€)
Seat 6: Fried Berg (0.51€)
*** ANTE/BLINDS ***
matteito posts small blind 0.01€
NiggRice posts big blind 0.02€
Dealt to Fried Berg [Qc Td]
*** PRE-FLOP *** 
Carlos_Jugon folds
smpadrino folds
El BuRbUjO folds
Fried Berg raises 0.02€ to 0.04€
matteito folds
NiggRice folds
Fried Berg collected 0.07€ from pot
*** SUMMARY ***
Total pot 0.07€ | No rake
Seat 6: Fried Berg (button) won 0.07€


Winamax Poker - HOLD-UP "Colorado" - HandId: #19116069-692365-1701704395 - Holdem no limit (0.01€/0.02€) - 2023/12/04 15:39:55 UTC
Table: 'Colorado' 6-max (real money) Seat #6 is the button
Seat 1: Fried Berg (0.54€)
Seat 2: JTL22 (2.56€)
Seat 3: David Boring (6.93€)
Seat 4: bananAsSplit (2.82€)
Seat 5: FreeLouisias (2.01€)
Seat 6: PIQSOU (2€)
*** ANTE/BLINDS ***
Fried Berg posts small blind 0.01€
JTL22 posts big blind 0.02€
Dealt to Fried Berg [9d Qd]
*** PRE-FLOP *** 
David Boring folds
bananAsSplit folds
FreeLouisias folds
PIQSOU folds
Fried Berg folds
JTL22 collected 0.03€ from pot
*** SUMMARY ***
Total pot 0.03€ | No rake
Seat 2: JTL22 (big blind) won 0.03€


Winamax Poker - HOLD-UP "Colorado" - HandId: #19116069-692396-1701704411 - Holdem no limit (0.01€/0.02€) - 2023/12/04 15:40:11 UTC
Table: 'Colorado' 6-max (real money) Seat #6 is the button
Seat 1: cedricD23 (0.85€)
Seat 2: Fried Berg (0.53€)
Seat 3: David Boring (6.96€)
Seat 4: tichettede3 (3.83€)
Seat 5: Ertorko (9.57€)
Seat 6: jimsid (1.95€)
*** ANTE/BLINDS ***
cedricD23 posts small blind 0.01€
Fried Berg posts big blind 0.02€
Dealt to Fried Berg [4s 5h]
*** PRE-FLOP *** 
David Boring raises 0.04€ to 0.06€
tichettede3 folds
Ertorko calls 0.06€
jimsid folds
cedricD23 calls 0.05€
Fried Berg folds
*** FLOP *** [5c Td 9s]
cedricD23 checks
David Boring checks
Ertorko bets 0.08€
cedricD23 folds
David Boring folds
Ertorko collected 0.26€ from pot
*** SUMMARY ***
Total pot 0.26€ | Rake 0.02€
Board: [5c Td 9s]
Seat 5: Ertorko won 0.26€


Winamax Poker - HOLD-UP "Colorado" - HandId: #19116069-692402-1701704414 - Holdem no limit (0.01€/0.02€) - 2023/12/04 15:40:14 UTC
Table: 'Colorado' 6-max (real money) Seat #6 is the button
Seat 1: GTO-Mieko (2.76€)
Seat 2: LilRun (2.03€)
Seat 3: CaptainSpok (1.58€)
Seat 4: MrFlash9 (3.95€)
Seat 5: Fried Berg (0.51€)
Seat 6: damz69 (1.09€)
*** ANTE/BLINDS ***
GTO-Mieko posts small blind 0.01€
LilRun posts big blind 0.02€
Dealt to Fried Berg [Kh 4d]
*** PRE-FLOP *** 
CaptainSpok folds
MrFlash9 folds
Fried Berg folds
damz69 folds
GTO-Mieko raises 0.04€ to 0.06€
LilRun folds
GTO-Mieko collected 0.08€ from pot
*** SUMMARY ***
Total pot 0.08€ | No rake
Seat 1: GTO-Mieko (small blind) won 0.08€


Winamax Poker - HOLD-UP "Colorado" - HandId: #19116069-692408-1701704417 - Holdem no limit (0.01€/0.02€) - 2023/12/04 15:40:17 UTC
Table: 'Colorado' 6-max (real money) Seat #6 is the button
Seat 1: El BuRbUjO (2.01€)
Seat 2: bananAsSplit (2.79€)
Seat 3: Fried Berg (0.51€)
Seat 4: tichettede3 (6.91€)
Seat 5: FreeLouisias (2.04€)
Seat 6: DocteurSplit (2€)
*** ANTE/BLINDS ***
El BuRbUjO posts small blind 0.01€
bananAsSplit posts big blind 0.02€
Dealt to Fried Berg [As 7d]
*** PRE-FLOP *** 
Fried Berg folds
tichettede3 raises 0.03€ to 0.05€
FreeLouisias folds
DocteurSplit folds
El BuRbUjO folds
bananAsSplit calls 0.03€
*** FLOP *** [3h 5c Qs]
bananAsSplit checks
tichettede3 bets 0.07€
bananAsSplit calls 0.07€
*** TURN *** [3h 5c Qs][6d]
bananAsSplit checks
tichettede3 checks
*** RIVER *** [3h 5c Qs 6d][Jc]
bananAsSplit bets 0.08€
tichettede3 raises 0.24€ to 0.32€
bananAsSplit folds
tichettede3 collected 0.61€ from pot
*** SUMMARY ***
Total pot 0.61€ | Rake 0.04€
Board: [3h 5c Qs 6d Jc]
Seat 4: tichettede3 won 0.61€


Winamax Poker - HOLD-UP "Colorado" - HandId: #19116069-692414-1701704420 - Holdem no limit (0.01€/0.02€) - 2023/12/04 15:40:20 UTC
Table: 'Colorado' 6-max (real money) Seat #6 is the button
Seat 1: sse92 (2.73€)
Seat 2: renteria45 (2.43€)
Seat 3: pongo75 (0.63€)
Seat 4: yodacrusher (2€)
Seat 5: DocteurSplit (2€)
Seat 6: Fried Berg (0.51€)
*** ANTE/BLINDS ***
sse92 posts small blind 0.01€
renteria45 posts big blind 0.02€
Dealt to Fried Berg [Kh 3h]
*** PRE-FLOP *** 
pongo75 folds
yodacrusher folds
DocteurSplit folds
Fried Berg raises 0.02€ to 0.04€
sse92 raises 0.02€ to 0.06€
renteria45 calls 0.04€
Fried Berg calls 0.02€
*** FLOP *** [5h 9c 3d]
sse92 bets 0.02€
renteria45 calls 0.02€
Fried Berg calls 0.02€
*** TURN *** [5h 9c 3d][6c]
sse92 bets 0.02€
renteria45 folds
Fried Berg calls 0.02€
*** RIVER *** [5h 9c 3d 6c][Qs]
sse92 bets 0.10€
Fried Berg folds
sse92 collected 0.35€ from pot
*** SUMMARY ***
Total pot 0.35€ | Rake 0.03€
Board: [5h 9c 3d 6c Qs]
Seat 1: sse92 (small blind) won 0.35€


Winamax Poker - HOLD-UP "Colorado" - HandId: #19116069-692557-1701704497 - Holdem no limit (0.01€/0.02€) - 2023/12/04 15:41:37 UTC
Table: 'Colorado' 6-max (real money) Seat #6 is the button
Seat 1: DocteurSplit (2.80€)
Seat 2: Raggamin (4.20€)
Seat 3: N-22194 (3.64€)
Seat 4: g8o8k8u (2.52€)
Seat 5: Fried Berg (0.41€)
Seat 6: renteria45 (2.34€)
*** ANTE/BLINDS ***
DocteurSplit posts small blind 0.01€
Raggamin posts big blind 0.02€
Dealt to Fried Berg [2h Jc]
*** PRE-FLOP *** 
N-22194 folds
g8o8k8u folds
Fried Berg folds
renteria45 folds
DocteurSplit folds
Raggamin collected 0.03€ from pot
*** SUMMARY ***
Total pot 0.03€ | No rake
Seat 2: Raggamin (big blind) won 0.03€


Winamax Poker - HOLD-UP "Colorado" - HandId: #19116069-692563-1701704499 - Holdem no limit (0.01€/0.02€) - 2023/12/04 15:41:39 UTC
Table: 'Colorado' 6-max (real money) Seat #6 is the button
Seat 1: g8o8k8u (2.52€)
Seat 2: Fried Berg (0.41€)
Seat 3: sse92 (2.88€)
Seat 4: bananAsSplit (6.68€)
Seat 5: Killim (0.52€)
Seat 6: TontonA2L1 (2.23€)
*** ANTE/BLINDS ***
g8o8k8u posts small blind 0.01€
Fried Berg posts big blind 0.02€
Dealt to Fried Berg [Tc 8d]
*** PRE-FLOP *** 
sse92 folds
bananAsSplit folds
Killim folds
TontonA2L1 raises 0.05€ to 0.07€
g8o8k8u folds
Fried Berg folds
TontonA2L1 collected 0.10€ from pot
*** SUMMARY ***
Total pot 0.10€ | No rake
Seat 6: TontonA2L1 (button) won 0.10€


Winamax Poker - HOLD-UP "Colorado" - HandId: #19116069-692581-1701704507 - Holdem no limit (0.01€/0.02€) - 2023/12/04 15:41:47 UTC
Table: 'Colorado' 6-max (real money) Seat #6 is the button
Seat 1: Fried Berg (0.39€)
Seat 2: DonKmillo (4.03€)
Seat 3: relaxalex27 (4.08€)
Seat 4: TONETONE510 (0.50€)
Seat 5: Pas2bowl (2€)
Seat 6: nico033 (4.09€)
Hold-up to Pot: total 0.10€
*** ANTE/BLINDS ***
Fried Berg posts small blind 0.01€
DonKmillo posts big blind 0.02€
Dealt to Fried Berg [Jc 5h]
*** PRE-FLOP *** 
relaxalex27 folds
TONETONE510 raises 0.48€ to 0.50€ and is all-in
Pas2bowl folds
nico033 folds
Fried Berg folds
DonKmillo folds
TONETONE510 collected 0.63€ from pot
*** SUMMARY ***
Total pot 0.63€ | No rake
Seat 4: TONETONE510 won 0.63€


Winamax Poker - HOLD-UP "Colorado" - HandId: #19116069-692593-1701704512 - Holdem no limit (0.01€/0.02€) - 2023/12/04 15:41:52 UTC
Table: 'Colorado' 6-max (real money) Seat #6 is the button
Seat 1: JTL22 (2.40€)
Seat 2: sarzeNe (3.88€)
Seat 3: Fried Berg (0.38€)
Seat 4: Killim (0.55€)
Seat 5: Keep Solving (2.48€)
Seat 6: NyKOh11 (0.64€)
*** ANTE/BLINDS ***
JTL22 posts small blind 0.01€
sarzeNe posts big blind 0.02€
Dealt to Fried Berg [Js 4h]
*** PRE-FLOP *** 
Fried Berg folds
Killim folds
Keep Solving folds
NyKOh11 folds
JTL22 folds
sarzeNe collected 0.03€ from pot
*** SUMMARY ***
Total pot 0.03€ | No rake
Seat 2: sarzeNe (big blind) won 0.03€


Winamax Poker - HOLD-UP "Colorado" - HandId: #19116069-692598-1701704514 - Holdem no limit (0.01€/0.02€) - 2023/12/04 15:41:54 UTC
Table: 'Colorado' 6-max (real money) Seat #6 is the button
Seat 1: bananAsSplit (6.68€)
Seat 2: N-22194 (2.38€)
Seat 3: Fried Berg (0.38€)
Seat 4: El BuRbUjO (3.70€)
Seat 5: Glirry (1.64€)
Seat 6: PIQSOU (2.06€)
*** ANTE/BLINDS ***
bananAsSplit posts small blind 0.01€
N-22194 posts big blind 0.02€
Dealt to Fried Berg [5c 5h]
*** PRE-FLOP *** 
Fried Berg folds
El BuRbUjO raises 0.05€ to 0.07€
Glirry folds
PIQSOU folds
bananAsSplit folds
N-22194 folds
El BuRbUjO collected 0.10€ from pot
*** SUMMARY ***
Total pot 0.10€ | No rake
Seat 4: El BuRbUjO won 0.10€


Winamax Poker - HOLD-UP "Colorado" - HandId: #19116069-692604-1701704516 - Holdem no limit (0.01€/0.02€) - 2023/12/04 15:41:56 UTC
Table: 'Colorado' 6-max (real money) Seat #6 is the button
Seat 1: JTL22 (2€)
Seat 2: Tofini (2.32€)
Seat 3: curiouz dje (2€)
Seat 4: Fried Berg (0.38€)
Seat 5: Richard Reuk (2.99€)
Seat 6: Raggamin (4.21€)
*** ANTE/BLINDS ***
JTL22 posts small blind 0.01€
Tofini posts big blind 0.02€
Dealt to Fried Berg [Ks 8c]
*** PRE-FLOP *** 
curiouz dje folds
Fried Berg folds
Richard Reuk raises 0.03€ to 0.05€
Raggamin folds
JTL22 folds
Tofini folds
Richard Reuk collected 0.08€ from pot
*** SUMMARY ***
Total pot 0.08€ | No rake
Seat 5: Richard Reuk won 0.08€


Winamax Poker - HOLD-UP "Colorado" - HandId: #19116069-692613-1701704520 - Holdem no limit (0.01€/0.02€) - 2023/12/04 15:42:00 UTC
Table: 'Colorado' 6-max (real money) Seat #6 is the button
Seat 1: renteria45 (2.32€)
Seat 2: DocteurSplit (2€)
Seat 3: David Boring (5.21€)
Seat 4: JACKJACK54 (2.30€)
Seat 5: OTE BABA (2.36€)
Seat 6: Fried Berg (0.38€)
*** ANTE/BLINDS ***
renteria45 posts small blind 0.01€
DocteurSplit posts big blind 0.02€
Dealt to Fried Berg [Qs Th]
*** PRE-FLOP *** 
David Boring folds
JACKJACK54 folds
OTE BABA folds
Fried Berg raises 0.02€ to 0.04€
renteria45 raises 0.10€ to 0.14€
DocteurSplit folds
Fried Berg calls 0.10€
*** FLOP *** [Ad Jd Jc]
renteria45 bets 0.20€
Fried Berg raises 0.04€ to 0.24€ and is all-in
renteria45 calls 0.04€
*** TURN *** [Ad Jd Jc][4s]
*** RIVER *** [Ad Jd Jc 4s][Kh]
*** SHOW DOWN ***
renteria45 shows [8s As] (Two pairs : Aces and Jacks)
Fried Berg shows [Qs Th] (Straight Ace high)
Fried Berg collected 0.70€ from pot
*** SUMMARY ***
Total pot 0.70€ | Rake 0.08€
Board: [Ad Jd Jc 4s Kh]
Seat 1: renteria45 (small blind) showed [8s As] and lost with Two pairs : Aces and Jacks
Seat 6: Fried Berg (button) showed [Qs Th] and won 0.70€ with Straight Ace high


Winamax Poker - HOLD-UP "Colorado" - HandId: #19116069-692683-1701704556 - Holdem no limit (0.01€/0.02€) - 2023/12/04 15:42:36 UTC
Table: 'Colorado' 6-max (real money) Seat #6 is the button
Seat 1: Fried Berg (0.70€)
Seat 2: Stradivari (2€)
Seat 3: Tofini (2.09€)
Seat 4: DocteurSplit (2.13€)
Seat 5: renteria45 (2€)
Seat 6: David Boring (5.26€)
*** ANTE/BLINDS ***
Fried Berg posts small blind 0.01€
Stradivari posts big blind 0.02€
Dealt to Fried Berg [3h 2c]
*** PRE-FLOP *** 
Tofini folds
DocteurSplit folds
renteria45 raises 0.05€ to 0.07€
David Boring folds
Fried Berg folds
Stradivari folds
renteria45 collected 0.10€ from pot
*** SUMMARY ***
Total pot 0.10€ | No rake
Seat 5: renteria45 won 0.10€


Winamax Poker - HOLD-UP "Colorado" - HandId: #19116069-692700-1701704565 - Holdem no limit (0.01€/0.02€) - 2023/12/04 15:42:45 UTC
Table: 'Colorado' 6-max (real money) Seat #6 is the button
Seat 1: Killim (0.53€)
Seat 2: Fried Berg (0.69€)
Seat 3: bananAsSplit (6.67€)
Seat 4: packymaitre (5€)
Seat 5: El BuRbUjO (2€)
Seat 6: TontonA2L1 (2.19€)
*** ANTE/BLINDS ***
Killim posts small blind 0.01€
Fried Berg posts big blind 0.02€
Dealt to Fried Berg [7h Jc]
*** PRE-FLOP *** 
bananAsSplit folds
packymaitre folds
El BuRbUjO folds
TontonA2L1 folds
Killim folds
Fried Berg collected 0.03€ from pot
*** SUMMARY ***
Total pot 0.03€ | No rake
Seat 2: Fried Berg (big blind) won 0.03€


Winamax Poker - HOLD-UP "Colorado" - HandId: #19116069-692730-1701704582 - Holdem no limit (0.01€/0.02€) - 2023/12/04 15:43:02 UTC
Table: 'Colorado' 6-max (real money) Seat #6 is the button
Seat 1: PHeNiX_FiRe (0.40€)
Seat 2: Killim (0.43€)
Seat 3: Peak8eighter (1.96€)
Seat 4: Fried Berg (0.70€)
Seat 5: nunsuka69 (5.68€)
Seat 6: smpadrino (2.28€)
*** ANTE/BLINDS ***
PHeNiX_FiRe posts small blind 0.01€
Killim posts big blind 0.02€
Dealt to Fried Berg [2h 3c]
*** PRE-FLOP *** 
Peak8eighter folds
Fried Berg folds
nunsuka69 folds
smpadrino raises 0.04€ to 0.06€
PHeNiX_FiRe folds
Killim folds
smpadrino collected 0.09€ from pot
*** SUMMARY ***
Total pot 0.09€ | No rake
Seat 6: smpadrino (button) won 0.09€


Winamax Poker - HOLD-UP "Colorado" - HandId: #19116069-692735-1701704586 - Holdem no limit (0.01€/0.02€) - 2023/12/04 15:43:06 UTC
Table: 'Colorado' 6-max (real money) Seat #6 is the button
Seat 1: PIQSOU (2.04€)
Seat 2: kostia35 (2.03€)
Seat 3: N-22194 (2.48€)
Seat 4: Jojo-andros5 (0.83€)
Seat 5: Tofini (2.02€)
Seat 6: Fried Berg (0.70€)
*** ANTE/BLINDS ***
PIQSOU posts small blind 0.01€
kostia35 posts big blind 0.02€
Dealt to Fried Berg [2d Qh]
*** PRE-FLOP *** 
N-22194 folds
Jojo-andros5 folds
Tofini folds
Fried Berg folds
PIQSOU raises 0.03€ to 0.05€
kostia35 calls 0.03€
*** FLOP *** [3s 7s Jh]
PIQSOU bets 0.05€
kostia35 folds
PIQSOU collected 0.14€ from pot
*** SUMMARY ***
Total pot 0.14€ | Rake 0.01€
Board: [3s 7s Jh]
Seat 1: PIQSOU (small blind) won 0.14€


Winamax Poker - HOLD-UP "Colorado" - HandId: #19116069-692739-1701704587 - Holdem no limit (0.01€/0.02€) - 2023/12/04 15:43:07 UTC
Table: 'Colorado' 6-max (real money) Seat #6 is the button
Seat 1: bananAsSplit (6.64€)
Seat 2: ZAK 13006 (1.01€)
Seat 3: Fried Berg (0.70€)
Seat 4: N-22194 (2.48€)
Seat 5: Keep Solving (2.09€)
Seat 6: relaxalex27 (4.08€)
Hold-up to Pot: total 0.20€
*** ANTE/BLINDS ***
bananAsSplit posts small blind 0.01€
ZAK 13006 posts big blind 0.02€
Dealt to Fried Berg [6h 7s]
*** PRE-FLOP *** 
Fried Berg folds
N-22194 folds
Keep Solving folds
relaxalex27 raises 0.03€ to 0.05€
bananAsSplit folds
ZAK 13006 calls 0.03€
*** FLOP *** [Qc Th 8c]
ZAK 13006 checks
relaxalex27 bets 0.08€
ZAK 13006 folds
relaxalex27 collected 0.38€ from pot
*** SUMMARY ***
Total pot 0.38€ | Rake 0.01€
Board: [Qc Th 8c]
Seat 6: relaxalex27 (button) won 0.38€


Winamax Poker - HOLD-UP "Colorado" - HandId: #19116069-692751-1701704593 - Holdem no limit (0.01€/0.02€) - 2023/12/04 15:43:13 UTC
Table: 'Colorado' 6-max (real money) Seat #6 is the button
Seat 1: Leretour2bat (2.07€)
Seat 2: PHeNiX_FiRe (0.39€)
Seat 3: Carlos_Jugon (1.97€)
Seat 4: J1nx3d (1.97€)
Seat 5: Fried Berg (0.70€)
Seat 6: yodacrusher (2.24€)
*** ANTE/BLINDS ***
Leretour2bat posts small blind 0.01€
PHeNiX_FiRe posts big blind 0.02€
Dealt to Fried Berg [Qh 8c]
*** PRE-FLOP *** 
Carlos_Jugon raises 0.03€ to 0.05€
J1nx3d folds
Fried Berg folds
yodacrusher folds
Leretour2bat folds
PHeNiX_FiRe folds
Carlos_Jugon collected 0.08€ from pot
*** SUMMARY ***
Total pot 0.08€ | No rake
Seat 3: Carlos_Jugon won 0.08€


Winamax Poker - HOLD-UP "Colorado" - HandId: #19116069-692757-1701704596 - Holdem no limit (0.01€/0.02€) - 2023/12/04 15:43:16 UTC
Table: 'Colorado' 6-max (real money) Seat #6 is the button
Seat 1: Jojo-andros5 (0.83€)
Seat 2: Fried Berg (0.70€)
Seat 3: Leretour2bat (2.06€)
Seat 4: David Boring (4.02€)
Seat 5: Keep Solving (2.09€)
Seat 6: J1nx3d (1.97€)
Hold-up to Pot: total 0.10€
*** ANTE/BLINDS ***
Jojo-andros5 posts small blind 0.01€
Fried Berg posts big blind 0.02€
Dealt to Fried Berg [7s 5s]
*** PRE-FLOP *** 
Leretour2bat raises 0.02€ to 0.04€
David Boring calls 0.04€
Keep Solving folds
J1nx3d calls 0.04€
Jojo-andros5 raises 0.79€ to 0.83€ and is all-in
Fried Berg folds
Leretour2bat folds
David Boring folds
J1nx3d folds
Jojo-andros5 collected 1.07€ from pot
*** SUMMARY ***
Total pot 1.07€ | No rake
Seat 1: Jojo-andros5 (small blind) won 1.07€


Winamax Poker - HOLD-UP "Colorado" - HandId: #19116069-692782-1701704608 - Holdem no limit (0.01€/0.02€) - 2023/12/04 15:43:28 UTC
Table: 'Colorado' 6-max (real money) Seat #6 is the button
Seat 1: Fried Berg (0.68€)
Seat 2: El BuRbUjO (2€)
Seat 3: TiagoSS (2€)
Seat 4: Syssy43 (6.47€)
Seat 5: MCGHansen (2€)
Seat 6: Chanclaveloz (6.12€)
*** ANTE/BLINDS ***
Fried Berg posts small blind 0.01€
El BuRbUjO posts big blind 0.02€
Dealt to Fried Berg [8s 9c]
*** PRE-FLOP *** 
TiagoSS folds
Syssy43 raises 0.04€ to 0.06€
MCGHansen folds
Chanclaveloz folds
Fried Berg folds
El BuRbUjO calls 0.04€
*** FLOP *** [8d 4h 6d]
El BuRbUjO checks
Syssy43 checks
*** TURN *** [8d 4h 6d][5d]
El BuRbUjO bets 0.07€
Syssy43 folds
El BuRbUjO collected 0.19€ from pot
*** SUMMARY ***
Total pot 0.19€ | Rake 0.01€
Board: [8d 4h 6d 5d]
Seat 2: El BuRbUjO (big blind) won 0.19€


Winamax Poker - HOLD-UP "Colorado" - HandId: #19116069-692794-1701704614 - Holdem no limit (0.01€/0.02€) - 2023/12/04 15:43:34 UTC
Table: 'Colorado' 6-max (real money) Seat #6 is the button
Seat 1: sse92 (2.86€)
Seat 2: bananAsSplit (6.61€)
Seat 3: Pas2bowl (2.31€)
Seat 4: Fried Berg (0.67€)
Seat 5: curiouz dje (2.17€)
Seat 6: kostia35 (1.98€)
*** ANTE/BLINDS ***
sse92 posts small blind 0.01€
bananAsSplit posts big blind 0.02€
Dealt to Fried Berg [7s 8d]
*** PRE-FLOP *** 
Pas2bowl folds
Fried Berg folds
curiouz dje folds
kostia35 folds
sse92 calls 0.01€
bananAsSplit raises 0.06€ to 0.08€
sse92 calls 0.06€
*** FLOP *** [9s 3d 7c]
sse92 bets 0.06€
bananAsSplit calls 0.06€
*** TURN *** [9s 3d 7c][Ah]
sse92 bets 0.02€
bananAsSplit calls 0.02€
*** RIVER *** [9s 3d 7c Ah][Ks]
sse92 bets 2.70€ and is all-in
bananAsSplit folds
sse92 collected 2.99€ from pot
*** SUMMARY ***
Total pot 2.99€ | Rake 0.03€
Board: [9s 3d 7c Ah Ks]
Seat 1: sse92 (small blind) won 2.99€


Winamax Poker - HOLD-UP "Colorado" - HandId: #19116069-692801-1701704616 - Holdem no limit (0.01€/0.02€) - 2023/12/04 15:43:36 UTC
Table: 'Colorado' 6-max (real money) Seat #6 is the button
Seat 1: curiouz dje (2€)
Seat 2: NiggRice (1.74€)
Seat 3: PIQSOU (2.21€)
Seat 4: Tofini (2.24€)
Seat 5: Fried Berg (0.67€)
Seat 6: MCGHansen (2€)
*** ANTE/BLINDS ***
curiouz dje posts small blind 0.01€
NiggRice posts big blind 0.02€
Dealt to Fried Berg [4c 2h]
*** PRE-FLOP *** 
PIQSOU folds
Tofini folds
Fried Berg folds
MCGHansen folds
curiouz dje folds
NiggRice collected 0.03€ from pot
*** SUMMARY ***
Total pot 0.03€ | No rake
Seat 2: NiggRice (big blind) won 0.03€


Winamax Poker - HOLD-UP "Colorado" - HandId: #19116069-692806-1701704618 - Holdem no limit (0.01€/0.02€) - 2023/12/04 15:43:38 UTC
Table: 'Colorado' 6-max (real money) Seat #6 is the button
Seat 1: Ziildjiin (1.93€)
Seat 2: NR.10 (2.09€)
Seat 3: curiouz dje (2€)
Seat 4: tichettede3 (3.66€)
Seat 5: NyKOh11 (0.73€)
Seat 6: Fried Berg (0.67€)
*** ANTE/BLINDS ***
Ziildjiin posts small blind 0.01€
NR.10 posts big blind 0.02€
Dealt to Fried Berg [4c Qd]
*** PRE-FLOP *** 
curiouz dje raises 0.03€ to 0.05€
tichettede3 folds
NyKOh11 folds
Fried Berg folds
Ziildjiin calls 0.04€
NR.10 raises 0.10€ to 0.15€
curiouz dje calls 0.10€
Ziildjiin folds
*** FLOP *** [Kc 5h Ts]
NR.10 bets 1.94€ and is all-in
curiouz dje folds
NR.10 collected 2.25€ from pot
*** SUMMARY ***
Total pot 2.25€ | Rake 0.04€
Board: [Kc 5h Ts]
Seat 2: NR.10 (big blind) won 2.25€


Winamax Poker - HOLD-UP "Colorado" - HandId: #19116069-692809-1701704620 - Holdem no limit (0.01€/0.02€) - 2023/12/04 15:43:40 UTC
Table: 'Colorado' 6-max (real money) Seat #6 is the button
Seat 1: OTE BABA (2.24€)
Seat 2: GERMINALE (0.67€)
Seat 3: Richard Reuk (2.27€)
Seat 4: g8o8k8u (2€)
Seat 5: relaxalex27 (4.33€)
Seat 6: Fried Berg (0.67€)
*** ANTE/BLINDS ***
OTE BABA posts small blind 0.01€
GERMINALE posts big blind 0.02€
Dealt to Fried Berg [4c 9c]
*** PRE-FLOP *** 
Richard Reuk folds
g8o8k8u raises 0.06€ to 0.08€
relaxalex27 folds
Fried Berg folds
OTE BABA folds
GERMINALE folds
g8o8k8u collected 0.11€ from pot
*** SUMMARY ***
Total pot 0.11€ | No rake
Seat 4: g8o8k8u won 0.11€


Winamax Poker - HOLD-UP "Colorado" - HandId: #19116069-692812-1701704622 - Holdem no limit (0.01€/0.02€) - 2023/12/04 15:43:42 UTC
Table: 'Colorado' 6-max (real money) Seat #6 is the button
Seat 1: pongo75 (0.70€)
Seat 2: Fried Berg (0.67€)
Seat 3: _Croute_ (7.93€)
Seat 4: Romrom222 (1.72€)
Seat 5: Jojo-andros5 (1.07€)
Seat 6: Adame199623 (2€)
*** ANTE/BLINDS ***
pongo75 posts small blind 0.01€
Fried Berg posts big blind 0.02€
Dealt to Fried Berg [Ac 8d]
*** PRE-FLOP *** 
_Croute_ folds
Romrom222 raises 0.03€ to 0.05€
Jojo-andros5 folds
Adame199623 folds
pongo75 folds
Fried Berg calls 0.03€
*** FLOP *** [Jd 6s 5s]
Fried Berg bets 0.04€
Romrom222 raises 0.04€ to 0.08€
Fried Berg folds
Romrom222 collected 0.21€ from pot
*** SUMMARY ***
Total pot 0.21€ | Rake 0.02€
Board: [Jd 6s 5s]
Seat 4: Romrom222 won 0.21€


Winamax Poker - HOLD-UP "Colorado" - HandId: #19116069-692886-1701704655 - Holdem no limit (0.01€/0.02€) - 2023/12/04 15:44:15 UTC
Table: 'Colorado' 6-max (real money) Seat #6 is the button
Seat 1: Fried Berg (0.58€)
Seat 2: Tofini (2€)
Seat 3: go_fl0p (1.97€)
Seat 4: Le Chiffre - (1.38€)
Seat 5: nunsuka69 (5.63€)
Seat 6: Ga31k (2€)
Hold-up to Pot: total 0.10€
*** ANTE/BLINDS ***
Fried Berg posts small blind 0.01€
Tofini posts big blind 0.02€
Dealt to Fried Berg [Td Qh]
*** PRE-FLOP *** 
go_fl0p raises 0.04€ to 0.06€
Le Chiffre - folds
nunsuka69 folds
Ga31k folds
Fried Berg folds
Tofini folds
go_fl0p collected 0.19€ from pot
*** SUMMARY ***
Total pot 0.19€ | No rake
Seat 3: go_fl0p won 0.19€


Winamax Poker - HOLD-UP "Colorado" - HandId: #19116069-692933-1701704674 - Holdem no limit (0.01€/0.02€) - 2023/12/04 15:44:34 UTC
Table: 'Colorado' 6-max (real money) Seat #6 is the button
Seat 1: Ga31k (2€)
Seat 2: CaptainSpok (1.67€)
Seat 3: ginodeon (2€)
Seat 4: N-22194 (3.65€)
Seat 5: Fried Berg (0.57€)
Seat 6: TJ Podoli II (1.17€)
*** ANTE/BLINDS ***
Ga31k posts small blind 0.01€
CaptainSpok posts big blind 0.02€
Dealt to Fried Berg [Kc Qc]
*** PRE-FLOP *** 
ginodeon folds
N-22194 folds
Fried Berg raises 0.02€ to 0.04€
TJ Podoli II folds
Ga31k folds
CaptainSpok folds
Fried Berg collected 0.07€ from pot
*** SUMMARY ***
Total pot 0.07€ | No rake
Seat 5: Fried Berg won 0.07€


Winamax Poker - HOLD-UP "Colorado" - HandId: #19116069-692955-1701704686 - Holdem no limit (0.01€/0.02€) - 2023/12/04 15:44:46 UTC
Table: 'Colorado' 6-max (real money) Seat #6 is the button
Seat 1: fishkingbull (2.90€)
Seat 2: NL_as40 (3.01€)
Seat 3: MarieLenclos (1.09€)
Seat 4: Fried Berg (0.60€)
Seat 5: tichettede3 (3.61€)
Seat 6: TiagoSS (2€)
*** ANTE/BLINDS ***
fishkingbull posts small blind 0.01€
NL_as40 posts big blind 0.02€
Dealt to Fried Berg [8c As]
*** PRE-FLOP *** 
MarieLenclos calls 0.02€
Fried Berg raises 0.02€ to 0.04€
tichettede3 folds
TiagoSS folds
fishkingbull folds
NL_as40 calls 0.02€
MarieLenclos calls 0.02€
*** FLOP *** [9d 4c 3h]
NL_as40 checks
MarieLenclos checks
Fried Berg checks
*** TURN *** [9d 4c 3h][7h]
NL_as40 bets 0.02€
MarieLenclos calls 0.02€
Fried Berg folds
*** RIVER *** [9d 4c 3h 7h][6s]
NL_as40 checks
MarieLenclos checks
*** SHOW DOWN ***
NL_as40 shows [6d Ad] (One pair : 6)
MarieLenclos shows [Qh Qc] (One pair : Queens)
MarieLenclos collected 0.15€ from pot
*** SUMMARY ***
Total pot 0.15€ | Rake 0.02€
Board: [9d 4c 3h 7h 6s]
Seat 2: NL_as40 (big blind) showed [6d Ad] and lost with One pair : 6
Seat 3: MarieLenclos showed [Qh Qc] and won 0.15€ with One pair : Queens


Winamax Poker - HOLD-UP "Colorado" - HandId: #19116069-693003-1701704710 - Holdem no limit (0.01€/0.02€) - 2023/12/04 15:45:10 UTC
Table: 'Colorado' 6-max (real money) Seat #6 is the button
Seat 1: Glirry (1.99€)
Seat 2: Tofini (2.26€)
Seat 3: 48centaure (1.78€)
Seat 4: bandarra8520 (3.19€)
Seat 5: Fried Berg (0.56€)
Seat 6: Carlos_Jugon (2.09€)
*** ANTE/BLINDS ***
Glirry posts small blind 0.01€
Tofini posts big blind 0.02€
Dealt to Fried Berg [6d Jc]
*** PRE-FLOP *** 
48centaure calls 0.02€
bandarra8520 folds
Fried Berg folds
Carlos_Jugon folds
Glirry folds
Tofini checks
*** FLOP *** [9s 8c Qc]
Tofini checks
48centaure bets 1.76€ and is all-in
Tofini folds
48centaure collected 1.80€ from pot
*** SUMMARY ***
Total pot 1.80€ | Rake 0.01€
Board: [9s 8c Qc]
Seat 3: 48centaure won 1.80€


Winamax Poker - HOLD-UP "Colorado" - HandId: #19116069-693014-1701704718 - Holdem no limit (0.01€/0.02€) - 2023/12/04 15:45:18 UTC
Table: 'Colorado' 6-max (real money) Seat #6 is the button
Seat 1: Maracujaaaa (2.01€)
Seat 2: FreeLouisias (2.27€)
Seat 3: Fried Berg (0.56€)
Seat 4: TiagoSS (2€)
Seat 5: -BrokenSmile (2.23€)
Seat 6: N-22194 (3.68€)
*** ANTE/BLINDS ***
Maracujaaaa posts small blind 0.01€
FreeLouisias posts big blind 0.02€
Dealt to Fried Berg [7h 3d]
*** PRE-FLOP *** 
Fried Berg folds
TiagoSS raises 0.03€ to 0.05€
-BrokenSmile calls 0.05€
N-22194 raises 0.18€ to 0.23€
Maracujaaaa folds
FreeLouisias raises 0.35€ to 0.58€
TiagoSS raises 1.42€ to 2€ and is all-in
-BrokenSmile folds
N-22194 folds
FreeLouisias calls 1.42€
*** FLOP *** [5c 4c 9c]
*** TURN *** [5c 4c 9c][Jh]
*** RIVER *** [5c 4c 9c Jh][Kh]
*** SHOW DOWN ***
TiagoSS shows [Ad Ah] (One pair : Aces)
FreeLouisias shows [Qc Ac] (Flush Ace high)
FreeLouisias collected 3.86€ from pot
*** SUMMARY ***
Total pot 3.86€ | Rake 0.43€
Board: [5c 4c 9c Jh Kh]
Seat 2: FreeLouisias (big blind) showed [Qc Ac] and won 3.86€ with Flush Ace high
Seat 4: TiagoSS showed [Ad Ah] and lost with One pair : Aces


