Winamax Poker - HOLD-UP "Colorado" - HandId: #19116069-429799-1701507919 - Holdem no limit (0.01€/0.02€) - 2023/12/02 09:05:19 UTC
Table: 'Colorado' 6-max (real money) Seat #6 is the button
Seat 1: badou29 (2.03€)
Seat 2: Fried Berg (0.50€)
Seat 3: Anty-dot (2.17€)
Seat 4: _gonzai_ (0.58€)
Seat 5: berlinouest (1.11€)
Seat 6: erguishe (2.11€)
*** ANTE/BLINDS ***
badou29 posts small blind 0.01€
Fried Berg posts big blind 0.02€
Dealt to Fried Berg [8c Js]
*** PRE-FLOP *** 
Anty-dot folds
_gonzai_ folds
berlinouest folds
erguishe raises 0.03€ to 0.05€
badou29 raises 0.12€ to 0.17€
Fried Berg folds
erguishe calls 0.12€
*** FLOP *** [4s 5d 5c]
badou29 bets 0.18€
erguishe raises 0.27€ to 0.45€
badou29 folds
erguishe collected 0.92€ from pot
*** SUMMARY ***
Total pot 0.92€ | Rake 0.07€
Board: [4s 5d 5c]
Seat 6: erguishe (button) won 0.92€


Winamax Poker - HOLD-UP "Colorado" - HandId: #19116069-429815-1701507933 - Holdem no limit (0.01€/0.02€) - 2023/12/02 09:05:33 UTC
Table: 'Colorado' 6-max (real money) Seat #6 is the button
Seat 1: Fried Berg (0.48€)
Seat 2: guito3954 (1€)
Seat 3: Roi 69 (2.13€)
Seat 4: ZenoidZ (1.97€)
Seat 5: Betiegarri (6.40€)
Seat 6: Chacal-Punk (1.68€)
*** ANTE/BLINDS ***
Fried Berg posts small blind 0.01€
guito3954 posts big blind 0.02€
Dealt to Fried Berg [3d 4d]
*** PRE-FLOP *** 
Roi 69 calls 0.02€
ZenoidZ calls 0.02€
Betiegarri folds
Chacal-Punk folds
Fried Berg calls 0.01€
guito3954 checks
*** FLOP *** [2c 7c 8h]
Fried Berg checks
guito3954 checks
Roi 69 checks
ZenoidZ checks
*** TURN *** [2c 7c 8h][4h]
Fried Berg checks
guito3954 bets 0.05€
Roi 69 calls 0.05€
ZenoidZ folds
Fried Berg folds
*** RIVER *** [2c 7c 8h 4h][Kd]
guito3954 bets 0.18€
Roi 69 folds
guito3954 collected 0.34€ from pot
*** SUMMARY ***
Total pot 0.34€ | Rake 0.02€
Board: [2c 7c 8h 4h Kd]
Seat 2: guito3954 (big blind) won 0.34€


Winamax Poker - HOLD-UP "Colorado" - HandId: #19116069-429876-1701507982 - Holdem no limit (0.01€/0.02€) - 2023/12/02 09:06:22 UTC
Table: 'Colorado' 6-max (real money) Seat #6 is the button
Seat 1: grut28 (3.97€)
Seat 2: clembool (2.85€)
Seat 3: Fried Berg (0.46€)
Seat 4: kawasan (0.57€)
Seat 5: witcher14 (0.40€)
Seat 6: Brut2pok (2€)
*** ANTE/BLINDS ***
grut28 posts small blind 0.01€
clembool posts big blind 0.02€
Dealt to Fried Berg [8d 3s]
*** PRE-FLOP *** 
Fried Berg folds
kawasan raises 0.04€ to 0.06€
witcher14 raises 0.34€ to 0.40€ and is all-in
Brut2pok folds
grut28 folds
clembool folds
kawasan calls 0.34€
*** FLOP *** [9d Jh 2c]
*** TURN *** [9d Jh 2c][4h]
*** RIVER *** [9d Jh 2c 4h][4s]
*** SHOW DOWN ***
witcher14 shows [Td Th] (Two pairs : Tens and 4)
kawasan shows [Ks Kc] (Two pairs : Kings and 4)
kawasan collected 0.75€ from pot
*** SUMMARY ***
Total pot 0.75€ | Rake 0.08€
Board: [9d Jh 2c 4h 4s]
Seat 4: kawasan showed [Ks Kc] and won 0.75€ with Two pairs : Kings and 4
Seat 5: witcher14 showed [Td Th] and lost with Two pairs : Tens and 4


Winamax Poker - HOLD-UP "Colorado" - HandId: #19116069-429883-1701507986 - Holdem no limit (0.01€/0.02€) - 2023/12/02 09:06:26 UTC
Table: 'Colorado' 6-max (real money) Seat #6 is the button
Seat 1: KON-2-PEUTE (2.79€)
Seat 2: lestat6993 (1.51€)
Seat 3: Ikoairline (0.66€)
Seat 4: Fried Berg (0.46€)
Seat 5: Vanight (5.27€)
Seat 6: 77boy77 (0.79€)
*** ANTE/BLINDS ***
KON-2-PEUTE posts small blind 0.01€
lestat6993 posts big blind 0.02€
Dealt to Fried Berg [Js Th]
*** PRE-FLOP *** 
Ikoairline folds
Fried Berg folds
Vanight folds
77boy77 folds
KON-2-PEUTE folds
lestat6993 collected 0.03€ from pot
*** SUMMARY ***
Total pot 0.03€ | No rake
Seat 2: lestat6993 (big blind) won 0.03€


Winamax Poker - HOLD-UP "Colorado" - HandId: #19116069-429898-1701507997 - Holdem no limit (0.01€/0.02€) - 2023/12/02 09:06:37 UTC
Table: 'Colorado' 6-max (real money) Seat #6 is the button
Seat 1: g8o8k8u (2€)
Seat 2: Brut2pok (2€)
Seat 3: jdeepenslip (2.44€)
Seat 4: iron-dada (1€)
Seat 5: Fried Berg (0.46€)
Seat 6: D13C (2€)
*** ANTE/BLINDS ***
g8o8k8u posts small blind 0.01€
Brut2pok posts big blind 0.02€
Dealt to Fried Berg [9d Qs]
*** PRE-FLOP *** 
jdeepenslip folds
iron-dada folds
Fried Berg folds
D13C folds
g8o8k8u folds
Brut2pok collected 0.03€ from pot
*** SUMMARY ***
Total pot 0.03€ | No rake
Seat 2: Brut2pok (big blind) won 0.03€


Winamax Poker - HOLD-UP "Colorado" - HandId: #19116069-429912-1701508012 - Holdem no limit (0.01€/0.02€) - 2023/12/02 09:06:52 UTC
Table: 'Colorado' 6-max (real money) Seat #6 is the button
Seat 1: scach-111 (2.46€)
Seat 2: g8o8k8u (2€)
Seat 3: fishkingbull (2.10€)
Seat 4: Nainsoss (2.19€)
Seat 5: Vanight (5.25€)
Seat 6: Fried Berg (0.46€)
*** ANTE/BLINDS ***
scach-111 posts small blind 0.01€
g8o8k8u posts big blind 0.02€
Dealt to Fried Berg [8d Qc]
*** PRE-FLOP *** 
fishkingbull folds
Nainsoss folds
Vanight folds
Fried Berg folds
scach-111 folds
g8o8k8u collected 0.03€ from pot
*** SUMMARY ***
Total pot 0.03€ | No rake
Seat 2: g8o8k8u (big blind) won 0.03€


Winamax Poker - HOLD-UP "Colorado" - HandId: #19116069-429919-1701508020 - Holdem no limit (0.01€/0.02€) - 2023/12/02 09:07:00 UTC
Table: 'Colorado' 6-max (real money) Seat #6 is the button
Seat 1: Fried Berg (0.46€)
Seat 2: Halmosthard (2.65€)
Seat 3: dcamerlo (2.39€)
Seat 4: dan.doc (1.52€)
Seat 5: Brut2pok (2€)
Seat 6: Brictos (1.82€)
Hold-up to Pot: total 0.10€
*** ANTE/BLINDS ***
Fried Berg posts small blind 0.01€
Halmosthard posts big blind 0.02€
Dealt to Fried Berg [Ah 4d]
*** PRE-FLOP *** 
dcamerlo raises 0.09€ to 0.11€
dan.doc folds
Brut2pok folds
Brictos folds
Fried Berg folds
Halmosthard folds
dcamerlo collected 0.24€ from pot
*** SUMMARY ***
Total pot 0.24€ | No rake
Seat 3: dcamerlo won 0.24€


Winamax Poker - HOLD-UP "Colorado" - HandId: #19116069-429933-1701508031 - Holdem no limit (0.01€/0.02€) - 2023/12/02 09:07:11 UTC
Table: 'Colorado' 6-max (real money) Seat #6 is the button
Seat 1: fishkingbull (2.10€)
Seat 2: Fried Berg (0.45€)
Seat 3: clembool (3.22€)
Seat 4: toinitou9 (2.04€)
Seat 5: Kito31 (6.95€)
Seat 6: scach-111 (2.38€)
*** ANTE/BLINDS ***
fishkingbull posts small blind 0.01€
Fried Berg posts big blind 0.02€
Dealt to Fried Berg [3h 9c]
*** PRE-FLOP *** 
clembool raises 0.04€ to 0.06€
toinitou9 folds
Kito31 folds
scach-111 folds
fishkingbull folds
Fried Berg folds
clembool collected 0.09€ from pot
*** SUMMARY ***
Total pot 0.09€ | No rake
Seat 3: clembool won 0.09€


Winamax Poker - HOLD-UP "Colorado" - HandId: #19116069-429939-1701508035 - Holdem no limit (0.01€/0.02€) - 2023/12/02 09:07:15 UTC
Table: 'Colorado' 6-max (real money) Seat #6 is the button
Seat 1: KON-2-PEUTE (2€)
Seat 2: scach-111 (2.45€)
Seat 3: Brut2pok (2.14€)
Seat 4: Fried Berg (0.43€)
Seat 5: guito3954 (1.36€)
Seat 6: _gonzai_ (0.50€)
*** ANTE/BLINDS ***
KON-2-PEUTE posts small blind 0.01€
scach-111 posts big blind 0.02€
Dealt to Fried Berg [2h 3d]
*** PRE-FLOP *** 
Brut2pok folds
Fried Berg folds
guito3954 folds
_gonzai_ folds
KON-2-PEUTE folds
scach-111 collected 0.03€ from pot
*** SUMMARY ***
Total pot 0.03€ | No rake
Seat 2: scach-111 (big blind) won 0.03€


Winamax Poker - HOLD-UP "Colorado" - HandId: #19116069-429944-1701508038 - Holdem no limit (0.01€/0.02€) - 2023/12/02 09:07:18 UTC
Table: 'Colorado' 6-max (real money) Seat #6 is the button
Seat 1: guito3954 (1.36€)
Seat 2: KON-2-PEUTE (2€)
Seat 3: Fried Berg (0.43€)
Seat 4: g8o8k8u (2.19€)
Seat 5: Brut2pok (2.14€)
Seat 6: dan.doc (1.93€)
*** ANTE/BLINDS ***
guito3954 posts small blind 0.01€
KON-2-PEUTE posts big blind 0.02€
Dealt to Fried Berg [Qd 8d]
*** PRE-FLOP *** 
Fried Berg folds
g8o8k8u folds
Brut2pok folds
dan.doc calls 0.02€
guito3954 folds
KON-2-PEUTE checks
*** FLOP *** [Kd 9s 2c]
KON-2-PEUTE checks
dan.doc bets 0.02€
KON-2-PEUTE folds
dan.doc collected 0.06€ from pot
*** SUMMARY ***
Total pot 0.06€ | Rake 0.01€
Board: [Kd 9s 2c]
Seat 6: dan.doc (button) won 0.06€


Winamax Poker - HOLD-UP "Colorado" - HandId: #19116069-429949-1701508041 - Holdem no limit (0.01€/0.02€) - 2023/12/02 09:07:21 UTC
Table: 'Colorado' 6-max (real money) Seat #6 is the button
Seat 1: GreenCard225 (2.01€)
Seat 2: D13C (2€)
Seat 3: g8o8k8u (2.19€)
Seat 4: jjakpour (1.46€)
Seat 5: Fried Berg (0.43€)
Seat 6: Nainsoss (2.20€)
*** ANTE/BLINDS ***
GreenCard225 posts small blind 0.01€
D13C posts big blind 0.02€
Dealt to Fried Berg [Ac As]
*** PRE-FLOP *** 
g8o8k8u folds
jjakpour folds
Fried Berg raises 0.04€ to 0.06€
Nainsoss folds
GreenCard225 folds
D13C folds
Fried Berg collected 0.09€ from pot
*** SUMMARY ***
Total pot 0.09€ | No rake
Seat 5: Fried Berg won 0.09€


Winamax Poker - HOLD-UP "Colorado" - HandId: #19116069-429962-1701508051 - Holdem no limit (0.01€/0.02€) - 2023/12/02 09:07:31 UTC
Table: 'Colorado' 6-max (real money) Seat #6 is the button
Seat 1: Chacal-Punk (1.64€)
Seat 2: lestat6993 (1.41€)
Seat 3: scach-111 (2.45€)
Seat 4: g8o8k8u (2€)
Seat 5: Fried Berg (0.46€)
Seat 6: kionimax05 (1.95€)
*** ANTE/BLINDS ***
Chacal-Punk posts small blind 0.01€
lestat6993 posts big blind 0.02€
Dealt to Fried Berg [6c Ac]
*** PRE-FLOP *** 
scach-111 folds
g8o8k8u folds
Fried Berg raises 0.03€ to 0.05€
kionimax05 folds
Chacal-Punk folds
lestat6993 raises 0.10€ to 0.15€
Fried Berg calls 0.10€
*** FLOP *** [4s Kh 7h]
lestat6993 bets 0.20€
Fried Berg folds
lestat6993 collected 0.48€ from pot
*** SUMMARY ***
Total pot 0.48€ | Rake 0.03€
Board: [4s Kh 7h]
Seat 2: lestat6993 (big blind) won 0.48€


Winamax Poker - HOLD-UP "Colorado" - HandId: #19116069-429989-1701508077 - Holdem no limit (0.01€/0.02€) - 2023/12/02 09:07:57 UTC
Table: 'Colorado' 6-max (real money) Seat #6 is the button
Seat 1: Alexisdpp (3.51€)
Seat 2: g8o8k8u (2€)
Seat 3: _gonzai_ (0.50€)
Seat 4: Fried Berg (0.31€)
Seat 5: GwenLaGrise (2.01€)
Seat 6: kevinbetwin (0.59€)
*** ANTE/BLINDS ***
Alexisdpp posts small blind 0.01€
g8o8k8u posts big blind 0.02€
Dealt to Fried Berg [9d 5d]
*** PRE-FLOP *** 
_gonzai_ raises 0.04€ to 0.06€
Fried Berg folds
GwenLaGrise raises 0.15€ to 0.21€
kevinbetwin folds
Alexisdpp folds
g8o8k8u folds
_gonzai_ raises 0.29€ to 0.50€ and is all-in
GwenLaGrise raises 1.51€ to 2.01€ and is all-in
*** FLOP *** [8d 3c 2d]
*** TURN *** [8d 3c 2d][Kc]
*** RIVER *** [8d 3c 2d Kc][Ks]
*** SHOW DOWN ***
_gonzai_ shows [Qc Ac] (One pair : Kings)
GwenLaGrise shows [Kd Kh] (Quads of Kings)
GwenLaGrise collected 2.44€ from pot
*** SUMMARY ***
Total pot 2.44€ | Rake 0.10€
Board: [8d 3c 2d Kc Ks]
Seat 3: _gonzai_ showed [Qc Ac] and lost with One pair : Kings
Seat 5: GwenLaGrise showed [Kd Kh] and won 2.44€ with Quads of Kings


Winamax Poker - HOLD-UP "Colorado" - HandId: #19116069-430001-1701508086 - Holdem no limit (0.01€/0.02€) - 2023/12/02 09:08:06 UTC
Table: 'Colorado' 6-max (real money) Seat #6 is the button
Seat 1: yam69 (3.99€)
Seat 2: Fried Berg (0.31€)
Seat 3: scach-111 (2.27€)
Seat 4: Brictos (1.87€)
Seat 5: lestat6993 (1.53€)
Seat 6: Halmosthard (2.67€)
*** ANTE/BLINDS ***
yam69 posts small blind 0.01€
Fried Berg posts big blind 0.02€
Dealt to Fried Berg [7s 6c]
*** PRE-FLOP *** 
scach-111 raises 0.04€ to 0.06€
Brictos calls 0.06€
lestat6993 folds
Halmosthard folds
yam69 folds
Fried Berg folds
*** FLOP *** [6s 8s 8h]
scach-111 bets 0.08€
Brictos calls 0.08€
*** TURN *** [6s 8s 8h][9d]
scach-111 checks
Brictos bets 0.11€
scach-111 folds
Brictos collected 0.39€ from pot
*** SUMMARY ***
Total pot 0.39€ | Rake 0.03€
Board: [6s 8s 8h 9d]
Seat 4: Brictos won 0.39€


Winamax Poker - HOLD-UP "Colorado" - HandId: #19116069-430012-1701508095 - Holdem no limit (0.01€/0.02€) - 2023/12/02 09:08:15 UTC
Table: 'Colorado' 6-max (real money) Seat #6 is the button
Seat 1: Fried Berg (0.29€)
Seat 2: djaymanta (4.90€)
Seat 3: yam69 (3.97€)
Seat 4: Siradella80 (1.87€)
Seat 5: Tribuna38 (2.31€)
Seat 6: grut28 (1.93€)
*** ANTE/BLINDS ***
Fried Berg posts small blind 0.01€
djaymanta posts big blind 0.02€
Dealt to Fried Berg [9h 9d]
*** PRE-FLOP *** 
yam69 folds
Siradella80 folds
Tribuna38 folds
grut28 calls 0.02€
Fried Berg raises 0.04€ to 0.06€
djaymanta calls 0.04€
grut28 raises 1.87€ to 1.93€ and is all-in
Fried Berg calls 0.23€ and is all-in
djaymanta folds
*** FLOP *** [Ad 4s 2s]
*** TURN *** [Ad 4s 2s][2d]
*** RIVER *** [Ad 4s 2s 2d][7d]
*** SHOW DOWN ***
Fried Berg shows [9h 9d] (Two pairs : 9 and 2)
grut28 shows [Qs Ac] (Two pairs : Aces and 2)
grut28 collected 2.22€ from pot
*** SUMMARY ***
Total pot 2.22€ | Rake 0.06€
Board: [Ad 4s 2s 2d 7d]
Seat 1: Fried Berg (small blind) showed [9h 9d] and lost with Two pairs : 9 and 2
Seat 6: grut28 (button) showed [Qs Ac] and won 2.22€ with Two pairs : Aces and 2


Winamax Poker - HOLD-UP "Colorado" - HandId: #19116069-430045-1701508126 - Holdem no limit (0.01€/0.02€) - 2023/12/02 09:08:46 UTC
Table: 'Colorado' 6-max (real money) Seat #6 is the button
Seat 1: Halmosthard (2.65€)
Seat 2: I6pokerP4 (3.34€)
Seat 3: Fried Berg (0.50€)
Seat 4: Brut2pok (2€)
Seat 5: junkokonno (2.01€)
Seat 6: Stuntman (3.65€)
*** ANTE/BLINDS ***
Halmosthard posts small blind 0.01€
I6pokerP4 posts big blind 0.02€
Dealt to Fried Berg [Th 8c]
*** PRE-FLOP *** 
Fried Berg folds
Brut2pok folds
junkokonno folds
Stuntman calls 0.02€
Halmosthard folds
I6pokerP4 checks
*** FLOP *** [5c 4d 9c]
I6pokerP4 checks
Stuntman bets 0.03€
I6pokerP4 raises 0.07€ to 0.10€
Stuntman folds
I6pokerP4 collected 0.17€ from pot
*** SUMMARY ***
Total pot 0.17€ | Rake 0.01€
Board: [5c 4d 9c]
Seat 2: I6pokerP4 (big blind) won 0.17€


Winamax Poker - HOLD-UP "Colorado" - HandId: #19116069-430047-1701508128 - Holdem no limit (0.01€/0.02€) - 2023/12/02 09:08:48 UTC
Table: 'Colorado' 6-max (real money) Seat #6 is the button
Seat 1: wmx-b6v02tv (1.40€)
Seat 2: D13C (2€)
Seat 3: clembool (2.82€)
Seat 4: _gonzai_ (0.50€)
Seat 5: dan.doc (1.51€)
Seat 6: Fried Berg (0.50€)
*** ANTE/BLINDS ***
wmx-b6v02tv posts small blind 0.01€
D13C posts big blind 0.02€
Dealt to Fried Berg [Jc 7c]
*** PRE-FLOP *** 
clembool folds
_gonzai_ folds
dan.doc folds
Fried Berg raises 0.02€ to 0.04€
wmx-b6v02tv calls 0.03€
D13C folds
*** FLOP *** [5c 4s 5h]
wmx-b6v02tv checks
Fried Berg checks
*** TURN *** [5c 4s 5h][3d]
wmx-b6v02tv checks
Fried Berg checks
*** RIVER *** [5c 4s 5h 3d][7h]
wmx-b6v02tv checks
Fried Berg checks
*** SHOW DOWN ***
wmx-b6v02tv shows [Ts Ac] (One pair : 5)
Fried Berg shows [Jc 7c] (Two pairs : 7 and 5)
Fried Berg collected 0.09€ from pot
*** SUMMARY ***
Total pot 0.09€ | Rake 0.01€
Board: [5c 4s 5h 3d 7h]
Seat 1: wmx-b6v02tv (small blind) showed [Ts Ac] and lost with One pair : 5
Seat 6: Fried Berg (button) showed [Jc 7c] and won 0.09€ with Two pairs : 7 and 5


Winamax Poker - HOLD-UP "Colorado" - HandId: #19116069-430132-1701508254 - Holdem no limit (0.01€/0.02€) - 2023/12/02 09:10:54 UTC
Table: 'Colorado' 6-max (real money) Seat #6 is the button
Seat 1: Nainsoss (2.72€)
Seat 2: Betiegarri (6.45€)
Seat 3: Brut2pok (2€)
Seat 4: wmx-b6v02tv (1.36€)
Seat 5: dan.doc (1.41€)
Seat 6: Fried Berg (0.55€)
*** ANTE/BLINDS ***
Nainsoss posts small blind 0.01€
Betiegarri posts big blind 0.02€
Dealt to Fried Berg [6d Kc]
*** PRE-FLOP *** 
Brut2pok folds
wmx-b6v02tv folds
dan.doc folds
Fried Berg folds
Nainsoss raises 0.03€ to 0.05€
Betiegarri folds
Nainsoss collected 0.07€ from pot
*** SUMMARY ***
Total pot 0.07€ | No rake
Seat 1: Nainsoss (small blind) won 0.07€


Winamax Poker - HOLD-UP "Colorado" - HandId: #19116069-430143-1701508270 - Holdem no limit (0.01€/0.02€) - 2023/12/02 09:11:10 UTC
Table: 'Colorado' 6-max (real money) Seat #6 is the button
Seat 1: jdeepenslip (2.78€)
Seat 2: Tribuna38 (2.27€)
Seat 3: _Lilli Rush (4.74€)
Seat 4: Fried Berg (0.55€)
Seat 5: edfcain (4.54€)
Seat 6: KON-2-PEUTE (2.73€)
*** ANTE/BLINDS ***
jdeepenslip posts small blind 0.01€
Tribuna38 posts big blind 0.02€
Dealt to Fried Berg [8s 4c]
*** PRE-FLOP *** 
_Lilli Rush raises 0.02€ to 0.04€
Fried Berg folds
edfcain folds
KON-2-PEUTE folds
jdeepenslip folds
Tribuna38 calls 0.02€
*** FLOP *** [5s 7d 9d]
Tribuna38 checks
_Lilli Rush checks
*** TURN *** [5s 7d 9d][2d]
Tribuna38 bets 0.02€
_Lilli Rush calls 0.02€
*** RIVER *** [5s 7d 9d 2d][8h]
Tribuna38 bets 0.07€
_Lilli Rush calls 0.07€
*** SHOW DOWN ***
Tribuna38 shows [Jc 9c] (One pair : 9)
_Lilli Rush shows [6h Ah] (Straight 9 high)
_Lilli Rush collected 0.24€ from pot
*** SUMMARY ***
Total pot 0.24€ | Rake 0.03€
Board: [5s 7d 9d 2d 8h]
Seat 2: Tribuna38 (big blind) showed [Jc 9c] and lost with One pair : 9
Seat 3: _Lilli Rush showed [6h Ah] and won 0.24€ with Straight 9 high


Winamax Poker - HOLD-UP "Colorado" - HandId: #19116069-430152-1701508282 - Holdem no limit (0.01€/0.02€) - 2023/12/02 09:11:22 UTC
Table: 'Colorado' 6-max (real money) Seat #6 is the button
Seat 1: timou27 (1.94€)
Seat 2: Fried Berg (0.55€)
Seat 3: elsrab (2.26€)
Seat 4: toinitou9 (1.66€)
Seat 5: Chacal-Punk (1.80€)
Seat 6: GwenLaGrise (2.55€)
*** ANTE/BLINDS ***
timou27 posts small blind 0.01€
Fried Berg posts big blind 0.02€
Dealt to Fried Berg [Td 5s]
*** PRE-FLOP *** 
elsrab folds
toinitou9 folds
Chacal-Punk raises 0.04€ to 0.06€
GwenLaGrise folds
timou27 folds
Fried Berg folds
Chacal-Punk collected 0.09€ from pot
*** SUMMARY ***
Total pot 0.09€ | No rake
Seat 5: Chacal-Punk won 0.09€


Winamax Poker - HOLD-UP "Colorado" - HandId: #19116069-430159-1701508291 - Holdem no limit (0.01€/0.02€) - 2023/12/02 09:11:31 UTC
Table: 'Colorado' 6-max (real money) Seat #6 is the button
Seat 1: Fried Berg (0.53€)
Seat 2: Halmosthard (2.25€)
Seat 3: Brut2pok (2€)
Seat 4: ._Just_. (2.40€)
Seat 5: Nainsoss (2.60€)
Seat 6: junkokonno (2.03€)
*** ANTE/BLINDS ***
Fried Berg posts small blind 0.01€
Halmosthard posts big blind 0.02€
Dealt to Fried Berg [Ad 2s]
*** PRE-FLOP *** 
Brut2pok folds
._Just_. folds
Nainsoss folds
junkokonno raises 0.03€ to 0.05€
Fried Berg calls 0.04€
Halmosthard folds
*** FLOP *** [5s 3h Th]
Fried Berg checks
junkokonno bets 0.04€
Fried Berg folds
junkokonno collected 0.15€ from pot
*** SUMMARY ***
Total pot 0.15€ | Rake 0.01€
Board: [5s 3h Th]
Seat 6: junkokonno (button) won 0.15€


Winamax Poker - HOLD-UP "Colorado" - HandId: #19116069-430187-1701508320 - Holdem no limit (0.01€/0.02€) - 2023/12/02 09:12:00 UTC
Table: 'Colorado' 6-max (real money) Seat #6 is the button
Seat 1: edfcain (4.60€)
Seat 2: GwenLaGrise (2.77€)
Seat 3: Fried Berg (0.48€)
Seat 4: Casperardenn (0.50€)
Seat 5: Melielvir (3.24€)
Seat 6: Brut2pok (2.44€)
*** ANTE/BLINDS ***
edfcain posts small blind 0.01€
GwenLaGrise posts big blind 0.02€
Dealt to Fried Berg [Js 9s]
*** PRE-FLOP *** 
Fried Berg folds
Casperardenn folds
Melielvir folds
Brut2pok raises 0.04€ to 0.06€
edfcain folds
GwenLaGrise folds
Brut2pok collected 0.09€ from pot
*** SUMMARY ***
Total pot 0.09€ | No rake
Seat 6: Brut2pok (button) won 0.09€


Winamax Poker - HOLD-UP "Colorado" - HandId: #19116069-430193-1701508329 - Holdem no limit (0.01€/0.02€) - 2023/12/02 09:12:09 UTC
Table: 'Colorado' 6-max (real money) Seat #6 is the button
Seat 1: Kito31 (6.86€)
Seat 2: Roi 69 (1.78€)
Seat 3: junkokonno (2.08€)
Seat 4: D13C (2.06€)
Seat 5: Fried Berg (0.48€)
Seat 6: elsrab (2.06€)
Hold-up to Pot: total 0.10€
*** ANTE/BLINDS ***
Kito31 posts small blind 0.01€
Roi 69 posts big blind 0.02€
Dealt to Fried Berg [4s Qc]
*** PRE-FLOP *** 
junkokonno folds
D13C folds
Fried Berg folds
elsrab raises 0.15€ to 0.17€
Kito31 folds
Roi 69 folds
elsrab collected 0.30€ from pot
*** SUMMARY ***
Total pot 0.30€ | No rake
Seat 6: elsrab (button) won 0.30€


Winamax Poker - HOLD-UP "Colorado" - HandId: #19116069-430199-1701508335 - Holdem no limit (0.01€/0.02€) - 2023/12/02 09:12:15 UTC
Table: 'Colorado' 6-max (real money) Seat #6 is the button
Seat 1: Anty-dot (2.15€)
Seat 2: Vanight (5.04€)
Seat 3: edfcain (4.59€)
Seat 4: Tribuna38 (2.10€)
Seat 5: Betiegarri (2.31€)
Seat 6: Fried Berg (0.48€)
*** ANTE/BLINDS ***
Anty-dot posts small blind 0.01€
Vanight posts big blind 0.02€
Dealt to Fried Berg [Kc 9c]
*** PRE-FLOP *** 
edfcain folds
Tribuna38 folds
Betiegarri folds
Fried Berg raises 0.02€ to 0.04€
Anty-dot folds
Vanight folds
Fried Berg collected 0.07€ from pot
*** SUMMARY ***
Total pot 0.07€ | No rake
Seat 6: Fried Berg (button) won 0.07€


Winamax Poker - HOLD-UP "Colorado" - HandId: #19116069-430209-1701508346 - Holdem no limit (0.01€/0.02€) - 2023/12/02 09:12:26 UTC
Table: 'Colorado' 6-max (real money) Seat #6 is the button
Seat 1: Cobichou (1.84€)
Seat 2: TaBrEaMoI (2€)
Seat 3: Tribuna38 (2.09€)
Seat 4: GreenCard225 (2€)
Seat 5: Vanight (7.60€)
Seat 6: Fried Berg (0.51€)
*** ANTE/BLINDS ***
Cobichou posts small blind 0.01€
TaBrEaMoI posts big blind 0.02€
Dealt to Fried Berg [Kc Qs]
*** PRE-FLOP *** 
Tribuna38 folds
GreenCard225 raises 0.03€ to 0.05€
Vanight folds
Fried Berg raises 0.10€ to 0.15€
Cobichou folds
TaBrEaMoI folds
GreenCard225 calls 0.10€
*** FLOP *** [3c 4h 5h]
GreenCard225 checks
Fried Berg checks
*** TURN *** [3c 4h 5h][Qh]
GreenCard225 bets 0.03€
Fried Berg raises 0.03€ to 0.06€
GreenCard225 raises 0.09€ to 0.15€
Fried Berg calls 0.09€
*** RIVER *** [3c 4h 5h Qh][7s]
GreenCard225 bets 0.24€
Fried Berg calls 0.21€ and is all-in
*** SHOW DOWN ***
GreenCard225 shows [Td Qd] (One pair : Queens)
Fried Berg shows [Kc Qs] (One pair : Queens)
Fried Berg collected 0.94€ from main pot
GreenCard225 collected 0.03€ from side pot 1
*** SUMMARY ***
Total pot 0.97€ | Rake 0.11€
Board: [3c 4h 5h Qh 7s]
Seat 4: GreenCard225 showed [Td Qd] and won 0.03€ with One pair : Queens
Seat 6: Fried Berg (button) showed [Kc Qs] and won 0.94€ with One pair : Queens


Winamax Poker - HOLD-UP "Colorado" - HandId: #19116069-430265-1701508410 - Holdem no limit (0.01€/0.02€) - 2023/12/02 09:13:30 UTC
Table: 'Colorado' 6-max (real money) Seat #6 is the button
Seat 1: GreenCard225 (2€)
Seat 2: Fried Berg (0.94€)
Seat 3: TaBrEaMoI (1.97€)
Seat 4: elsrab (2.26€)
Seat 5: Fanfan21260 (2.38€)
Seat 6: BADchic (1.19€)
*** ANTE/BLINDS ***
GreenCard225 posts small blind 0.01€
Fried Berg posts big blind 0.02€
Dealt to Fried Berg [As 9c]
*** PRE-FLOP *** 
TaBrEaMoI folds
elsrab raises 0.02€ to 0.04€
Fanfan21260 calls 0.04€
BADchic folds
GreenCard225 folds
Fried Berg calls 0.02€
*** FLOP *** [Kd Js Kc]
Fried Berg checks
elsrab bets 0.04€
Fanfan21260 folds
Fried Berg calls 0.04€
*** TURN *** [Kd Js Kc][7c]
Fried Berg checks
elsrab checks
*** RIVER *** [Kd Js Kc 7c][3h]
Fried Berg checks
elsrab bets 0.04€
Fried Berg calls 0.04€
*** SHOW DOWN ***
Fried Berg shows [As 9c] (One pair : Kings)
elsrab shows [Jh 7h] (Two pairs : Kings and Jacks)
elsrab collected 0.26€ from pot
*** SUMMARY ***
Total pot 0.26€ | Rake 0.03€
Board: [Kd Js Kc 7c 3h]
Seat 2: Fried Berg (big blind) showed [As 9c] and lost with One pair : Kings
Seat 4: elsrab showed [Jh 7h] and won 0.26€ with Two pairs : Kings and Jacks


Winamax Poker - HOLD-UP "Colorado" - HandId: #19116069-430327-1701508487 - Holdem no limit (0.01€/0.02€) - 2023/12/02 09:14:47 UTC
Table: 'Colorado' 6-max (real money) Seat #6 is the button
Seat 1: Fried Berg (0.82€)
Seat 2: Betiegarri (6.66€)
Seat 3: Melielvir (3.46€)
Seat 4: junkokonno (2.16€)
Seat 5: livthe34 (2.46€)
Seat 6: Kito31 (6.83€)
*** ANTE/BLINDS ***
Fried Berg posts small blind 0.01€
Betiegarri posts big blind 0.02€
Dealt to Fried Berg [5c Jd]
*** PRE-FLOP *** 
Melielvir folds
junkokonno folds
livthe34 folds
Kito31 folds
Fried Berg folds
Betiegarri collected 0.03€ from pot
*** SUMMARY ***
Total pot 0.03€ | No rake
Seat 2: Betiegarri (big blind) won 0.03€


Winamax Poker - HOLD-UP "Colorado" - HandId: #19116069-430338-1701508499 - Holdem no limit (0.01€/0.02€) - 2023/12/02 09:14:59 UTC
Table: 'Colorado' 6-max (real money) Seat #6 is the button
Seat 1: jdeepenslip (3.56€)
Seat 2: Tom360 (1.95€)
Seat 3: Fried Berg (0.81€)
Seat 4: Samostheouf (0.55€)
Seat 5: edfcain (4.57€)
Seat 6: GreenCard225 (2.89€)
*** ANTE/BLINDS ***
jdeepenslip posts small blind 0.01€
Tom360 posts big blind 0.02€
Dealt to Fried Berg [2h 7c]
*** PRE-FLOP *** 
Fried Berg folds
Samostheouf calls 0.02€
edfcain raises 0.07€ to 0.09€
GreenCard225 folds
jdeepenslip folds
Tom360 calls 0.07€
Samostheouf calls 0.07€
*** FLOP *** [8h 5h 2s]
Tom360 checks
Samostheouf checks
edfcain bets 0.14€
Tom360 folds
Samostheouf folds
edfcain collected 0.39€ from pot
*** SUMMARY ***
Total pot 0.39€ | Rake 0.03€
Board: [8h 5h 2s]
Seat 5: edfcain won 0.39€


Winamax Poker - HOLD-UP "Colorado" - HandId: #19116069-430339-1701508500 - Holdem no limit (0.01€/0.02€) - 2023/12/02 09:15:00 UTC
Table: 'Colorado' 6-max (real money) Seat #6 is the button
Seat 1: Kito31 (6.83€)
Seat 2: TaBrEaMoI (2.01€)
Seat 3: wmx-b6v02tv (1.62€)
Seat 4: Fried Berg (0.81€)
Seat 5: scach-111 (2.98€)
Seat 6: MissLoulou (1.96€)
*** ANTE/BLINDS ***
Kito31 posts small blind 0.01€
TaBrEaMoI posts big blind 0.02€
Dealt to Fried Berg [5d 7c]
*** PRE-FLOP *** 
wmx-b6v02tv folds
Fried Berg folds
scach-111 folds
MissLoulou calls 0.02€
Kito31 calls 0.01€
TaBrEaMoI checks
*** FLOP *** [4d 6d 9d]
Kito31 checks
TaBrEaMoI bets 0.02€
MissLoulou raises 0.06€ to 0.08€
Kito31 folds
TaBrEaMoI calls 0.06€
*** TURN *** [4d 6d 9d][4h]
TaBrEaMoI checks
MissLoulou bets 0.22€
TaBrEaMoI folds
MissLoulou collected 0.42€ from pot
*** SUMMARY ***
Total pot 0.42€ | Rake 0.02€
Board: [4d 6d 9d 4h]
Seat 6: MissLoulou (button) won 0.42€


Winamax Poker - HOLD-UP "Colorado" - HandId: #19116069-430341-1701508502 - Holdem no limit (0.01€/0.02€) - 2023/12/02 09:15:02 UTC
Table: 'Colorado' 6-max (real money) Seat #6 is the button
Seat 1: jjakpour (0.53€)
Seat 2: D13C (2.03€)
Seat 3: yam69 (3.50€)
Seat 4: Tribuna38 (2€)
Seat 5: Fried Berg (0.81€)
Seat 6: GreenCard225 (2.89€)
*** ANTE/BLINDS ***
jjakpour posts small blind 0.01€
D13C posts big blind 0.02€
Dealt to Fried Berg [Th Ts]
*** PRE-FLOP *** 
yam69 folds
Tribuna38 raises 0.04€ to 0.06€
Fried Berg raises 0.12€ to 0.18€
GreenCard225 folds
jjakpour calls 0.17€
D13C folds
Tribuna38 calls 0.12€
*** FLOP *** [4d 9d Qh]
jjakpour checks
Tribuna38 checks
Fried Berg bets 0.63€ and is all-in
jjakpour calls 0.35€ and is all-in
Tribuna38 calls 0.63€
*** TURN *** [4d 9d Qh][7s]
*** RIVER *** [4d 9d Qh 7s][Jd]
*** SHOW DOWN ***
jjakpour shows [6h Ad] (High card : Ace)
Fried Berg shows [Th Ts] (One pair : Tens)
Tribuna38 shows [7h 7c] (Trips of 7)
Tribuna38 collected 1.95€ from pot
*** SUMMARY ***
Total pot 1.95€ | Rake 0.22€
Board: [4d 9d Qh 7s Jd]
Seat 1: jjakpour (small blind) showed [6h Ad] and lost with High card : Ace
Seat 4: Tribuna38 showed [7h 7c] and won 1.95€ with Trips of 7
Seat 5: Fried Berg showed [Th Ts] and lost with One pair : Tens


Winamax Poker - HOLD-UP "Colorado" - HandId: #19116069-430383-1701508546 - Holdem no limit (0.01€/0.02€) - 2023/12/02 09:15:46 UTC
Table: 'Colorado' 6-max (real money) Seat #6 is the button
Seat 1: Queen6668 (1.83€)
Seat 2: swag-Morue73 (2€)
Seat 3: GwenLaGrise (3.66€)
Seat 4: BADchic (1.04€)
Seat 5: edfcain (4.73€)
Seat 6: Fried Berg (0.50€)
*** ANTE/BLINDS ***
Queen6668 posts small blind 0.01€
swag-Morue73 posts big blind 0.02€
Dealt to Fried Berg [As 6d]
*** PRE-FLOP *** 
GwenLaGrise folds
BADchic calls 0.02€
edfcain folds
Fried Berg calls 0.02€
Queen6668 calls 0.01€
swag-Morue73 checks
*** FLOP *** [5s Ts 2c]
Queen6668 checks
swag-Morue73 bets 0.05€
BADchic folds
Fried Berg folds
Queen6668 calls 0.05€
*** TURN *** [5s Ts 2c][7s]
Queen6668 checks
swag-Morue73 bets 0.06€
Queen6668 folds
swag-Morue73 collected 0.22€ from pot
*** SUMMARY ***
Total pot 0.22€ | Rake 0.02€
Board: [5s Ts 2c 7s]
Seat 2: swag-Morue73 (big blind) won 0.22€


Winamax Poker - HOLD-UP "Colorado" - HandId: #19116069-430417-1701508582 - Holdem no limit (0.01€/0.02€) - 2023/12/02 09:16:22 UTC
Table: 'Colorado' 6-max (real money) Seat #6 is the button
Seat 1: junkokonno (2.24€)
Seat 2: Fried Berg (0.48€)
Seat 3: Brut2pok (2€)
Seat 4: GwenLaGrise (2€)
Seat 5: jdeepenslip (2.47€)
Seat 6: djaymanta (10.07€)
*** ANTE/BLINDS ***
junkokonno posts small blind 0.01€
Fried Berg posts big blind 0.02€
Dealt to Fried Berg [Ts 8c]
*** PRE-FLOP *** 
Brut2pok folds
GwenLaGrise folds
jdeepenslip folds
djaymanta raises 0.03€ to 0.05€
junkokonno raises 0.18€ to 0.23€
Fried Berg folds
djaymanta raises 0.48€ to 0.71€
junkokonno raises 1.53€ to 2.24€ and is all-in
djaymanta calls 1.53€
*** FLOP *** [Ks 3d 4s]
*** TURN *** [Ks 3d 4s][2h]
*** RIVER *** [Ks 3d 4s 2h][2d]
*** SHOW DOWN ***
junkokonno shows [Qs Qd] (Two pairs : Queens and 2)
djaymanta shows [Kd Ad] (Two pairs : Kings and 2)
djaymanta collected 4.05€ from pot
*** SUMMARY ***
Total pot 4.05€ | Rake 0.45€
Board: [Ks 3d 4s 2h 2d]
Seat 1: junkokonno (small blind) showed [Qs Qd] and lost with Two pairs : Queens and 2
Seat 6: djaymanta (button) showed [Kd Ad] and won 4.05€ with Two pairs : Kings and 2


Winamax Poker - HOLD-UP "Colorado" - HandId: #19116069-430455-1701508615 - Holdem no limit (0.01€/0.02€) - 2023/12/02 09:16:55 UTC
Table: 'Colorado' 6-max (real money) Seat #6 is the button
Seat 1: Fried Berg (0.46€)
Seat 2: wmx-b6v02tv (1.54€)
Seat 3: jjakpour (2.11€)
Seat 4: Tom360 (1.81€)
Seat 5: LicenceIV (2.58€)
Seat 6: Alexisdpp (2.97€)
*** ANTE/BLINDS ***
Fried Berg posts small blind 0.01€
wmx-b6v02tv posts big blind 0.02€
Dealt to Fried Berg [9h Ac]
*** PRE-FLOP *** 
jjakpour calls 0.02€
Tom360 folds
LicenceIV calls 0.02€
Alexisdpp calls 0.02€
Fried Berg calls 0.01€
wmx-b6v02tv checks
*** FLOP *** [Td Qs 8h]
Fried Berg checks
wmx-b6v02tv checks
jjakpour checks
LicenceIV checks
Alexisdpp bets 0.03€
Fried Berg calls 0.03€
wmx-b6v02tv calls 0.03€
jjakpour calls 0.03€
LicenceIV folds
*** TURN *** [Td Qs 8h][5d]
Fried Berg checks
wmx-b6v02tv checks
jjakpour checks
Alexisdpp bets 0.14€
Fried Berg folds
wmx-b6v02tv folds
jjakpour calls 0.14€
*** RIVER *** [Td Qs 8h 5d][6d]
jjakpour checks
Alexisdpp checks
*** SHOW DOWN ***
jjakpour shows [Jc As] (High card : Ace)
Alexisdpp shows [Ks 8s] (One pair : 8)
Alexisdpp collected 0.45€ from pot
*** SUMMARY ***
Total pot 0.45€ | Rake 0.05€
Board: [Td Qs 8h 5d 6d]
Seat 3: jjakpour showed [Jc As] and lost with High card : Ace
Seat 6: Alexisdpp (button) showed [Ks 8s] and won 0.45€ with One pair : 8


Winamax Poker - HOLD-UP "Colorado" - HandId: #19116069-430547-1701508725 - Holdem no limit (0.01€/0.02€) - 2023/12/02 09:18:45 UTC
Table: 'Colorado' 6-max (real money) Seat #6 is the button
Seat 1: junkokonno (2.04€)
Seat 2: Alexisdpp (3.23€)
Seat 3: Fried Berg (0.41€)
Seat 4: Rue115 (1.58€)
Seat 5: g8o8k8u (2.11€)
Seat 6: jjakpour (1.92€)
*** ANTE/BLINDS ***
junkokonno posts small blind 0.01€
Alexisdpp posts big blind 0.02€
Dealt to Fried Berg [Kc Ks]
*** PRE-FLOP *** 
Fried Berg raises 0.39€ to 0.41€ and is all-in
Rue115 folds
g8o8k8u folds
jjakpour folds
junkokonno folds
Alexisdpp folds
Fried Berg collected 0.44€ from pot
*** SUMMARY ***
Total pot 0.44€ | No rake
Seat 3: Fried Berg won 0.44€


Winamax Poker - HOLD-UP "Colorado" - HandId: #19116069-430565-1701508740 - Holdem no limit (0.01€/0.02€) - 2023/12/02 09:19:00 UTC
Table: 'Colorado' 6-max (real money) Seat #6 is the button
Seat 1: 2winchester (0.43€)
Seat 2: Cobichou (2€)
Seat 3: edfcain (2.05€)
Seat 4: Fried Berg (0.44€)
Seat 5: Alexisdpp (3.20€)
Seat 6: ._Just_. (3.35€)
*** ANTE/BLINDS ***
2winchester posts small blind 0.01€
Cobichou posts big blind 0.02€
Dealt to Fried Berg [3c 2c]
*** PRE-FLOP *** 
edfcain folds
Fried Berg folds
Alexisdpp folds
._Just_. folds
2winchester calls 0.01€
Cobichou checks
*** FLOP *** [Ts 6h Ad]
2winchester checks
Cobichou checks
*** TURN *** [Ts 6h Ad][Ah]
2winchester checks
Cobichou bets 0.03€
2winchester calls 0.03€
*** RIVER *** [Ts 6h Ad Ah][5s]
2winchester checks
Cobichou checks
*** SHOW DOWN ***
Cobichou shows [9d 7c] (One pair : Aces)
2winchester shows [Jd Qs] (One pair : Aces)
2winchester collected 0.09€ from pot
*** SUMMARY ***
Total pot 0.09€ | Rake 0.01€
Board: [Ts 6h Ad Ah 5s]
Seat 1: 2winchester (small blind) showed [Jd Qs] and won 0.09€ with One pair : Aces
Seat 2: Cobichou (big blind) showed [9d 7c] and lost with One pair : Aces


Winamax Poker - HOLD-UP "Colorado" - HandId: #19116069-430569-1701508744 - Holdem no limit (0.01€/0.02€) - 2023/12/02 09:19:04 UTC
Table: 'Colorado' 6-max (real money) Seat #6 is the button
Seat 1: elsrab (2.33€)
Seat 2: Brut2pok (2€)
Seat 3: GwenLaGrise (2€)
Seat 4: Queen6668 (2.19€)
Seat 5: Fried Berg (0.44€)
Seat 6: Stuntman (2.93€)
*** ANTE/BLINDS ***
elsrab posts small blind 0.01€
Brut2pok posts big blind 0.02€
Dealt to Fried Berg [8d 6s]
*** PRE-FLOP *** 
GwenLaGrise folds
Queen6668 calls 0.02€
Fried Berg folds
Stuntman folds
elsrab folds
Brut2pok checks
*** FLOP *** [Qs 2h 7d]
Brut2pok checks
Queen6668 checks
*** TURN *** [Qs 2h 7d][8h]
Brut2pok checks
Queen6668 checks
*** RIVER *** [Qs 2h 7d 8h][4h]
Brut2pok checks
Queen6668 checks
*** SHOW DOWN ***
Queen6668 shows [Td Js] (High card : Queen)
Brut2pok shows [7c 3s] (One pair : 7)
Brut2pok collected 0.04€ from pot
*** SUMMARY ***
Total pot 0.04€ | Rake 0.01€
Board: [Qs 2h 7d 8h 4h]
Seat 2: Brut2pok (big blind) showed [7c 3s] and won 0.04€ with One pair : 7
Seat 4: Queen6668 showed [Td Js] and lost with High card : Queen


Winamax Poker - HOLD-UP "Colorado" - HandId: #19116069-430570-1701508746 - Holdem no limit (0.01€/0.02€) - 2023/12/02 09:19:06 UTC
Table: 'Colorado' 6-max (real money) Seat #6 is the button
Seat 1: anastasias (1.98€)
Seat 2: H4ma (2.15€)
Seat 3: BADchic (0.98€)
Seat 4: Fried Berg (0.44€)
Seat 5: Nainsoss (4.67€)
Seat 6: Kito31 (6.99€)
*** ANTE/BLINDS ***
anastasias posts small blind 0.01€
H4ma posts big blind 0.02€
Dealt to Fried Berg [Qs 4h]
*** PRE-FLOP *** 
BADchic folds
Fried Berg folds
Nainsoss folds
Kito31 calls 0.02€
anastasias folds
H4ma checks
*** FLOP *** [Kc 8d 4c]
H4ma bets 0.04€
Kito31 calls 0.04€
*** TURN *** [Kc 8d 4c][5h]
H4ma checks
Kito31 checks
*** RIVER *** [Kc 8d 4c 5h][9h]
H4ma checks
Kito31 checks
*** SHOW DOWN ***
H4ma shows [3c 3h] (One pair : 3)
Kito31 shows [4s 7h] (One pair : 4)
Kito31 collected 0.12€ from pot
*** SUMMARY ***
Total pot 0.12€ | Rake 0.01€
Board: [Kc 8d 4c 5h 9h]
Seat 2: H4ma (big blind) showed [3c 3h] and lost with One pair : 3
Seat 6: Kito31 (button) showed [4s 7h] and won 0.12€ with One pair : 4


Winamax Poker - HOLD-UP "Colorado" - HandId: #19116069-430571-1701508747 - Holdem no limit (0.01€/0.02€) - 2023/12/02 09:19:07 UTC
Table: 'Colorado' 6-max (real money) Seat #6 is the button
Seat 1: RaGnaR00k (1.85€)
Seat 2: Fried Berg (0.44€)
Seat 3: TaBrEaMoI (2.46€)
Seat 4: jdeepenslip (3.34€)
Seat 5: Phinsh43 (3.33€)
Seat 6: Chacal-Punk (1.85€)
*** ANTE/BLINDS ***
RaGnaR00k posts small blind 0.01€
Fried Berg posts big blind 0.02€
Dealt to Fried Berg [Qh Ad]
*** PRE-FLOP *** 
TaBrEaMoI folds
jdeepenslip folds
Phinsh43 calls 0.02€
Chacal-Punk folds
RaGnaR00k folds
Fried Berg raises 0.04€ to 0.06€
Phinsh43 calls 0.04€
*** FLOP *** [5d 6d Ah]
Fried Berg bets 0.08€
Phinsh43 folds
Fried Berg collected 0.20€ from pot
*** SUMMARY ***
Total pot 0.20€ | Rake 0.01€
Board: [5d 6d Ah]
Seat 2: Fried Berg (big blind) won 0.20€


Winamax Poker - HOLD-UP "Colorado" - HandId: #19116069-430610-1701508784 - Holdem no limit (0.01€/0.02€) - 2023/12/02 09:19:44 UTC
Table: 'Colorado' 6-max (real money) Seat #6 is the button
Seat 1: Fried Berg (0.50€)
Seat 2: cecilon (0.53€)
Seat 3: LicenceIV (2.47€)
Seat 4: Brictos (2.36€)
Seat 5: Kick-Ace-751 (1€)
Seat 6: DeX70 (1.88€)
*** ANTE/BLINDS ***
Fried Berg posts small blind 0.01€
cecilon posts big blind 0.02€
Dealt to Fried Berg [5s Td]
*** PRE-FLOP *** 
LicenceIV folds
Brictos folds
Kick-Ace-751 raises 0.05€ to 0.07€
DeX70 folds
Fried Berg folds
cecilon folds
Kick-Ace-751 collected 0.10€ from pot
*** SUMMARY ***
Total pot 0.10€ | No rake
Seat 5: Kick-Ace-751 won 0.10€


Winamax Poker - HOLD-UP "Colorado" - HandId: #19116069-430616-1701508790 - Holdem no limit (0.01€/0.02€) - 2023/12/02 09:19:50 UTC
Table: 'Colorado' 6-max (real money) Seat #6 is the button
Seat 1: Nainsoss (4.65€)
Seat 2: junkokonno (2€)
Seat 3: Fried Berg (0.49€)
Seat 4: Halmosthard (2.46€)
Seat 5: Tom360 (1.72€)
Seat 6: Betiegarri (6.71€)
*** ANTE/BLINDS ***
Nainsoss posts small blind 0.01€
junkokonno posts big blind 0.02€
Dealt to Fried Berg [9h Tc]
*** PRE-FLOP *** 
Fried Berg folds
Halmosthard folds
Tom360 folds
Betiegarri folds
Nainsoss folds
junkokonno collected 0.03€ from pot
*** SUMMARY ***
Total pot 0.03€ | No rake
Seat 2: junkokonno (big blind) won 0.03€


Winamax Poker - HOLD-UP "Colorado" - HandId: #19116069-430620-1701508793 - Holdem no limit (0.01€/0.02€) - 2023/12/02 09:19:53 UTC
Table: 'Colorado' 6-max (real money) Seat #6 is the button
Seat 1: GwenLaGrise (3.04€)
Seat 2: edfcain (2€)
Seat 3: Betiegarri (6.71€)
Seat 4: TaBrEaMoI (2€)
Seat 5: Amazigh 78 (2.11€)
Seat 6: Fried Berg (0.49€)
*** ANTE/BLINDS ***
GwenLaGrise posts small blind 0.01€
edfcain posts big blind 0.02€
Dealt to Fried Berg [5c As]
*** PRE-FLOP *** 
Betiegarri folds
TaBrEaMoI folds
Amazigh 78 folds
Fried Berg raises 0.02€ to 0.04€
GwenLaGrise folds
edfcain folds
Fried Berg collected 0.07€ from pot
*** SUMMARY ***
Total pot 0.07€ | No rake
Seat 6: Fried Berg (button) won 0.07€


Winamax Poker - HOLD-UP "Colorado" - HandId: #19116069-430640-1701508810 - Holdem no limit (0.01€/0.02€) - 2023/12/02 09:20:10 UTC
Table: 'Colorado' 6-max (real money) Seat #6 is the button
Seat 1: H4ma (2.07€)
Seat 2: Brut2pok (3.27€)
Seat 3: Nainsoss (4.64€)
Seat 4: scach-111 (2.04€)
Seat 5: Fried Berg (0.52€)
Seat 6: GwenLaGrise (2€)
*** ANTE/BLINDS ***
H4ma posts small blind 0.01€
Brut2pok posts big blind 0.02€
Dealt to Fried Berg [8c 8d]
*** PRE-FLOP *** 
Nainsoss folds
scach-111 folds
Fried Berg raises 0.08€ to 0.10€
GwenLaGrise calls 0.10€
H4ma folds
Brut2pok folds
*** FLOP *** [7d Qd Jd]
Fried Berg checks
GwenLaGrise bets 0.06€
Fried Berg calls 0.06€
*** TURN *** [7d Qd Jd][7s]
Fried Berg checks
GwenLaGrise checks
*** RIVER *** [7d Qd Jd 7s][Ac]
Fried Berg checks
GwenLaGrise bets 0.18€
Fried Berg folds
GwenLaGrise collected 0.49€ from pot
*** SUMMARY ***
Total pot 0.49€ | Rake 0.04€
Board: [7d Qd Jd 7s Ac]
Seat 6: GwenLaGrise (button) won 0.49€


Winamax Poker - HOLD-UP "Colorado" - HandId: #19116069-430710-1701508884 - Holdem no limit (0.01€/0.02€) - 2023/12/02 09:21:24 UTC
Table: 'Colorado' 6-max (real money) Seat #6 is the button
Seat 1: Brut2pok (3.26€)
Seat 2: TaBrEaMoI (2€)
Seat 3: scach-111 (2€)
Seat 4: junkokonno (2€)
Seat 5: Stuntman (3.21€)
Seat 6: Fried Berg (0.36€)
*** ANTE/BLINDS ***
Brut2pok posts small blind 0.01€
TaBrEaMoI posts big blind 0.02€
Dealt to Fried Berg [6s As]
*** PRE-FLOP *** 
scach-111 folds
junkokonno raises 0.03€ to 0.05€
Stuntman folds
Fried Berg raises 0.10€ to 0.15€
Brut2pok folds
TaBrEaMoI folds
junkokonno raises 0.26€ to 0.41€
Fried Berg calls 0.21€ and is all-in
*** FLOP *** [4h 2d 8h]
*** TURN *** [4h 2d 8h][9s]
*** RIVER *** [4h 2d 8h 9s][4s]
*** SHOW DOWN ***
Fried Berg shows [6s As] (One pair : 4)
junkokonno shows [Ah Ks] (One pair : 4)
junkokonno collected 0.72€ from pot
*** SUMMARY ***
Total pot 0.72€ | Rake 0.08€
Board: [4h 2d 8h 9s 4s]
Seat 4: junkokonno showed [Ah Ks] and won 0.72€ with One pair : 4
Seat 6: Fried Berg (button) showed [6s As] and lost with One pair : 4


Winamax Poker - HOLD-UP "Colorado" - HandId: #19116069-430743-1701508916 - Holdem no limit (0.01€/0.02€) - 2023/12/02 09:21:56 UTC
Table: 'Colorado' 6-max (real money) Seat #6 is the button
Seat 1: Fried Berg (0.50€)
Seat 2: TaBrEaMoI (2€)
Seat 3: jdeepenslip (3.26€)
Seat 4: mixtep (2.43€)
Seat 5: ._Just_. (3.29€)
Seat 6: Brictos (2.46€)
*** ANTE/BLINDS ***
Fried Berg posts small blind 0.01€
TaBrEaMoI posts big blind 0.02€
Dealt to Fried Berg [6s 6c]
*** PRE-FLOP *** 
jdeepenslip folds
mixtep folds
._Just_. calls 0.02€
Brictos folds
Fried Berg raises 0.06€ to 0.08€
TaBrEaMoI folds
._Just_. calls 0.06€
*** FLOP *** [8c As 4h]
Fried Berg checks
._Just_. checks
*** TURN *** [8c As 4h][Ac]
Fried Berg bets 0.06€
._Just_. raises 0.06€ to 0.12€
Fried Berg calls 0.06€
*** RIVER *** [8c As 4h Ac][Jd]
Fried Berg checks
._Just_. bets 0.15€
Fried Berg calls 0.15€
*** SHOW DOWN ***
._Just_. shows [Kd Ts] (One pair : Aces)
Fried Berg shows [6s 6c] (Two pairs : Aces and 6)
Fried Berg collected 0.65€ from pot
*** SUMMARY ***
Total pot 0.65€ | Rake 0.07€
Board: [8c As 4h Ac Jd]
Seat 1: Fried Berg (small blind) showed [6s 6c] and won 0.65€ with Two pairs : Aces and 6
Seat 5: ._Just_. showed [Kd Ts] and lost with One pair : Aces


Winamax Poker - HOLD-UP "Colorado" - HandId: #19116069-430802-1701508980 - Holdem no limit (0.01€/0.02€) - 2023/12/02 09:23:00 UTC
Table: 'Colorado' 6-max (real money) Seat #6 is the button
Seat 1: Cobichou (2.23€)
Seat 2: Fried Berg (0.80€)
Seat 3: TaBrEaMoI (2.10€)
Seat 4: jdeepenslip (2.46€)
Seat 5: yam69 (5.39€)
Seat 6: ._Just_. (2.94€)
*** ANTE/BLINDS ***
Cobichou posts small blind 0.01€
Fried Berg posts big blind 0.02€
Dealt to Fried Berg [7h Th]
*** PRE-FLOP *** 
TaBrEaMoI folds
jdeepenslip folds
yam69 folds
._Just_. folds
Cobichou calls 0.01€
Fried Berg checks
*** FLOP *** [8c 2s Jh]
Cobichou checks
Fried Berg checks
*** TURN *** [8c 2s Jh][Kc]
Cobichou bets 0.02€
Fried Berg folds
Cobichou collected 0.06€ from pot
*** SUMMARY ***
Total pot 0.06€ | No rake
Board: [8c 2s Jh Kc]
Seat 1: Cobichou (small blind) won 0.06€


Winamax Poker - HOLD-UP "Colorado" - HandId: #19116069-430815-1701508995 - Holdem no limit (0.01€/0.02€) - 2023/12/02 09:23:15 UTC
Table: 'Colorado' 6-max (real money) Seat #6 is the button
Seat 1: D13C (2€)
Seat 2: muespachois1 (1.97€)
Seat 3: Fried Berg (0.78€)
Seat 4: iron-dada (2.26€)
Seat 5: Halmosthard (4.34€)
Seat 6: GwenLaGrise (3.48€)
*** ANTE/BLINDS ***
D13C posts small blind 0.01€
muespachois1 posts big blind 0.02€
Dealt to Fried Berg [5h 5c]
*** PRE-FLOP *** 
Fried Berg folds
iron-dada folds
Halmosthard folds
GwenLaGrise folds
D13C folds
muespachois1 collected 0.03€ from pot
*** SUMMARY ***
Total pot 0.03€ | No rake
Seat 2: muespachois1 (big blind) won 0.03€


Winamax Poker - HOLD-UP "Colorado" - HandId: #19116069-430823-1701509003 - Holdem no limit (0.01€/0.02€) - 2023/12/02 09:23:23 UTC
Table: 'Colorado' 6-max (real money) Seat #6 is the button
Seat 1: ._Just_. (2.95€)
Seat 2: junkokonno (2€)
Seat 3: Itashi.95 (0.59€)
Seat 4: Fried Berg (0.78€)
Seat 5: antodu62psr (8.14€)
Seat 6: TaBrEaMoI (2€)
*** ANTE/BLINDS ***
._Just_. posts small blind 0.01€
junkokonno posts big blind 0.02€
Dealt to Fried Berg [Ac 2h]
*** PRE-FLOP *** 
Itashi.95 folds
Fried Berg folds
antodu62psr folds
TaBrEaMoI folds
._Just_. folds
junkokonno collected 0.03€ from pot
*** SUMMARY ***
Total pot 0.03€ | No rake
Seat 2: junkokonno (big blind) won 0.03€


Winamax Poker - HOLD-UP "Colorado" - HandId: #19116069-430825-1701509006 - Holdem no limit (0.01€/0.02€) - 2023/12/02 09:23:26 UTC
Table: 'Colorado' 6-max (real money) Seat #6 is the button
Seat 1: g8o8k8u (2€)
Seat 2: antodu62psr (8.14€)
Seat 3: rick26 (1.89€)
Seat 4: Itashi.95 (0.59€)
Seat 5: Fried Berg (0.78€)
Seat 6: TaBrEaMoI (2€)
*** ANTE/BLINDS ***
g8o8k8u posts small blind 0.01€
antodu62psr posts big blind 0.02€
Dealt to Fried Berg [6c 8d]
*** PRE-FLOP *** 
rick26 folds
Itashi.95 folds
Fried Berg folds
TaBrEaMoI raises 0.04€ to 0.06€
g8o8k8u folds
antodu62psr folds
TaBrEaMoI collected 0.09€ from pot
*** SUMMARY ***
Total pot 0.09€ | No rake
Seat 6: TaBrEaMoI (button) won 0.09€


Winamax Poker - HOLD-UP "Colorado" - HandId: #19116069-430827-1701509007 - Holdem no limit (0.01€/0.02€) - 2023/12/02 09:23:27 UTC
Table: 'Colorado' 6-max (real money) Seat #6 is the button
Seat 1: lsiIdur1 (2€)
Seat 2: GwenLaGrise (3.48€)
Seat 3: Fried Berg (0.78€)
Seat 4: MENDOSA-31 (0.50€)
Seat 5: g8o8k8u (2€)
Seat 6: Samostheouf (1€)
*** ANTE/BLINDS ***
lsiIdur1 posts small blind 0.01€
GwenLaGrise posts big blind 0.02€
Dealt to Fried Berg [Qh 7d]
*** PRE-FLOP *** 
Fried Berg folds
MENDOSA-31 raises 0.02€ to 0.04€
g8o8k8u raises 0.08€ to 0.12€
Samostheouf folds
lsiIdur1 calls 0.11€
GwenLaGrise folds
MENDOSA-31 calls 0.08€
*** FLOP *** [Jd 6s Ah]
lsiIdur1 checks
MENDOSA-31 checks
g8o8k8u bets 0.13€
lsiIdur1 folds
MENDOSA-31 folds
g8o8k8u collected 0.47€ from pot
*** SUMMARY ***
Total pot 0.47€ | Rake 0.04€
Board: [Jd 6s Ah]
Seat 5: g8o8k8u won 0.47€


Winamax Poker - HOLD-UP "Colorado" - HandId: #19116069-430828-1701509009 - Holdem no limit (0.01€/0.02€) - 2023/12/02 09:23:29 UTC
Table: 'Colorado' 6-max (real money) Seat #6 is the button
Seat 1: Fried Berg (0.78€)
Seat 2: GreenCard225 (2.88€)
Seat 3: Adame199623 (2€)
Seat 4: Halmosthard (4.34€)
Seat 5: Itashi.95 (0.59€)
Seat 6: H4ma (3.90€)
*** ANTE/BLINDS ***
Fried Berg posts small blind 0.01€
GreenCard225 posts big blind 0.02€
Dealt to Fried Berg [9h 9d]
*** PRE-FLOP *** 
Adame199623 raises 0.06€ to 0.08€
Halmosthard folds
Itashi.95 folds
H4ma folds
Fried Berg calls 0.07€
GreenCard225 folds
*** FLOP *** [8h 3d Jc]
Fried Berg bets 0.04€
Adame199623 raises 0.19€ to 0.23€
Fried Berg calls 0.19€
*** TURN *** [8h 3d Jc][Kc]
Fried Berg checks
Adame199623 bets 0.77€
Fried Berg calls 0.47€ and is all-in
*** RIVER *** [8h 3d Jc Kc][Qd]
*** SHOW DOWN ***
Fried Berg shows [9h 9d] (One pair : 9)
Adame199623 shows [Qh Qs] (Trips of Queens)
Adame199623 collected 1.72€ from pot
*** SUMMARY ***
Total pot 1.72€ | Rake 0.16€
Board: [8h 3d Jc Kc Qd]
Seat 1: Fried Berg (small blind) showed [9h 9d] and lost with One pair : 9
Seat 3: Adame199623 showed [Qh Qs] and won 1.72€ with Trips of Queens


Winamax Poker - HOLD-UP "Colorado" - HandId: #19116069-430887-1701509083 - Holdem no limit (0.01€/0.02€) - 2023/12/02 09:24:43 UTC
Table: 'Colorado' 6-max (real money) Seat #6 is the button
Seat 1: TaBrEaMoI (2.05€)
Seat 2: Fried Berg (0.50€)
Seat 3: swag-Morue73 (1.96€)
Seat 4: muespachois1 (1.84€)
Seat 5: GreenCard225 (3.06€)
Seat 6: GwenLaGrise (3.41€)
*** ANTE/BLINDS ***
TaBrEaMoI posts small blind 0.01€
Fried Berg posts big blind 0.02€
Dealt to Fried Berg [4s 5d]
*** PRE-FLOP *** 
swag-Morue73 folds
muespachois1 folds
GreenCard225 folds
GwenLaGrise folds
TaBrEaMoI folds
Fried Berg collected 0.03€ from pot
*** SUMMARY ***
Total pot 0.03€ | No rake
Seat 2: Fried Berg (big blind) won 0.03€


Winamax Poker - HOLD-UP "Colorado" - HandId: #19116069-430915-1701509109 - Holdem no limit (0.01€/0.02€) - 2023/12/02 09:25:09 UTC
Table: 'Colorado' 6-max (real money) Seat #6 is the button
Seat 1: Marcelo2424 (2.10€)
Seat 2: lestat6993 (2€)
Seat 3: muespachois1 (1.76€)
Seat 4: Fried Berg (0.51€)
Seat 5: junkokonno (2.05€)
Seat 6: rick26 (1.97€)
*** ANTE/BLINDS ***
Marcelo2424 posts small blind 0.01€
lestat6993 posts big blind 0.02€
Dealt to Fried Berg [6h 9s]
*** PRE-FLOP *** 
muespachois1 folds
Fried Berg folds
junkokonno folds
rick26 calls 0.02€
Marcelo2424 raises 0.06€ to 0.08€
lestat6993 calls 0.06€
rick26 calls 0.06€
*** FLOP *** [Qh Kd 6d]
Marcelo2424 bets 0.24€
lestat6993 calls 0.24€
rick26 calls 0.24€
*** TURN *** [Qh Kd 6d][5s]
Marcelo2424 bets 0.34€
lestat6993 calls 0.34€
rick26 folds
*** RIVER *** [Qh Kd 6d 5s][7d]
Marcelo2424 bets 0.02€
lestat6993 calls 0.02€
*** SHOW DOWN ***
Marcelo2424 shows [4d Kh] (One pair : Kings)
lestat6993 shows [Ks Js] (One pair : Kings)
lestat6993 collected 1.51€ from pot
*** SUMMARY ***
Total pot 1.51€ | Rake 0.17€
Board: [Qh Kd 6d 5s 7d]
Seat 1: Marcelo2424 (small blind) showed [4d Kh] and lost with One pair : Kings
Seat 2: lestat6993 (big blind) showed [Ks Js] and won 1.51€ with One pair : Kings


Winamax Poker - HOLD-UP "Colorado" - HandId: #19116069-430918-1701509112 - Holdem no limit (0.01€/0.02€) - 2023/12/02 09:25:12 UTC
Table: 'Colorado' 6-max (real money) Seat #6 is the button
Seat 1: Queen6668 (2.36€)
Seat 2: Tom360 (3.17€)
Seat 3: jdeepenslip (3.60€)
Seat 4: muespachois1 (1.76€)
Seat 5: Fried Berg (0.51€)
Seat 6: Tuto_A_Posto (2€)
*** ANTE/BLINDS ***
Queen6668 posts small blind 0.01€
Tom360 posts big blind 0.02€
Dealt to Fried Berg [Jc Tc]
*** PRE-FLOP *** 
jdeepenslip folds
muespachois1 raises 0.04€ to 0.06€
Fried Berg calls 0.06€
Tuto_A_Posto folds
Queen6668 calls 0.05€
Tom360 folds
*** FLOP *** [Qh 7h Kh]
Queen6668 bets 0.13€
muespachois1 folds
Fried Berg folds
Queen6668 collected 0.31€ from pot
*** SUMMARY ***
Total pot 0.31€ | Rake 0.02€
Board: [Qh 7h Kh]
Seat 1: Queen6668 (small blind) won 0.31€


Winamax Poker - HOLD-UP "Colorado" - HandId: #19116069-430957-1701509149 - Holdem no limit (0.01€/0.02€) - 2023/12/02 09:25:49 UTC
Table: 'Colorado' 6-max (real money) Seat #6 is the button
Seat 1: junkokonno (2€)
Seat 2: Kallonys (2€)
Seat 3: Adame199623 (2€)
Seat 4: RaGnaR00k (2.01€)
Seat 5: Samostheouf (0.78€)
Seat 6: Fried Berg (0.45€)
*** ANTE/BLINDS ***
junkokonno posts small blind 0.01€
Kallonys posts big blind 0.02€
Dealt to Fried Berg [8h 4h]
*** PRE-FLOP *** 
Adame199623 folds
RaGnaR00k folds
Samostheouf folds
Fried Berg folds
junkokonno raises 0.04€ to 0.06€
Kallonys folds
junkokonno collected 0.08€ from pot
*** SUMMARY ***
Total pot 0.08€ | No rake
Seat 1: junkokonno (small blind) won 0.08€


Winamax Poker - HOLD-UP "Colorado" - HandId: #19116069-430975-1701509167 - Holdem no limit (0.01€/0.02€) - 2023/12/02 09:26:07 UTC
Table: 'Colorado' 6-max (real money) Seat #6 is the button
Seat 1: GwenLaGrise (3.39€)
Seat 2: GreenCard225 (3.19€)
Seat 3: TaBrEaMoI (2€)
Seat 4: EYN PicPic (2€)
Seat 5: scach-111 (3.74€)
Seat 6: Fried Berg (0.45€)
*** ANTE/BLINDS ***
GwenLaGrise posts small blind 0.01€
GreenCard225 posts big blind 0.02€
Dealt to Fried Berg [Ts Qs]
*** PRE-FLOP *** 
TaBrEaMoI raises 0.04€ to 0.06€
EYN PicPic folds
scach-111 folds
Fried Berg calls 0.06€
GwenLaGrise calls 0.05€
GreenCard225 folds
*** FLOP *** [Jh Td Ac]
GwenLaGrise checks
TaBrEaMoI bets 0.13€
Fried Berg folds
GwenLaGrise calls 0.13€
*** TURN *** [Jh Td Ac][4h]
GwenLaGrise checks
TaBrEaMoI bets 0.37€
GwenLaGrise folds
TaBrEaMoI collected 0.78€ from pot
*** SUMMARY ***
Total pot 0.78€ | Rake 0.05€
Board: [Jh Td Ac 4h]
Seat 3: TaBrEaMoI won 0.78€


Winamax Poker - HOLD-UP "Colorado" - HandId: #19116069-431023-1701509212 - Holdem no limit (0.01€/0.02€) - 2023/12/02 09:26:52 UTC
Table: 'Colorado' 6-max (real money) Seat #6 is the button
Seat 1: cecilon (0.56€)
Seat 2: Kallonys (1.97€)
Seat 3: Fried Berg (0.39€)
Seat 4: yam69 (5.51€)
Seat 5: RaGnaR00k (1.90€)
Seat 6: Kito31 (6.67€)
*** ANTE/BLINDS ***
cecilon posts small blind 0.01€
Kallonys posts big blind 0.02€
Dealt to Fried Berg [7c Qd]
*** PRE-FLOP *** 
Fried Berg folds
yam69 folds
RaGnaR00k folds
Kito31 folds
cecilon folds
Kallonys collected 0.03€ from pot
*** SUMMARY ***
Total pot 0.03€ | No rake
Seat 2: Kallonys (big blind) won 0.03€


Winamax Poker - HOLD-UP "Colorado" - HandId: #19116069-431025-1701509214 - Holdem no limit (0.01€/0.02€) - 2023/12/02 09:26:54 UTC
Table: 'Colorado' 6-max (real money) Seat #6 is the button
Seat 1: leloupdu66. (1.99€)
Seat 2: cecilon (0.55€)
Seat 3: swag-Morue73 (2.07€)
Seat 4: Fried Berg (0.39€)
Seat 5: Samostheouf (0.87€)
Seat 6: scach-111 (3.72€)
*** ANTE/BLINDS ***
leloupdu66. posts small blind 0.01€
cecilon posts big blind 0.02€
Dealt to Fried Berg [Js 4s]
*** PRE-FLOP *** 
swag-Morue73 folds
Fried Berg folds
Samostheouf folds
scach-111 folds
leloupdu66. calls 0.01€
cecilon checks
*** FLOP *** [5d Jc 4d]
leloupdu66. bets 0.03€
cecilon folds
leloupdu66. collected 0.07€ from pot
*** SUMMARY ***
Total pot 0.07€ | No rake
Board: [5d Jc 4d]
Seat 1: leloupdu66. (small blind) won 0.07€


Winamax Poker - HOLD-UP "Colorado" - HandId: #19116069-431035-1701509223 - Holdem no limit (0.01€/0.02€) - 2023/12/02 09:27:03 UTC
Table: 'Colorado' 6-max (real money) Seat #6 is the button
Seat 1: Johnytop (2.05€)
Seat 2: Full-AJA-89 (1.82€)
Seat 3: jdeepenslip (2.26€)
Seat 4: durba (0.93€)
Seat 5: ckok (0.75€)
Seat 6: Fried Berg (0.39€)
*** ANTE/BLINDS ***
Johnytop posts small blind 0.01€
Full-AJA-89 posts big blind 0.02€
Dealt to Fried Berg [2c 2d]
*** PRE-FLOP *** 
jdeepenslip folds
durba folds
ckok raises 0.73€ to 0.75€ and is all-in
Fried Berg folds
Johnytop folds
Full-AJA-89 calls 0.73€
*** FLOP *** [4d 6s Kh]
*** TURN *** [4d 6s Kh][5d]
*** RIVER *** [4d 6s Kh 5d][3c]
*** SHOW DOWN ***
ckok shows [Js Ac] (High card : Ace)
Full-AJA-89 shows [5h 5c] (Trips of 5)
Full-AJA-89 collected 1.36€ from pot
*** SUMMARY ***
Total pot 1.36€ | Rake 0.15€
Board: [4d 6s Kh 5d 3c]
Seat 2: Full-AJA-89 (big blind) showed [5h 5c] and won 1.36€ with Trips of 5
Seat 5: ckok showed [Js Ac] and lost with High card : Ace


Winamax Poker - HOLD-UP "Colorado" - HandId: #19116069-431040-1701509228 - Holdem no limit (0.01€/0.02€) - 2023/12/02 09:27:08 UTC
Table: 'Colorado' 6-max (real money) Seat #6 is the button
Seat 1: lamuerta8300 (2.01€)
Seat 2: Fried Berg (0.39€)
Seat 3: CTMieuxAvant (2€)
Seat 4: Kallonys (1.98€)
Seat 5: J.C Deuces.0 (2€)
Seat 6: Tom360 (2.33€)
*** ANTE/BLINDS ***
lamuerta8300 posts small blind 0.01€
Fried Berg posts big blind 0.02€
Dealt to Fried Berg [5h 6s]
*** PRE-FLOP *** 
CTMieuxAvant folds
Kallonys folds
J.C Deuces.0 folds
Tom360 folds
lamuerta8300 raises 0.04€ to 0.06€
Fried Berg folds
lamuerta8300 collected 0.08€ from pot
*** SUMMARY ***
Total pot 0.08€ | No rake
Seat 1: lamuerta8300 (small blind) won 0.08€


Winamax Poker - HOLD-UP "Colorado" - HandId: #19116069-431060-1701509243 - Holdem no limit (0.01€/0.02€) - 2023/12/02 09:27:23 UTC
Table: 'Colorado' 6-max (real money) Seat #6 is the button
Seat 1: Fried Berg (0.37€)
Seat 2: scach-111 (2€)
Seat 3: R2Dread2 (2.54€)
Seat 4: J.C Deuces.0 (1.94€)
Seat 5: lestat6993 (2.85€)
Seat 6: TaBrEaMoI (2.22€)
*** ANTE/BLINDS ***
Fried Berg posts small blind 0.01€
scach-111 posts big blind 0.02€
Dealt to Fried Berg [2h 9c]
*** PRE-FLOP *** 
R2Dread2 folds
J.C Deuces.0 folds
lestat6993 folds
TaBrEaMoI folds
Fried Berg folds
scach-111 collected 0.03€ from pot
*** SUMMARY ***
Total pot 0.03€ | No rake
Seat 2: scach-111 (big blind) won 0.03€


Winamax Poker - HOLD-UP "Colorado" - HandId: #19116069-431065-1701509247 - Holdem no limit (0.01€/0.02€) - 2023/12/02 09:27:27 UTC
Table: 'Colorado' 6-max (real money) Seat #6 is the button
Seat 1: Furka08 (0.38€)
Seat 2: crossRiver (2€)
Seat 3: Fried Berg (0.36€)
Seat 4: cecilon (0.53€)
Seat 5: DeX70 (2.33€)
Seat 6: rick26 (1.94€)
*** ANTE/BLINDS ***
Furka08 posts small blind 0.01€
crossRiver posts big blind 0.02€
Dealt to Fried Berg [Qc Tc]
*** PRE-FLOP *** 
Fried Berg folds
cecilon folds
DeX70 folds
rick26 folds
Furka08 folds
crossRiver collected 0.03€ from pot
*** SUMMARY ***
Total pot 0.03€ | No rake
Seat 2: crossRiver (big blind) won 0.03€


Winamax Poker - HOLD-UP "Colorado" - HandId: #19116069-431073-1701509256 - Holdem no limit (0.01€/0.02€) - 2023/12/02 09:27:36 UTC
Table: 'Colorado' 6-max (real money) Seat #6 is the button
Seat 1: GwenLaGrise (2.95€)
Seat 2: Fried Berg (0.36€)
Seat 3: Chacal-Punk (2.61€)
Seat 4: lamuerta8300 (2.03€)
Seat 5: CTMieuxAvant (2€)
Seat 6: Johnytop (2.02€)
*** ANTE/BLINDS ***
GwenLaGrise posts small blind 0.01€
Fried Berg posts big blind 0.02€
Dealt to Fried Berg [8s 8d]
*** PRE-FLOP *** 
Chacal-Punk folds
lamuerta8300 raises 0.04€ to 0.06€
CTMieuxAvant folds
Johnytop folds
GwenLaGrise folds
Fried Berg raises 0.12€ to 0.18€
lamuerta8300 calls 0.12€
*** FLOP *** [Ad 2s 5h]
Fried Berg checks
lamuerta8300 checks
*** TURN *** [Ad 2s 5h][9d]
Fried Berg checks
lamuerta8300 checks
*** RIVER *** [Ad 2s 5h 9d][Kd]
Fried Berg checks
lamuerta8300 checks
*** SHOW DOWN ***
Fried Berg shows [8s 8d] (One pair : 8)
lamuerta8300 shows [Qc Kc] (One pair : Kings)
lamuerta8300 collected 0.33€ from pot
*** SUMMARY ***
Total pot 0.33€ | Rake 0.04€
Board: [Ad 2s 5h 9d Kd]
Seat 2: Fried Berg (big blind) showed [8s 8d] and lost with One pair : 8
Seat 4: lamuerta8300 showed [Qc Kc] and won 0.33€ with One pair : Kings


Winamax Poker - HOLD-UP "Colorado" - HandId: #19116069-431151-1701509325 - Holdem no limit (0.01€/0.02€) - 2023/12/02 09:28:45 UTC
Table: 'Colorado' 6-max (real money) Seat #6 is the button
Seat 1: durba (0.55€)
Seat 2: CTMieuxAvant (1.97€)
Seat 3: GwenLaGrise (2.95€)
Seat 4: Fried Berg (0.18€)
Seat 5: lamuerta8300 (2.18€)
Seat 6: Blackmamba06 (2.14€)
*** ANTE/BLINDS ***
durba posts small blind 0.01€
CTMieuxAvant posts big blind 0.02€
Dealt to Fried Berg [Qh 6h]
*** PRE-FLOP *** 
GwenLaGrise folds
Fried Berg folds
lamuerta8300 raises 0.04€ to 0.06€
Blackmamba06 folds
durba folds
CTMieuxAvant folds
lamuerta8300 collected 0.09€ from pot
*** SUMMARY ***
Total pot 0.09€ | No rake
Seat 5: lamuerta8300 won 0.09€


Winamax Poker - HOLD-UP "Colorado" - HandId: #19116069-431177-1701509349 - Holdem no limit (0.01€/0.02€) - 2023/12/02 09:29:09 UTC
Table: 'Colorado' 6-max (real money) Seat #6 is the button
Seat 1: Kallonys (2.17€)
Seat 2: ITALIA291 (2€)
Seat 3: TaBrEaMoI (2.22€)
Seat 4: scach-111 (2€)
Seat 5: Fried Berg (0.18€)
Seat 6: GwenLaGrise (3.32€)
*** ANTE/BLINDS ***
Kallonys posts small blind 0.01€
ITALIA291 posts big blind 0.02€
Dealt to Fried Berg [Js 4h]
*** PRE-FLOP *** 
TaBrEaMoI folds
scach-111 folds
Fried Berg folds
GwenLaGrise folds
Kallonys folds
ITALIA291 collected 0.03€ from pot
*** SUMMARY ***
Total pot 0.03€ | No rake
Seat 2: ITALIA291 (big blind) won 0.03€


Winamax Poker - HOLD-UP "Colorado" - HandId: #19116069-431179-1701509352 - Holdem no limit (0.01€/0.02€) - 2023/12/02 09:29:12 UTC
Table: 'Colorado' 6-max (real money) Seat #6 is the button
Seat 1: Toulon best (0.48€)
Seat 2: popoche29 (8.14€)
Seat 3: tichettede3 (2.11€)
Seat 4: g8o8k8u (3€)
Seat 5: Fried Berg (0.18€)
Seat 6: Betiegarri (5.88€)
Hold-up to Pot: total 0.50€
*** ANTE/BLINDS ***
Toulon best posts small blind 0.01€
popoche29 posts big blind 0.02€
Dealt to Fried Berg [Js 7s]
*** PRE-FLOP *** 
tichettede3 folds
g8o8k8u calls 0.02€
Fried Berg raises 0.16€ to 0.18€ and is all-in
Betiegarri folds
Toulon best folds
popoche29 calls 0.16€
g8o8k8u calls 0.16€
*** FLOP *** [2d Jd Qh]
popoche29 checks
g8o8k8u checks
*** TURN *** [2d Jd Qh][Tc]
popoche29 bets 0.68€
g8o8k8u folds
*** RIVER *** [2d Jd Qh Tc][8h]
*** SHOW DOWN ***
Fried Berg shows [Js 7s] (One pair : Jacks)
popoche29 shows [9d Kd] (Straight King high)
popoche29 collected 1.67€ from pot
*** SUMMARY ***
Total pot 1.67€ | Rake 0.06€
Board: [2d Jd Qh Tc 8h]
Seat 2: popoche29 (big blind) showed [9d Kd] and won 1.67€ with Straight King high
Seat 5: Fried Berg showed [Js 7s] and lost with One pair : Jacks


Winamax Poker - HOLD-UP "Colorado" - HandId: #19116069-431258-1701509425 - Holdem no limit (0.01€/0.02€) - 2023/12/02 09:30:25 UTC
Table: 'Colorado' 6-max (real money) Seat #6 is the button
Seat 1: Fried Berg (0.50€)
Seat 2: TaBrEaMoI (2.01€)
Seat 3: berlinouest (1.06€)
Seat 4: Kallonys (2.13€)
Seat 5: crossRiver (2.03€)
Seat 6: Blackmamba06 (2.14€)
*** ANTE/BLINDS ***
Fried Berg posts small blind 0.01€
TaBrEaMoI posts big blind 0.02€
Dealt to Fried Berg [5d 4c]
*** PRE-FLOP *** 
berlinouest folds
Kallonys folds
crossRiver folds
Blackmamba06 raises 0.03€ to 0.05€
Fried Berg folds
TaBrEaMoI folds
Blackmamba06 collected 0.08€ from pot
*** SUMMARY ***
Total pot 0.08€ | No rake
Seat 6: Blackmamba06 (button) won 0.08€


Winamax Poker - HOLD-UP "Colorado" - HandId: #19116069-431266-1701509433 - Holdem no limit (0.01€/0.02€) - 2023/12/02 09:30:33 UTC
Table: 'Colorado' 6-max (real money) Seat #6 is the button
Seat 1: leloupdu66. (1.55€)
Seat 2: GwenLaGrise (2.69€)
Seat 3: Chacal-Punk (3.40€)
Seat 4: Merlus83 (2€)
Seat 5: Fried Berg (0.49€)
Seat 6: yam69 (5.84€)
*** ANTE/BLINDS ***
leloupdu66. posts small blind 0.01€
GwenLaGrise posts big blind 0.02€
Dealt to Fried Berg [5c 3h]
*** PRE-FLOP *** 
Chacal-Punk folds
Merlus83 folds
Fried Berg folds
yam69 folds
leloupdu66. calls 0.01€
GwenLaGrise checks
*** FLOP *** [Kd Jc Kc]
leloupdu66. checks
GwenLaGrise bets 0.02€
leloupdu66. calls 0.02€
*** TURN *** [Kd Jc Kc][Ks]
leloupdu66. checks
GwenLaGrise bets 0.03€
leloupdu66. calls 0.03€
*** RIVER *** [Kd Jc Kc Ks][9d]
leloupdu66. checks
GwenLaGrise bets 2.62€ and is all-in
leloupdu66. folds
GwenLaGrise collected 2.75€ from pot
*** SUMMARY ***
Total pot 2.75€ | Rake 0.01€
Board: [Kd Jc Kc Ks 9d]
Seat 2: GwenLaGrise (big blind) won 2.75€


Winamax Poker - HOLD-UP "Colorado" - HandId: #19116069-431270-1701509436 - Holdem no limit (0.01€/0.02€) - 2023/12/02 09:30:36 UTC
Table: 'Colorado' 6-max (real money) Seat #6 is the button
Seat 1: tichettede3 (2.27€)
Seat 2: scach-111 (3.65€)
Seat 3: I6pokerP4 (3.53€)
Seat 4: Fried Berg (0.49€)
Seat 5: Le_Greg17 (1.97€)
Seat 6: lamuerta8300 (3.02€)
*** ANTE/BLINDS ***
tichettede3 posts small blind 0.01€
scach-111 posts big blind 0.02€
Dealt to Fried Berg [Th Kh]
*** PRE-FLOP *** 
I6pokerP4 folds
Fried Berg raises 0.02€ to 0.04€
Le_Greg17 calls 0.04€
lamuerta8300 folds
tichettede3 folds
scach-111 calls 0.02€
*** FLOP *** [7h 8c Js]
scach-111 checks
Fried Berg checks
Le_Greg17 bets 0.06€
scach-111 folds
Fried Berg calls 0.06€
*** TURN *** [7h 8c Js][Tc]
Fried Berg checks
Le_Greg17 bets 0.08€
Fried Berg calls 0.08€
*** RIVER *** [7h 8c Js Tc][As]
Fried Berg checks
Le_Greg17 bets 1.79€ and is all-in
Fried Berg calls 0.31€ and is all-in
*** SHOW DOWN ***
Fried Berg shows [Th Kh] (One pair : Tens)
Le_Greg17 shows [Jc 9c] (Straight Jack high)
Le_Greg17 collected 2.41€ from pot
*** SUMMARY ***
Total pot 2.41€ | Rake 0.10€
Board: [7h 8c Js Tc As]
Seat 4: Fried Berg showed [Th Kh] and lost with One pair : Tens
Seat 5: Le_Greg17 showed [Jc 9c] and won 2.41€ with Straight Jack high


Winamax Poker - HOLD-UP "Colorado" - HandId: #19116069-431424-1701509570 - Holdem no limit (0.01€/0.02€) - 2023/12/02 09:32:50 UTC
Table: 'Colorado' 6-max (real money) Seat #6 is the button
Seat 1: tichettede3 (2.12€)
Seat 2: SashaTDouss (3.88€)
Seat 3: Ikigaivvv (2.03€)
Seat 4: jdeepenslip (3.94€)
Seat 5: Fried Berg (0.50€)
Seat 6: pedrohxx (1.91€)
*** ANTE/BLINDS ***
tichettede3 posts small blind 0.01€
SashaTDouss posts big blind 0.02€
Dealt to Fried Berg [Qs 8h]
*** PRE-FLOP *** 
Ikigaivvv folds
jdeepenslip folds
Fried Berg folds
pedrohxx raises 0.02€ to 0.04€
tichettede3 folds
SashaTDouss calls 0.02€
*** FLOP *** [As Ad 6c]
SashaTDouss checks
pedrohxx bets 0.04€
SashaTDouss folds
pedrohxx collected 0.12€ from pot
*** SUMMARY ***
Total pot 0.12€ | Rake 0.01€
Board: [As Ad 6c]
Seat 6: pedrohxx (button) won 0.12€


Winamax Poker - HOLD-UP "Colorado" - HandId: #19116069-431430-1701509576 - Holdem no limit (0.01€/0.02€) - 2023/12/02 09:32:56 UTC
Table: 'Colorado' 6-max (real money) Seat #6 is the button
Seat 1: antodu62psr (3.24€)
Seat 2: Fried Berg (0.50€)
Seat 3: g8o8k8u (2.93€)
Seat 4: berlinouest (0.98€)
Seat 5: Alexisdpp (2.11€)
Seat 6: tichettede3 (2.11€)
*** ANTE/BLINDS ***
antodu62psr posts small blind 0.01€
Fried Berg posts big blind 0.02€
Dealt to Fried Berg [Th 7s]
*** PRE-FLOP *** 
g8o8k8u folds
berlinouest folds
Alexisdpp raises 0.04€ to 0.06€
tichettede3 folds
antodu62psr folds
Fried Berg folds
Alexisdpp collected 0.09€ from pot
*** SUMMARY ***
Total pot 0.09€ | No rake
Seat 5: Alexisdpp won 0.09€


Winamax Poker - HOLD-UP "Colorado" - HandId: #19116069-431439-1701509584 - Holdem no limit (0.01€/0.02€) - 2023/12/02 09:33:04 UTC
Table: 'Colorado' 6-max (real money) Seat #6 is the button
Seat 1: El Paellas (0.50€)
Seat 2: scach-111 (2€)
Seat 3: Le_Greg17 (2.33€)
Seat 4: rick26 (1.75€)
Seat 5: Full-AJA-89 (1.82€)
Seat 6: Fried Berg (0.48€)
*** ANTE/BLINDS ***
El Paellas posts small blind 0.01€
scach-111 posts big blind 0.02€
Dealt to Fried Berg [9d Ac]
*** PRE-FLOP *** 
Le_Greg17 folds
rick26 folds
Full-AJA-89 raises 0.03€ to 0.05€
Fried Berg calls 0.05€
El Paellas folds
scach-111 calls 0.03€
*** FLOP *** [Ah Qs Js]
scach-111 checks
Full-AJA-89 checks
Fried Berg bets 0.04€
scach-111 calls 0.04€
Full-AJA-89 folds
*** TURN *** [Ah Qs Js][7d]
scach-111 checks
Fried Berg bets 0.10€
scach-111 calls 0.10€
*** RIVER *** [Ah Qs Js 7d][4c]
scach-111 bets 0.12€
Fried Berg calls 0.12€
*** SHOW DOWN ***
Fried Berg shows [9d Ac] (One pair : Aces)
scach-111 shows [Qd Jh] (Two pairs : Queens and Jacks)
scach-111 collected 0.61€ from pot
*** SUMMARY ***
Total pot 0.61€ | Rake 0.07€
Board: [Ah Qs Js 7d 4c]
Seat 2: scach-111 (big blind) showed [Qd Jh] and won 0.61€ with Two pairs : Queens and Jacks
Seat 6: Fried Berg (button) showed [9d Ac] and lost with One pair : Aces


Winamax Poker - HOLD-UP "Colorado" - HandId: #19116069-431514-1701509660 - Holdem no limit (0.01€/0.02€) - 2023/12/02 09:34:20 UTC
Table: 'Colorado' 6-max (real money) Seat #6 is the button
Seat 1: Fried Berg (0.17€)
Seat 2: Ikigaivvv (2.93€)
Seat 3: cecilon (0.32€)
Seat 4: scach-111 (2.30€)
Seat 5: yam69 (5.58€)
Seat 6: El Paellas (0.50€)
*** ANTE/BLINDS ***
Fried Berg posts small blind 0.01€
Ikigaivvv posts big blind 0.02€
Dealt to Fried Berg [As 3h]
*** PRE-FLOP *** 
cecilon folds
scach-111 folds
yam69 raises 0.03€ to 0.05€
El Paellas folds
Fried Berg folds
Ikigaivvv folds
yam69 collected 0.08€ from pot
*** SUMMARY ***
Total pot 0.08€ | No rake
Seat 5: yam69 won 0.08€


Winamax Poker - HOLD-UP "Colorado" - HandId: #19116069-431529-1701509672 - Holdem no limit (0.01€/0.02€) - 2023/12/02 09:34:32 UTC
Table: 'Colorado' 6-max (real money) Seat #6 is the button
Seat 1: Fried Berg (0.16€)
Seat 2: Kallonys (2.67€)
Seat 3: scach-111 (2€)
Seat 4: Zile741 (2€)
Seat 5: pedrohxx (2.08€)
Seat 6: durba (0.81€)
*** ANTE/BLINDS ***
Fried Berg posts small blind 0.01€
Kallonys posts big blind 0.02€
Dealt to Fried Berg [As 4s]
*** PRE-FLOP *** 
scach-111 folds
Zile741 folds
pedrohxx raises 0.04€ to 0.06€
durba calls 0.06€
Fried Berg calls 0.05€
Kallonys folds
*** FLOP *** [Ts 5d 9s]
Fried Berg checks
pedrohxx checks
durba checks
*** TURN *** [Ts 5d 9s][8d]
Fried Berg checks
pedrohxx checks
durba bets 0.10€
Fried Berg calls 0.10€ and is all-in
pedrohxx folds
*** RIVER *** [Ts 5d 9s 8d][6d]
*** SHOW DOWN ***
Fried Berg shows [As 4s] (High card : Ace)
durba shows [4c 4d] (One pair : 4)
durba collected 0.36€ from pot
*** SUMMARY ***
Total pot 0.36€ | Rake 0.04€
Board: [Ts 5d 9s 8d 6d]
Seat 1: Fried Berg (small blind) showed [As 4s] and lost with High card : Ace
Seat 6: durba (button) showed [4c 4d] and won 0.36€ with One pair : 4


Winamax Poker - HOLD-UP "Colorado" - HandId: #19116069-431598-1701509735 - Holdem no limit (0.01€/0.02€) - 2023/12/02 09:35:35 UTC
Table: 'Colorado' 6-max (real money) Seat #6 is the button
Seat 1: Betiegarri (5.35€)
Seat 2: durba (1.01€)
Seat 3: Fried Berg (0.50€)
Seat 4: Melielvir (2€)
Seat 5: Kallonys (2.64€)
Seat 6: jdeepenslip (3.92€)
*** ANTE/BLINDS ***
Betiegarri posts small blind 0.01€
durba posts big blind 0.02€
Dealt to Fried Berg [Ks 7s]
*** PRE-FLOP *** 
Fried Berg raises 0.02€ to 0.04€
Melielvir folds
Kallonys folds
jdeepenslip folds
Betiegarri folds
durba folds
Fried Berg collected 0.07€ from pot
*** SUMMARY ***
Total pot 0.07€ | No rake
Seat 3: Fried Berg won 0.07€


Winamax Poker - HOLD-UP "Colorado" - HandId: #19116069-431616-1701509751 - Holdem no limit (0.01€/0.02€) - 2023/12/02 09:35:51 UTC
Table: 'Colorado' 6-max (real money) Seat #6 is the button
Seat 1: jdeepenslip (2.12€)
Seat 2: SashaTDouss (3.66€)
Seat 3: Petchou50 (1.97€)
Seat 4: Fried Berg (0.53€)
Seat 5: CTMieuxAvant (4.21€)
Seat 6: yam69 (5.73€)
*** ANTE/BLINDS ***
jdeepenslip posts small blind 0.01€
SashaTDouss posts big blind 0.02€
Dealt to Fried Berg [Jd 4h]
*** PRE-FLOP *** 
Petchou50 folds
Fried Berg folds
CTMieuxAvant raises 0.03€ to 0.05€
yam69 folds
jdeepenslip raises 0.15€ to 0.20€
SashaTDouss folds
CTMieuxAvant folds
jdeepenslip collected 0.27€ from pot
*** SUMMARY ***
Total pot 0.27€ | No rake
Seat 1: jdeepenslip (small blind) won 0.27€


Winamax Poker - HOLD-UP "Colorado" - HandId: #19116069-431621-1701509755 - Holdem no limit (0.01€/0.02€) - 2023/12/02 09:35:55 UTC
Table: 'Colorado' 6-max (real money) Seat #6 is the button
Seat 1: yam69 (5.73€)
Seat 2: Fried Berg (0.53€)
Seat 3: tichettede3 (2.28€)
Seat 4: lsiIdur1 (2€)
Seat 5: Petchou50 (1.97€)
Seat 6: cecilon (0.39€)
*** ANTE/BLINDS ***
yam69 posts small blind 0.01€
Fried Berg posts big blind 0.02€
Dealt to Fried Berg [2c 6s]
*** PRE-FLOP *** 
tichettede3 folds
lsiIdur1 raises 0.03€ to 0.05€
Petchou50 folds
cecilon folds
yam69 folds
Fried Berg folds
lsiIdur1 collected 0.08€ from pot
*** SUMMARY ***
Total pot 0.08€ | No rake
Seat 4: lsiIdur1 won 0.08€


Winamax Poker - HOLD-UP "Colorado" - HandId: #19116069-431635-1701509767 - Holdem no limit (0.01€/0.02€) - 2023/12/02 09:36:07 UTC
Table: 'Colorado' 6-max (real money) Seat #6 is the button
Seat 1: pedrohxx (2€)
Seat 2: Betiegarri (5.34€)
Seat 3: Fried Berg (0.51€)
Seat 4: bilal30 (0.50€)
Seat 5: TaBrEaMoI (2.14€)
Seat 6: loic51360 (2.51€)
Hold-up to Pot: total 0.10€
*** ANTE/BLINDS ***
pedrohxx posts small blind 0.01€
Betiegarri posts big blind 0.02€
Dealt to Fried Berg [2s Kh]
*** PRE-FLOP *** 
Fried Berg folds
bilal30 folds
TaBrEaMoI folds
loic51360 raises 0.02€ to 0.04€
pedrohxx folds
Betiegarri calls 0.02€
*** FLOP *** [3h Qd Kc]
Betiegarri checks
loic51360 bets 0.07€
Betiegarri folds
loic51360 collected 0.25€ from pot
*** SUMMARY ***
Total pot 0.25€ | Rake 0.01€
Board: [3h Qd Kc]
Seat 6: loic51360 (button) won 0.25€


Winamax Poker - HOLD-UP "Colorado" - HandId: #19116069-431639-1701509772 - Holdem no limit (0.01€/0.02€) - 2023/12/02 09:36:12 UTC
Table: 'Colorado' 6-max (real money) Seat #6 is the button
Seat 1: El Paellas (0.50€)
Seat 2: Abec16 (2€)
Seat 3: pedrohxx (1.99€)
Seat 4: scach-111 (2.23€)
Seat 5: jdeepenslip (2.19€)
Seat 6: Fried Berg (0.51€)
*** ANTE/BLINDS ***
El Paellas posts small blind 0.01€
Abec16 posts big blind 0.02€
Dealt to Fried Berg [Js 3s]
*** PRE-FLOP *** 
pedrohxx folds
scach-111 folds
jdeepenslip folds
Fried Berg raises 0.03€ to 0.05€
El Paellas folds
Abec16 folds
Fried Berg collected 0.08€ from pot
*** SUMMARY ***
Total pot 0.08€ | No rake
Seat 6: Fried Berg (button) won 0.08€


Winamax Poker - HOLD-UP "Colorado" - HandId: #19116069-431667-1701509790 - Holdem no limit (0.01€/0.02€) - 2023/12/02 09:36:30 UTC
Table: 'Colorado' 6-max (real money) Seat #6 is the button
Seat 1: rick26 (1.22€)
Seat 2: Zile741 (2€)
Seat 3: Chacal-Punk (3.08€)
Seat 4: D13C (6.43€)
Seat 5: Fried Berg (0.54€)
Seat 6: scach-111 (3.29€)
Hold-up to Pot: total 0.20€
*** ANTE/BLINDS ***
rick26 posts small blind 0.01€
Zile741 posts big blind 0.02€
Dealt to Fried Berg [6s Jd]
*** PRE-FLOP *** 
Chacal-Punk folds
D13C calls 0.02€
Fried Berg folds
scach-111 folds
rick26 folds
Zile741 raises 0.25€ to 0.27€
D13C folds
Zile741 collected 0.50€ from pot
*** SUMMARY ***
Total pot 0.50€ | No rake
Seat 2: Zile741 (big blind) won 0.50€


Winamax Poker - HOLD-UP "Colorado" - HandId: #19116069-431675-1701509795 - Holdem no limit (0.01€/0.02€) - 2023/12/02 09:36:35 UTC
Table: 'Colorado' 6-max (real money) Seat #6 is the button
Seat 1: cecilon (0.34€)
Seat 2: El Paellas (0.53€)
Seat 3: Blackmamba06 (2.17€)
Seat 4: Abec16 (1.97€)
Seat 5: Fried Berg (0.54€)
Seat 6: Artorias (2€)
*** ANTE/BLINDS ***
cecilon posts small blind 0.01€
El Paellas posts big blind 0.02€
Dealt to Fried Berg [Qs 7h]
*** PRE-FLOP *** 
Blackmamba06 folds
Abec16 raises 0.03€ to 0.05€
Fried Berg folds
Artorias folds
cecilon folds
El Paellas folds
Abec16 collected 0.08€ from pot
*** SUMMARY ***
Total pot 0.08€ | No rake
Seat 4: Abec16 won 0.08€


Winamax Poker - HOLD-UP "Colorado" - HandId: #19116069-431680-1701509798 - Holdem no limit (0.01€/0.02€) - 2023/12/02 09:36:38 UTC
Table: 'Colorado' 6-max (real money) Seat #6 is the button
Seat 1: Fried Berg (0.54€)
Seat 2: g8o8k8u (2€)
Seat 3: Kallonys (2.48€)
Seat 4: Artorias (2€)
Seat 5: tichettede3 (2.21€)
Seat 6: scach-111 (3.29€)
*** ANTE/BLINDS ***
Fried Berg posts small blind 0.01€
g8o8k8u posts big blind 0.02€
Dealt to Fried Berg [Ks 7c]
*** PRE-FLOP *** 
Kallonys folds
Artorias folds
tichettede3 raises 0.03€ to 0.05€
scach-111 folds
Fried Berg folds
g8o8k8u folds
tichettede3 collected 0.08€ from pot
*** SUMMARY ***
Total pot 0.08€ | No rake
Seat 5: tichettede3 won 0.08€


Winamax Poker - HOLD-UP "Colorado" - HandId: #19116069-431682-1701509799 - Holdem no limit (0.01€/0.02€) - 2023/12/02 09:36:39 UTC
Table: 'Colorado' 6-max (real money) Seat #6 is the button
Seat 1: TaBrEaMoI (2.12€)
Seat 2: Fried Berg (0.53€)
Seat 3: GriGri24 (2.05€)
Seat 4: Ikigaivvv (2.66€)
Seat 5: cecilon (0.33€)
Seat 6: jdeepenslip (3.84€)
*** ANTE/BLINDS ***
TaBrEaMoI posts small blind 0.01€
Fried Berg posts big blind 0.02€
Dealt to Fried Berg [Th Kh]
*** PRE-FLOP *** 
GriGri24 folds
Ikigaivvv raises 0.04€ to 0.06€
cecilon folds
jdeepenslip folds
TaBrEaMoI folds
Fried Berg calls 0.04€
*** FLOP *** [7d 8h 3s]
Fried Berg checks
Ikigaivvv bets 0.07€
Fried Berg folds
Ikigaivvv collected 0.19€ from pot
*** SUMMARY ***
Total pot 0.19€ | Rake 0.01€
Board: [7d 8h 3s]
Seat 4: Ikigaivvv won 0.19€


Winamax Poker - HOLD-UP "Colorado" - HandId: #19116069-431719-1701509821 - Holdem no limit (0.01€/0.02€) - 2023/12/02 09:37:01 UTC
Table: 'Colorado' 6-max (real money) Seat #6 is the button
Seat 1: Artorias (1.98€)
Seat 2: TaBrEaMoI (2.10€)
Seat 3: Fried Berg (0.47€)
Seat 4: crossRiver (2.25€)
Seat 5: Winico (0.56€)
Seat 6: jdeepenslip (3.81€)
*** ANTE/BLINDS ***
Artorias posts small blind 0.01€
TaBrEaMoI posts big blind 0.02€
Dealt to Fried Berg [8c 4d]
*** PRE-FLOP *** 
Fried Berg folds
crossRiver folds
Winico raises 0.02€ to 0.04€
jdeepenslip folds
Artorias folds
TaBrEaMoI folds
Winico collected 0.07€ from pot
*** SUMMARY ***
Total pot 0.07€ | No rake
Seat 5: Winico won 0.07€


Winamax Poker - HOLD-UP "Colorado" - HandId: #19116069-431725-1701509824 - Holdem no limit (0.01€/0.02€) - 2023/12/02 09:37:04 UTC
Table: 'Colorado' 6-max (real money) Seat #6 is the button
Seat 1: Ikigaivvv (2.72€)
Seat 2: durba (0.95€)
Seat 3: crossRiver (2.24€)
Seat 4: Fried Berg (0.47€)
Seat 5: jdeepenslip (3.81€)
Seat 6: I6pokerP4 (3.68€)
*** ANTE/BLINDS ***
Ikigaivvv posts small blind 0.01€
durba posts big blind 0.02€
Dealt to Fried Berg [3h 5h]
*** PRE-FLOP *** 
crossRiver folds
Fried Berg folds
jdeepenslip raises 0.03€ to 0.05€
I6pokerP4 folds
Ikigaivvv raises 0.17€ to 0.22€
durba folds
jdeepenslip folds
Ikigaivvv collected 0.29€ from pot
*** SUMMARY ***
Total pot 0.29€ | No rake
Seat 1: Ikigaivvv (small blind) won 0.29€


Winamax Poker - HOLD-UP "Colorado" - HandId: #19116069-431730-1701509827 - Holdem no limit (0.01€/0.02€) - 2023/12/02 09:37:07 UTC
Table: 'Colorado' 6-max (real money) Seat #6 is the button
Seat 1: tichettede3 (2€)
Seat 2: slowreplay (2.02€)
Seat 3: Amazigh 78 (3.15€)
Seat 4: pedrohxx (2.46€)
Seat 5: g8o8k8u (2€)
Seat 6: Fried Berg (0.47€)
Hold-up to Pot: total 0.20€
*** ANTE/BLINDS ***
tichettede3 posts small blind 0.01€
slowreplay posts big blind 0.02€
Dealt to Fried Berg [Ks Ah]
*** PRE-FLOP *** 
Amazigh 78 calls 0.02€
pedrohxx raises 0.02€ to 0.04€
g8o8k8u folds
Fried Berg raises 0.43€ to 0.47€ and is all-in
tichettede3 folds
slowreplay folds
Amazigh 78 calls 0.45€
pedrohxx folds
*** FLOP *** [7h 7c 3d]
*** TURN *** [7h 7c 3d][2s]
*** RIVER *** [7h 7c 3d 2s][Ts]
*** SHOW DOWN ***
Amazigh 78 shows [Qh 4c] (One pair : 7)
Fried Berg shows [Ks Ah] (One pair : 7)
Fried Berg collected 1.11€ from pot
*** SUMMARY ***
Total pot 1.11€ | Rake 0.10€
Board: [7h 7c 3d 2s Ts]
Seat 3: Amazigh 78 showed [Qh 4c] and lost with One pair : 7
Seat 6: Fried Berg (button) showed [Ks Ah] and won 1.11€ with One pair : 7


Winamax Poker - HOLD-UP "Colorado" - HandId: #19116069-431767-1701509859 - Holdem no limit (0.01€/0.02€) - 2023/12/02 09:37:39 UTC
Table: 'Colorado' 6-max (real money) Seat #6 is the button
Seat 1: DeX70 (4.07€)
Seat 2: pedrohxx (2.42€)
Seat 3: durba (0.43€)
Seat 4: Trader2020 (2€)
Seat 5: Fried Berg (1.11€)
Seat 6: GriGri24 (2.19€)
*** ANTE/BLINDS ***
DeX70 posts small blind 0.01€
pedrohxx posts big blind 0.02€
Dealt to Fried Berg [Qc Js]
*** PRE-FLOP *** 
durba folds
Trader2020 folds
Fried Berg raises 0.02€ to 0.04€
GriGri24 calls 0.04€
DeX70 folds
pedrohxx folds
*** FLOP *** [4s 4c Ac]
Fried Berg bets 0.06€
GriGri24 calls 0.06€
*** TURN *** [4s 4c Ac][3h]
Fried Berg bets 0.16€
GriGri24 calls 0.16€
*** RIVER *** [4s 4c Ac 3h][Kh]
Fried Berg bets 0.32€
GriGri24 calls 0.32€
*** SHOW DOWN ***
Fried Berg shows [Qc Js] (One pair : 4)
GriGri24 shows [7h Ah] (Two pairs : Aces and 4)
GriGri24 collected 1.07€ from pot
*** SUMMARY ***
Total pot 1.07€ | Rake 0.12€
Board: [4s 4c Ac 3h Kh]
Seat 5: Fried Berg showed [Qc Js] and lost with One pair : 4
Seat 6: GriGri24 (button) showed [7h Ah] and won 1.07€ with Two pairs : Aces and 4


Winamax Poker - HOLD-UP "Colorado" - HandId: #19116069-431879-1701509937 - Holdem no limit (0.01€/0.02€) - 2023/12/02 09:38:57 UTC
Table: 'Colorado' 6-max (real money) Seat #6 is the button
Seat 1: El Paellas (0.53€)
Seat 2: Fried Berg (0.53€)
Seat 3: TaBrEaMoI (2.01€)
Seat 4: Ikigaivvv (3.01€)
Seat 5: rick26 (1.17€)
Seat 6: scach-111 (3.24€)
*** ANTE/BLINDS ***
El Paellas posts small blind 0.01€
Fried Berg posts big blind 0.02€
Dealt to Fried Berg [Qd 9h]
*** PRE-FLOP *** 
TaBrEaMoI folds
Ikigaivvv folds
rick26 folds
scach-111 folds
El Paellas raises 0.03€ to 0.05€
Fried Berg folds
El Paellas collected 0.07€ from pot
*** SUMMARY ***
Total pot 0.07€ | No rake
Seat 1: El Paellas (small blind) won 0.07€


Winamax Poker - HOLD-UP "Colorado" - HandId: #19116069-431900-1701509953 - Holdem no limit (0.01€/0.02€) - 2023/12/02 09:39:13 UTC
Table: 'Colorado' 6-max (real money) Seat #6 is the button
Seat 1: nico033 (1.90€)
Seat 2: TaBrEaMoI (2€)
Seat 3: Pas1erreur (2.07€)
Seat 4: Fried Berg (0.51€)
Seat 5: Samourai-777 (0.92€)
Seat 6: scach-111 (2.30€)
*** ANTE/BLINDS ***
nico033 posts small blind 0.01€
TaBrEaMoI posts big blind 0.02€
Dealt to Fried Berg [Ts 9d]
*** PRE-FLOP *** 
Pas1erreur raises 0.03€ to 0.05€
Fried Berg folds
Samourai-777 folds
scach-111 folds
nico033 folds
TaBrEaMoI calls 0.03€
*** FLOP *** [9h Ad Ks]
TaBrEaMoI checks
Pas1erreur checks
*** TURN *** [9h Ad Ks][4c]
TaBrEaMoI checks
Pas1erreur bets 0.04€
TaBrEaMoI calls 0.04€
*** RIVER *** [9h Ad Ks 4c][8c]
TaBrEaMoI checks
Pas1erreur checks
*** SHOW DOWN ***
Pas1erreur shows [Jc Jh] (One pair : Jacks)
TaBrEaMoI shows [Qd Ac] (One pair : Aces)
TaBrEaMoI collected 0.17€ from pot
*** SUMMARY ***
Total pot 0.17€ | Rake 0.02€
Board: [9h Ad Ks 4c 8c]
Seat 2: TaBrEaMoI (big blind) showed [Qd Ac] and won 0.17€ with One pair : Aces
Seat 3: Pas1erreur showed [Jc Jh] and lost with One pair : Jacks


Winamax Poker - HOLD-UP "Colorado" - HandId: #19116069-431912-1701509962 - Holdem no limit (0.01€/0.02€) - 2023/12/02 09:39:22 UTC
Table: 'Colorado' 6-max (real money) Seat #6 is the button
Seat 1: Fried Berg (0.51€)
Seat 2: rick26 (1.61€)
Seat 3: g8o8k8u (2.40€)
Seat 4: scach-111 (2.27€)
Seat 5: AGALMMLA (1.79€)
Seat 6: Ikigaivvv (2.41€)
*** ANTE/BLINDS ***
Fried Berg posts small blind 0.01€
rick26 posts big blind 0.02€
Dealt to Fried Berg [9d Js]
*** PRE-FLOP *** 
g8o8k8u folds
scach-111 folds
AGALMMLA folds
Ikigaivvv raises 0.04€ to 0.06€
Fried Berg folds
rick26 folds
Ikigaivvv collected 0.09€ from pot
*** SUMMARY ***
Total pot 0.09€ | No rake
Seat 6: Ikigaivvv (button) won 0.09€


Winamax Poker - HOLD-UP "Colorado" - HandId: #19116069-431915-1701509964 - Holdem no limit (0.01€/0.02€) - 2023/12/02 09:39:24 UTC
Table: 'Colorado' 6-max (real money) Seat #6 is the button
Seat 1: antodu62psr (3.14€)
Seat 2: AGALMMLA (1.79€)
Seat 3: Fried Berg (0.50€)
Seat 4: Jerojam (2€)
Seat 5: jdeepenslip (2.16€)
Seat 6: g8o8k8u (2.40€)
*** ANTE/BLINDS ***
antodu62psr posts small blind 0.01€
AGALMMLA posts big blind 0.02€
Dealt to Fried Berg [Ac 5h]
*** PRE-FLOP *** 
Fried Berg folds
Jerojam folds
jdeepenslip folds
g8o8k8u folds
antodu62psr folds
AGALMMLA collected 0.03€ from pot
*** SUMMARY ***
Total pot 0.03€ | No rake
Seat 2: AGALMMLA (big blind) won 0.03€


Winamax Poker - HOLD-UP "Colorado" - HandId: #19116069-431920-1701509967 - Holdem no limit (0.01€/0.02€) - 2023/12/02 09:39:27 UTC
Table: 'Colorado' 6-max (real money) Seat #6 is the button
Seat 1: Mathis14_12 (2.01€)
Seat 2: g8o8k8u (2.40€)
Seat 3: slowreplay (2.38€)
Seat 4: Fried Berg (0.50€)
Seat 5: Kallonys (1.73€)
Seat 6: Trader2020 (2.19€)
*** ANTE/BLINDS ***
Mathis14_12 posts small blind 0.01€
g8o8k8u posts big blind 0.02€
Dealt to Fried Berg [8d 2d]
*** PRE-FLOP *** 
slowreplay folds
Fried Berg folds
Kallonys folds
Trader2020 folds
Mathis14_12 folds
g8o8k8u collected 0.03€ from pot
*** SUMMARY ***
Total pot 0.03€ | No rake
Seat 2: g8o8k8u (big blind) won 0.03€


Winamax Poker - HOLD-UP "Colorado" - HandId: #19116069-431922-1701509968 - Holdem no limit (0.01€/0.02€) - 2023/12/02 09:39:28 UTC
Table: 'Colorado' 6-max (real money) Seat #6 is the button
Seat 1: Fried Berg (0.50€)
Seat 2: D13C (6.46€)
Seat 3: MissLoulou (5.77€)
Seat 4: yam69 (5.02€)
Seat 5: ITALIA291 (2.06€)
Seat 6: Zile741 (3.92€)
*** ANTE/BLINDS ***
Fried Berg posts small blind 0.01€
D13C posts big blind 0.02€
Dealt to Fried Berg [5h 5d]
*** PRE-FLOP *** 
MissLoulou folds
yam69 raises 0.03€ to 0.05€
ITALIA291 raises 0.10€ to 0.15€
Zile741 folds
Fried Berg folds
D13C folds
yam69 calls 0.10€
*** FLOP *** [Td Ad 2d]
yam69 checks
ITALIA291 bets 0.33€
yam69 calls 0.33€
*** TURN *** [Td Ad 2d][7s]
yam69 checks
ITALIA291 checks
*** RIVER *** [Td Ad 2d 7s][3d]
yam69 bets 0.64€
ITALIA291 folds
yam69 collected 1.53€ from pot
*** SUMMARY ***
Total pot 1.53€ | Rake 0.10€
Board: [Td Ad 2d 7s 3d]
Seat 4: yam69 won 1.53€


Winamax Poker - HOLD-UP "Colorado" - HandId: #19116069-431936-1701509981 - Holdem no limit (0.01€/0.02€) - 2023/12/02 09:39:41 UTC
Table: 'Colorado' 6-max (real money) Seat #6 is the button
Seat 1: CTMieuxAvant (4.13€)
Seat 2: scach-111 (3.19€)
Seat 3: Fried Berg (0.49€)
Seat 4: duonrep (1.56€)
Seat 5: durba (0.45€)
Seat 6: D13C (6.44€)
*** ANTE/BLINDS ***
CTMieuxAvant posts small blind 0.01€
scach-111 posts big blind 0.02€
Dealt to Fried Berg [3s Jh]
*** PRE-FLOP *** 
Fried Berg folds
duonrep raises 0.17€ to 0.19€
durba folds
D13C folds
CTMieuxAvant folds
scach-111 folds
duonrep collected 0.22€ from pot
*** SUMMARY ***
Total pot 0.22€ | No rake
Seat 4: duonrep won 0.22€


Winamax Poker - HOLD-UP "Colorado" - HandId: #19116069-431938-1701509982 - Holdem no limit (0.01€/0.02€) - 2023/12/02 09:39:42 UTC
Table: 'Colorado' 6-max (real money) Seat #6 is the button
Seat 1: lamuerta8300 (3.35€)
Seat 2: Fried Berg (0.49€)
Seat 3: 2winchester (0.77€)
Seat 4: Ikigaivvv (3.21€)
Seat 5: El Paellas (0.53€)
Seat 6: Tribuna38 (2.98€)
*** ANTE/BLINDS ***
lamuerta8300 posts small blind 0.01€
Fried Berg posts big blind 0.02€
Dealt to Fried Berg [Tc Ad]
*** PRE-FLOP *** 
2winchester calls 0.02€
Ikigaivvv folds
El Paellas folds
Tribuna38 folds
lamuerta8300 folds
Fried Berg checks
*** FLOP *** [Ts 6h 4s]
Fried Berg bets 0.06€
2winchester folds
Fried Berg collected 0.10€ from pot
*** SUMMARY ***
Total pot 0.10€ | Rake 0.01€
Board: [Ts 6h 4s]
Seat 2: Fried Berg (big blind) won 0.10€


Winamax Poker - HOLD-UP "Colorado" - HandId: #19116069-431974-1701510011 - Holdem no limit (0.01€/0.02€) - 2023/12/02 09:40:11 UTC
Table: 'Colorado' 6-max (real money) Seat #6 is the button
Seat 1: Tuto_A_Posto (2.10€)
Seat 2: slowreplay (2€)
Seat 3: Kito31 (6.25€)
Seat 4: GwenLaGrise (3.46€)
Seat 5: Full-AJA-89 (2.59€)
Seat 6: Fried Berg (0.51€)
*** ANTE/BLINDS ***
Tuto_A_Posto posts small blind 0.01€
slowreplay posts big blind 0.02€
Dealt to Fried Berg [3c Jd]
*** PRE-FLOP *** 
Kito31 folds
GwenLaGrise folds
Full-AJA-89 folds
Fried Berg folds
Tuto_A_Posto raises 0.04€ to 0.06€
slowreplay folds
Tuto_A_Posto collected 0.08€ from pot
*** SUMMARY ***
Total pot 0.08€ | No rake
Seat 1: Tuto_A_Posto (small blind) won 0.08€


Winamax Poker - HOLD-UP "Colorado" - HandId: #19116069-431983-1701510021 - Holdem no limit (0.01€/0.02€) - 2023/12/02 09:40:21 UTC
Table: 'Colorado' 6-max (real money) Seat #6 is the button
Seat 1: Johnytop (5.14€)
Seat 2: Artorias (1.90€)
Seat 3: scach-111 (3.96€)
Seat 4: El Paellas (0.51€)
Seat 5: TaBrEaMoI (2.25€)
Seat 6: Fried Berg (0.51€)
*** ANTE/BLINDS ***
Johnytop posts small blind 0.01€
Artorias posts big blind 0.02€
Dealt to Fried Berg [Kc Jh]
*** PRE-FLOP *** 
scach-111 folds
El Paellas folds
TaBrEaMoI folds
Fried Berg raises 0.04€ to 0.06€
Johnytop folds
Artorias folds
Fried Berg collected 0.09€ from pot
*** SUMMARY ***
Total pot 0.09€ | No rake
Seat 6: Fried Berg (button) won 0.09€


Winamax Poker - HOLD-UP "Colorado" - HandId: #19116069-432006-1701510036 - Holdem no limit (0.01€/0.02€) - 2023/12/02 09:40:36 UTC
Table: 'Colorado' 6-max (real money) Seat #6 is the button
Seat 1: Fried Berg (0.54€)
Seat 2: scach-111 (3.95€)
Seat 3: TaBrEaMoI (2.04€)
Seat 4: slowreplay (2€)
Seat 5: Petchou50 (2.22€)
Seat 6: nico033 (2.53€)
*** ANTE/BLINDS ***
Fried Berg posts small blind 0.01€
scach-111 posts big blind 0.02€
Dealt to Fried Berg [4h Ad]
*** PRE-FLOP *** 
TaBrEaMoI folds
slowreplay folds
Petchou50 calls 0.02€
nico033 folds
Fried Berg folds
scach-111 checks
*** FLOP *** [5h Kd Qs]
scach-111 checks
Petchou50 checks
*** TURN *** [5h Kd Qs][8d]
scach-111 checks
Petchou50 checks
*** RIVER *** [5h Kd Qs 8d][Qh]
scach-111 checks
Petchou50 checks
*** SHOW DOWN ***
scach-111 shows [7c As] (One pair : Queens)
Petchou50 shows [Jh Js] (Two pairs : Queens and Jacks)
Petchou50 collected 0.04€ from pot
*** SUMMARY ***
Total pot 0.04€ | Rake 0.01€
Board: [5h Kd Qs 8d Qh]
Seat 2: scach-111 (big blind) showed [7c As] and lost with One pair : Queens
Seat 5: Petchou50 showed [Jh Js] and won 0.04€ with Two pairs : Queens and Jacks


Winamax Poker - HOLD-UP "Colorado" - HandId: #19116069-432035-1701510061 - Holdem no limit (0.01€/0.02€) - 2023/12/02 09:41:01 UTC
Table: 'Colorado' 6-max (real money) Seat #6 is the button
Seat 1: TaBrEaMoI (2.22€)
Seat 2: Betiegarri (6.96€)
Seat 3: Fried Berg (0.53€)
Seat 4: Longjohn779 (1.99€)
Seat 5: Chacal-Punk (4.24€)
Seat 6: slowreplay (2€)
*** ANTE/BLINDS ***
TaBrEaMoI posts small blind 0.01€
Betiegarri posts big blind 0.02€
Dealt to Fried Berg [5s 3c]
*** PRE-FLOP *** 
Fried Berg folds
Longjohn779 folds
Chacal-Punk raises 0.02€ to 0.04€
slowreplay folds
TaBrEaMoI folds
Betiegarri raises 0.10€ to 0.14€
Chacal-Punk calls 0.10€
*** FLOP *** [8c 6c Jc]
Betiegarri bets 0.23€
Chacal-Punk folds
Betiegarri collected 0.49€ from pot
*** SUMMARY ***
Total pot 0.49€ | Rake 0.03€
Board: [8c 6c Jc]
Seat 2: Betiegarri (big blind) won 0.49€


Winamax Poker - HOLD-UP "Colorado" - HandId: #19116069-432038-1701510063 - Holdem no limit (0.01€/0.02€) - 2023/12/02 09:41:03 UTC
Table: 'Colorado' 6-max (real money) Seat #6 is the button
Seat 1: lamuerta8300 (2.43€)
Seat 2: CTMieuxAvant (1.34€)
Seat 3: Fanfan21260 (1.91€)
Seat 4: Fried Berg (0.53€)
Seat 5: Kallonys (1.67€)
Seat 6: Zile741 (2.77€)
*** ANTE/BLINDS ***
lamuerta8300 posts small blind 0.01€
CTMieuxAvant posts big blind 0.02€
Dealt to Fried Berg [Ah 8h]
*** PRE-FLOP *** 
Fanfan21260 folds
Fried Berg raises 0.04€ to 0.06€
Kallonys folds
Zile741 folds
lamuerta8300 folds
CTMieuxAvant folds
Fried Berg collected 0.09€ from pot
*** SUMMARY ***
Total pot 0.09€ | No rake
Seat 4: Fried Berg won 0.09€


Winamax Poker - HOLD-UP "Colorado" - HandId: #19116069-432054-1701510074 - Holdem no limit (0.01€/0.02€) - 2023/12/02 09:41:14 UTC
Table: 'Colorado' 6-max (real money) Seat #6 is the button
Seat 1: GwenLaGrise (2.44€)
Seat 2: Fried Berg (0.56€)
Seat 3: slowreplay (2.25€)
Seat 4: Melielvir (1.76€)
Seat 5: Zile741 (2.77€)
Seat 6: lsiIdur1 (2.01€)
*** ANTE/BLINDS ***
GwenLaGrise posts small blind 0.01€
Fried Berg posts big blind 0.02€
Dealt to Fried Berg [2h 8d]
*** PRE-FLOP *** 
slowreplay folds
Melielvir folds
Zile741 folds
lsiIdur1 raises 0.03€ to 0.05€
GwenLaGrise folds
Fried Berg folds
lsiIdur1 collected 0.08€ from pot
*** SUMMARY ***
Total pot 0.08€ | No rake
Seat 6: lsiIdur1 (button) won 0.08€


Winamax Poker - HOLD-UP "Colorado" - HandId: #19116069-432071-1701510088 - Holdem no limit (0.01€/0.02€) - 2023/12/02 09:41:28 UTC
Table: 'Colorado' 6-max (real money) Seat #6 is the button
Seat 1: Ikigaivvv (3.31€)
Seat 2: Pas1erreur (1.57€)
Seat 3: MissLoulou (6.71€)
Seat 4: Amazigh 78 (3.21€)
Seat 5: Fried Berg (0.54€)
Seat 6: Johnytop (5.05€)
*** ANTE/BLINDS ***
Ikigaivvv posts small blind 0.01€
Pas1erreur posts big blind 0.02€
Dealt to Fried Berg [Ts 8d]
*** PRE-FLOP *** 
MissLoulou folds
Amazigh 78 folds
Fried Berg folds
Johnytop raises 0.03€ to 0.05€
Ikigaivvv folds
Pas1erreur folds
Johnytop collected 0.08€ from pot
*** SUMMARY ***
Total pot 0.08€ | No rake
Seat 6: Johnytop (button) won 0.08€


Winamax Poker - HOLD-UP "Colorado" - HandId: #19116069-432076-1701510091 - Holdem no limit (0.01€/0.02€) - 2023/12/02 09:41:31 UTC
Table: 'Colorado' 6-max (real money) Seat #6 is the button
Seat 1: lsiIdur1 (2.04€)
Seat 2: CTMieuxAvant (3.75€)
Seat 3: antodu62psr (2.95€)
Seat 4: slowreplay (2.01€)
Seat 5: Melielvir (1.73€)
Seat 6: Fried Berg (0.54€)
*** ANTE/BLINDS ***
lsiIdur1 posts small blind 0.01€
CTMieuxAvant posts big blind 0.02€
Dealt to Fried Berg [5h 4c]
*** PRE-FLOP *** 
antodu62psr raises 0.05€ to 0.07€
slowreplay folds
Melielvir folds
Fried Berg folds
lsiIdur1 folds
CTMieuxAvant folds
antodu62psr collected 0.10€ from pot
*** SUMMARY ***
Total pot 0.10€ | No rake
Seat 3: antodu62psr won 0.10€


Winamax Poker - HOLD-UP "Colorado" - HandId: #19116069-432082-1701510096 - Holdem no limit (0.01€/0.02€) - 2023/12/02 09:41:36 UTC
Table: 'Colorado' 6-max (real money) Seat #6 is the button
Seat 1: yam69 (5.52€)
Seat 2: TaBrEaMoI (2€)
Seat 3: scach-111 (3.41€)
Seat 4: lsiIdur1 (2.02€)
Seat 5: 121 (2.26€)
Seat 6: Fried Berg (0.54€)
*** ANTE/BLINDS ***
yam69 posts small blind 0.01€
TaBrEaMoI posts big blind 0.02€
Dealt to Fried Berg [2h 7s]
*** PRE-FLOP *** 
scach-111 folds
lsiIdur1 folds
121 folds
Fried Berg folds
yam69 raises 0.03€ to 0.05€
TaBrEaMoI folds
yam69 collected 0.07€ from pot
*** SUMMARY ***
Total pot 0.07€ | No rake
Seat 1: yam69 (small blind) won 0.07€


Winamax Poker - HOLD-UP "Colorado" - HandId: #19116069-432084-1701510099 - Holdem no limit (0.01€/0.02€) - 2023/12/02 09:41:39 UTC
Table: 'Colorado' 6-max (real money) Seat #6 is the button
Seat 1: GreenCard225 (4.95€)
Seat 2: CTMieuxAvant (4.76€)
Seat 3: Fried Berg (0.54€)
Seat 4: antodu62psr (2.98€)
Seat 5: lsiIdur1 (2.02€)
Seat 6: scach-111 (2€)
*** ANTE/BLINDS ***
GreenCard225 posts small blind 0.01€
CTMieuxAvant posts big blind 0.02€
Dealt to Fried Berg [Tc Jh]
*** PRE-FLOP *** 
Fried Berg folds
antodu62psr folds
lsiIdur1 folds
scach-111 raises 0.03€ to 0.05€
GreenCard225 folds
CTMieuxAvant folds
scach-111 collected 0.08€ from pot
*** SUMMARY ***
Total pot 0.08€ | No rake
Seat 6: scach-111 (button) won 0.08€


Winamax Poker - HOLD-UP "Colorado" - HandId: #19116069-432086-1701510101 - Holdem no limit (0.01€/0.02€) - 2023/12/02 09:41:41 UTC
Table: 'Colorado' 6-max (real money) Seat #6 is the button
Seat 1: iron-dada (3.30€)
Seat 2: GreenCard225 (4.94€)
Seat 3: GwenLaGrise (2.41€)
Seat 4: Fried Berg (0.54€)
Seat 5: antodu62psr (2.98€)
Seat 6: lsiIdur1 (2.02€)
*** ANTE/BLINDS ***
iron-dada posts small blind 0.01€
GreenCard225 posts big blind 0.02€
Dealt to Fried Berg [8d As]
*** PRE-FLOP *** 
GwenLaGrise folds
Fried Berg raises 0.02€ to 0.04€
antodu62psr calls 0.04€
lsiIdur1 folds
iron-dada folds
GreenCard225 folds
*** FLOP *** [4c 4d Ac]
Fried Berg bets 0.04€
antodu62psr calls 0.04€
*** TURN *** [4c 4d Ac][5s]
Fried Berg bets 0.08€
antodu62psr calls 0.08€
*** RIVER *** [4c 4d Ac 5s][Ah]
Fried Berg bets 0.16€
antodu62psr calls 0.16€
*** SHOW DOWN ***
antodu62psr shows [4h Kh] (Full of 4 and Aces)
Fried Berg shows [8d As] (Full of Aces and 4)
Fried Berg collected 0.60€ from pot
*** SUMMARY ***
Total pot 0.60€ | Rake 0.07€
Board: [4c 4d Ac 5s Ah]
Seat 4: Fried Berg showed [8d As] and won 0.60€ with Full of Aces and 4
Seat 5: antodu62psr showed [4h Kh] and lost with Full of 4 and Aces


Winamax Poker - HOLD-UP "Colorado" - HandId: #19116069-432170-1701510165 - Holdem no limit (0.01€/0.02€) - 2023/12/02 09:42:45 UTC
Table: 'Colorado' 6-max (real money) Seat #6 is the button
Seat 1: Fried Berg (0.82€)
Seat 2: Johnytop (2.09€)
Seat 3: lamuerta8300 (3.18€)
Seat 4: Artorias (1.86€)
Seat 5: GwenLaGrise (3.12€)
Seat 6: Zile741 (2.09€)
*** ANTE/BLINDS ***
Fried Berg posts small blind 0.01€
Johnytop posts big blind 0.02€
Dealt to Fried Berg [Ah Ad]
*** PRE-FLOP *** 
lamuerta8300 folds
Artorias folds
GwenLaGrise folds
Zile741 raises 0.03€ to 0.05€
Fried Berg raises 0.10€ to 0.15€
Johnytop folds
Zile741 folds
Fried Berg collected 0.22€ from pot
*** SUMMARY ***
Total pot 0.22€ | No rake
Seat 1: Fried Berg (small blind) won 0.22€


Winamax Poker - HOLD-UP "Colorado" - HandId: #19116069-432224-1701510204 - Holdem no limit (0.01€/0.02€) - 2023/12/02 09:43:24 UTC
Table: 'Colorado' 6-max (real money) Seat #6 is the button
Seat 1: Zile741 (2€)
Seat 2: Artorias (1.85€)
Seat 3: El Paellas (0.50€)
Seat 4: CTMieuxAvant (4.85€)
Seat 5: Fried Berg (0.89€)
Seat 6: Tribuna38 (3.47€)
*** ANTE/BLINDS ***
Zile741 posts small blind 0.01€
Artorias posts big blind 0.02€
Dealt to Fried Berg [Qc As]
*** PRE-FLOP *** 
El Paellas folds
CTMieuxAvant raises 0.03€ to 0.05€
Fried Berg calls 0.05€
Tribuna38 folds
Zile741 folds
Artorias folds
*** FLOP *** [9s Ad 3s]
CTMieuxAvant checks
Fried Berg bets 0.08€
CTMieuxAvant folds
Fried Berg collected 0.20€ from pot
*** SUMMARY ***
Total pot 0.20€ | Rake 0.01€
Board: [9s Ad 3s]
Seat 5: Fried Berg won 0.20€


Winamax Poker - HOLD-UP "Colorado" - HandId: #19116069-432264-1701510236 - Holdem no limit (0.01€/0.02€) - 2023/12/02 09:43:56 UTC
Table: 'Colorado' 6-max (real money) Seat #6 is the button
Seat 1: cecilon (0.39€)
Seat 2: Fried Berg (0.96€)
Seat 3: popoche29 (10.41€)
Seat 4: Tuto_A_Posto (2.22€)
Seat 5: pedrohxx (1.99€)
Seat 6: El Paellas (0.50€)
*** ANTE/BLINDS ***
cecilon posts small blind 0.01€
Fried Berg posts big blind 0.02€
Dealt to Fried Berg [5c Jc]
*** PRE-FLOP *** 
popoche29 folds
Tuto_A_Posto folds
pedrohxx folds
El Paellas folds
cecilon folds
Fried Berg collected 0.03€ from pot
*** SUMMARY ***
Total pot 0.03€ | No rake
Seat 2: Fried Berg (big blind) won 0.03€


Winamax Poker - HOLD-UP "Colorado" - HandId: #19116069-432281-1701510247 - Holdem no limit (0.01€/0.02€) - 2023/12/02 09:44:07 UTC
Table: 'Colorado' 6-max (real money) Seat #6 is the button
Seat 1: Fried Berg (0.97€)
Seat 2: iron-dada (3.16€)
Seat 3: Ikigaivvv (2.44€)
Seat 4: popoche29 (10.39€)
Seat 5: TaBrEaMoI (2€)
Seat 6: AGALMMLA (1.81€)
*** ANTE/BLINDS ***
Fried Berg posts small blind 0.01€
iron-dada posts big blind 0.02€
Dealt to Fried Berg [3d 3s]
*** PRE-FLOP *** 
Ikigaivvv raises 0.04€ to 0.06€
popoche29 calls 0.06€
TaBrEaMoI folds
AGALMMLA calls 0.06€
Fried Berg folds
iron-dada calls 0.04€
*** FLOP *** [Ks 2h 9h]
iron-dada checks
Ikigaivvv checks
popoche29 checks
AGALMMLA checks
*** TURN *** [Ks 2h 9h][Ah]
iron-dada checks
Ikigaivvv checks
popoche29 checks
AGALMMLA checks
*** RIVER *** [Ks 2h 9h Ah][4h]
iron-dada checks
Ikigaivvv checks
popoche29 checks
AGALMMLA checks
*** SHOW DOWN ***
iron-dada shows [6d Jc] (High card : Ace)
Ikigaivvv shows [6c Ac] (One pair : Aces)
AGALMMLA shows [Jd 2d] (One pair : 2)
popoche29 shows [Ad 9d] (Two pairs : Aces and 9)
popoche29 collected 0.22€ from pot
*** SUMMARY ***
Total pot 0.22€ | Rake 0.03€
Board: [Ks 2h 9h Ah 4h]
Seat 2: iron-dada (big blind) showed [6d Jc] and lost with High card : Ace
Seat 3: Ikigaivvv showed [6c Ac] and lost with One pair : Aces
Seat 4: popoche29 showed [Ad 9d] and won 0.22€ with Two pairs : Aces and 9
Seat 6: AGALMMLA (button) showed [Jd 2d] and lost with One pair : 2


Winamax Poker - HOLD-UP "Colorado" - HandId: #19116069-432290-1701510255 - Holdem no limit (0.01€/0.02€) - 2023/12/02 09:44:15 UTC
Table: 'Colorado' 6-max (real money) Seat #6 is the button
Seat 1: Zile741 (2€)
Seat 2: lsiIdur1 (2.04€)
Seat 3: PANDIKORNIO (2.07€)
Seat 4: ComeOn75 (2.31€)
Seat 5: Fried Berg (0.96€)
Seat 6: TaBrEaMoI (2.40€)
*** ANTE/BLINDS ***
Zile741 posts small blind 0.01€
lsiIdur1 posts big blind 0.02€
Dealt to Fried Berg [6s 2s]
*** PRE-FLOP *** 
PANDIKORNIO folds
ComeOn75 raises 0.03€ to 0.05€
Fried Berg folds
TaBrEaMoI folds
Zile741 folds
lsiIdur1 folds
ComeOn75 collected 0.08€ from pot
*** SUMMARY ***
Total pot 0.08€ | No rake
Seat 4: ComeOn75 won 0.08€


Winamax Poker - HOLD-UP "Colorado" - HandId: #19116069-432303-1701510264 - Holdem no limit (0.01€/0.02€) - 2023/12/02 09:44:24 UTC
Table: 'Colorado' 6-max (real money) Seat #6 is the button
Seat 1: Melielvir (2.05€)
Seat 2: rick26 (1.13€)
Seat 3: Fried Berg (0.96€)
Seat 4: Lego-AAs (2.47€)
Seat 5: scach-111 (3.83€)
Seat 6: 2winchester (0.86€)
*** ANTE/BLINDS ***
Melielvir posts small blind 0.01€
rick26 posts big blind 0.02€
Dealt to Fried Berg [3h Kc]
*** PRE-FLOP *** 
Fried Berg folds
Lego-AAs calls 0.02€
scach-111 folds
2winchester raises 0.04€ to 0.06€
Melielvir raises 0.16€ to 0.22€
rick26 folds
Lego-AAs folds
2winchester raises 0.44€ to 0.66€
Melielvir raises 1.39€ to 2.05€ and is all-in
2winchester calls 0.20€ and is all-in
*** FLOP *** [2c 9h 8s]
*** TURN *** [2c 9h 8s][Ah]
*** RIVER *** [2c 9h 8s Ah][6c]
*** SHOW DOWN ***
2winchester shows [As Qd] (One pair : Aces)
Melielvir shows [8c 8d] (Trips of 8)
Melielvir collected 2.77€ from pot
*** SUMMARY ***
Total pot 2.77€ | Rake 0.18€
Board: [2c 9h 8s Ah 6c]
Seat 1: Melielvir (small blind) showed [8c 8d] and won 2.77€ with Trips of 8
Seat 6: 2winchester (button) showed [As Qd] and lost with One pair : Aces


Winamax Poker - HOLD-UP "Colorado" - HandId: #19116069-432305-1701510266 - Holdem no limit (0.01€/0.02€) - 2023/12/02 09:44:26 UTC
Table: 'Colorado' 6-max (real money) Seat #6 is the button
Seat 1: Chacal-Punk (4.22€)
Seat 2: Zile741 (2€)
Seat 3: c-riddick (2.02€)
Seat 4: Fried Berg (0.96€)
Seat 5: Kallonys (1.74€)
Seat 6: 121 (2.14€)
*** ANTE/BLINDS ***
Chacal-Punk posts small blind 0.01€
Zile741 posts big blind 0.02€
Dealt to Fried Berg [Jc Tc]
*** PRE-FLOP *** 
c-riddick calls 0.02€
Fried Berg calls 0.02€
Kallonys calls 0.02€
121 folds
Chacal-Punk folds
Zile741 checks
*** FLOP *** [2h 7d Ts]
Zile741 checks
c-riddick bets 0.03€
Fried Berg calls 0.03€
Kallonys calls 0.03€
Zile741 folds
*** TURN *** [2h 7d Ts][3c]
c-riddick checks
Fried Berg checks
Kallonys checks
*** RIVER *** [2h 7d Ts 3c][Qd]
c-riddick checks
Fried Berg checks
Kallonys checks
*** SHOW DOWN ***
c-riddick shows [Kc 7c] (One pair : 7)
Kallonys shows [Ad Jh] (High card : Ace)
Fried Berg shows [Jc Tc] (One pair : Tens)
Fried Berg collected 0.16€ from pot
*** SUMMARY ***
Total pot 0.16€ | Rake 0.02€
Board: [2h 7d Ts 3c Qd]
Seat 3: c-riddick showed [Kc 7c] and lost with One pair : 7
Seat 4: Fried Berg showed [Jc Tc] and won 0.16€ with One pair : Tens
Seat 5: Kallonys showed [Ad Jh] and lost with High card : Ace


Winamax Poker - HOLD-UP "Colorado" - HandId: #19116069-432370-1701510313 - Holdem no limit (0.01€/0.02€) - 2023/12/02 09:45:13 UTC
Table: 'Colorado' 6-max (real money) Seat #6 is the button
Seat 1: Fanfan21260 (2.16€)
Seat 2: Fried Berg (1.07€)
Seat 3: Kyks_ (0.79€)
Seat 4: Kallonys (1.69€)
Seat 5: PANDIKORNIO (2.10€)
Seat 6: 121 (2.05€)
*** ANTE/BLINDS ***
Fanfan21260 posts small blind 0.01€
Fried Berg posts big blind 0.02€
Dealt to Fried Berg [7c 3h]
*** PRE-FLOP *** 
Kyks_ calls 0.02€
Kallonys folds
PANDIKORNIO folds
121 folds
Fanfan21260 calls 0.01€
Fried Berg checks
*** FLOP *** [Ks Qd 2c]
Fanfan21260 checks
Fried Berg checks
Kyks_ checks
*** TURN *** [Ks Qd 2c][Kd]
Fanfan21260 checks
Fried Berg checks
Kyks_ checks
*** RIVER *** [Ks Qd 2c Kd][Ah]
Fanfan21260 checks
Fried Berg checks
Kyks_ checks
*** SHOW DOWN ***
Fried Berg shows [7c 3h] (One pair : Kings)
Kyks_ shows [9c Tc] (One pair : Kings)
Fanfan21260 shows [4h 4s] (Two pairs : Kings and 4)
Fanfan21260 collected 0.05€ from pot
*** SUMMARY ***
Total pot 0.05€ | Rake 0.01€
Board: [Ks Qd 2c Kd Ah]
Seat 1: Fanfan21260 (small blind) showed [4h 4s] and won 0.05€ with Two pairs : Kings and 4
Seat 2: Fried Berg (big blind) showed [7c 3h] and lost with One pair : Kings
Seat 3: Kyks_ showed [9c Tc] and lost with One pair : Kings


Winamax Poker - HOLD-UP "Colorado" - HandId: #19116069-432466-1701510383 - Holdem no limit (0.01€/0.02€) - 2023/12/02 09:46:23 UTC
Table: 'Colorado' 6-max (real money) Seat #6 is the button
Seat 1: slowreplay (2.06€)
Seat 2: Betiegarri (7.19€)
Seat 3: Fanfan21260 (2.19€)
Seat 4: Kyks_ (0.77€)
Seat 5: Fried Berg (1.05€)
Seat 6: pedrohxx (2.30€)
*** ANTE/BLINDS ***
slowreplay posts small blind 0.01€
Betiegarri posts big blind 0.02€
Dealt to Fried Berg [8h Jd]
*** PRE-FLOP *** 
Fanfan21260 folds
Kyks_ calls 0.02€
Fried Berg folds
pedrohxx folds
slowreplay folds
Betiegarri checks
*** FLOP *** [Qd 3c Ks]
Betiegarri checks
Kyks_ bets 0.02€
Betiegarri calls 0.02€
*** TURN *** [Qd 3c Ks][4s]
Betiegarri checks
Kyks_ bets 0.03€
Betiegarri calls 0.03€
*** RIVER *** [Qd 3c Ks 4s][Ts]
Betiegarri bets 0.15€
Kyks_ calls 0.15€
*** SHOW DOWN ***
Kyks_ shows [9h Kh] (One pair : Kings)
Betiegarri shows [As Jc] (Straight Ace high)
Betiegarri collected 0.40€ from pot
*** SUMMARY ***
Total pot 0.40€ | Rake 0.05€
Board: [Qd 3c Ks 4s Ts]
Seat 2: Betiegarri (big blind) showed [As Jc] and won 0.40€ with Straight Ace high
Seat 4: Kyks_ showed [9h Kh] and lost with One pair : Kings


Winamax Poker - HOLD-UP "Colorado" - HandId: #19116069-432482-1701510393 - Holdem no limit (0.01€/0.02€) - 2023/12/02 09:46:33 UTC
Table: 'Colorado' 6-max (real money) Seat #6 is the button
Seat 1: CTMieuxAvant (4.72€)
Seat 2: VEVIDIVICIKO (0.88€)
Seat 3: g8o8k8u (2.71€)
Seat 4: cynomolgus (2€)
Seat 5: D13C (6.14€)
Seat 6: Fried Berg (1.05€)
*** ANTE/BLINDS ***
CTMieuxAvant posts small blind 0.01€
VEVIDIVICIKO posts big blind 0.02€
Dealt to Fried Berg [Td 7s]
*** PRE-FLOP *** 
g8o8k8u folds
cynomolgus folds
D13C folds
Fried Berg folds
CTMieuxAvant folds
VEVIDIVICIKO collected 0.03€ from pot
*** SUMMARY ***
Total pot 0.03€ | No rake
Seat 2: VEVIDIVICIKO (big blind) won 0.03€


Winamax Poker - HOLD-UP "Colorado" - HandId: #19116069-432488-1701510397 - Holdem no limit (0.01€/0.02€) - 2023/12/02 09:46:37 UTC
Table: 'Colorado' 6-max (real money) Seat #6 is the button
Seat 1: PANDIKORNIO (2.11€)
Seat 2: El Paellas (0.50€)
Seat 3: Fried Berg (1.05€)
Seat 4: MissLoulou (7.19€)
Seat 5: GwenLaGrise (2.28€)
Seat 6: CTMieuxAvant (4.71€)
*** ANTE/BLINDS ***
PANDIKORNIO posts small blind 0.01€
El Paellas posts big blind 0.02€
Dealt to Fried Berg [As 2h]
*** PRE-FLOP *** 
Fried Berg folds
MissLoulou raises 0.05€ to 0.07€
GwenLaGrise folds
CTMieuxAvant folds
PANDIKORNIO folds
El Paellas folds
MissLoulou collected 0.10€ from pot
*** SUMMARY ***
Total pot 0.10€ | No rake
Seat 4: MissLoulou won 0.10€


Winamax Poker - HOLD-UP "Colorado" - HandId: #19116069-432492-1701510400 - Holdem no limit (0.01€/0.02€) - 2023/12/02 09:46:40 UTC
Table: 'Colorado' 6-max (real money) Seat #6 is the button
Seat 1: Ronan K (2€)
Seat 2: _Lilli Rush (1.13€)
Seat 3: cecilon (0.37€)
Seat 4: Fried Berg (1.05€)
Seat 5: CTMieuxAvant (4.71€)
Seat 6: Chacal-Punk (4.38€)
*** ANTE/BLINDS ***
Ronan K posts small blind 0.01€
_Lilli Rush posts big blind 0.02€
Dealt to Fried Berg [8s 4s]
*** PRE-FLOP *** 
cecilon folds
Fried Berg folds
CTMieuxAvant folds
Chacal-Punk raises 0.02€ to 0.04€
Ronan K folds
_Lilli Rush folds
Chacal-Punk collected 0.07€ from pot
*** SUMMARY ***
Total pot 0.07€ | No rake
Seat 6: Chacal-Punk (button) won 0.07€


Winamax Poker - HOLD-UP "Colorado" - HandId: #19116069-432497-1701510403 - Holdem no limit (0.01€/0.02€) - 2023/12/02 09:46:43 UTC
Table: 'Colorado' 6-max (real money) Seat #6 is the button
Seat 1: Johnytop (2.23€)
Seat 2: Fried Berg (1.05€)
Seat 3: jdeepenshort (2€)
Seat 4: Ronan K (2€)
Seat 5: 2winchester (0.42€)
Seat 6: cecilon (0.36€)
*** ANTE/BLINDS ***
Johnytop posts small blind 0.01€
Fried Berg posts big blind 0.02€
Dealt to Fried Berg [Jh Js]
*** PRE-FLOP *** 
jdeepenshort raises 0.04€ to 0.06€
Ronan K folds
2winchester folds
cecilon folds
Johnytop folds
Fried Berg calls 0.04€
*** FLOP *** [Qc 7h Tc]
Fried Berg checks
jdeepenshort bets 0.08€
Fried Berg calls 0.08€
*** TURN *** [Qc 7h Tc][Qs]
Fried Berg checks
jdeepenshort bets 0.10€
Fried Berg calls 0.10€
*** RIVER *** [Qc 7h Tc Qs][5d]
Fried Berg checks
jdeepenshort checks
*** SHOW DOWN ***
jdeepenshort shows [Td Ac] (Two pairs : Queens and Tens)
Fried Berg shows [Jh Js] (Two pairs : Queens and Jacks)
Fried Berg collected 0.44€ from pot
*** SUMMARY ***
Total pot 0.44€ | Rake 0.05€
Board: [Qc 7h Tc Qs 5d]
Seat 2: Fried Berg (big blind) showed [Jh Js] and won 0.44€ with Two pairs : Queens and Jacks
Seat 3: jdeepenshort showed [Td Ac] and lost with Two pairs : Queens and Tens


Winamax Poker - HOLD-UP "Colorado" - HandId: #19116069-432579-1701510463 - Holdem no limit (0.01€/0.02€) - 2023/12/02 09:47:43 UTC
Table: 'Colorado' 6-max (real money) Seat #6 is the button
Seat 1: antho-08260 (1.81€)
Seat 2: GwenLaGrise (3.68€)
Seat 3: BimBamFlop (2.08€)
Seat 4: jdeepenshort (2€)
Seat 5: Kallonys (1.63€)
Seat 6: Fried Berg (1.25€)
*** ANTE/BLINDS ***
antho-08260 posts small blind 0.01€
GwenLaGrise posts big blind 0.02€
Dealt to Fried Berg [7c 8c]
*** PRE-FLOP *** 
BimBamFlop folds
jdeepenshort raises 0.04€ to 0.06€
Kallonys folds
Fried Berg calls 0.06€
antho-08260 folds
GwenLaGrise folds
*** FLOP *** [8s Ks 3d]
jdeepenshort bets 0.10€
Fried Berg folds
jdeepenshort collected 0.23€ from pot
*** SUMMARY ***
Total pot 0.23€ | Rake 0.02€
Board: [8s Ks 3d]
Seat 4: jdeepenshort won 0.23€


Winamax Poker - HOLD-UP "Colorado" - HandId: #19116069-432757-1701510580 - Holdem no limit (0.01€/0.02€) - 2023/12/02 09:49:40 UTC
Table: 'Colorado' 6-max (real money) Seat #6 is the button
Seat 1: Fried Berg (1.19€)
Seat 2: D13C (5.95€)
Seat 3: Manaiiss64 (0.62€)
Seat 4: CTMieuxAvant (3.50€)
Seat 5: scach-111 (3.96€)
Seat 6: El Paellas (0.50€)
*** ANTE/BLINDS ***
Fried Berg posts small blind 0.01€
D13C posts big blind 0.02€
Dealt to Fried Berg [5d Jh]
*** PRE-FLOP *** 
Manaiiss64 calls 0.02€
CTMieuxAvant folds
scach-111 calls 0.02€
El Paellas folds
Fried Berg folds
D13C checks
*** FLOP *** [5s 6s 2d]
D13C checks
Manaiiss64 checks
scach-111 checks
*** TURN *** [5s 6s 2d][8h]
D13C checks
Manaiiss64 checks
scach-111 checks
*** RIVER *** [5s 6s 2d 8h][9d]
D13C checks
Manaiiss64 checks
scach-111 checks
*** SHOW DOWN ***
Manaiiss64 shows [4h Ah] (High card : Ace)
scach-111 shows [4s 4c] (One pair : 4)
D13C shows [Qc 9c] (One pair : 9)
D13C collected 0.06€ from pot
*** SUMMARY ***
Total pot 0.06€ | Rake 0.01€
Board: [5s 6s 2d 8h 9d]
Seat 2: D13C (big blind) showed [Qc 9c] and won 0.06€ with One pair : 9
Seat 3: Manaiiss64 showed [4h Ah] and lost with High card : Ace
Seat 5: scach-111 showed [4s 4c] and lost with One pair : 4


Winamax Poker - HOLD-UP "Colorado" - HandId: #19116069-432787-1701510602 - Holdem no limit (0.01€/0.02€) - 2023/12/02 09:50:02 UTC
Table: 'Colorado' 6-max (real money) Seat #6 is the button
Seat 1: g8o8k8u (2.73€)
Seat 2: Roby16 (3.63€)
Seat 3: Fried Berg (1.18€)
Seat 4: Ikigaivvv (2.36€)
Seat 5: Abec16 (1.85€)
Seat 6: elsrab (2.46€)
*** ANTE/BLINDS ***
g8o8k8u posts small blind 0.01€
Roby16 posts big blind 0.02€
Dealt to Fried Berg [3s 9s]
*** PRE-FLOP *** 
Fried Berg folds
Ikigaivvv folds
Abec16 folds
elsrab folds
g8o8k8u folds
Roby16 collected 0.03€ from pot
*** SUMMARY ***
Total pot 0.03€ | No rake
Seat 2: Roby16 (big blind) won 0.03€


Winamax Poker - HOLD-UP "Colorado" - HandId: #19116069-432789-1701510603 - Holdem no limit (0.01€/0.02€) - 2023/12/02 09:50:03 UTC
Table: 'Colorado' 6-max (real money) Seat #6 is the button
Seat 1: Fanfan21260 (2.07€)
Seat 2: slowreplay (2.57€)
Seat 3: CTMieuxAvant (3.47€)
Seat 4: Fried Berg (1.18€)
Seat 5: Ikigaivvv (2.36€)
Seat 6: Abec16 (1.85€)
*** ANTE/BLINDS ***
Fanfan21260 posts small blind 0.01€
slowreplay posts big blind 0.02€
Dealt to Fried Berg [Jh As]
*** PRE-FLOP *** 
CTMieuxAvant folds
Fried Berg raises 0.03€ to 0.05€
Ikigaivvv folds
Abec16 folds
Fanfan21260 folds
slowreplay folds
Fried Berg collected 0.08€ from pot
*** SUMMARY ***
Total pot 0.08€ | No rake
Seat 4: Fried Berg won 0.08€


Winamax Poker - HOLD-UP "Colorado" - HandId: #19116069-432810-1701510616 - Holdem no limit (0.01€/0.02€) - 2023/12/02 09:50:16 UTC
Table: 'Colorado' 6-max (real money) Seat #6 is the button
Seat 1: El Paellas (0.51€)
Seat 2: DosdeBras (1.91€)
Seat 3: swag-Morue73 (2€)
Seat 4: Melielvir (2.95€)
Seat 5: EYN PicPic (2.32€)
Seat 6: Fried Berg (1.21€)
*** ANTE/BLINDS ***
El Paellas posts small blind 0.01€
DosdeBras posts big blind 0.02€
Dealt to Fried Berg [2d Kd]
*** PRE-FLOP *** 
swag-Morue73 folds
Melielvir raises 0.04€ to 0.06€
EYN PicPic folds
Fried Berg folds
El Paellas folds
DosdeBras folds
Melielvir collected 0.09€ from pot
*** SUMMARY ***
Total pot 0.09€ | No rake
Seat 4: Melielvir won 0.09€


Winamax Poker - HOLD-UP "Colorado" - HandId: #19116069-432820-1701510625 - Holdem no limit (0.01€/0.02€) - 2023/12/02 09:50:25 UTC
Table: 'Colorado' 6-max (real money) Seat #6 is the button
Seat 1: CTMieuxAvant (3.45€)
Seat 2: Fried Berg (1.21€)
Seat 3: sopra61 (2.22€)
Seat 4: Rue115 (2.61€)
Seat 5: GwenLaGrise (3.47€)
Seat 6: pinfloi (0.93€)
Hold-up to Pot: total 0.10€
*** ANTE/BLINDS ***
CTMieuxAvant posts small blind 0.01€
Fried Berg posts big blind 0.02€
Dealt to Fried Berg [2c 3c]
*** PRE-FLOP *** 
sopra61 calls 0.02€
Rue115 raises 0.03€ to 0.05€
GwenLaGrise folds
pinfloi calls 0.05€
CTMieuxAvant folds
Fried Berg folds
sopra61 calls 0.03€
*** FLOP *** [Jh 3s 4s]
sopra61 bets 0.07€
Rue115 raises 0.10€ to 0.17€
pinfloi folds
sopra61 calls 0.10€
*** TURN *** [Jh 3s 4s][Ts]
sopra61 bets 0.31€
Rue115 folds
sopra61 collected 0.88€ from pot
*** SUMMARY ***
Total pot 0.88€ | Rake 0.05€
Board: [Jh 3s 4s Ts]
Seat 3: sopra61 won 0.88€


Winamax Poker - HOLD-UP "Colorado" - HandId: #19116069-432850-1701510650 - Holdem no limit (0.01€/0.02€) - 2023/12/02 09:50:50 UTC
Table: 'Colorado' 6-max (real money) Seat #6 is the button
Seat 1: Fried Berg (1.19€)
Seat 2: Tribuna38 (3.26€)
Seat 3: GwenLaGrise (2.28€)
Seat 4: jdeepenslip (3.53€)
Seat 5: El Paellas (0.50€)
Seat 6: Kallonys (2.34€)
*** ANTE/BLINDS ***
Fried Berg posts small blind 0.01€
Tribuna38 posts big blind 0.02€
Dealt to Fried Berg [6d 9h]
*** PRE-FLOP *** 
GwenLaGrise folds
jdeepenslip folds
El Paellas folds
Kallonys raises 0.03€ to 0.05€
Fried Berg folds
Tribuna38 folds
Kallonys collected 0.08€ from pot
*** SUMMARY ***
Total pot 0.08€ | No rake
Seat 6: Kallonys (button) won 0.08€


Winamax Poker - HOLD-UP "Colorado" - HandId: #19116069-432854-1701510653 - Holdem no limit (0.01€/0.02€) - 2023/12/02 09:50:53 UTC
Table: 'Colorado' 6-max (real money) Seat #6 is the button
Seat 1: BimBamFlop (2€)
Seat 2: scach-111 (3.94€)
Seat 3: elsrab (2.56€)
Seat 4: Manaiiss64 (0.60€)
Seat 5: Fried Berg (1.18€)
Seat 6: slowreplay (2€)
*** ANTE/BLINDS ***
BimBamFlop posts small blind 0.01€
scach-111 posts big blind 0.02€
Dealt to Fried Berg [3d 9c]
*** PRE-FLOP *** 
elsrab folds
Manaiiss64 folds
Fried Berg folds
slowreplay folds
BimBamFlop calls 0.01€
scach-111 checks
*** FLOP *** [Jh Kc 4d]
BimBamFlop checks
scach-111 checks
*** TURN *** [Jh Kc 4d][4s]
BimBamFlop bets 0.02€
scach-111 calls 0.02€
*** RIVER *** [Jh Kc 4d 4s][9d]
BimBamFlop bets 0.02€
scach-111 raises 0.07€ to 0.09€
BimBamFlop calls 0.07€
*** SHOW DOWN ***
BimBamFlop shows [Td Kh] (Two pairs : Kings and 4)
scach-111 shows [4c 8s] (Trips of 4)
scach-111 collected 0.23€ from pot
*** SUMMARY ***
Total pot 0.23€ | Rake 0.03€
Board: [Jh Kc 4d 4s 9d]
Seat 1: BimBamFlop (small blind) showed [Td Kh] and lost with Two pairs : Kings and 4
Seat 2: scach-111 (big blind) showed [4c 8s] and won 0.23€ with Trips of 4


Winamax Poker - HOLD-UP "Colorado" - HandId: #19116069-432856-1701510655 - Holdem no limit (0.01€/0.02€) - 2023/12/02 09:50:55 UTC
Table: 'Colorado' 6-max (real money) Seat #6 is the button
Seat 1: josep2170 (2.18€)
Seat 2: g8o8k8u (3.01€)
Seat 3: swag-Morue73 (1.93€)
Seat 4: Fried Berg (1.18€)
Seat 5: yam69 (5.49€)
Seat 6: CTMieuxAvant (4.36€)
*** ANTE/BLINDS ***
josep2170 posts small blind 0.01€
g8o8k8u posts big blind 0.02€
Dealt to Fried Berg [5s 6h]
*** PRE-FLOP *** 
swag-Morue73 folds
Fried Berg folds
yam69 folds
CTMieuxAvant raises 0.04€ to 0.06€
josep2170 raises 0.15€ to 0.21€
g8o8k8u folds
CTMieuxAvant calls 0.15€
*** FLOP *** [2s Jc 6d]
josep2170 bets 0.14€
CTMieuxAvant folds
josep2170 collected 0.54€ from pot
*** SUMMARY ***
Total pot 0.54€ | Rake 0.04€
Board: [2s Jc 6d]
Seat 1: josep2170 (small blind) won 0.54€


Winamax Poker - HOLD-UP "Colorado" - HandId: #19116069-432857-1701510656 - Holdem no limit (0.01€/0.02€) - 2023/12/02 09:50:56 UTC
Table: 'Colorado' 6-max (real money) Seat #6 is the button
Seat 1: 121 (2.13€)
Seat 2: Artorias (1.99€)
Seat 3: Fried Berg (1.18€)
Seat 4: Kito31 (6.53€)
Seat 5: Betiegarri (5.37€)
Seat 6: _FanZ_ (1.35€)
*** ANTE/BLINDS ***
121 posts small blind 0.01€
Artorias posts big blind 0.02€
Dealt to Fried Berg [Ah 7c]
*** PRE-FLOP *** 
Fried Berg folds
Kito31 folds
Betiegarri folds
_FanZ_ raises 0.03€ to 0.05€
121 folds
Artorias folds
_FanZ_ collected 0.08€ from pot
*** SUMMARY ***
Total pot 0.08€ | No rake
Seat 6: _FanZ_ (button) won 0.08€


Winamax Poker - HOLD-UP "Colorado" - HandId: #19116069-432865-1701510664 - Holdem no limit (0.01€/0.02€) - 2023/12/02 09:51:04 UTC
Table: 'Colorado' 6-max (real money) Seat #6 is the button
Seat 1: 2winchester (0.67€)
Seat 2: slowreplay (2€)
Seat 3: g8o8k8u (2.98€)
Seat 4: Lego-AAs (1.89€)
Seat 5: Fried Berg (1.18€)
Seat 6: TaBrEaMoI (2.25€)
*** ANTE/BLINDS ***
2winchester posts small blind 0.01€
slowreplay posts big blind 0.02€
Dealt to Fried Berg [2d 7s]
*** PRE-FLOP *** 
g8o8k8u folds
Lego-AAs folds
Fried Berg folds
TaBrEaMoI folds
2winchester folds
slowreplay collected 0.03€ from pot
*** SUMMARY ***
Total pot 0.03€ | No rake
Seat 2: slowreplay (big blind) won 0.03€


Winamax Poker - HOLD-UP "Colorado" - HandId: #19116069-432868-1701510665 - Holdem no limit (0.01€/0.02€) - 2023/12/02 09:51:05 UTC
Table: 'Colorado' 6-max (real money) Seat #6 is the button
Seat 1: swag-Morue73 (0.35€)
Seat 2: rick26 (1.34€)
Seat 3: g8o8k8u (2.98€)
Seat 4: Tribuna38 (3.24€)
Seat 5: 2winchester (0.66€)
Seat 6: Fried Berg (1.18€)
*** ANTE/BLINDS ***
swag-Morue73 posts small blind 0.01€
rick26 posts big blind 0.02€
Dealt to Fried Berg [5c 9h]
*** PRE-FLOP *** 
g8o8k8u raises 0.04€ to 0.06€
Tribuna38 folds
2winchester folds
Fried Berg folds
swag-Morue73 raises 0.12€ to 0.18€
rick26 folds
g8o8k8u folds
swag-Morue73 collected 0.26€ from pot
*** SUMMARY ***
Total pot 0.26€ | No rake
Seat 1: swag-Morue73 (small blind) won 0.26€


Winamax Poker - HOLD-UP "Colorado" - HandId: #19116069-432874-1701510669 - Holdem no limit (0.01€/0.02€) - 2023/12/02 09:51:09 UTC
Table: 'Colorado' 6-max (real money) Seat #6 is the button
Seat 1: Fried Berg (1.18€)
Seat 2: Kallonys (1.73€)
Seat 3: jjakpour (2.41€)
Seat 4: Ronan K (4.91€)
Seat 5: jdeepenslip (3.53€)
Seat 6: Merlus83 (2€)
*** ANTE/BLINDS ***
Fried Berg posts small blind 0.01€
Kallonys posts big blind 0.02€
Dealt to Fried Berg [Ah 6s]
*** PRE-FLOP *** 
jjakpour calls 0.02€
Ronan K folds
jdeepenslip folds
Merlus83 folds
Fried Berg calls 0.01€
Kallonys checks
*** FLOP *** [Ad 7s 7d]
Fried Berg checks
Kallonys bets 0.06€
jjakpour folds
Fried Berg calls 0.06€
*** TURN *** [Ad 7s 7d][8h]
Fried Berg checks
Kallonys bets 0.06€
Fried Berg calls 0.06€
*** RIVER *** [Ad 7s 7d 8h][Th]
Fried Berg checks
Kallonys bets 0.11€
Fried Berg calls 0.11€
*** SHOW DOWN ***
Fried Berg shows [Ah 6s] (Two pairs : Aces and 7)
Kallonys shows [7h 4d] (Trips of 7)
Kallonys collected 0.47€ from pot
*** SUMMARY ***
Total pot 0.47€ | Rake 0.05€
Board: [Ad 7s 7d 8h Th]
Seat 1: Fried Berg (small blind) showed [Ah 6s] and lost with Two pairs : Aces and 7
Seat 2: Kallonys (big blind) showed [7h 4d] and won 0.47€ with Trips of 7


Winamax Poker - HOLD-UP "Colorado" - HandId: #19116069-433024-1701510778 - Holdem no limit (0.01€/0.02€) - 2023/12/02 09:52:58 UTC
Table: 'Colorado' 6-max (real money) Seat #6 is the button
Seat 1: Pas1erreur (1.39€)
Seat 2: TaBrEaMoI (3.65€)
Seat 3: muespachois1 (1.26€)
Seat 4: lamuerta8300 (2.85€)
Seat 5: scach-111 (4.01€)
Seat 6: Fried Berg (0.93€)
Hold-up to Pot: total 0.10€
*** ANTE/BLINDS ***
Pas1erreur posts small blind 0.01€
TaBrEaMoI posts big blind 0.02€
Dealt to Fried Berg [4c Kc]
*** PRE-FLOP *** 
muespachois1 folds
lamuerta8300 raises 0.04€ to 0.06€
scach-111 raises 0.20€ to 0.26€
Fried Berg folds
Pas1erreur folds
TaBrEaMoI folds
lamuerta8300 folds
scach-111 collected 0.45€ from pot
*** SUMMARY ***
Total pot 0.45€ | No rake
Seat 5: scach-111 won 0.45€


Winamax Poker - HOLD-UP "Colorado" - HandId: #19116069-433046-1701510794 - Holdem no limit (0.01€/0.02€) - 2023/12/02 09:53:14 UTC
Table: 'Colorado' 6-max (real money) Seat #6 is the button
Seat 1: CTMieuxAvant (3.97€)
Seat 2: Fried Berg (0.93€)
Seat 3: AGALMMLA (1.30€)
Seat 4: Kito31 (6.63€)
Seat 5: slowreplay (2.59€)
Seat 6: Johnytop (2.45€)
*** ANTE/BLINDS ***
CTMieuxAvant posts small blind 0.01€
Fried Berg posts big blind 0.02€
Dealt to Fried Berg [7d 8s]
*** PRE-FLOP *** 
AGALMMLA raises 0.05€ to 0.07€
Kito31 folds
slowreplay folds
Johnytop folds
CTMieuxAvant folds
Fried Berg folds
AGALMMLA collected 0.10€ from pot
*** SUMMARY ***
Total pot 0.10€ | No rake
Seat 3: AGALMMLA won 0.10€


Winamax Poker - HOLD-UP "Colorado" - HandId: #19116069-433062-1701510806 - Holdem no limit (0.01€/0.02€) - 2023/12/02 09:53:26 UTC
Table: 'Colorado' 6-max (real money) Seat #6 is the button
Seat 1: -PHILG00D- (2.01€)
Seat 2: Ikigaivvv (3.07€)
Seat 3: Tuto_A_Posto (2.80€)
Seat 4: Fried Berg (0.91€)
Seat 5: Tribuna38 (3.23€)
Seat 6: 2winchester (0.58€)
*** ANTE/BLINDS ***
-PHILG00D- posts small blind 0.01€
Ikigaivvv posts big blind 0.02€
Dealt to Fried Berg [Qh Qc]
*** PRE-FLOP *** 
Tuto_A_Posto folds
Fried Berg raises 0.04€ to 0.06€
Tribuna38 folds
2winchester folds
-PHILG00D- folds
Ikigaivvv folds
Fried Berg collected 0.09€ from pot
*** SUMMARY ***
Total pot 0.09€ | No rake
Seat 4: Fried Berg won 0.09€


Winamax Poker - HOLD-UP "Colorado" - HandId: #19116069-433081-1701510816 - Holdem no limit (0.01€/0.02€) - 2023/12/02 09:53:36 UTC
Table: 'Colorado' 6-max (real money) Seat #6 is the button
Seat 1: lamuerta8300 (3.18€)
Seat 2: CTMieuxAvant (3.96€)
Seat 3: Fried Berg (0.94€)
Seat 4: PIQSOU (2€)
Seat 5: mixtep (2.37€)
Seat 6: slowreplay (2.44€)
*** ANTE/BLINDS ***
lamuerta8300 posts small blind 0.01€
CTMieuxAvant posts big blind 0.02€
Dealt to Fried Berg [Jh 2h]
*** PRE-FLOP *** 
Fried Berg folds
PIQSOU folds
mixtep folds
slowreplay raises 0.04€ to 0.06€
lamuerta8300 folds
CTMieuxAvant folds
slowreplay collected 0.09€ from pot
*** SUMMARY ***
Total pot 0.09€ | No rake
Seat 6: slowreplay (button) won 0.09€


Winamax Poker - HOLD-UP "Colorado" - HandId: #19116069-433085-1701510817 - Holdem no limit (0.01€/0.02€) - 2023/12/02 09:53:37 UTC
Table: 'Colorado' 6-max (real money) Seat #6 is the button
Seat 1: 49_3 (1.04€)
Seat 2: Polanskii (3.20€)
Seat 3: swag-Morue73 (1.84€)
Seat 4: scach-111 (2.12€)
Seat 5: Fried Berg (0.94€)
Seat 6: D13C (2.86€)
*** ANTE/BLINDS ***
49_3 posts small blind 0.01€
Polanskii posts big blind 0.02€
Dealt to Fried Berg [3s 3h]
*** PRE-FLOP *** 
swag-Morue73 folds
scach-111 folds
Fried Berg folds
D13C folds
49_3 folds
Polanskii collected 0.03€ from pot
*** SUMMARY ***
Total pot 0.03€ | No rake
Seat 2: Polanskii (big blind) won 0.03€


Winamax Poker - HOLD-UP "Colorado" - HandId: #19116069-433087-1701510819 - Holdem no limit (0.01€/0.02€) - 2023/12/02 09:53:39 UTC
Table: 'Colorado' 6-max (real money) Seat #6 is the button
Seat 1: Dit_Bondour (2.01€)
Seat 2: Fried Berg (0.94€)
Seat 3: Lego-AAs (1.48€)
Seat 4: I6pokerP4 (3.73€)
Seat 5: Pas1erreur (1.38€)
Seat 6: josep2170 (2.31€)
*** ANTE/BLINDS ***
Dit_Bondour posts small blind 0.01€
Fried Berg posts big blind 0.02€
Dealt to Fried Berg [3h 9s]
*** PRE-FLOP *** 
Lego-AAs raises 0.03€ to 0.05€
I6pokerP4 folds
Pas1erreur folds
josep2170 folds
Dit_Bondour folds
Fried Berg folds
Lego-AAs collected 0.08€ from pot
*** SUMMARY ***
Total pot 0.08€ | No rake
Seat 3: Lego-AAs won 0.08€


Winamax Poker - HOLD-UP "Colorado" - HandId: #19116069-433092-1701510822 - Holdem no limit (0.01€/0.02€) - 2023/12/02 09:53:42 UTC
Table: 'Colorado' 6-max (real money) Seat #6 is the button
Seat 1: Fanfan21260 (2.36€)
Seat 2: ComeOn75 (4.89€)
Seat 3: Ikigaivvv (3.75€)
Seat 4: kameleon73 (2€)
Seat 5: rick26 (1.97€)
Seat 6: Fried Berg (0.92€)
*** ANTE/BLINDS ***
Fanfan21260 posts small blind 0.01€
ComeOn75 posts big blind 0.02€
Dealt to Fried Berg [4c Jh]
*** PRE-FLOP *** 
Ikigaivvv folds
kameleon73 folds
rick26 folds
Fried Berg folds
Fanfan21260 calls 0.01€
ComeOn75 raises 0.04€ to 0.06€
Fanfan21260 calls 0.04€
*** FLOP *** [7h 6c 8h]
Fanfan21260 checks
ComeOn75 bets 0.04€
Fanfan21260 calls 0.04€
*** TURN *** [7h 6c 8h][Qh]
Fanfan21260 checks
ComeOn75 checks
*** RIVER *** [7h 6c 8h Qh][Th]
Fanfan21260 bets 0.20€
ComeOn75 folds
Fanfan21260 collected 0.38€ from pot
*** SUMMARY ***
Total pot 0.38€ | Rake 0.02€
Board: [7h 6c 8h Qh Th]
Seat 1: Fanfan21260 (small blind) won 0.38€


Winamax Poker - HOLD-UP "Colorado" - HandId: #19116069-433097-1701510825 - Holdem no limit (0.01€/0.02€) - 2023/12/02 09:53:45 UTC
Table: 'Colorado' 6-max (real money) Seat #6 is the button
Seat 1: Fried Berg (0.92€)
Seat 2: 49_3 (1.03€)
Seat 3: josep2170 (2€)
Seat 4: Dit_Bondour (2€)
Seat 5: Artorias (2.04€)
Seat 6: SashaTDouss (4.32€)
*** ANTE/BLINDS ***
Fried Berg posts small blind 0.01€
49_3 posts big blind 0.02€
Dealt to Fried Berg [5c 4s]
*** PRE-FLOP *** 
josep2170 raises 0.04€ to 0.06€
Dit_Bondour folds
Artorias folds
SashaTDouss calls 0.06€
Fried Berg folds
49_3 calls 0.04€
*** FLOP *** [9s Qc 7s]
49_3 bets 0.19€
josep2170 calls 0.19€
SashaTDouss folds
*** TURN *** [9s Qc 7s][6s]
49_3 checks
josep2170 checks
*** RIVER *** [9s Qc 7s 6s][2s]
49_3 checks
josep2170 checks
*** SHOW DOWN ***
josep2170 shows [Qd Kd] (One pair : Queens)
49_3 shows [6h Qh] (Two pairs : Queens and 6)
49_3 collected 0.51€ from pot
*** SUMMARY ***
Total pot 0.51€ | Rake 0.06€
Board: [9s Qc 7s 6s 2s]
Seat 2: 49_3 (big blind) showed [6h Qh] and won 0.51€ with Two pairs : Queens and 6
Seat 3: josep2170 showed [Qd Kd] and lost with One pair : Queens


Winamax Poker - HOLD-UP "Colorado" - HandId: #19116069-433101-1701510827 - Holdem no limit (0.01€/0.02€) - 2023/12/02 09:53:47 UTC
Table: 'Colorado' 6-max (real money) Seat #6 is the button
Seat 1: Fried Berg (0.91€)
Seat 2: sopra61 (2.49€)
Seat 3: Polanskii (3.21€)
Seat 4: BimBamFlop (4.13€)
Seat 5: kameleon73 (2€)
Seat 6: Petchou50 (5.05€)
*** ANTE/BLINDS ***
Fried Berg posts small blind 0.01€
sopra61 posts big blind 0.02€
Dealt to Fried Berg [3d Ac]
*** PRE-FLOP *** 
Polanskii folds
BimBamFlop raises 0.03€ to 0.05€
kameleon73 folds
Petchou50 raises 0.03€ to 0.08€
Fried Berg folds
sopra61 folds
BimBamFlop calls 0.03€
*** FLOP *** [Qh Jh 2c]
BimBamFlop checks
Petchou50 bets 0.07€
BimBamFlop calls 0.07€
*** TURN *** [Qh Jh 2c][5c]
BimBamFlop checks
Petchou50 bets 0.21€
BimBamFlop calls 0.21€
*** RIVER *** [Qh Jh 2c 5c][7h]
BimBamFlop checks
Petchou50 checks
*** SHOW DOWN ***
BimBamFlop shows [Qs Ks] (One pair : Queens)
Petchou50 shows [As Ad] (One pair : Aces)
Petchou50 collected 0.67€ from pot
*** SUMMARY ***
Total pot 0.67€ | Rake 0.08€
Board: [Qh Jh 2c 5c 7h]
Seat 4: BimBamFlop showed [Qs Ks] and lost with One pair : Queens
Seat 6: Petchou50 (button) showed [As Ad] and won 0.67€ with One pair : Aces


Winamax Poker - HOLD-UP "Colorado" - HandId: #19116069-433103-1701510829 - Holdem no limit (0.01€/0.02€) - 2023/12/02 09:53:49 UTC
Table: 'Colorado' 6-max (real money) Seat #6 is the button
Seat 1: Kallonys (1.95€)
Seat 2: rick26 (1.97€)
Seat 3: Fried Berg (0.90€)
Seat 4: mixtep (2.35€)
Seat 5: Polanskii (3.21€)
Seat 6: El Paellas (0.50€)
*** ANTE/BLINDS ***
Kallonys posts small blind 0.01€
rick26 posts big blind 0.02€
Dealt to Fried Berg [6c 6d]
*** PRE-FLOP *** 
Fried Berg raises 0.02€ to 0.04€
mixtep folds
Polanskii folds
El Paellas folds
Kallonys folds
rick26 folds
Fried Berg collected 0.07€ from pot
*** SUMMARY ***
Total pot 0.07€ | No rake
Seat 3: Fried Berg won 0.07€


Winamax Poker - HOLD-UP "Colorado" - HandId: #19116069-433118-1701510842 - Holdem no limit (0.01€/0.02€) - 2023/12/02 09:54:02 UTC
Table: 'Colorado' 6-max (real money) Seat #6 is the button
Seat 1: slowreplay (2.47€)
Seat 2: Samostheouf (0.50€)
Seat 3: scach-111 (2€)
Seat 4: CTMieuxAvant (4.12€)
Seat 5: Fried Berg (0.93€)
Seat 6: PIQSOU (2€)
*** ANTE/BLINDS ***
slowreplay posts small blind 0.01€
Samostheouf posts big blind 0.02€
Dealt to Fried Berg [7h 5s]
*** PRE-FLOP *** 
scach-111 folds
CTMieuxAvant folds
Fried Berg folds
PIQSOU raises 0.03€ to 0.05€
slowreplay folds
Samostheouf calls 0.03€
*** FLOP *** [Ts Kd Td]
Samostheouf checks
PIQSOU checks
*** TURN *** [Ts Kd Td][5h]
Samostheouf checks
PIQSOU checks
*** RIVER *** [Ts Kd Td 5h][7c]
Samostheouf checks
PIQSOU folds
Samostheouf collected 0.10€ from pot
*** SUMMARY ***
Total pot 0.10€ | Rake 0.01€
Board: [Ts Kd Td 5h 7c]
Seat 2: Samostheouf (big blind) won 0.10€


Winamax Poker - HOLD-UP "Colorado" - HandId: #19116069-433123-1701510844 - Holdem no limit (0.01€/0.02€) - 2023/12/02 09:54:04 UTC
Table: 'Colorado' 6-max (real money) Seat #6 is the button
Seat 1: Johnytop (2.41€)
Seat 2: Fried Berg (0.93€)
Seat 3: pinfloi (0.94€)
Seat 4: AGALMMLA (1.18€)
Seat 5: Zile741 (3.57€)
Seat 6: Full-AJA-89 (2.41€)
*** ANTE/BLINDS ***
Johnytop posts small blind 0.01€
Fried Berg posts big blind 0.02€
Dealt to Fried Berg [8c Qd]
*** PRE-FLOP *** 
pinfloi folds
AGALMMLA raises 0.05€ to 0.07€
Zile741 folds
Full-AJA-89 folds
Johnytop folds
Fried Berg folds
AGALMMLA collected 0.10€ from pot
*** SUMMARY ***
Total pot 0.10€ | No rake
Seat 4: AGALMMLA won 0.10€


Winamax Poker - HOLD-UP "Colorado" - HandId: #19116069-433131-1701510850 - Holdem no limit (0.01€/0.02€) - 2023/12/02 09:54:10 UTC
Table: 'Colorado' 6-max (real money) Seat #6 is the button
Seat 1: mixtep (2.33€)
Seat 2: MissLoulou (8.28€)
Seat 3: Kito31 (6.55€)
Seat 4: Fried Berg (0.91€)
Seat 5: CTMieuxAvant (4.12€)
Seat 6: jdeepenslip (2.84€)
*** ANTE/BLINDS ***
mixtep posts small blind 0.01€
MissLoulou posts big blind 0.02€
Dealt to Fried Berg [3c 6d]
*** PRE-FLOP *** 
Kito31 calls 0.02€
Fried Berg folds
CTMieuxAvant folds
jdeepenslip folds
mixtep folds
MissLoulou checks
*** FLOP *** [Kd Ac Qs]
MissLoulou checks
Kito31 checks
*** TURN *** [Kd Ac Qs][Ad]
MissLoulou checks
Kito31 checks
*** RIVER *** [Kd Ac Qs Ad][7d]
MissLoulou checks
Kito31 bets 6.53€ and is all-in
MissLoulou folds
Kito31 collected 6.57€ from pot
*** SUMMARY ***
Total pot 6.57€ | Rake 0.01€
Board: [Kd Ac Qs Ad 7d]
Seat 3: Kito31 won 6.57€


Winamax Poker - HOLD-UP "Colorado" - HandId: #19116069-433133-1701510851 - Holdem no limit (0.01€/0.02€) - 2023/12/02 09:54:11 UTC
Table: 'Colorado' 6-max (real money) Seat #6 is the button
Seat 1: mixtep (2.32€)
Seat 2: muespachois1 (1.45€)
Seat 3: Fried Berg (0.91€)
Seat 4: nico033 (2.07€)
Seat 5: Dit_Bondour (2€)
Seat 6: Fanfan21260 (2.44€)
*** ANTE/BLINDS ***
mixtep posts small blind 0.01€
muespachois1 posts big blind 0.02€
Dealt to Fried Berg [Td Ah]
*** PRE-FLOP *** 
Fried Berg raises 0.02€ to 0.04€
nico033 folds
Dit_Bondour folds
Fanfan21260 folds
mixtep folds
muespachois1 calls 0.02€
*** FLOP *** [6c 4s 5c]
muespachois1 checks
Fried Berg checks
*** TURN *** [6c 4s 5c][6s]
muespachois1 checks
Fried Berg checks
*** RIVER *** [6c 4s 5c 6s][Th]
muespachois1 checks
Fried Berg bets 0.02€
muespachois1 folds
Fried Berg collected 0.10€ from pot
*** SUMMARY ***
Total pot 0.10€ | Rake 0.01€
Board: [6c 4s 5c 6s Th]
Seat 3: Fried Berg won 0.10€


Winamax Poker - HOLD-UP "Colorado" - HandId: #19116069-433186-1701510881 - Holdem no limit (0.01€/0.02€) - 2023/12/02 09:54:41 UTC
Table: 'Colorado' 6-max (real money) Seat #6 is the button
Seat 1: Zile741 (3.81€)
Seat 2: Tuto_A_Posto (2.78€)
Seat 3: Solo. (2€)
Seat 4: GwenLaGrise (2.45€)
Seat 5: nico033 (2.06€)
Seat 6: Fried Berg (0.95€)
*** ANTE/BLINDS ***
Zile741 posts small blind 0.01€
Tuto_A_Posto posts big blind 0.02€
Dealt to Fried Berg [4h Ks]
*** PRE-FLOP *** 
Solo. raises 0.05€ to 0.07€
GwenLaGrise folds
nico033 folds
Fried Berg folds
Zile741 folds
Tuto_A_Posto folds
Solo. collected 0.10€ from pot
*** SUMMARY ***
Total pot 0.10€ | No rake
Seat 3: Solo. won 0.10€


Winamax Poker - HOLD-UP "Colorado" - HandId: #19116069-433193-1701510886 - Holdem no limit (0.01€/0.02€) - 2023/12/02 09:54:46 UTC
Table: 'Colorado' 6-max (real money) Seat #6 is the button
Seat 1: Fried Berg (0.95€)
Seat 2: Pas1erreur (1.93€)
Seat 3: jdeepenslip (2.79€)
Seat 4: josep2170 (2.07€)
Seat 5: scach-111 (2€)
Seat 6: Ikigaivvv (2.85€)
*** ANTE/BLINDS ***
Fried Berg posts small blind 0.01€
Pas1erreur posts big blind 0.02€
Dealt to Fried Berg [3s 6s]
*** PRE-FLOP *** 
jdeepenslip folds
josep2170 folds
scach-111 folds
Ikigaivvv raises 0.04€ to 0.06€
Fried Berg folds
Pas1erreur folds
Ikigaivvv collected 0.09€ from pot
*** SUMMARY ***
Total pot 0.09€ | No rake
Seat 6: Ikigaivvv (button) won 0.09€


Winamax Poker - HOLD-UP "Colorado" - HandId: #19116069-433204-1701510893 - Holdem no limit (0.01€/0.02€) - 2023/12/02 09:54:53 UTC
Table: 'Colorado' 6-max (real money) Seat #6 is the button
Seat 1: TaBrEaMoI (2€)
Seat 2: Kallonys (2.34€)
Seat 3: Johnytop (5.32€)
Seat 4: Fried Berg (0.94€)
Seat 5: Lego-AAs (1.49€)
Seat 6: BimBamFlop (2€)
*** ANTE/BLINDS ***
TaBrEaMoI posts small blind 0.01€
Kallonys posts big blind 0.02€
Dealt to Fried Berg [7d Kc]
*** PRE-FLOP *** 
Johnytop folds
Fried Berg folds
Lego-AAs folds
BimBamFlop folds
TaBrEaMoI folds
Kallonys collected 0.03€ from pot
*** SUMMARY ***
Total pot 0.03€ | No rake
Seat 2: Kallonys (big blind) won 0.03€


Winamax Poker - HOLD-UP "Colorado" - HandId: #19116069-433210-1701510897 - Holdem no limit (0.01€/0.02€) - 2023/12/02 09:54:57 UTC
Table: 'Colorado' 6-max (real money) Seat #6 is the button
Seat 1: D13C (2.71€)
Seat 2: Merlus83 (2.05€)
Seat 3: Johnytop (2€)
Seat 4: scach-111 (2.12€)
Seat 5: Fried Berg (0.94€)
Seat 6: I6pokerP4 (3.75€)
*** ANTE/BLINDS ***
D13C posts small blind 0.01€
Merlus83 posts big blind 0.02€
Dealt to Fried Berg [Qd 7c]
*** PRE-FLOP *** 
Johnytop folds
scach-111 folds
Fried Berg folds
I6pokerP4 raises 0.04€ to 0.06€
D13C folds
Merlus83 folds
I6pokerP4 collected 0.09€ from pot
*** SUMMARY ***
Total pot 0.09€ | No rake
Seat 6: I6pokerP4 (button) won 0.09€


Winamax Poker - HOLD-UP "Colorado" - HandId: #19116069-433223-1701510905 - Holdem no limit (0.01€/0.02€) - 2023/12/02 09:55:05 UTC
Table: 'Colorado' 6-max (real money) Seat #6 is the button
Seat 1: Alldid (0.60€)
Seat 2: Fried Berg (0.94€)
Seat 3: jdeepenslip (2.79€)
Seat 4: slowreplay (2€)
Seat 5: D13C (5.71€)
Seat 6: Dit_Bondour (2€)
*** ANTE/BLINDS ***
Alldid posts small blind 0.01€
Fried Berg posts big blind 0.02€
Dealt to Fried Berg [3s Qh]
*** PRE-FLOP *** 
jdeepenslip folds
slowreplay folds
D13C calls 0.02€
Dit_Bondour folds
Alldid folds
Fried Berg checks
*** FLOP *** [2d 7c Ts]
Fried Berg checks
D13C bets 0.02€
Fried Berg folds
D13C collected 0.06€ from pot
*** SUMMARY ***
Total pot 0.06€ | Rake 0.01€
Board: [2d 7c Ts]
Seat 5: D13C won 0.06€


Winamax Poker - HOLD-UP "Colorado" - HandId: #19116069-433258-1701510928 - Holdem no limit (0.01€/0.02€) - 2023/12/02 09:55:28 UTC
Table: 'Colorado' 6-max (real money) Seat #6 is the button
Seat 1: PIQSOU (2.09€)
Seat 2: LuckyLopez (2€)
Seat 3: CTMieuxAvant (3.41€)
Seat 4: Fried Berg (0.92€)
Seat 5: scach-111 (5.75€)
Seat 6: Pas1erreur (1.90€)
*** ANTE/BLINDS ***
PIQSOU posts small blind 0.01€
LuckyLopez posts big blind 0.02€
Dealt to Fried Berg [9d Qd]
*** PRE-FLOP *** 
CTMieuxAvant folds
Fried Berg calls 0.02€
scach-111 folds
Pas1erreur folds
PIQSOU folds
LuckyLopez raises 0.08€ to 0.10€
Fried Berg folds
LuckyLopez collected 0.13€ from pot
*** SUMMARY ***
Total pot 0.13€ | No rake
Seat 2: LuckyLopez (big blind) won 0.13€


Winamax Poker - HOLD-UP "Colorado" - HandId: #19116069-433315-1701510963 - Holdem no limit (0.01€/0.02€) - 2023/12/02 09:56:03 UTC
Table: 'Colorado' 6-max (real money) Seat #6 is the button
Seat 1: Fried Berg (0.90€)
Seat 2: Odieux Car4 (1.09€)
Seat 3: PIQSOU (2€)
Seat 4: Dit_Bondour (2€)
Seat 5: El Paellas (0.50€)
Seat 6: Abec16 (1.80€)
*** ANTE/BLINDS ***
Fried Berg posts small blind 0.01€
Odieux Car4 posts big blind 0.02€
Dealt to Fried Berg [Kd Ks]
*** PRE-FLOP *** 
PIQSOU raises 0.03€ to 0.05€
Dit_Bondour folds
El Paellas folds
Abec16 calls 0.05€
Fried Berg raises 0.10€ to 0.15€
Odieux Car4 folds
PIQSOU calls 0.10€
Abec16 calls 0.10€
*** FLOP *** [2d 8h 7c]
Fried Berg bets 0.16€
PIQSOU folds
Abec16 calls 0.16€
*** TURN *** [2d 8h 7c][Qd]
Fried Berg bets 0.20€
Abec16 folds
Fried Berg collected 0.91€ from pot
*** SUMMARY ***
Total pot 0.91€ | Rake 0.08€
Board: [2d 8h 7c Qd]
Seat 1: Fried Berg (small blind) won 0.91€


Winamax Poker - HOLD-UP "Colorado" - HandId: #19116069-433399-1701511023 - Holdem no limit (0.01€/0.02€) - 2023/12/02 09:57:03 UTC
Table: 'Colorado' 6-max (real money) Seat #6 is the button
Seat 1: Odieux Car4 (1.07€)
Seat 2: Ronan K (5.01€)
Seat 3: TaBrEaMoI (4.60€)
Seat 4: CTMieuxAvant (4.19€)
Seat 5: Fried Berg (1.30€)
Seat 6: pedrohxx (1.76€)
*** ANTE/BLINDS ***
Odieux Car4 posts small blind 0.01€
Ronan K posts big blind 0.02€
Dealt to Fried Berg [8c 2d]
*** PRE-FLOP *** 
TaBrEaMoI folds
CTMieuxAvant raises 0.02€ to 0.04€
Fried Berg folds
pedrohxx folds
Odieux Car4 folds
Ronan K folds
CTMieuxAvant collected 0.07€ from pot
*** SUMMARY ***
Total pot 0.07€ | No rake
Seat 4: CTMieuxAvant won 0.07€


Winamax Poker - HOLD-UP "Colorado" - HandId: #19116069-433408-1701511029 - Holdem no limit (0.01€/0.02€) - 2023/12/02 09:57:09 UTC
Table: 'Colorado' 6-max (real money) Seat #6 is the button
Seat 1: GwenLaGrise (2.32€)
Seat 2: Dit_Bondour (2€)
Seat 3: Fanfan21260 (2.74€)
Seat 4: djbassco (2.84€)
Seat 5: 49_3 (1.45€)
Seat 6: Fried Berg (1.30€)
*** ANTE/BLINDS ***
GwenLaGrise posts small blind 0.01€
Dit_Bondour posts big blind 0.02€
Dealt to Fried Berg [8c 3s]
*** PRE-FLOP *** 
Fanfan21260 folds
djbassco calls 0.02€
49_3 folds
Fried Berg folds
GwenLaGrise folds
Dit_Bondour checks
*** FLOP *** [4h Js Tc]
Dit_Bondour checks
djbassco bets 0.02€
Dit_Bondour raises 0.07€ to 0.09€
djbassco folds
Dit_Bondour collected 0.15€ from pot
*** SUMMARY ***
Total pot 0.15€ | Rake 0.01€
Board: [4h Js Tc]
Seat 2: Dit_Bondour (big blind) won 0.15€


Winamax Poker - HOLD-UP "Colorado" - HandId: #19116069-433415-1701511034 - Holdem no limit (0.01€/0.02€) - 2023/12/02 09:57:14 UTC
Table: 'Colorado' 6-max (real money) Seat #6 is the button
Seat 1: D13C (5.68€)
Seat 2: CTMieuxAvant (1.88€)
Seat 3: Fried Berg (1.30€)
Seat 4: sAArtouKK (2.02€)
Seat 5: _Lilli Rush (1.69€)
Seat 6: Fanfan21260 (2.74€)
*** ANTE/BLINDS ***
D13C posts small blind 0.01€
CTMieuxAvant posts big blind 0.02€
Dealt to Fried Berg [7s 8s]
*** PRE-FLOP *** 
Fried Berg raises 0.02€ to 0.04€
sAArtouKK folds
_Lilli Rush raises 0.02€ to 0.06€
Fanfan21260 folds
D13C folds
CTMieuxAvant folds
Fried Berg calls 0.02€
*** FLOP *** [Jh Tc 8c]
Fried Berg checks
_Lilli Rush bets 0.15€
Fried Berg folds
_Lilli Rush collected 0.28€ from pot
*** SUMMARY ***
Total pot 0.28€ | Rake 0.02€
Board: [Jh Tc 8c]
Seat 5: _Lilli Rush won 0.28€


Winamax Poker - HOLD-UP "Colorado" - HandId: #19116069-433447-1701511061 - Holdem no limit (0.01€/0.02€) - 2023/12/02 09:57:41 UTC
Table: 'Colorado' 6-max (real money) Seat #6 is the button
Seat 1: PIQSOU (2.29€)
Seat 2: Fried Berg (1.24€)
Seat 3: GwenLaGrise (2.29€)
Seat 4: TaBrEaMoI (3.67€)
Seat 5: slowreplay (2.03€)
Seat 6: Melielvir (3.24€)
*** ANTE/BLINDS ***
PIQSOU posts small blind 0.01€
Fried Berg posts big blind 0.02€
Dealt to Fried Berg [Js 4s]
*** PRE-FLOP *** 
GwenLaGrise folds
TaBrEaMoI folds
slowreplay folds
Melielvir folds
PIQSOU raises 0.03€ to 0.05€
Fried Berg folds
PIQSOU collected 0.07€ from pot
*** SUMMARY ***
Total pot 0.07€ | No rake
Seat 1: PIQSOU (small blind) won 0.07€


Winamax Poker - HOLD-UP "Colorado" - HandId: #19116069-433473-1701511081 - Holdem no limit (0.01€/0.02€) - 2023/12/02 09:58:01 UTC
Table: 'Colorado' 6-max (real money) Seat #6 is the button
Seat 1: El Paellas (0.50€)
Seat 2: TaBrEaMoI (2.84€)
Seat 3: LuckyLopez (2€)
Seat 4: slowreplay (2.39€)
Seat 5: lamuerta8300 (3.90€)
Seat 6: Fried Berg (1.22€)
*** ANTE/BLINDS ***
El Paellas posts small blind 0.01€
TaBrEaMoI posts big blind 0.02€
Dealt to Fried Berg [Jc 7c]
*** PRE-FLOP *** 
LuckyLopez raises 0.04€ to 0.06€
slowreplay calls 0.06€
lamuerta8300 folds
Fried Berg folds
El Paellas folds
TaBrEaMoI folds
*** FLOP *** [6h 7d Ts]
LuckyLopez checks
slowreplay bets 0.15€
LuckyLopez folds
slowreplay collected 0.28€ from pot
*** SUMMARY ***
Total pot 0.28€ | Rake 0.02€
Board: [6h 7d Ts]
Seat 4: slowreplay won 0.28€


Winamax Poker - HOLD-UP "Colorado" - HandId: #19116069-433510-1701511105 - Holdem no limit (0.01€/0.02€) - 2023/12/02 09:58:25 UTC
Table: 'Colorado' 6-max (real money) Seat #6 is the button
Seat 1: Dit_Bondour (2.05€)
Seat 2: TaBrEaMoI (2.82€)
Seat 3: Fried Berg (1.22€)
Seat 4: scach-111 (2€)
Seat 5: Pat Poker 73 (2.20€)
Seat 6: Johnytop (2.51€)
*** ANTE/BLINDS ***
Dit_Bondour posts small blind 0.01€
TaBrEaMoI posts big blind 0.02€
Dealt to Fried Berg [2d Ad]
*** PRE-FLOP *** 
Fried Berg folds
scach-111 folds
Pat Poker 73 folds
Johnytop raises 0.03€ to 0.05€
Dit_Bondour folds
TaBrEaMoI calls 0.03€
*** FLOP *** [9s 2h 7c]
TaBrEaMoI checks
Johnytop checks
*** TURN *** [9s 2h 7c][Ks]
TaBrEaMoI checks
Johnytop bets 0.05€
TaBrEaMoI calls 0.05€
*** RIVER *** [9s 2h 7c Ks][Qs]
TaBrEaMoI checks
Johnytop checks
*** SHOW DOWN ***
Johnytop shows [Ah 7d] (One pair : 7)
TaBrEaMoI shows [As 3s] (Flush Ace high)
TaBrEaMoI collected 0.19€ from pot
*** SUMMARY ***
Total pot 0.19€ | Rake 0.02€
Board: [9s 2h 7c Ks Qs]
Seat 2: TaBrEaMoI (big blind) showed [As 3s] and won 0.19€ with Flush Ace high
Seat 6: Johnytop (button) showed [Ah 7d] and lost with One pair : 7


Winamax Poker - HOLD-UP "Colorado" - HandId: #19116069-433521-1701511111 - Holdem no limit (0.01€/0.02€) - 2023/12/02 09:58:31 UTC
Table: 'Colorado' 6-max (real money) Seat #6 is the button
Seat 1: Fefekalome (2€)
Seat 2: CB-Joker6274 (0.71€)
Seat 3: Odieux Car4 (1.29€)
Seat 4: Dit_Bondour (2.04€)
Seat 5: Fried Berg (1.22€)
Seat 6: AAlwinkk (2€)
*** ANTE/BLINDS ***
Fefekalome posts small blind 0.01€
CB-Joker6274 posts big blind 0.02€
Dealt to Fried Berg [Qc Qs]
*** PRE-FLOP *** 
Odieux Car4 folds
Dit_Bondour folds
Fried Berg raises 0.03€ to 0.05€
AAlwinkk calls 0.05€
Fefekalome folds
CB-Joker6274 calls 0.03€
*** FLOP *** [2c Kh 7d]
CB-Joker6274 checks
Fried Berg bets 0.08€
AAlwinkk folds
CB-Joker6274 folds
Fried Berg collected 0.22€ from pot
*** SUMMARY ***
Total pot 0.22€ | Rake 0.02€
Board: [2c Kh 7d]
Seat 5: Fried Berg won 0.22€


Winamax Poker - HOLD-UP "Colorado" - HandId: #19116069-433574-1701511142 - Holdem no limit (0.01€/0.02€) - 2023/12/02 09:59:02 UTC
Table: 'Colorado' 6-max (real money) Seat #6 is the button
Seat 1: MaryAthena (0.50€)
Seat 2: MONEYFOREVER (2.07€)
Seat 3: Dit_Bondour (2.27€)
Seat 4: LuckyLopez (2.28€)
Seat 5: Fried Berg (1.31€)
Seat 6: Artorias (3.41€)
*** ANTE/BLINDS ***
MaryAthena posts small blind 0.01€
MONEYFOREVER posts big blind 0.02€
Dealt to Fried Berg [9d 7s]
*** PRE-FLOP *** 
Dit_Bondour folds
LuckyLopez folds
Fried Berg folds
Artorias folds
MaryAthena calls 0.01€
MONEYFOREVER checks
*** FLOP *** [Ad Qh 4c]
MaryAthena checks
MONEYFOREVER bets 0.02€
MaryAthena folds
MONEYFOREVER collected 0.06€ from pot
*** SUMMARY ***
Total pot 0.06€ | No rake
Board: [Ad Qh 4c]
Seat 2: MONEYFOREVER (big blind) won 0.06€


Winamax Poker - HOLD-UP "Colorado" - HandId: #19116069-433583-1701511148 - Holdem no limit (0.01€/0.02€) - 2023/12/02 09:59:08 UTC
Table: 'Colorado' 6-max (real money) Seat #6 is the button
Seat 1: popoche29 (10.77€)
Seat 2: Fried Berg (1.31€)
Seat 3: _FanZ_ (4.42€)
Seat 4: Artorias (3.40€)
Seat 5: The parias (2.05€)
Seat 6: MissLoulou (4.85€)
*** ANTE/BLINDS ***
popoche29 posts small blind 0.01€
Fried Berg posts big blind 0.02€
Dealt to Fried Berg [7s 8d]
*** PRE-FLOP *** 
_FanZ_ folds
Artorias folds
The parias calls 0.02€
MissLoulou folds
popoche29 folds
Fried Berg checks
*** FLOP *** [Td Ad Qs]
Fried Berg checks
The parias bets 0.02€
Fried Berg folds
The parias collected 0.06€ from pot
*** SUMMARY ***
Total pot 0.06€ | Rake 0.01€
Board: [Td Ad Qs]
Seat 5: The parias won 0.06€


Winamax Poker - HOLD-UP "Colorado" - HandId: #19116069-433631-1701511181 - Holdem no limit (0.01€/0.02€) - 2023/12/02 09:59:41 UTC
Table: 'Colorado' 6-max (real money) Seat #6 is the button
Seat 1: Fried Berg (1.29€)
Seat 2: D13C (2€)
Seat 3: Pas1erreur (1.35€)
Seat 4: slowreplay (2€)
Seat 5: LuckyLopez (4.39€)
Seat 6: josep2170 (2.52€)
*** ANTE/BLINDS ***
Fried Berg posts small blind 0.01€
D13C posts big blind 0.02€
Dealt to Fried Berg [7d 7s]
*** PRE-FLOP *** 
Pas1erreur raises 0.03€ to 0.05€
slowreplay folds
LuckyLopez folds
josep2170 folds
Fried Berg calls 0.04€
D13C calls 0.03€
*** FLOP *** [3c Kd Qs]
Fried Berg checks
D13C checks
Pas1erreur bets 0.10€
Fried Berg folds
D13C calls 0.10€
*** TURN *** [3c Kd Qs][7h]
D13C checks
Pas1erreur bets 0.26€
D13C folds
Pas1erreur collected 0.57€ from pot
*** SUMMARY ***
Total pot 0.57€ | Rake 0.04€
Board: [3c Kd Qs 7h]
Seat 3: Pas1erreur won 0.57€


Winamax Poker - HOLD-UP "Colorado" - HandId: #19116069-433678-1701511215 - Holdem no limit (0.01€/0.02€) - 2023/12/02 10:00:15 UTC
Table: 'Colorado' 6-max (real money) Seat #6 is the button
Seat 1: rick26 (1.60€)
Seat 2: _Lilli Rush (1.91€)
Seat 3: Tribuna38 (5.22€)
Seat 4: Fried Berg (1.24€)
Seat 5: Dit_Bondour (2.11€)
Seat 6: Zile741 (3.98€)
*** ANTE/BLINDS ***
rick26 posts small blind 0.01€
_Lilli Rush posts big blind 0.02€
Dealt to Fried Berg [2c 8d]
*** PRE-FLOP *** 
Tribuna38 folds
Fried Berg folds
Dit_Bondour folds
Zile741 raises 0.03€ to 0.05€
rick26 folds
_Lilli Rush folds
Zile741 collected 0.08€ from pot
*** SUMMARY ***
Total pot 0.08€ | No rake
Seat 6: Zile741 (button) won 0.08€


Winamax Poker - HOLD-UP "Colorado" - HandId: #19116069-433702-1701511230 - Holdem no limit (0.01€/0.02€) - 2023/12/02 10:00:30 UTC
Table: 'Colorado' 6-max (real money) Seat #6 is the button
Seat 1: Kallonys (2.74€)
Seat 2: The parias (1.90€)
Seat 3: Fried Berg (1.24€)
Seat 4: Chacal-Punk (4.63€)
Seat 5: rick26 (1.59€)
Seat 6: MaryAthena (0.32€)
*** ANTE/BLINDS ***
Kallonys posts small blind 0.01€
The parias posts big blind 0.02€
Dealt to Fried Berg [2s Qh]
*** PRE-FLOP *** 
Fried Berg folds
Chacal-Punk folds
rick26 folds
MaryAthena folds
Kallonys folds
The parias collected 0.03€ from pot
*** SUMMARY ***
Total pot 0.03€ | No rake
Seat 2: The parias (big blind) won 0.03€


Winamax Poker - HOLD-UP "Colorado" - HandId: #19116069-433711-1701511239 - Holdem no limit (0.01€/0.02€) - 2023/12/02 10:00:39 UTC
Table: 'Colorado' 6-max (real money) Seat #6 is the button
Seat 1: _FanZ_ (4.35€)
Seat 2: Chacal-Punk (4.61€)
Seat 3: LuckyLopez (2€)
Seat 4: El Paellas (0.51€)
Seat 5: sopra61 (2.50€)
Seat 6: Fried Berg (1.24€)
*** ANTE/BLINDS ***
_FanZ_ posts small blind 0.01€
Chacal-Punk posts big blind 0.02€
Dealt to Fried Berg [7h 5h]
*** PRE-FLOP *** 
LuckyLopez folds
El Paellas folds
sopra61 folds
Fried Berg raises 0.02€ to 0.04€
_FanZ_ folds
Chacal-Punk folds
Fried Berg collected 0.07€ from pot
*** SUMMARY ***
Total pot 0.07€ | No rake
Seat 6: Fried Berg (button) won 0.07€


Winamax Poker - HOLD-UP "Colorado" - HandId: #19116069-433724-1701511249 - Holdem no limit (0.01€/0.02€) - 2023/12/02 10:00:49 UTC
Table: 'Colorado' 6-max (real money) Seat #6 is the button
Seat 1: sAArtouKK (2.54€)
Seat 2: pedrohxx (2.30€)
Seat 3: Ikigaivvv (3.24€)
Seat 4: Johnytop (2.33€)
Seat 5: Fried Berg (1.27€)
Seat 6: Dit_Bondour (2.14€)
*** ANTE/BLINDS ***
sAArtouKK posts small blind 0.01€
pedrohxx posts big blind 0.02€
Dealt to Fried Berg [3d Tc]
*** PRE-FLOP *** 
Ikigaivvv folds
Johnytop folds
Fried Berg folds
Dit_Bondour folds
sAArtouKK folds
pedrohxx collected 0.03€ from pot
*** SUMMARY ***
Total pot 0.03€ | No rake
Seat 2: pedrohxx (big blind) won 0.03€


Winamax Poker - HOLD-UP "Colorado" - HandId: #19116069-433744-1701511262 - Holdem no limit (0.01€/0.02€) - 2023/12/02 10:01:02 UTC
Table: 'Colorado' 6-max (real money) Seat #6 is the button
Seat 1: CB-Joker6274 (0.62€)
Seat 2: lamuerta8300 (1.34€)
Seat 3: Fefekalome (2€)
Seat 4: Pas1erreur (1.43€)
Seat 5: Fried Berg (1.27€)
Seat 6: sAArtouKK (2.01€)
*** ANTE/BLINDS ***
CB-Joker6274 posts small blind 0.01€
lamuerta8300 posts big blind 0.02€
Dealt to Fried Berg [Qs Jd]
*** PRE-FLOP *** 
Fefekalome folds
Pas1erreur folds
Fried Berg raises 0.02€ to 0.04€
sAArtouKK folds
CB-Joker6274 folds
lamuerta8300 calls 0.02€
*** FLOP *** [7s Tc 3s]
lamuerta8300 checks
Fried Berg bets 0.04€
lamuerta8300 calls 0.04€
*** TURN *** [7s Tc 3s][Td]
lamuerta8300 bets 0.12€
Fried Berg folds
lamuerta8300 collected 0.27€ from pot
*** SUMMARY ***
Total pot 0.27€ | Rake 0.02€
Board: [7s Tc 3s Td]
Seat 2: lamuerta8300 (big blind) won 0.27€


Winamax Poker - HOLD-UP "Colorado" - HandId: #19116069-433825-1701511312 - Holdem no limit (0.01€/0.02€) - 2023/12/02 10:01:52 UTC
Table: 'Colorado' 6-max (real money) Seat #6 is the button
Seat 1: Dit_Bondour (2€)
Seat 2: Fried Berg (1.19€)
Seat 3: Chacal-Punk (4.31€)
Seat 4: D13C (6.46€)
Seat 5: Melielvir (3.45€)
Seat 6: LuckyLopez (2€)
*** ANTE/BLINDS ***
Dit_Bondour posts small blind 0.01€
Fried Berg posts big blind 0.02€
Dealt to Fried Berg [4h 7d]
*** PRE-FLOP *** 
Chacal-Punk folds
D13C folds
Melielvir folds
LuckyLopez raises 0.04€ to 0.06€
Dit_Bondour folds
Fried Berg folds
LuckyLopez collected 0.09€ from pot
*** SUMMARY ***
Total pot 0.09€ | No rake
Seat 6: LuckyLopez (button) won 0.09€


Winamax Poker - HOLD-UP "Colorado" - HandId: #19116069-433836-1701511318 - Holdem no limit (0.01€/0.02€) - 2023/12/02 10:01:58 UTC
Table: 'Colorado' 6-max (real money) Seat #6 is the button
Seat 1: Fried Berg (1.17€)
Seat 2: TaBrEaMoI (2.65€)
Seat 3: elsrab (3.83€)
Seat 4: GwenLaGrise (2€)
Seat 5: JPB73 (1.02€)
Seat 6: Ipiz (1.50€)
*** ANTE/BLINDS ***
Fried Berg posts small blind 0.01€
TaBrEaMoI posts big blind 0.02€
Dealt to Fried Berg [Jh 8s]
*** PRE-FLOP *** 
elsrab raises 0.02€ to 0.04€
GwenLaGrise folds
JPB73 calls 0.04€
Ipiz folds
Fried Berg folds
TaBrEaMoI folds
*** FLOP *** [3h 7s 7c]
elsrab checks
JPB73 checks
*** TURN *** [3h 7s 7c][8c]
elsrab bets 0.04€
JPB73 calls 0.04€
*** RIVER *** [3h 7s 7c 8c][Qs]
elsrab bets 0.10€
JPB73 calls 0.10€
*** SHOW DOWN ***
JPB73 shows [Ac 8h] (Two pairs : 8 and 7)
elsrab shows [Qd 8d] (Two pairs : Queens and 8)
elsrab collected 0.35€ from pot
*** SUMMARY ***
Total pot 0.35€ | Rake 0.04€
Board: [3h 7s 7c 8c Qs]
Seat 3: elsrab showed [Qd 8d] and won 0.35€ with Two pairs : Queens and 8
Seat 5: JPB73 showed [Ac 8h] and lost with Two pairs : 8 and 7


Winamax Poker - HOLD-UP "Colorado" - HandId: #19116069-433844-1701511323 - Holdem no limit (0.01€/0.02€) - 2023/12/02 10:02:03 UTC
Table: 'Colorado' 6-max (real money) Seat #6 is the button
Seat 1: GwenLaGrise (2€)
Seat 2: Jdeepenjeans (1€)
Seat 3: popoche29 (10.68€)
Seat 4: Fried Berg (1.16€)
Seat 5: PIQSOU (3.66€)
Seat 6: HenriGuyBet (2€)
*** ANTE/BLINDS ***
GwenLaGrise posts small blind 0.01€
Jdeepenjeans posts big blind 0.02€
Dealt to Fried Berg [5h Td]
*** PRE-FLOP *** 
popoche29 folds
Fried Berg folds
PIQSOU folds
HenriGuyBet folds
GwenLaGrise folds
Jdeepenjeans collected 0.03€ from pot
*** SUMMARY ***
Total pot 0.03€ | No rake
Seat 2: Jdeepenjeans (big blind) won 0.03€


Winamax Poker - HOLD-UP "Colorado" - HandId: #19116069-433856-1701511331 - Holdem no limit (0.01€/0.02€) - 2023/12/02 10:02:11 UTC
Table: 'Colorado' 6-max (real money) Seat #6 is the button
Seat 1: elx111 (2.72€)
Seat 2: MissLoulou (5.14€)
Seat 3: Fried Berg (1.16€)
Seat 4: Chacal-Punk (4.29€)
Seat 5: jdeepenslip (2.69€)
Seat 6: _Lilli Rush (2.19€)
*** ANTE/BLINDS ***
elx111 posts small blind 0.01€
MissLoulou posts big blind 0.02€
Dealt to Fried Berg [5c Kh]
*** PRE-FLOP *** 
Fried Berg folds
Chacal-Punk folds
jdeepenslip folds
_Lilli Rush folds
elx111 raises 0.03€ to 0.05€
MissLoulou calls 0.03€
*** FLOP *** [7s 6s 6c]
elx111 bets 0.04€
MissLoulou calls 0.04€
*** TURN *** [7s 6s 6c][8h]
elx111 checks
MissLoulou bets 0.06€
elx111 calls 0.06€
*** RIVER *** [7s 6s 6c 8h][6h]
elx111 checks
MissLoulou bets 0.30€
elx111 calls 0.30€
*** SHOW DOWN ***
elx111 shows [Qd Ad] (Trips of 6)
MissLoulou shows [8c Ah] (Full of 6 and 8)
MissLoulou collected 0.81€ from pot
*** SUMMARY ***
Total pot 0.81€ | Rake 0.09€
Board: [7s 6s 6c 8h 6h]
Seat 1: elx111 (small blind) showed [Qd Ad] and lost with Trips of 6
Seat 2: MissLoulou (big blind) showed [8c Ah] and won 0.81€ with Full of 6 and 8


Winamax Poker - HOLD-UP "Colorado" - HandId: #19116069-433880-1701511350 - Holdem no limit (0.01€/0.02€) - 2023/12/02 10:02:30 UTC
Table: 'Colorado' 6-max (real money) Seat #6 is the button
Seat 1: 121 (2€)
Seat 2: PIQSOU (2.06€)
Seat 3: maniz66 (0.45€)
Seat 4: Fried Berg (1.16€)
Seat 5: viins42 (4.04€)
Seat 6: D13C (2.05€)
*** ANTE/BLINDS ***
121 posts small blind 0.01€
PIQSOU posts big blind 0.02€
Dealt to Fried Berg [9s Jh]
*** PRE-FLOP *** 
maniz66 folds
Fried Berg folds
viins42 raises 0.02€ to 0.04€
D13C folds
121 folds
PIQSOU folds
viins42 collected 0.07€ from pot
*** SUMMARY ***
Total pot 0.07€ | No rake
Seat 5: viins42 won 0.07€


Winamax Poker - HOLD-UP "Colorado" - HandId: #19116069-433894-1701511361 - Holdem no limit (0.01€/0.02€) - 2023/12/02 10:02:41 UTC
Table: 'Colorado' 6-max (real money) Seat #6 is the button
Seat 1: ComeOn75 (2.03€)
Seat 2: popoche29 (10.61€)
Seat 3: Ipiz (1.57€)
Seat 4: CB-Joker6274 (0.72€)
Seat 5: Fried Berg (1.16€)
Seat 6: El Paellas (0.53€)
Hold-up to Pot: total 0.10€
*** ANTE/BLINDS ***
ComeOn75 posts small blind 0.01€
popoche29 posts big blind 0.02€
Dealt to Fried Berg [Kd 4d]
*** PRE-FLOP *** 
Ipiz raises 0.04€ to 0.06€
CB-Joker6274 calls 0.06€
Fried Berg folds
El Paellas folds
ComeOn75 raises 1.97€ to 2.03€ and is all-in
popoche29 folds
Ipiz calls 1.51€ and is all-in
CB-Joker6274 calls 0.66€ and is all-in
*** FLOP *** [7d 3s 3d]
*** TURN *** [7d 3s 3d][4c]
*** RIVER *** [7d 3s 3d 4c][Jc]
*** SHOW DOWN ***
ComeOn75 shows [8c Tc] (One pair : 3)
Ipiz shows [Ks Ac] (One pair : 3)
CB-Joker6274 shows [7h Qh] (Two pairs : 7 and 3)
CB-Joker6274 collected 2.06€ from main pot
Ipiz collected 1.53€ from side pot 1
ComeOn75 collected 0.46€ from side pot 2
*** SUMMARY ***
Total pot 4.05€ | Rake 0.39€
Board: [7d 3s 3d 4c Jc]
Seat 1: ComeOn75 (small blind) showed [8c Tc] and won 0.46€ with One pair : 3
Seat 3: Ipiz showed [Ks Ac] and won 1.53€ with One pair : 3
Seat 4: CB-Joker6274 showed [7h Qh] and won 2.06€ with Two pairs : 7 and 3


Winamax Poker - HOLD-UP "Colorado" - HandId: #19116069-433914-1701511373 - Holdem no limit (0.01€/0.02€) - 2023/12/02 10:02:53 UTC
Table: 'Colorado' 6-max (real money) Seat #6 is the button
Seat 1: Dit_Bondour (2.30€)
Seat 2: Fried Berg (1.16€)
Seat 3: Odieux Car4 (1.38€)
Seat 4: nico033 (1.90€)
Seat 5: lamuerta8300 (2.68€)
Seat 6: D13C (6.46€)
*** ANTE/BLINDS ***
Dit_Bondour posts small blind 0.01€
Fried Berg posts big blind 0.02€
Dealt to Fried Berg [Ts Ad]
*** PRE-FLOP *** 
Odieux Car4 folds
nico033 folds
lamuerta8300 folds
D13C folds
Dit_Bondour folds
Fried Berg collected 0.03€ from pot
*** SUMMARY ***
Total pot 0.03€ | No rake
Seat 2: Fried Berg (big blind) won 0.03€


Winamax Poker - HOLD-UP "Colorado" - HandId: #19116069-433949-1701511392 - Holdem no limit (0.01€/0.02€) - 2023/12/02 10:03:12 UTC
Table: 'Colorado' 6-max (real money) Seat #6 is the button
Seat 1: Dit_Bondour (2.01€)
Seat 2: LuckyLopez (2.37€)
Seat 3: PIQSOU (2.83€)
Seat 4: D13C (2€)
Seat 5: Johnytop (3€)
Seat 6: Fried Berg (1.17€)
*** ANTE/BLINDS ***
Dit_Bondour posts small blind 0.01€
LuckyLopez posts big blind 0.02€
Dealt to Fried Berg [Jh 6s]
*** PRE-FLOP *** 
PIQSOU folds
D13C folds
Johnytop raises 0.03€ to 0.05€
Fried Berg folds
Dit_Bondour folds
LuckyLopez folds
Johnytop collected 0.08€ from pot
*** SUMMARY ***
Total pot 0.08€ | No rake
Seat 5: Johnytop won 0.08€


Winamax Poker - HOLD-UP "Colorado" - HandId: #19116069-433963-1701511401 - Holdem no limit (0.01€/0.02€) - 2023/12/02 10:03:21 UTC
Table: 'Colorado' 6-max (real money) Seat #6 is the button
Seat 1: Fried Berg (1.17€)
Seat 2: elsrab (2.92€)
Seat 3: MissLoulou (5.41€)
Seat 4: PIQSOU (3.66€)
Seat 5: rick26 (1.03€)
Seat 6: D13C (2€)
*** ANTE/BLINDS ***
Fried Berg posts small blind 0.01€
elsrab posts big blind 0.02€
Dealt to Fried Berg [6c Jc]
*** PRE-FLOP *** 
MissLoulou folds
PIQSOU folds
rick26 folds
D13C raises 0.02€ to 0.04€
Fried Berg folds
elsrab calls 0.02€
*** FLOP *** [7h 2c Qs]
elsrab checks
D13C bets 0.06€
elsrab folds
D13C collected 0.14€ from pot
*** SUMMARY ***
Total pot 0.14€ | Rake 0.01€
Board: [7h 2c Qs]
Seat 6: D13C (button) won 0.14€


Winamax Poker - HOLD-UP "Colorado" - HandId: #19116069-433994-1701511417 - Holdem no limit (0.01€/0.02€) - 2023/12/02 10:03:37 UTC
Table: 'Colorado' 6-max (real money) Seat #6 is the button
Seat 1: Fried Berg (1.16€)
Seat 2: briben21 (2.29€)
Seat 3: PIQSOU (3.65€)
Seat 4: Full-AJA-89 (3.45€)
Seat 5: Tribuna38 (5.42€)
Seat 6: durba (0.97€)
*** ANTE/BLINDS ***
Fried Berg posts small blind 0.01€
briben21 posts big blind 0.02€
Dealt to Fried Berg [7s 6s]
*** PRE-FLOP *** 
PIQSOU raises 0.03€ to 0.05€
Full-AJA-89 folds
Tribuna38 calls 0.05€
durba folds
Fried Berg calls 0.04€
briben21 folds
*** FLOP *** [7h 3h 9s]
Fried Berg checks
PIQSOU bets 0.06€
Tribuna38 calls 0.06€
Fried Berg folds
*** TURN *** [7h 3h 9s][7c]
PIQSOU bets 0.22€
Tribuna38 folds
PIQSOU collected 0.48€ from pot
*** SUMMARY ***
Total pot 0.48€ | Rake 0.03€
Board: [7h 3h 9s 7c]
Seat 3: PIQSOU won 0.48€


Winamax Poker - HOLD-UP "Colorado" - HandId: #19116069-434031-1701511442 - Holdem no limit (0.01€/0.02€) - 2023/12/02 10:04:02 UTC
Table: 'Colorado' 6-max (real money) Seat #6 is the button
Seat 1: Johnytop (6.44€)
Seat 2: lefraisier (1.61€)
Seat 3: Fried Berg (1.11€)
Seat 4: Jdeepenjeans (0.99€)
Seat 5: Melielvir (3.78€)
Seat 6: mea botellas (2.22€)
*** ANTE/BLINDS ***
Johnytop posts small blind 0.01€
lefraisier posts big blind 0.02€
Dealt to Fried Berg [5h 3d]
*** PRE-FLOP *** 
Fried Berg folds
Jdeepenjeans raises 0.03€ to 0.05€
Melielvir folds
mea botellas folds
Johnytop folds
lefraisier calls 0.03€
*** FLOP *** [6h Qs Jd]
lefraisier checks
Jdeepenjeans checks
*** TURN *** [6h Qs Jd][8c]
lefraisier checks
Jdeepenjeans checks
*** RIVER *** [6h Qs Jd 8c][Kd]
lefraisier checks
Jdeepenjeans checks
*** SHOW DOWN ***
Jdeepenjeans shows [2d 5d] (High card : King)
lefraisier shows [6c 9s] (One pair : 6)
lefraisier collected 0.10€ from pot
*** SUMMARY ***
Total pot 0.10€ | Rake 0.01€
Board: [6h Qs Jd 8c Kd]
Seat 2: lefraisier (big blind) showed [6c 9s] and won 0.10€ with One pair : 6
Seat 4: Jdeepenjeans showed [2d 5d] and lost with High card : King


Winamax Poker - HOLD-UP "Colorado" - HandId: #19116069-434038-1701511446 - Holdem no limit (0.01€/0.02€) - 2023/12/02 10:04:06 UTC
Table: 'Colorado' 6-max (real money) Seat #6 is the button
Seat 1: El Paellas (0.52€)
Seat 2: Fried Berg (1.11€)
Seat 3: WeezA74 (1.95€)
Seat 4: Johnytop (6.43€)
Seat 5: Zile741 (3.78€)
Seat 6: Fefekalome (2.07€)
*** ANTE/BLINDS ***
El Paellas posts small blind 0.01€
Fried Berg posts big blind 0.02€
Dealt to Fried Berg [2d Ts]
*** PRE-FLOP *** 
WeezA74 folds
Johnytop folds
Zile741 folds
Fefekalome folds
El Paellas folds
Fried Berg collected 0.03€ from pot
*** SUMMARY ***
Total pot 0.03€ | No rake
Seat 2: Fried Berg (big blind) won 0.03€


Winamax Poker - HOLD-UP "Colorado" - HandId: #19116069-434051-1701511453 - Holdem no limit (0.01€/0.02€) - 2023/12/02 10:04:13 UTC
Table: 'Colorado' 6-max (real money) Seat #6 is the button
Seat 1: jdeepenslip (2.01€)
Seat 2: PIQSOU (3.80€)
Seat 3: D13C (6.31€)
Seat 4: rick26 (1.02€)
Seat 5: Fried Berg (1.12€)
Seat 6: Johnytop (4.15€)
*** ANTE/BLINDS ***
jdeepenslip posts small blind 0.01€
PIQSOU posts big blind 0.02€
Dealt to Fried Berg [6h Ks]
*** PRE-FLOP *** 
D13C folds
rick26 folds
Fried Berg folds
Johnytop raises 0.03€ to 0.05€
jdeepenslip folds
PIQSOU calls 0.03€
*** FLOP *** [9d 3d Qc]
PIQSOU checks
Johnytop checks
*** TURN *** [9d 3d Qc][Td]
PIQSOU bets 0.06€
Johnytop raises 0.19€ to 0.25€
PIQSOU folds
Johnytop collected 0.40€ from pot
*** SUMMARY ***
Total pot 0.40€ | Rake 0.02€
Board: [9d 3d Qc Td]
Seat 6: Johnytop (button) won 0.40€


Winamax Poker - HOLD-UP "Colorado" - HandId: #19116069-434057-1701511457 - Holdem no limit (0.01€/0.02€) - 2023/12/02 10:04:17 UTC
Table: 'Colorado' 6-max (real money) Seat #6 is the button
Seat 1: Anty-dot (2€)
Seat 2: Zile741 (4.06€)
Seat 3: GwenLaGrise (3.75€)
Seat 4: Fried Berg (1.12€)
Seat 5: Artorias (3.14€)
Seat 6: Ikigaivvv (2.66€)
*** ANTE/BLINDS ***
Anty-dot posts small blind 0.01€
Zile741 posts big blind 0.02€
Dealt to Fried Berg [Ts Jd]
*** PRE-FLOP *** 
GwenLaGrise folds
Fried Berg calls 0.02€
Artorias folds
Ikigaivvv folds
Anty-dot folds
Zile741 checks
*** FLOP *** [6d Jc Jh]
Zile741 checks
Fried Berg bets 0.02€
Zile741 folds
Fried Berg collected 0.06€ from pot
*** SUMMARY ***
Total pot 0.06€ | Rake 0.01€
Board: [6d Jc Jh]
Seat 4: Fried Berg won 0.06€


Winamax Poker - HOLD-UP "Colorado" - HandId: #19116069-434122-1701511500 - Holdem no limit (0.01€/0.02€) - 2023/12/02 10:05:00 UTC
Table: 'Colorado' 6-max (real money) Seat #6 is the button
Seat 1: mea botellas (2.05€)
Seat 2: Fried Berg (1.14€)
Seat 3: Anty-dot (2.10€)
Seat 4: Dit_Bondour (2€)
Seat 5: Chacal-Punk (4.25€)
Seat 6: slowreplay (3.41€)
*** ANTE/BLINDS ***
mea botellas posts small blind 0.01€
Fried Berg posts big blind 0.02€
Dealt to Fried Berg [Qh Jd]
*** PRE-FLOP *** 
Anty-dot folds
Dit_Bondour folds
Chacal-Punk folds
slowreplay folds
mea botellas folds
Fried Berg collected 0.03€ from pot
*** SUMMARY ***
Total pot 0.03€ | No rake
Seat 2: Fried Berg (big blind) won 0.03€


Winamax Poker - HOLD-UP "Colorado" - HandId: #19116069-434139-1701511509 - Holdem no limit (0.01€/0.02€) - 2023/12/02 10:05:09 UTC
Table: 'Colorado' 6-max (real money) Seat #6 is the button
Seat 1: Melielvir (4.75€)
Seat 2: briben21 (2.18€)
Seat 3: Fried Berg (1.15€)
Seat 4: slowreplay (3.41€)
Seat 5: Thequeen1205 (2.21€)
Seat 6: durba (0.62€)
*** ANTE/BLINDS ***
Melielvir posts small blind 0.01€
briben21 posts big blind 0.02€
Dealt to Fried Berg [6c 4c]
*** PRE-FLOP *** 
Fried Berg folds
slowreplay folds
Thequeen1205 folds
durba raises 0.03€ to 0.05€
Melielvir calls 0.04€
briben21 calls 0.03€
*** FLOP *** [5d 4h 5c]
Melielvir checks
briben21 checks
durba bets 0.10€
Melielvir calls 0.10€
briben21 folds
*** TURN *** [5d 4h 5c][Kd]
Melielvir checks
durba checks
*** RIVER *** [5d 4h 5c Kd][Ts]
Melielvir checks
durba bets 0.18€
Melielvir folds
durba collected 0.49€ from pot
*** SUMMARY ***
Total pot 0.49€ | Rake 0.04€
Board: [5d 4h 5c Kd Ts]
Seat 6: durba (button) won 0.49€


Winamax Poker - HOLD-UP "Colorado" - HandId: #19116069-434145-1701511511 - Holdem no limit (0.01€/0.02€) - 2023/12/02 10:05:11 UTC
Table: 'Colorado' 6-max (real money) Seat #6 is the button
Seat 1: Fried Berg (1.15€)
Seat 2: Pas1erreur (1.20€)
Seat 3: jdeepenslip (4.06€)
Seat 4: emojipok (0.51€)
Seat 5: Fefekalome (2.24€)
Seat 6: TaBrEaMoI (2.37€)
*** ANTE/BLINDS ***
Fried Berg posts small blind 0.01€
Pas1erreur posts big blind 0.02€
Dealt to Fried Berg [8d Kd]
*** PRE-FLOP *** 
jdeepenslip folds
emojipok folds
Fefekalome folds
TaBrEaMoI folds
Fried Berg raises 0.02€ to 0.04€
Pas1erreur folds
Fried Berg collected 0.06€ from pot
*** SUMMARY ***
Total pot 0.06€ | No rake
Seat 1: Fried Berg (small blind) won 0.06€


Winamax Poker - HOLD-UP "Colorado" - HandId: #19116069-434188-1701511534 - Holdem no limit (0.01€/0.02€) - 2023/12/02 10:05:34 UTC
Table: 'Colorado' 6-max (real money) Seat #6 is the button
Seat 1: I6pokerP4 (3.13€)
Seat 2: El Paellas (0.57€)
Seat 3: Jdeepenjeans (0.91€)
Seat 4: Fried Berg (1.17€)
Seat 5: TaBrEaMoI (2.47€)
Seat 6: GwenLaGrise (5.54€)
*** ANTE/BLINDS ***
I6pokerP4 posts small blind 0.01€
El Paellas posts big blind 0.02€
Dealt to Fried Berg [5c Ac]
*** PRE-FLOP *** 
Jdeepenjeans folds
Fried Berg raises 0.02€ to 0.04€
TaBrEaMoI folds
GwenLaGrise folds
I6pokerP4 folds
El Paellas folds
Fried Berg collected 0.07€ from pot
*** SUMMARY ***
Total pot 0.07€ | No rake
Seat 4: Fried Berg won 0.07€


Winamax Poker - HOLD-UP "Colorado" - HandId: #19116069-434219-1701511553 - Holdem no limit (0.01€/0.02€) - 2023/12/02 10:05:53 UTC
Table: 'Colorado' 6-max (real money) Seat #6 is the button
Seat 1: Zile741 (2.93€)
Seat 2: El Paellas (0.58€)
Seat 3: GwenLaGrise (2.36€)
Seat 4: Anty-dot (2.03€)
Seat 5: sAArtouKK (3.47€)
Seat 6: Fried Berg (1.20€)
*** ANTE/BLINDS ***
Zile741 posts small blind 0.01€
El Paellas posts big blind 0.02€
Dealt to Fried Berg [Qh Ah]
*** PRE-FLOP *** 
GwenLaGrise folds
Anty-dot folds
sAArtouKK folds
Fried Berg raises 0.03€ to 0.05€
Zile741 folds
El Paellas folds
Fried Berg collected 0.08€ from pot
*** SUMMARY ***
Total pot 0.08€ | No rake
Seat 6: Fried Berg (button) won 0.08€


Winamax Poker - HOLD-UP "Colorado" - HandId: #19116069-434282-1701511584 - Holdem no limit (0.01€/0.02€) - 2023/12/02 10:06:24 UTC
Table: 'Colorado' 6-max (real money) Seat #6 is the button
Seat 1: Chacal-Punk (4.39€)
Seat 2: Pat Poker 73 (2.22€)
Seat 3: Fried Berg (1.23€)
Seat 4: jdeepenslip (3.99€)
Seat 5: kameleon73 (2.94€)
Seat 6: HenriGuyBet (2.09€)
*** ANTE/BLINDS ***
Chacal-Punk posts small blind 0.01€
Pat Poker 73 posts big blind 0.02€
Dealt to Fried Berg [8c Ts]
*** PRE-FLOP *** 
Fried Berg folds
jdeepenslip folds
kameleon73 folds
HenriGuyBet raises 0.02€ to 0.04€
Chacal-Punk raises 0.05€ to 0.09€
Pat Poker 73 folds
HenriGuyBet calls 0.05€
*** FLOP *** [7d Tc 3h]
Chacal-Punk bets 4.30€ and is all-in
HenriGuyBet folds
Chacal-Punk collected 4.48€ from pot
*** SUMMARY ***
Total pot 4.48€ | Rake 0.02€
Board: [7d Tc 3h]
Seat 1: Chacal-Punk (small blind) won 4.48€


Winamax Poker - HOLD-UP "Colorado" - HandId: #19116069-434287-1701511587 - Holdem no limit (0.01€/0.02€) - 2023/12/02 10:06:27 UTC
Table: 'Colorado' 6-max (real money) Seat #6 is the button
Seat 1: Fried Berg (1.23€)
Seat 2: Ikigaivvv (4.09€)
Seat 3: Pas1erreur (1.95€)
Seat 4: TaBrEaMoI (3.44€)
Seat 5: ironman33 (2.83€)
Seat 6: slowreplay (2.12€)
*** ANTE/BLINDS ***
Fried Berg posts small blind 0.01€
Ikigaivvv posts big blind 0.02€
Dealt to Fried Berg [3h As]
*** PRE-FLOP *** 
Pas1erreur folds
TaBrEaMoI raises 0.04€ to 0.06€
ironman33 calls 0.06€
slowreplay folds
Fried Berg folds
Ikigaivvv folds
*** FLOP *** [9s 8s Jh]
TaBrEaMoI bets 0.05€
ironman33 calls 0.05€
*** TURN *** [9s 8s Jh][4d]
TaBrEaMoI bets 0.06€
ironman33 calls 0.06€
*** RIVER *** [9s 8s Jh 4d][3d]
TaBrEaMoI checks
ironman33 bets 0.08€
TaBrEaMoI folds
ironman33 collected 0.41€ from pot
*** SUMMARY ***
Total pot 0.41€ | Rake 0.04€
Board: [9s 8s Jh 4d 3d]
Seat 5: ironman33 won 0.41€


Winamax Poker - HOLD-UP "Colorado" - HandId: #19116069-434302-1701511597 - Holdem no limit (0.01€/0.02€) - 2023/12/02 10:06:37 UTC
Table: 'Colorado' 6-max (real money) Seat #6 is the button
Seat 1: Zile741 (3.93€)
Seat 2: POKER49 (2.59€)
Seat 3: Tribuna38 (5.73€)
Seat 4: Fried Berg (1.22€)
Seat 5: PIQSOU (3€)
Seat 6: Td08nomotto (2.06€)
*** ANTE/BLINDS ***
Zile741 posts small blind 0.01€
POKER49 posts big blind 0.02€
Dealt to Fried Berg [8s 2s]
*** PRE-FLOP *** 
Tribuna38 folds
Fried Berg folds
PIQSOU raises 0.03€ to 0.05€
Td08nomotto folds
Zile741 raises 0.15€ to 0.20€
POKER49 folds
PIQSOU folds
Zile741 collected 0.27€ from pot
*** SUMMARY ***
Total pot 0.27€ | No rake
Seat 1: Zile741 (small blind) won 0.27€


Winamax Poker - HOLD-UP "Colorado" - HandId: #19116069-434307-1701511602 - Holdem no limit (0.01€/0.02€) - 2023/12/02 10:06:42 UTC
Table: 'Colorado' 6-max (real money) Seat #6 is the button
Seat 1: Odette1948 (0.48€)
Seat 2: Fried Berg (1.22€)
Seat 3: pinfloi (0.68€)
Seat 4: GwenLaGrise (5.55€)
Seat 5: Anty-dot (2.01€)
Seat 6: Jdeepenjeans (1.78€)
*** ANTE/BLINDS ***
Odette1948 posts small blind 0.01€
Fried Berg posts big blind 0.02€
Dealt to Fried Berg [3d Jc]
*** PRE-FLOP *** 
pinfloi calls 0.02€
GwenLaGrise folds
Anty-dot raises 0.05€ to 0.07€
Jdeepenjeans folds
Odette1948 folds
Fried Berg folds
pinfloi calls 0.05€
*** FLOP *** [9s 8s 5c]
pinfloi bets 0.06€
Anty-dot folds
pinfloi collected 0.21€ from pot
*** SUMMARY ***
Total pot 0.21€ | Rake 0.02€
Board: [9s 8s 5c]
Seat 3: pinfloi won 0.21€


Winamax Poker - HOLD-UP "Colorado" - HandId: #19116069-434318-1701511607 - Holdem no limit (0.01€/0.02€) - 2023/12/02 10:06:47 UTC
Table: 'Colorado' 6-max (real money) Seat #6 is the button
Seat 1: slowreplay (2.14€)
Seat 2: D13C (2€)
Seat 3: kameleon73 (2.92€)
Seat 4: Jdeepenjeans (0.47€)
Seat 5: Fried Berg (1.20€)
Seat 6: maniz66 (0.13€)
*** ANTE/BLINDS ***
slowreplay posts small blind 0.01€
D13C posts big blind 0.02€
Dealt to Fried Berg [8h As]
*** PRE-FLOP *** 
kameleon73 folds
Jdeepenjeans raises 0.03€ to 0.05€
Fried Berg folds
maniz66 folds
slowreplay folds
D13C calls 0.03€
*** FLOP *** [8c Qc Ks]
D13C checks
Jdeepenjeans bets 0.08€
D13C calls 0.08€
*** TURN *** [8c Qc Ks][5d]
D13C checks
Jdeepenjeans bets 0.20€
D13C calls 0.20€
*** RIVER *** [8c Qc Ks 5d][6c]
D13C checks
Jdeepenjeans bets 0.14€ and is all-in
D13C folds
Jdeepenjeans collected 0.74€ from pot
*** SUMMARY ***
Total pot 0.74€ | Rake 0.07€
Board: [8c Qc Ks 5d 6c]
Seat 4: Jdeepenjeans won 0.74€


Winamax Poker - HOLD-UP "Colorado" - HandId: #19116069-434361-1701511634 - Holdem no limit (0.01€/0.02€) - 2023/12/02 10:07:14 UTC
Table: 'Colorado' 6-max (real money) Seat #6 is the button
Seat 1: MissLoulou (4.98€)
Seat 2: Kallonys (1.67€)
Seat 3: DosdeBras (1.86€)
Seat 4: GwenLaGrise (3.85€)
Seat 5: Ipiz (1.12€)
Seat 6: Fried Berg (1.20€)
Hold-up to Pot: total 0.10€
*** ANTE/BLINDS ***
MissLoulou posts small blind 0.01€
Kallonys posts big blind 0.02€
Dealt to Fried Berg [Qh Tc]
*** PRE-FLOP *** 
DosdeBras raises 0.03€ to 0.05€
GwenLaGrise folds
Ipiz folds
Fried Berg calls 0.05€
MissLoulou folds
Kallonys calls 0.03€
*** FLOP *** [8h 6d Kd]
Kallonys checks
DosdeBras checks
Fried Berg checks
*** TURN *** [8h 6d Kd][Ts]
Kallonys bets 0.17€
DosdeBras calls 0.17€
Fried Berg folds
*** RIVER *** [8h 6d Kd Ts][Js]
Kallonys checks
DosdeBras checks
*** SHOW DOWN ***
DosdeBras shows [Qc Th] (One pair : Tens)
Kallonys shows [8c Kc] (Two pairs : Kings and 8)
Kallonys collected 0.55€ from pot
*** SUMMARY ***
Total pot 0.55€ | Rake 0.05€
Board: [8h 6d Kd Ts Js]
Seat 2: Kallonys (big blind) showed [8c Kc] and won 0.55€ with Two pairs : Kings and 8
Seat 3: DosdeBras showed [Qc Th] and lost with One pair : Tens


Winamax Poker - HOLD-UP "Colorado" - HandId: #19116069-434439-1701511680 - Holdem no limit (0.01€/0.02€) - 2023/12/02 10:08:00 UTC
Table: 'Colorado' 6-max (real money) Seat #6 is the button
Seat 1: Kito31 (8.32€)
Seat 2: YYOOYYOOYY (1.65€)
Seat 3: El Paellas (0.50€)
Seat 4: Fried Berg (1.15€)
Seat 5: elsrab (1.07€)
Seat 6: 121 (2.13€)
*** ANTE/BLINDS ***
Kito31 posts small blind 0.01€
YYOOYYOOYY posts big blind 0.02€
Dealt to Fried Berg [3h 6c]
*** PRE-FLOP *** 
El Paellas folds
Fried Berg folds
elsrab folds
121 folds
Kito31 folds
YYOOYYOOYY collected 0.03€ from pot
*** SUMMARY ***
Total pot 0.03€ | No rake
Seat 2: YYOOYYOOYY (big blind) won 0.03€


Winamax Poker - HOLD-UP "Colorado" - HandId: #19116069-434450-1701511686 - Holdem no limit (0.01€/0.02€) - 2023/12/02 10:08:06 UTC
Table: 'Colorado' 6-max (real money) Seat #6 is the button
Seat 1: Kallonys (2€)
Seat 2: El Paellas (0.51€)
Seat 3: GwenLaGrise (5.53€)
Seat 4: DosdeBras (1.64€)
Seat 5: Jdeepenjeans (1.43€)
Seat 6: Fried Berg (1.15€)
*** ANTE/BLINDS ***
Kallonys posts small blind 0.01€
El Paellas posts big blind 0.02€
Dealt to Fried Berg [8c 8s]
*** PRE-FLOP *** 
GwenLaGrise folds
DosdeBras folds
Jdeepenjeans folds
Fried Berg raises 0.02€ to 0.04€
Kallonys folds
El Paellas folds
Fried Berg collected 0.07€ from pot
*** SUMMARY ***
Total pot 0.07€ | No rake
Seat 6: Fried Berg (button) won 0.07€


Winamax Poker - HOLD-UP "Colorado" - HandId: #19116069-434483-1701511708 - Holdem no limit (0.01€/0.02€) - 2023/12/02 10:08:28 UTC
Table: 'Colorado' 6-max (real money) Seat #6 is the button
Seat 1: lamuerta8300 (2€)
Seat 2: sAArtouKK (3.44€)
Seat 3: Fried Berg (1.18€)
Seat 4: maniz66 (0.64€)
Seat 5: Zile741 (3.76€)
Seat 6: TheRealWill (2.06€)
*** ANTE/BLINDS ***
lamuerta8300 posts small blind 0.01€
sAArtouKK posts big blind 0.02€
Dealt to Fried Berg [Th 3d]
*** PRE-FLOP *** 
Fried Berg folds
maniz66 folds
Zile741 raises 0.03€ to 0.05€
TheRealWill folds
lamuerta8300 calls 0.04€
sAArtouKK folds
*** FLOP *** [8s 3c Jc]
lamuerta8300 checks
Zile741 bets 0.04€
lamuerta8300 calls 0.04€
*** TURN *** [8s 3c Jc][Js]
lamuerta8300 checks
Zile741 checks
*** RIVER *** [8s 3c Jc Js][Kh]
lamuerta8300 checks
Zile741 checks
*** SHOW DOWN ***
lamuerta8300 shows [Qd 9d] (One pair : Jacks)
Zile741 shows [8c 9c] (Two pairs : Jacks and 8)
Zile741 collected 0.18€ from pot
*** SUMMARY ***
Total pot 0.18€ | Rake 0.02€
Board: [8s 3c Jc Js Kh]
Seat 1: lamuerta8300 (small blind) showed [Qd 9d] and lost with One pair : Jacks
Seat 5: Zile741 showed [8c 9c] and won 0.18€ with Two pairs : Jacks and 8


Winamax Poker - HOLD-UP "Colorado" - HandId: #19116069-434487-1701511711 - Holdem no limit (0.01€/0.02€) - 2023/12/02 10:08:31 UTC
Table: 'Colorado' 6-max (real money) Seat #6 is the button
Seat 1: Fried Berg (1.18€)
Seat 2: TheRealWill (2.06€)
Seat 3: PSGcocotelly (0.47€)
Seat 4: Thequeen1205 (1.97€)
Seat 5: El Paellas (0.57€)
Seat 6: GwenLaGrise (3.90€)
*** ANTE/BLINDS ***
Fried Berg posts small blind 0.01€
TheRealWill posts big blind 0.02€
Dealt to Fried Berg [6s As]
*** PRE-FLOP *** 
PSGcocotelly folds
Thequeen1205 folds
El Paellas folds
GwenLaGrise raises 0.04€ to 0.06€
Fried Berg calls 0.05€
TheRealWill calls 0.04€
*** FLOP *** [6h 4s 3h]
Fried Berg checks
TheRealWill checks
GwenLaGrise bets 0.12€
Fried Berg calls 0.12€
TheRealWill folds
*** TURN *** [6h 4s 3h][Ks]
Fried Berg checks
GwenLaGrise bets 0.21€
Fried Berg calls 0.21€
*** RIVER *** [6h 4s 3h Ks][7d]
Fried Berg checks
GwenLaGrise bets 0.29€
Fried Berg calls 0.29€
*** SHOW DOWN ***
GwenLaGrise shows [Qs Ah] (High card : Ace)
Fried Berg shows [6s As] (One pair : 6)
Fried Berg collected 1.28€ from pot
*** SUMMARY ***
Total pot 1.28€ | Rake 0.14€
Board: [6h 4s 3h Ks 7d]
Seat 1: Fried Berg (small blind) showed [6s As] and won 1.28€ with One pair : 6
Seat 6: GwenLaGrise (button) showed [Qs Ah] and lost with High card : Ace


Winamax Poker - HOLD-UP "Colorado" - HandId: #19116069-434631-1701511803 - Holdem no limit (0.01€/0.02€) - 2023/12/02 10:10:03 UTC
Table: 'Colorado' 6-max (real money) Seat #6 is the button
Seat 1: PIQSOU (2.90€)
Seat 2: Pas1erreur (2.34€)
Seat 3: GwenLaGrise (3.22€)
Seat 4: rick26 (1.79€)
Seat 5: Fried Berg (1.78€)
Seat 6: Baston57 (2€)
*** ANTE/BLINDS ***
PIQSOU posts small blind 0.01€
Pas1erreur posts big blind 0.02€
Dealt to Fried Berg [3h 8s]
*** PRE-FLOP *** 
GwenLaGrise folds
rick26 folds
Fried Berg folds
Baston57 folds
PIQSOU folds
Pas1erreur collected 0.03€ from pot
*** SUMMARY ***
Total pot 0.03€ | No rake
Seat 2: Pas1erreur (big blind) won 0.03€


Winamax Poker - HOLD-UP "Colorado" - HandId: #19116069-434642-1701511809 - Holdem no limit (0.01€/0.02€) - 2023/12/02 10:10:09 UTC
Table: 'Colorado' 6-max (real money) Seat #6 is the button
Seat 1: MONEYFOREVER (2.03€)
Seat 2: TheRealWill (2€)
Seat 3: Kallonys (1.94€)
Seat 4: GwenLaGrise (2.38€)
Seat 5: TaBrEaMoI (4.02€)
Seat 6: Fried Berg (1.78€)
*** ANTE/BLINDS ***
MONEYFOREVER posts small blind 0.01€
TheRealWill posts big blind 0.02€
Dealt to Fried Berg [6c Jd]
*** PRE-FLOP *** 
Kallonys folds
GwenLaGrise folds
TaBrEaMoI folds
Fried Berg folds
MONEYFOREVER raises 0.04€ to 0.06€
TheRealWill folds
MONEYFOREVER collected 0.08€ from pot
*** SUMMARY ***
Total pot 0.08€ | No rake
Seat 1: MONEYFOREVER (small blind) won 0.08€


Winamax Poker - HOLD-UP "Colorado" - HandId: #19116069-434657-1701511818 - Holdem no limit (0.01€/0.02€) - 2023/12/02 10:10:18 UTC
Table: 'Colorado' 6-max (real money) Seat #6 is the button
Seat 1: Dit_Bondour (2.11€)
Seat 2: Fefekalome (2.03€)
Seat 3: elx111 (2.60€)
Seat 4: pedrohxx (2.20€)
Seat 5: josep2170 (2.29€)
Seat 6: Fried Berg (1.78€)
*** ANTE/BLINDS ***
Dit_Bondour posts small blind 0.01€
Fefekalome posts big blind 0.02€
Dealt to Fried Berg [As 6s]
*** PRE-FLOP *** 
elx111 folds
pedrohxx folds
josep2170 folds
Fried Berg raises 0.02€ to 0.04€
Dit_Bondour folds
Fefekalome calls 0.02€
*** FLOP *** [6h Qc 4d]
Fefekalome checks
Fried Berg checks
*** TURN *** [6h Qc 4d][6d]
Fefekalome bets 0.04€
Fried Berg calls 0.04€
*** RIVER *** [6h Qc 4d 6d][Td]
Fefekalome checks
Fried Berg bets 0.02€
Fefekalome raises 0.13€ to 0.15€
Fried Berg calls 0.13€
*** SHOW DOWN ***
Fefekalome shows [Kc Qd] (Two pairs : Queens and 6)
Fried Berg shows [As 6s] (Trips of 6)
Fried Berg collected 0.42€ from pot
*** SUMMARY ***
Total pot 0.42€ | Rake 0.05€
Board: [6h Qc 4d 6d Td]
Seat 2: Fefekalome (big blind) showed [Kc Qd] and lost with Two pairs : Queens and 6
Seat 6: Fried Berg (button) showed [As 6s] and won 0.42€ with Trips of 6


Winamax Poker - HOLD-UP "Colorado" - HandId: #19116069-434730-1701511864 - Holdem no limit (0.01€/0.02€) - 2023/12/02 10:11:04 UTC
Table: 'Colorado' 6-max (real money) Seat #6 is the button
Seat 1: josep2170 (2.31€)
Seat 2: Fried Berg (1.97€)
Seat 3: Abec16 (2.53€)
Seat 4: Fefekalome (2€)
Seat 5: Fran1Oller (4.68€)
Seat 6: jdeepenslip (4.25€)
*** ANTE/BLINDS ***
josep2170 posts small blind 0.01€
Fried Berg posts big blind 0.02€
Dealt to Fried Berg [6c 3s]
*** PRE-FLOP *** 
Abec16 folds
Fefekalome raises 0.04€ to 0.06€
Fran1Oller folds
jdeepenslip folds
josep2170 folds
Fried Berg folds
Fefekalome collected 0.09€ from pot
*** SUMMARY ***
Total pot 0.09€ | No rake
Seat 4: Fefekalome won 0.09€


Winamax Poker - HOLD-UP "Colorado" - HandId: #19116069-434762-1701511883 - Holdem no limit (0.01€/0.02€) - 2023/12/02 10:11:23 UTC
Table: 'Colorado' 6-max (real money) Seat #6 is the button
Seat 1: 20enbastos (2.06€)
Seat 2: Thequeen1205 (1.89€)
Seat 3: Fried Berg (1.95€)
Seat 4: jdeepenslip (4.25€)
Seat 5: Anty-dot (3.40€)
Seat 6: Betiegarri (1.95€)
*** ANTE/BLINDS ***
20enbastos posts small blind 0.01€
Thequeen1205 posts big blind 0.02€
Dealt to Fried Berg [7d 4s]
*** PRE-FLOP *** 
Fried Berg folds
jdeepenslip folds
Anty-dot raises 0.03€ to 0.05€
Betiegarri folds
20enbastos folds
Thequeen1205 folds
Anty-dot collected 0.08€ from pot
*** SUMMARY ***
Total pot 0.08€ | No rake
Seat 5: Anty-dot won 0.08€


Winamax Poker - HOLD-UP "Colorado" - HandId: #19116069-434769-1701511888 - Holdem no limit (0.01€/0.02€) - 2023/12/02 10:11:28 UTC
Table: 'Colorado' 6-max (real money) Seat #6 is the button
Seat 1: Artorias (2.88€)
Seat 2: g8o8k8u (2€)
Seat 3: Td08nomotto (2.39€)
Seat 4: jdeepenslip (2.43€)
Seat 5: TaBrEaMoI (2.43€)
Seat 6: Fried Berg (1.95€)
*** ANTE/BLINDS ***
Artorias posts small blind 0.01€
g8o8k8u posts big blind 0.02€
Dealt to Fried Berg [7s 8h]
*** PRE-FLOP *** 
Td08nomotto folds
jdeepenslip folds
TaBrEaMoI raises 0.04€ to 0.06€
Fried Berg folds
Artorias folds
g8o8k8u folds
TaBrEaMoI collected 0.09€ from pot
*** SUMMARY ***
Total pot 0.09€ | No rake
Seat 5: TaBrEaMoI won 0.09€


Winamax Poker - HOLD-UP "Colorado" - HandId: #19116069-434794-1701511900 - Holdem no limit (0.01€/0.02€) - 2023/12/02 10:11:40 UTC
Table: 'Colorado' 6-max (real money) Seat #6 is the button
Seat 1: TheRealWill (2.01€)
Seat 2: El Paellas (0.53€)
Seat 3: DosdeBras (1.91€)
Seat 4: I6pokerP4 (4.75€)
Seat 5: kameleon73 (3.21€)
Seat 6: Fried Berg (1.95€)
*** ANTE/BLINDS ***
TheRealWill posts small blind 0.01€
El Paellas posts big blind 0.02€
Dealt to Fried Berg [Qs As]
*** PRE-FLOP *** 
DosdeBras folds
I6pokerP4 folds
kameleon73 folds
Fried Berg raises 0.04€ to 0.06€
TheRealWill raises 0.24€ to 0.30€
El Paellas folds
Fried Berg calls 0.24€
*** FLOP *** [Th 9c 6c]
TheRealWill checks
Fried Berg checks
*** TURN *** [Th 9c 6c][Jh]
TheRealWill bets 0.31€
Fried Berg folds
TheRealWill collected 0.87€ from pot
*** SUMMARY ***
Total pot 0.87€ | Rake 0.06€
Board: [Th 9c 6c Jh]
Seat 1: TheRealWill (small blind) won 0.87€


Winamax Poker - HOLD-UP "Colorado" - HandId: #19116069-434907-1701511970 - Holdem no limit (0.01€/0.02€) - 2023/12/02 10:12:50 UTC
Table: 'Colorado' 6-max (real money) Seat #6 is the button
Seat 1: TaBrEaMoI (2.40€)
Seat 2: Fried Berg (1.65€)
Seat 3: Dit_Bondour (2.26€)
Seat 4: slowreplay (2.71€)
Seat 5: El Paellas (0.57€)
Seat 6: rick26 (0.84€)
*** ANTE/BLINDS ***
TaBrEaMoI posts small blind 0.01€
Fried Berg posts big blind 0.02€
Dealt to Fried Berg [6c Ah]
*** PRE-FLOP *** 
Dit_Bondour folds
slowreplay raises 0.03€ to 0.05€
El Paellas folds
rick26 folds
TaBrEaMoI folds
Fried Berg folds
slowreplay collected 0.08€ from pot
*** SUMMARY ***
Total pot 0.08€ | No rake
Seat 4: slowreplay won 0.08€


Winamax Poker - HOLD-UP "Colorado" - HandId: #19116069-434926-1701511983 - Holdem no limit (0.01€/0.02€) - 2023/12/02 10:13:03 UTC
Table: 'Colorado' 6-max (real money) Seat #6 is the button
Seat 1: Fried Berg (1.63€)
Seat 2: jdeepenslip (2.28€)
Seat 3: Trader2020 (2€)
Seat 4: Dit_Bondour (2.02€)
Seat 5: NE PA (0.50€)
Seat 6: Bloodgold666 (1.94€)
*** ANTE/BLINDS ***
Fried Berg posts small blind 0.01€
jdeepenslip posts big blind 0.02€
Dealt to Fried Berg [6c Jc]
*** PRE-FLOP *** 
Trader2020 folds
Dit_Bondour folds
NE PA folds
Bloodgold666 folds
Fried Berg raises 0.02€ to 0.04€
jdeepenslip folds
Fried Berg collected 0.06€ from pot
*** SUMMARY ***
Total pot 0.06€ | No rake
Seat 1: Fried Berg (small blind) won 0.06€


Winamax Poker - HOLD-UP "Colorado" - HandId: #19116069-434978-1701512016 - Holdem no limit (0.01€/0.02€) - 2023/12/02 10:13:36 UTC
Table: 'Colorado' 6-max (real money) Seat #6 is the button
Seat 1: elsrab (4.01€)
Seat 2: Haricotbleu1 (2€)
Seat 3: orange.98882 (2.11€)
Seat 4: whiteclover (1.77€)
Seat 5: mea botellas (2.45€)
Seat 6: Fried Berg (1.65€)
*** ANTE/BLINDS ***
elsrab posts small blind 0.01€
Haricotbleu1 posts big blind 0.02€
Dealt to Fried Berg [6c 3s]
*** PRE-FLOP *** 
orange.98882 calls 0.02€
whiteclover folds
mea botellas folds
Fried Berg folds
elsrab calls 0.01€
Haricotbleu1 checks
*** FLOP *** [5h 2h 5d]
elsrab checks
Haricotbleu1 checks
orange.98882 checks
*** TURN *** [5h 2h 5d][Ah]
elsrab bets 0.02€
Haricotbleu1 folds
orange.98882 folds
elsrab collected 0.07€ from pot
*** SUMMARY ***
Total pot 0.07€ | Rake 0.01€
Board: [5h 2h 5d Ah]
Seat 1: elsrab (small blind) won 0.07€


Winamax Poker - HOLD-UP "Colorado" - HandId: #19116069-435023-1701512043 - Holdem no limit (0.01€/0.02€) - 2023/12/02 10:14:03 UTC
Table: 'Colorado' 6-max (real money) Seat #6 is the button
Seat 1: Thequeen1205 (2.14€)
Seat 2: Dit_Bondour (2.15€)
Seat 3: Fried Berg (1.65€)
Seat 4: Homer14510 (2€)
Seat 5: Anty-dot (3.74€)
Seat 6: HenriGuyBet (2.19€)
*** ANTE/BLINDS ***
Thequeen1205 posts small blind 0.01€
Dit_Bondour posts big blind 0.02€
Dealt to Fried Berg [2h Jh]
*** PRE-FLOP *** 
Fried Berg folds
Homer14510 folds
Anty-dot folds
HenriGuyBet folds
Thequeen1205 folds
Dit_Bondour collected 0.03€ from pot
*** SUMMARY ***
Total pot 0.03€ | No rake
Seat 2: Dit_Bondour (big blind) won 0.03€


Winamax Poker - HOLD-UP "Colorado" - HandId: #19116069-435027-1701512046 - Holdem no limit (0.01€/0.02€) - 2023/12/02 10:14:06 UTC
Table: 'Colorado' 6-max (real money) Seat #6 is the button
Seat 1: I6pokerP4 (4.70€)
Seat 2: Fried Berg (1.65€)
Seat 3: Fefekalome (2€)
Seat 4: J.C Deuces.0 (2.81€)
Seat 5: Nombrillus (1.97€)
Seat 6: Thequeen1205 (2.13€)
*** ANTE/BLINDS ***
I6pokerP4 posts small blind 0.01€
Fried Berg posts big blind 0.02€
Dealt to Fried Berg [4h 5d]
*** PRE-FLOP *** 
Fefekalome folds
J.C Deuces.0 folds
Nombrillus folds
Thequeen1205 folds
I6pokerP4 folds
Fried Berg collected 0.03€ from pot
*** SUMMARY ***
Total pot 0.03€ | No rake
Seat 2: Fried Berg (big blind) won 0.03€


Winamax Poker - HOLD-UP "Colorado" - HandId: #19116069-435040-1701512056 - Holdem no limit (0.01€/0.02€) - 2023/12/02 10:14:16 UTC
Table: 'Colorado' 6-max (real money) Seat #6 is the button
Seat 1: Bloodgold666 (1.87€)
Seat 2: Nombrillus (1.97€)
Seat 3: LuckyLopez (2.48€)
Seat 4: Fried Berg (1.66€)
Seat 5: maniz66 (0.51€)
Seat 6: Betiegarri (3.13€)
*** ANTE/BLINDS ***
Bloodgold666 posts small blind 0.01€
Nombrillus posts big blind 0.02€
Dealt to Fried Berg [Tc 5s]
*** PRE-FLOP *** 
LuckyLopez folds
Fried Berg folds
maniz66 folds
Betiegarri folds
Bloodgold666 calls 0.01€
Nombrillus checks
*** FLOP *** [5c 3h Td]
Bloodgold666 bets 0.03€
Nombrillus folds
Bloodgold666 collected 0.07€ from pot
*** SUMMARY ***
Total pot 0.07€ | No rake
Board: [5c 3h Td]
Seat 1: Bloodgold666 (small blind) won 0.07€


Winamax Poker - HOLD-UP "Colorado" - HandId: #19116069-435042-1701512058 - Holdem no limit (0.01€/0.02€) - 2023/12/02 10:14:18 UTC
Table: 'Colorado' 6-max (real money) Seat #6 is the button
Seat 1: lamuerta8300 (2.28€)
Seat 2: jdeepenslip (4.27€)
Seat 3: Kallonys (2.42€)
Seat 4: Fried Berg (1.66€)
Seat 5: El Paellas (0.50€)
Seat 6: mea botellas (2.45€)
*** ANTE/BLINDS ***
lamuerta8300 posts small blind 0.01€
jdeepenslip posts big blind 0.02€
Dealt to Fried Berg [Jc 3s]
*** PRE-FLOP *** 
Kallonys folds
Fried Berg folds
El Paellas raises 0.03€ to 0.05€
mea botellas folds
lamuerta8300 folds
jdeepenslip folds
El Paellas collected 0.08€ from pot
*** SUMMARY ***
Total pot 0.08€ | No rake
Seat 5: El Paellas won 0.08€


Winamax Poker - HOLD-UP "Colorado" - HandId: #19116069-435045-1701512061 - Holdem no limit (0.01€/0.02€) - 2023/12/02 10:14:21 UTC
Table: 'Colorado' 6-max (real money) Seat #6 is the button
Seat 1: Fried Berg (1.66€)
Seat 2: Fran1Oller (3.82€)
Seat 3: Roimish (1.99€)
Seat 4: Thequeen1205 (2.11€)
Seat 5: Fefekalome (2€)
Seat 6: Louis Vignac (2.12€)
*** ANTE/BLINDS ***
Fried Berg posts small blind 0.01€
Fran1Oller posts big blind 0.02€
Dealt to Fried Berg [2h Ah]
*** PRE-FLOP *** 
Roimish calls 0.02€
Thequeen1205 folds
Fefekalome folds
Louis Vignac folds
Fried Berg calls 0.01€
Fran1Oller checks
*** FLOP *** [7h 7s 7d]
Fried Berg checks
Fran1Oller checks
Roimish checks
*** TURN *** [7h 7s 7d][3c]
Fried Berg checks
Fran1Oller checks
Roimish checks
*** RIVER *** [7h 7s 7d 3c][Kd]
Fried Berg checks
Fran1Oller checks
Roimish checks
*** SHOW DOWN ***
Fran1Oller shows [9s Td] (Trips of 7)
Fried Berg shows [2h Ah] (Trips of 7)
Roimish shows [Th Ac] (Trips of 7)
Roimish collected 0.03€ from pot
Fried Berg collected 0.02€ from pot
*** SUMMARY ***
Total pot 0.05€ | Rake 0.01€
Board: [7h 7s 7d 3c Kd]
Seat 1: Fried Berg (small blind) showed [2h Ah] and won 0.02€ with Trips of 7
Seat 2: Fran1Oller (big blind) showed [9s Td] and lost with Trips of 7
Seat 3: Roimish showed [Th Ac] and won 0.03€ with Trips of 7


Winamax Poker - HOLD-UP "Colorado" - HandId: #19116069-435129-1701512121 - Holdem no limit (0.01€/0.02€) - 2023/12/02 10:15:21 UTC
Table: 'Colorado' 6-max (real money) Seat #6 is the button
Seat 1: Homer14510 (1.97€)
Seat 2: jackie_chun (2€)
Seat 3: Fried Berg (1.66€)
Seat 4: Roimish (2€)
Seat 5: Td08nomotto (2.01€)
Seat 6: MaryAthena (2.79€)
Hold-up to Pot: total 0.10€
*** ANTE/BLINDS ***
Homer14510 posts small blind 0.01€
jackie_chun posts big blind 0.02€
Dealt to Fried Berg [8c 2s]
*** PRE-FLOP *** 
Fried Berg folds
Roimish calls 0.02€
Td08nomotto folds
MaryAthena calls 0.02€
Homer14510 calls 0.01€
jackie_chun checks
*** FLOP *** [3c Qc 2c]
Homer14510 checks
jackie_chun checks
Roimish checks
MaryAthena checks
*** TURN *** [3c Qc 2c][Jd]
Homer14510 checks
jackie_chun checks
Roimish checks
MaryAthena checks
*** RIVER *** [3c Qc 2c Jd][6d]
Homer14510 checks
jackie_chun checks
Roimish checks
MaryAthena bets 0.06€
Homer14510 folds
jackie_chun folds
Roimish folds
MaryAthena collected 0.23€ from pot
*** SUMMARY ***
Total pot 0.23€ | Rake 0.01€
Board: [3c Qc 2c Jd 6d]
Seat 6: MaryAthena (button) won 0.23€


Winamax Poker - HOLD-UP "Colorado" - HandId: #19116069-435136-1701512127 - Holdem no limit (0.01€/0.02€) - 2023/12/02 10:15:27 UTC
Table: 'Colorado' 6-max (real money) Seat #6 is the button
Seat 1: Chaberr (2.03€)
Seat 2: castilla1978 (2€)
Seat 3: 20enbastos (2€)
Seat 4: swag-Morue73 (0.46€)
Seat 5: Fried Berg (1.66€)
Seat 6: Td08nomotto (2.01€)
*** ANTE/BLINDS ***
Chaberr posts small blind 0.01€
castilla1978 posts big blind 0.02€
Dealt to Fried Berg [Kc 7c]
*** PRE-FLOP *** 
20enbastos folds
swag-Morue73 folds
Fried Berg raises 0.03€ to 0.05€
Td08nomotto folds
Chaberr folds
castilla1978 folds
Fried Berg collected 0.08€ from pot
*** SUMMARY ***
Total pot 0.08€ | No rake
Seat 5: Fried Berg won 0.08€


Winamax Poker - HOLD-UP "Colorado" - HandId: #19116069-435155-1701512142 - Holdem no limit (0.01€/0.02€) - 2023/12/02 10:15:42 UTC
Table: 'Colorado' 6-max (real money) Seat #6 is the button
Seat 1: sopra61 (1.28€)
Seat 2: Chacal-Punk (4.89€)
Seat 3: kameleon73 (2.94€)
Seat 4: Fried Berg (1.69€)
Seat 5: AK2-MILIK (3.29€)
Seat 6: Pas1erreur (2.04€)
*** ANTE/BLINDS ***
sopra61 posts small blind 0.01€
Chacal-Punk posts big blind 0.02€
Dealt to Fried Berg [Jh 3c]
*** PRE-FLOP *** 
kameleon73 folds
Fried Berg folds
AK2-MILIK raises 0.04€ to 0.06€
Pas1erreur folds
sopra61 folds
Chacal-Punk folds
AK2-MILIK collected 0.09€ from pot
*** SUMMARY ***
Total pot 0.09€ | No rake
Seat 5: AK2-MILIK won 0.09€


Winamax Poker - HOLD-UP "Colorado" - HandId: #19116069-435167-1701512151 - Holdem no limit (0.01€/0.02€) - 2023/12/02 10:15:51 UTC
Table: 'Colorado' 6-max (real money) Seat #6 is the button
Seat 1: orange.98882 (2.11€)
Seat 2: LuckyLopez (2.43€)
Seat 3: castilla1978 (1.97€)
Seat 4: Abec16 (2.55€)
Seat 5: Fried Berg (1.69€)
Seat 6: CB-Joker6274 (2.94€)
Hold-up to Pot: total 0.20€
*** ANTE/BLINDS ***
orange.98882 posts small blind 0.01€
LuckyLopez posts big blind 0.02€
Dealt to Fried Berg [5s Ad]
*** PRE-FLOP *** 
castilla1978 raises 0.04€ to 0.06€
Abec16 folds
Fried Berg folds
CB-Joker6274 folds
orange.98882 calls 0.05€
LuckyLopez raises 2.37€ to 2.43€ and is all-in
castilla1978 folds
orange.98882 folds
LuckyLopez collected 2.75€ from pot
*** SUMMARY ***
Total pot 2.75€ | No rake
Seat 2: LuckyLopez (big blind) won 2.75€


Winamax Poker - HOLD-UP "Colorado" - HandId: #19116069-435183-1701512162 - Holdem no limit (0.01€/0.02€) - 2023/12/02 10:16:02 UTC
Table: 'Colorado' 6-max (real money) Seat #6 is the button
Seat 1: lamuerta8300 (2€)
Seat 2: Fried Berg (1.69€)
Seat 3: kameleon73 (2.69€)
Seat 4: Trader2020 (2.01€)
Seat 5: GwenLaGrise (7.50€)
Seat 6: Kallonys (1.84€)
*** ANTE/BLINDS ***
lamuerta8300 posts small blind 0.01€
Fried Berg posts big blind 0.02€
Dealt to Fried Berg [7c As]
*** PRE-FLOP *** 
kameleon73 folds
Trader2020 raises 0.04€ to 0.06€
GwenLaGrise folds
Kallonys folds
lamuerta8300 folds
Fried Berg calls 0.04€
*** FLOP *** [Jh Tc 2s]
Fried Berg checks
Trader2020 bets 0.08€
Fried Berg folds
Trader2020 collected 0.20€ from pot
*** SUMMARY ***
Total pot 0.20€ | Rake 0.01€
Board: [Jh Tc 2s]
Seat 4: Trader2020 won 0.20€


Winamax Poker - HOLD-UP "Colorado" - HandId: #19116069-435225-1701512193 - Holdem no limit (0.01€/0.02€) - 2023/12/02 10:16:33 UTC
Table: 'Colorado' 6-max (real money) Seat #6 is the button
Seat 1: castilla1978 (1.89€)
Seat 2: Fefekalome (2.13€)
Seat 3: EYN PicPic (2.58€)
Seat 4: Fried Berg (1.63€)
Seat 5: GwenLaGrise (2.74€)
Seat 6: elx111 (1.95€)
*** ANTE/BLINDS ***
castilla1978 posts small blind 0.01€
Fefekalome posts big blind 0.02€
Dealt to Fried Berg [Ad Kd]
*** PRE-FLOP *** 
EYN PicPic raises 0.03€ to 0.05€
Fried Berg calls 0.05€
GwenLaGrise calls 0.05€
elx111 folds
castilla1978 folds
Fefekalome folds
*** FLOP *** [Ts Tc Jc]
EYN PicPic checks
Fried Berg checks
GwenLaGrise checks
*** TURN *** [Ts Tc Jc][Qc]
EYN PicPic bets 0.06€
Fried Berg calls 0.06€
GwenLaGrise folds
*** RIVER *** [Ts Tc Jc Qc][2h]
EYN PicPic bets 0.11€
Fried Berg raises 0.11€ to 0.22€
EYN PicPic calls 0.11€
*** SHOW DOWN ***
EYN PicPic shows [9s Ks] (Straight King high)
Fried Berg shows [Ad Kd] (Straight Ace high)
Fried Berg collected 0.67€ from pot
*** SUMMARY ***
Total pot 0.67€ | Rake 0.07€
Board: [Ts Tc Jc Qc 2h]
Seat 3: EYN PicPic showed [9s Ks] and lost with Straight King high
Seat 4: Fried Berg showed [Ad Kd] and won 0.67€ with Straight Ace high


Winamax Poker - HOLD-UP "Colorado" - HandId: #19116069-435290-1701512241 - Holdem no limit (0.01€/0.02€) - 2023/12/02 10:17:21 UTC
Table: 'Colorado' 6-max (real money) Seat #6 is the button
Seat 1: swag-Morue73 (0.40€)
Seat 2: EYN PicPic (2.25€)
Seat 3: Calypso01 (0.54€)
Seat 4: Merlus83 (2.70€)
Seat 5: Fran1Oller (4.80€)
Seat 6: Fried Berg (1.97€)
*** ANTE/BLINDS ***
swag-Morue73 posts small blind 0.01€
EYN PicPic posts big blind 0.02€
Dealt to Fried Berg [Th Td]
*** PRE-FLOP *** 
Calypso01 calls 0.02€
Merlus83 folds
Fran1Oller folds
Fried Berg raises 0.04€ to 0.06€
swag-Morue73 folds
EYN PicPic calls 0.04€
Calypso01 calls 0.04€
*** FLOP *** [4s 7s Jh]
EYN PicPic checks
Calypso01 bets 0.07€
Fried Berg folds
EYN PicPic folds
Calypso01 collected 0.24€ from pot
*** SUMMARY ***
Total pot 0.24€ | Rake 0.02€
Board: [4s 7s Jh]
Seat 3: Calypso01 won 0.24€


Winamax Poker - HOLD-UP "Colorado" - HandId: #19116069-435353-1701512284 - Holdem no limit (0.01€/0.02€) - 2023/12/02 10:18:04 UTC
Table: 'Colorado' 6-max (real money) Seat #6 is the button
Seat 1: _ilTulipano_ (2€)
Seat 2: orange.98882 (1.28€)
Seat 3: Pop_hop_hop (2.18€)
Seat 4: laconalostra (4.24€)
Seat 5: PIQSOU (4.59€)
Seat 6: Fried Berg (1.91€)
*** ANTE/BLINDS ***
_ilTulipano_ posts small blind 0.01€
orange.98882 posts big blind 0.02€
Dealt to Fried Berg [7c Jd]
*** PRE-FLOP *** 
Pop_hop_hop folds
laconalostra folds
PIQSOU folds
Fried Berg folds
_ilTulipano_ raises 0.04€ to 0.06€
orange.98882 folds
_ilTulipano_ collected 0.08€ from pot
*** SUMMARY ***
Total pot 0.08€ | No rake
Seat 1: _ilTulipano_ (small blind) won 0.08€


Winamax Poker - HOLD-UP "Colorado" - HandId: #19116069-435368-1701512292 - Holdem no limit (0.01€/0.02€) - 2023/12/02 10:18:12 UTC
Table: 'Colorado' 6-max (real money) Seat #6 is the button
Seat 1: ludolaval (1.87€)
Seat 2: Fried Berg (1.91€)
Seat 3: sopra61 (2.37€)
Seat 4: 20enbastos (2.29€)
Seat 5: franckyrud (3.47€)
Seat 6: lamuerta8300 (1.97€)
*** ANTE/BLINDS ***
ludolaval posts small blind 0.01€
Fried Berg posts big blind 0.02€
Dealt to Fried Berg [9h 5s]
*** PRE-FLOP *** 
sopra61 folds
20enbastos folds
franckyrud folds
lamuerta8300 folds
ludolaval raises 0.04€ to 0.06€
Fried Berg folds
ludolaval collected 0.08€ from pot
*** SUMMARY ***
Total pot 0.08€ | No rake
Seat 1: ludolaval (small blind) won 0.08€


Winamax Poker - HOLD-UP "Colorado" - HandId: #19116069-435382-1701512304 - Holdem no limit (0.01€/0.02€) - 2023/12/02 10:18:24 UTC
Table: 'Colorado' 6-max (real money) Seat #6 is the button
Seat 1: Fried Berg (1.89€)
Seat 2: Fefekalome (2.05€)
Seat 3: _ilTulipano_ (2.02€)
Seat 4: Kallonys (4.13€)
Seat 5: whiteclover (1.58€)
Seat 6: Td08nomotto (2.02€)
*** ANTE/BLINDS ***
Fried Berg posts small blind 0.01€
Fefekalome posts big blind 0.02€
Dealt to Fried Berg [9c 9h]
*** PRE-FLOP *** 
_ilTulipano_ folds
Kallonys folds
whiteclover raises 0.04€ to 0.06€
Td08nomotto calls 0.06€
Fried Berg calls 0.05€
Fefekalome folds
*** FLOP *** [3h Kd 9s]
Fried Berg checks
whiteclover checks
Td08nomotto checks
*** TURN *** [3h Kd 9s][Ad]
Fried Berg checks
whiteclover checks
Td08nomotto checks
*** RIVER *** [3h Kd 9s Ad][2d]
Fried Berg bets 0.06€
whiteclover folds
Td08nomotto folds
Fried Berg collected 0.24€ from pot
*** SUMMARY ***
Total pot 0.24€ | Rake 0.02€
Board: [3h Kd 9s Ad 2d]
Seat 1: Fried Berg (small blind) won 0.24€


Winamax Poker - HOLD-UP "Colorado" - HandId: #19116069-435437-1701512350 - Holdem no limit (0.01€/0.02€) - 2023/12/02 10:19:10 UTC
Table: 'Colorado' 6-max (real money) Seat #6 is the button
Seat 1: elsrab (4.24€)
Seat 2: popoche29 (11.98€)
Seat 3: Fried Berg (2.01€)
Seat 4: Fefekalome (2.03€)
Seat 5: MONEYFOREVER (2€)
Seat 6: MissLoulou (5.15€)
*** ANTE/BLINDS ***
elsrab posts small blind 0.01€
popoche29 posts big blind 0.02€
Dealt to Fried Berg [Td Ac]
*** PRE-FLOP *** 
Fried Berg raises 0.02€ to 0.04€
Fefekalome folds
MONEYFOREVER folds
MissLoulou folds
elsrab calls 0.03€
popoche29 calls 0.02€
*** FLOP *** [Qs 7d Ks]
elsrab checks
popoche29 checks
Fried Berg checks
*** TURN *** [Qs 7d Ks][Kh]
elsrab checks
popoche29 checks
Fried Berg checks
*** RIVER *** [Qs 7d Ks Kh][5s]
elsrab checks
popoche29 checks
Fried Berg checks
*** SHOW DOWN ***
popoche29 shows [Tc 9c] (One pair : Kings)
Fried Berg shows [Td Ac] (One pair : Kings)
elsrab shows [5d 6d] (Two pairs : Kings and 5)
elsrab collected 0.11€ from pot
*** SUMMARY ***
Total pot 0.11€ | Rake 0.01€
Board: [Qs 7d Ks Kh 5s]
Seat 1: elsrab (small blind) showed [5d 6d] and won 0.11€ with Two pairs : Kings and 5
Seat 2: popoche29 (big blind) showed [Tc 9c] and lost with One pair : Kings
Seat 3: Fried Berg showed [Td Ac] and lost with One pair : Kings


Winamax Poker - HOLD-UP "Colorado" - HandId: #19116069-435524-1701512418 - Holdem no limit (0.01€/0.02€) - 2023/12/02 10:20:18 UTC
Table: 'Colorado' 6-max (real money) Seat #6 is the button
Seat 1: HenriGuyBet (2.20€)
Seat 2: Fran1Oller (4.60€)
Seat 3: Bloodgold666 (1.85€)
Seat 4: LuckyLopez (3.43€)
Seat 5: Fried Berg (1.97€)
Seat 6: elsrab (4.31€)
*** ANTE/BLINDS ***
HenriGuyBet posts small blind 0.01€
Fran1Oller posts big blind 0.02€
Dealt to Fried Berg [3c Ah]
*** PRE-FLOP *** 
Bloodgold666 calls 0.02€
LuckyLopez folds
Fried Berg folds
elsrab folds
HenriGuyBet folds
Fran1Oller raises 0.07€ to 0.09€
Bloodgold666 folds
Fran1Oller collected 0.12€ from pot
*** SUMMARY ***
Total pot 0.12€ | No rake
Seat 2: Fran1Oller (big blind) won 0.12€


Winamax Poker - HOLD-UP "Colorado" - HandId: #19116069-435546-1701512430 - Holdem no limit (0.01€/0.02€) - 2023/12/02 10:20:30 UTC
Table: 'Colorado' 6-max (real money) Seat #6 is the button
Seat 1: Fried Berg (1.97€)
Seat 2: kameleon73 (5.28€)
Seat 3: whiteclover (1.60€)
Seat 4: MissLoulou (3.11€)
Seat 5: lamuerta8300 (2.25€)
Seat 6: castilla1978 (1.59€)
*** ANTE/BLINDS ***
Fried Berg posts small blind 0.01€
kameleon73 posts big blind 0.02€
Dealt to Fried Berg [Kc Jd]
*** PRE-FLOP *** 
whiteclover folds
MissLoulou folds
lamuerta8300 folds
castilla1978 folds
Fried Berg raises 0.02€ to 0.04€
kameleon73 calls 0.02€
*** FLOP *** [7c Ah 6s]
Fried Berg checks
kameleon73 bets 0.09€
Fried Berg folds
kameleon73 collected 0.16€ from pot
*** SUMMARY ***
Total pot 0.16€ | Rake 0.01€
Board: [7c Ah 6s]
Seat 2: kameleon73 (big blind) won 0.16€


Winamax Poker - HOLD-UP "Colorado" - HandId: #19116069-435595-1701512468 - Holdem no limit (0.01€/0.02€) - 2023/12/02 10:21:08 UTC
Table: 'Colorado' 6-max (real money) Seat #6 is the button
Seat 1: 20enbastos (2.08€)
Seat 2: 121 (4.01€)
Seat 3: Fried Berg (1.93€)
Seat 4: LuckyLopez (3.37€)
Seat 5: HenriGuyBet (2.16€)
Seat 6: Louis Vignac (2€)
*** ANTE/BLINDS ***
20enbastos posts small blind 0.01€
121 posts big blind 0.02€
Dealt to Fried Berg [Ac 9h]
*** PRE-FLOP *** 
Fried Berg folds
LuckyLopez folds
HenriGuyBet folds
Louis Vignac folds
20enbastos folds
121 collected 0.03€ from pot
*** SUMMARY ***
Total pot 0.03€ | No rake
Seat 2: 121 (big blind) won 0.03€


Winamax Poker - HOLD-UP "Colorado" - HandId: #19116069-435637-1701512497 - Holdem no limit (0.01€/0.02€) - 2023/12/02 10:21:37 UTC
Table: 'Colorado' 6-max (real money) Seat #6 is the button
Seat 1: Louis Vignac (2€)
Seat 2: _ilTulipano_ (3.63€)
Seat 3: castilla1978 (1.48€)
Seat 4: Td08nomotto (2€)
Seat 5: 20enbastos (5.87€)
Seat 6: Fried Berg (1.93€)
*** ANTE/BLINDS ***
Louis Vignac posts small blind 0.01€
_ilTulipano_ posts big blind 0.02€
Dealt to Fried Berg [Kd 4d]
*** PRE-FLOP *** 
castilla1978 folds
Td08nomotto folds
20enbastos folds
Fried Berg folds
Louis Vignac folds
_ilTulipano_ collected 0.03€ from pot
*** SUMMARY ***
Total pot 0.03€ | No rake
Seat 2: _ilTulipano_ (big blind) won 0.03€


Winamax Poker - HOLD-UP "Colorado" - HandId: #19116069-435652-1701512506 - Holdem no limit (0.01€/0.02€) - 2023/12/02 10:21:46 UTC
Table: 'Colorado' 6-max (real money) Seat #6 is the button
Seat 1: Fried Berg (1.93€)
Seat 2: Louis Vignac (2.56€)
Seat 3: laconalostra (3.20€)
Seat 4: HenriGuyBet (2.16€)
Seat 5: Baston57 (2.22€)
Seat 6: elsrab (4.38€)
*** ANTE/BLINDS ***
Fried Berg posts small blind 0.01€
Louis Vignac posts big blind 0.02€
Dealt to Fried Berg [8d Ts]
*** PRE-FLOP *** 
laconalostra folds
HenriGuyBet folds
Baston57 folds
elsrab folds
Fried Berg folds
Louis Vignac collected 0.03€ from pot
*** SUMMARY ***
Total pot 0.03€ | No rake
Seat 2: Louis Vignac (big blind) won 0.03€


Winamax Poker - HOLD-UP "Colorado" - HandId: #19116069-435676-1701512521 - Holdem no limit (0.01€/0.02€) - 2023/12/02 10:22:01 UTC
Table: 'Colorado' 6-max (real money) Seat #6 is the button
Seat 1: J.C Deuces.0 (1.94€)
Seat 2: Fried Berg (1.92€)
Seat 3: slowreplay (2.84€)
Seat 4: TaBrEaMoI (3.48€)
Seat 5: TheRealWill (3.16€)
Seat 6: lamuerta8300 (2.61€)
*** ANTE/BLINDS ***
J.C Deuces.0 posts small blind 0.01€
Fried Berg posts big blind 0.02€
Dealt to Fried Berg [3h Qc]
*** PRE-FLOP *** 
slowreplay folds
TaBrEaMoI folds
TheRealWill raises 0.04€ to 0.06€
lamuerta8300 raises 0.12€ to 0.18€
J.C Deuces.0 folds
Fried Berg folds
TheRealWill calls 0.12€
*** FLOP *** [3d As Jd]
TheRealWill checks
lamuerta8300 checks
*** TURN *** [3d As Jd][2c]
TheRealWill checks
lamuerta8300 checks
*** RIVER *** [3d As Jd 2c][Qs]
TheRealWill checks
lamuerta8300 bets 0.31€
TheRealWill folds
lamuerta8300 collected 0.66€ from pot
*** SUMMARY ***
Total pot 0.66€ | Rake 0.04€
Board: [3d As Jd 2c Qs]
Seat 6: lamuerta8300 (button) won 0.66€


Winamax Poker - HOLD-UP "Colorado" - HandId: #19116069-435702-1701512543 - Holdem no limit (0.01€/0.02€) - 2023/12/02 10:22:23 UTC
Table: 'Colorado' 6-max (real money) Seat #6 is the button
Seat 1: MONEYFOREVER (2.60€)
Seat 2: Kallonys (1.62€)
Seat 3: TaBrEaMoI (3.31€)
Seat 4: Fried Berg (1.90€)
Seat 5: slowreplay (2.66€)
Seat 6: jdeepenslip (4.33€)
Hold-up to Pot: total 0.20€
*** ANTE/BLINDS ***
MONEYFOREVER posts small blind 0.01€
Kallonys posts big blind 0.02€
Dealt to Fried Berg [Kc Ks]
*** PRE-FLOP *** 
TaBrEaMoI folds
Fried Berg raises 0.38€ to 0.40€
slowreplay folds
jdeepenslip folds
MONEYFOREVER folds
Kallonys folds
Fried Berg collected 0.63€ from pot
*** SUMMARY ***
Total pot 0.63€ | No rake
Seat 4: Fried Berg won 0.63€


Winamax Poker - HOLD-UP "Colorado" - HandId: #19116069-435733-1701512570 - Holdem no limit (0.01€/0.02€) - 2023/12/02 10:22:50 UTC
Table: 'Colorado' 6-max (real money) Seat #6 is the button
Seat 1: El Paellas (0.50€)
Seat 2: Fried Berg (2.13€)
Seat 3: g8o8k8u (0.54€)
Seat 4: Pas1erreur (2€)
Seat 5: Louis Vignac (3.36€)
Seat 6: DosdeBras (1.58€)
*** ANTE/BLINDS ***
El Paellas posts small blind 0.01€
Fried Berg posts big blind 0.02€
Dealt to Fried Berg [Kh 4s]
*** PRE-FLOP *** 
g8o8k8u folds
Pas1erreur folds
Louis Vignac folds
DosdeBras folds
El Paellas folds
Fried Berg collected 0.03€ from pot
*** SUMMARY ***
Total pot 0.03€ | No rake
Seat 2: Fried Berg (big blind) won 0.03€


Winamax Poker - HOLD-UP "Colorado" - HandId: #19116069-435764-1701512594 - Holdem no limit (0.01€/0.02€) - 2023/12/02 10:23:14 UTC
Table: 'Colorado' 6-max (real money) Seat #6 is the button
Seat 1: J1nx3d (1.96€)
Seat 2: Louis Vignac (3.30€)
Seat 3: Maliki95 (0.68€)
Seat 4: MONEYFOREVER (2.50€)
Seat 5: Fried Berg (2.14€)
Seat 6: jdeepenslip (2€)
*** ANTE/BLINDS ***
J1nx3d posts small blind 0.01€
Louis Vignac posts big blind 0.02€
Dealt to Fried Berg [4h 8d]
*** PRE-FLOP *** 
Maliki95 folds
MONEYFOREVER folds
Fried Berg folds
jdeepenslip raises 0.02€ to 0.04€
J1nx3d folds
Louis Vignac calls 0.02€
*** FLOP *** [7c Kc 6s]
Louis Vignac checks
jdeepenslip checks
*** TURN *** [7c Kc 6s][Kh]
Louis Vignac checks
jdeepenslip checks
*** RIVER *** [7c Kc 6s Kh][5d]
Louis Vignac checks
jdeepenslip checks
*** SHOW DOWN ***
Louis Vignac shows [Jc 9s] (One pair : Kings)
jdeepenslip shows [7s Qs] (Two pairs : Kings and 7)
jdeepenslip collected 0.08€ from pot
*** SUMMARY ***
Total pot 0.08€ | Rake 0.01€
Board: [7c Kc 6s Kh 5d]
Seat 2: Louis Vignac (big blind) showed [Jc 9s] and lost with One pair : Kings
Seat 6: jdeepenslip (button) showed [7s Qs] and won 0.08€ with Two pairs : Kings and 7


Winamax Poker - HOLD-UP "Colorado" - HandId: #19116069-435795-1701512615 - Holdem no limit (0.01€/0.02€) - 2023/12/02 10:23:35 UTC
Table: 'Colorado' 6-max (real money) Seat #6 is the button
Seat 1: GwenLaGrise (2.26€)
Seat 2: TaBrEaMoI (3.37€)
Seat 3: Fried Berg (2.14€)
Seat 4: ITALIA291 (2€)
Seat 5: El Paellas (0.50€)
Seat 6: am 21 (2.08€)
*** ANTE/BLINDS ***
GwenLaGrise posts small blind 0.01€
TaBrEaMoI posts big blind 0.02€
Dealt to Fried Berg [2s Kd]
*** PRE-FLOP *** 
Fried Berg folds
ITALIA291 folds
El Paellas raises 0.03€ to 0.05€
am 21 folds
GwenLaGrise folds
TaBrEaMoI folds
El Paellas collected 0.08€ from pot
*** SUMMARY ***
Total pot 0.08€ | No rake
Seat 5: El Paellas won 0.08€


Winamax Poker - HOLD-UP "Colorado" - HandId: #19116069-435799-1701512618 - Holdem no limit (0.01€/0.02€) - 2023/12/02 10:23:38 UTC
Table: 'Colorado' 6-max (real money) Seat #6 is the button
Seat 1: nico033 (3.24€)
Seat 2: J1nx3d (1.90€)
Seat 3: PIQSOU (2.46€)
Seat 4: slowreplay (2.75€)
Seat 5: Fried Berg (2.14€)
Seat 6: Retail Row (3.56€)
*** ANTE/BLINDS ***
nico033 posts small blind 0.01€
J1nx3d posts big blind 0.02€
Dealt to Fried Berg [7s 8s]
*** PRE-FLOP *** 
PIQSOU folds
slowreplay folds
Fried Berg raises 0.02€ to 0.04€
Retail Row folds
nico033 folds
J1nx3d calls 0.02€
*** FLOP *** [Tc Td 3h]
J1nx3d checks
Fried Berg checks
*** TURN *** [Tc Td 3h][5s]
J1nx3d bets 0.05€
Fried Berg folds
J1nx3d collected 0.13€ from pot
*** SUMMARY ***
Total pot 0.13€ | Rake 0.01€
Board: [Tc Td 3h 5s]
Seat 2: J1nx3d (big blind) won 0.13€


Winamax Poker - HOLD-UP "Colorado" - HandId: #19116069-435835-1701512644 - Holdem no limit (0.01€/0.02€) - 2023/12/02 10:24:04 UTC
Table: 'Colorado' 6-max (real money) Seat #6 is the button
Seat 1: alban158 (2.06€)
Seat 2: castilla1978 (3.83€)
Seat 3: Maliki95 (0.62€)
Seat 4: Fried Berg (2.10€)
Seat 5: Kito31 (7.92€)
Seat 6: slowreplay (2.73€)
*** ANTE/BLINDS ***
alban158 posts small blind 0.01€
castilla1978 posts big blind 0.02€
Dealt to Fried Berg [6c 6s]
*** PRE-FLOP *** 
Maliki95 raises 0.03€ to 0.05€
Fried Berg calls 0.05€
Kito31 folds
slowreplay folds
alban158 calls 0.04€
castilla1978 raises 0.20€ to 0.25€
Maliki95 folds
Fried Berg folds
alban158 folds
castilla1978 collected 0.40€ from pot
*** SUMMARY ***
Total pot 0.40€ | No rake
Seat 2: castilla1978 (big blind) won 0.40€


Winamax Poker - HOLD-UP "Colorado" - HandId: #19116069-435883-1701512679 - Holdem no limit (0.01€/0.02€) - 2023/12/02 10:24:39 UTC
Table: 'Colorado' 6-max (real money) Seat #6 is the button
Seat 1: Fried Berg (2.05€)
Seat 2: LuckyLopez (3.49€)
Seat 3: PIQSOU (2.63€)
Seat 4: Thequeen1205 (2.10€)
Seat 5: TJ Podoli II (0.52€)
Seat 6: slowreplay (2.42€)
Hold-up to Pot: total 0.10€
*** ANTE/BLINDS ***
Fried Berg posts small blind 0.01€
LuckyLopez posts big blind 0.02€
Dealt to Fried Berg [Jd Qd]
*** PRE-FLOP *** 
PIQSOU folds
Thequeen1205 folds
TJ Podoli II raises 0.03€ to 0.05€
slowreplay folds
Fried Berg raises 0.10€ to 0.15€
LuckyLopez folds
TJ Podoli II folds
Fried Berg collected 0.32€ from pot
*** SUMMARY ***
Total pot 0.32€ | No rake
Seat 1: Fried Berg (small blind) won 0.32€


Winamax Poker - HOLD-UP "Colorado" - HandId: #19116069-435929-1701512712 - Holdem no limit (0.01€/0.02€) - 2023/12/02 10:25:12 UTC
Table: 'Colorado' 6-max (real money) Seat #6 is the button
Seat 1: MissLoulou (4.03€)
Seat 2: El Paellas (0.50€)
Seat 3: Fried Berg (2.22€)
Seat 4: castilla1978 (3.97€)
Seat 5: laconalostra (3.39€)
Seat 6: Retail Row (3.91€)
*** ANTE/BLINDS ***
MissLoulou posts small blind 0.01€
El Paellas posts big blind 0.02€
Dealt to Fried Berg [9s As]
*** PRE-FLOP *** 
Fried Berg raises 0.02€ to 0.04€
castilla1978 folds
laconalostra folds
Retail Row folds
MissLoulou folds
El Paellas folds
Fried Berg collected 0.07€ from pot
*** SUMMARY ***
Total pot 0.07€ | No rake
Seat 3: Fried Berg won 0.07€


Winamax Poker - HOLD-UP "Colorado" - HandId: #19116069-435957-1701512730 - Holdem no limit (0.01€/0.02€) - 2023/12/02 10:25:30 UTC
Table: 'Colorado' 6-max (real money) Seat #6 is the button
Seat 1: rick26 (0.56€)
Seat 2: Fried Berg (2.25€)
Seat 3: castilla1978 (1.48€)
Seat 4: TaBrEaMoI (3.28€)
Seat 5: Fran1Oller (4.27€)
Seat 6: PIQSOU (2.69€)
*** ANTE/BLINDS ***
rick26 posts small blind 0.01€
Fried Berg posts big blind 0.02€
Dealt to Fried Berg [Qc 8d]
*** PRE-FLOP *** 
castilla1978 folds
TaBrEaMoI raises 0.04€ to 0.06€
Fran1Oller folds
PIQSOU folds
rick26 folds
Fried Berg folds
TaBrEaMoI collected 0.09€ from pot
*** SUMMARY ***
Total pot 0.09€ | No rake
Seat 4: TaBrEaMoI won 0.09€


Winamax Poker - HOLD-UP "Colorado" - HandId: #19116069-435985-1701512750 - Holdem no limit (0.01€/0.02€) - 2023/12/02 10:25:50 UTC
Table: 'Colorado' 6-max (real money) Seat #6 is the button
Seat 1: popoche29 (11.88€)
Seat 2: slowreplay (2.45€)
Seat 3: jdeepenslip (2.05€)
Seat 4: him-again (1.44€)
Seat 5: ComeOn75 (2.18€)
Seat 6: Fried Berg (2.23€)
*** ANTE/BLINDS ***
popoche29 posts small blind 0.01€
slowreplay posts big blind 0.02€
Dealt to Fried Berg [6c 5d]
*** PRE-FLOP *** 
jdeepenslip folds
him-again folds
ComeOn75 folds
Fried Berg raises 0.02€ to 0.04€
popoche29 folds
slowreplay calls 0.02€
*** FLOP *** [Ac 4d As]
slowreplay checks
Fried Berg checks
*** TURN *** [Ac 4d As][7c]
slowreplay bets 0.05€
Fried Berg folds
slowreplay collected 0.13€ from pot
*** SUMMARY ***
Total pot 0.13€ | Rake 0.01€
Board: [Ac 4d As 7c]
Seat 2: slowreplay (big blind) won 0.13€


Winamax Poker - HOLD-UP "Colorado" - HandId: #19116069-436059-1701512804 - Holdem no limit (0.01€/0.02€) - 2023/12/02 10:26:44 UTC
Table: 'Colorado' 6-max (real money) Seat #6 is the button
Seat 1: Fried Berg (2.19€)
Seat 2: LuckyLopez (4.56€)
Seat 3: FPVrominou (2.29€)
Seat 4: TaBrEaMoI (3.29€)
Seat 5: Td08nomotto (2€)
Seat 6: colgate12 (1.75€)
*** ANTE/BLINDS ***
Fried Berg posts small blind 0.01€
LuckyLopez posts big blind 0.02€
Dealt to Fried Berg [5s 6c]
*** PRE-FLOP *** 
FPVrominou folds
TaBrEaMoI folds
Td08nomotto calls 0.02€
colgate12 folds
Fried Berg folds
LuckyLopez checks
*** FLOP *** [2s 2c 5c]
LuckyLopez checks
Td08nomotto checks
*** TURN *** [2s 2c 5c][Ad]
LuckyLopez checks
Td08nomotto checks
*** RIVER *** [2s 2c 5c Ad][Ac]
LuckyLopez checks
Td08nomotto checks
*** SHOW DOWN ***
LuckyLopez shows [8d 4s] (Two pairs : Aces and 2)
Td08nomotto shows [Td 9d] (Two pairs : Aces and 2)
Td08nomotto collected 0.04€ from pot
*** SUMMARY ***
Total pot 0.04€ | Rake 0.01€
Board: [2s 2c 5c Ad Ac]
Seat 2: LuckyLopez (big blind) showed [8d 4s] and lost with Two pairs : Aces and 2
Seat 5: Td08nomotto showed [Td 9d] and won 0.04€ with Two pairs : Aces and 2


Winamax Poker - HOLD-UP "Colorado" - HandId: #19116069-436066-1701512809 - Holdem no limit (0.01€/0.02€) - 2023/12/02 10:26:49 UTC
Table: 'Colorado' 6-max (real money) Seat #6 is the button
Seat 1: slowreplay (2.25€)
Seat 2: Pas1erreur (1.14€)
Seat 3: mea botellas (3.33€)
Seat 4: -KrAKPAs- (2.07€)
Seat 5: castilla1978 (1.27€)
Seat 6: Fried Berg (2.18€)
*** ANTE/BLINDS ***
slowreplay posts small blind 0.01€
Pas1erreur posts big blind 0.02€
Dealt to Fried Berg [9c Ac]
*** PRE-FLOP *** 
mea botellas folds
-KrAKPAs- raises 0.03€ to 0.05€
castilla1978 folds
Fried Berg calls 0.05€
slowreplay folds
Pas1erreur folds
*** FLOP *** [7h 9h Qd]
-KrAKPAs- bets 0.05€
Fried Berg calls 0.05€
*** TURN *** [7h 9h Qd][6d]
-KrAKPAs- checks
Fried Berg checks
*** RIVER *** [7h 9h Qd 6d][Ts]
-KrAKPAs- bets 0.23€
Fried Berg folds
-KrAKPAs- collected 0.44€ from pot
*** SUMMARY ***
Total pot 0.44€ | Rake 0.02€
Board: [7h 9h Qd 6d Ts]
Seat 4: -KrAKPAs- won 0.44€


Winamax Poker - HOLD-UP "Colorado" - HandId: #19116069-436133-1701512855 - Holdem no limit (0.01€/0.02€) - 2023/12/02 10:27:35 UTC
Table: 'Colorado' 6-max (real money) Seat #6 is the button
Seat 1: Betiegarri (2.17€)
Seat 2: Fried Berg (2.08€)
Seat 3: Nombrillus (1.72€)
Seat 4: Pop_hop_hop (1.27€)
Seat 5: PIQSOU (6.21€)
Seat 6: kameleon73 (4.09€)
*** ANTE/BLINDS ***
Betiegarri posts small blind 0.01€
Fried Berg posts big blind 0.02€
Dealt to Fried Berg [Jh 6d]
*** PRE-FLOP *** 
Nombrillus folds
Pop_hop_hop folds
PIQSOU raises 0.03€ to 0.05€
kameleon73 folds
Betiegarri folds
Fried Berg folds
PIQSOU collected 0.08€ from pot
*** SUMMARY ***
Total pot 0.08€ | No rake
Seat 5: PIQSOU won 0.08€


Winamax Poker - HOLD-UP "Colorado" - HandId: #19116069-436175-1701512883 - Holdem no limit (0.01€/0.02€) - 2023/12/02 10:28:03 UTC
Table: 'Colorado' 6-max (real money) Seat #6 is the button
Seat 1: colgate12 (2.39€)
Seat 2: TheRealWill (3.13€)
Seat 3: TaBrEaMoI (3.16€)
Seat 4: Fried Berg (2.06€)
Seat 5: jdeepenslip (2€)
Seat 6: Pop_hop_hop (1.27€)
*** ANTE/BLINDS ***
colgate12 posts small blind 0.01€
TheRealWill posts big blind 0.02€
Dealt to Fried Berg [6s 9s]
*** PRE-FLOP *** 
TaBrEaMoI folds
Fried Berg raises 0.02€ to 0.04€
jdeepenslip folds
Pop_hop_hop folds
colgate12 calls 0.03€
TheRealWill folds
*** FLOP *** [Ac 3c Ad]
colgate12 checks
Fried Berg checks
*** TURN *** [Ac 3c Ad][6d]
colgate12 checks
Fried Berg bets 0.02€
colgate12 calls 0.02€
*** RIVER *** [Ac 3c Ad 6d][Ts]
colgate12 checks
Fried Berg checks
*** SHOW DOWN ***
colgate12 shows [Qs Jc] (One pair : Aces)
Fried Berg shows [6s 9s] (Two pairs : Aces and 6)
Fried Berg collected 0.13€ from pot
*** SUMMARY ***
Total pot 0.13€ | Rake 0.01€
Board: [Ac 3c Ad 6d Ts]
Seat 1: colgate12 (small blind) showed [Qs Jc] and lost with One pair : Aces
Seat 4: Fried Berg showed [6s 9s] and won 0.13€ with Two pairs : Aces and 6


Winamax Poker - HOLD-UP "Colorado" - HandId: #19116069-436228-1701512926 - Holdem no limit (0.01€/0.02€) - 2023/12/02 10:28:46 UTC
Table: 'Colorado' 6-max (real money) Seat #6 is the button
Seat 1: castilla1978 (1.20€)
Seat 2: Vorey43 (4.02€)
Seat 3: Retail Row (3.89€)
Seat 4: colgate12 (2.33€)
Seat 5: Fried Berg (2.13€)
Seat 6: slowreplay (3€)
*** ANTE/BLINDS ***
castilla1978 posts small blind 0.01€
Vorey43 posts big blind 0.02€
Dealt to Fried Berg [8d 4s]
*** PRE-FLOP *** 
Retail Row raises 0.04€ to 0.06€
colgate12 folds
Fried Berg folds
slowreplay folds
castilla1978 folds
Vorey43 calls 0.04€
*** FLOP *** [Qh Qs Kh]
Vorey43 checks
Retail Row bets 0.07€
Vorey43 folds
Retail Row collected 0.19€ from pot
*** SUMMARY ***
Total pot 0.19€ | Rake 0.01€
Board: [Qh Qs Kh]
Seat 3: Retail Row won 0.19€


Winamax Poker - HOLD-UP "Colorado" - HandId: #19116069-436281-1701512975 - Holdem no limit (0.01€/0.02€) - 2023/12/02 10:29:35 UTC
Table: 'Colorado' 6-max (real money) Seat #6 is the button
Seat 1: Fran1Oller (5.47€)
Seat 2: Popierre (2€)
Seat 3: Fried Berg (2.13€)
Seat 4: castilla1978 (2.52€)
Seat 5: HenriGuyBet (5.68€)
Seat 6: ITALIA291 (2.07€)
*** ANTE/BLINDS ***
Fran1Oller posts small blind 0.01€
Popierre posts big blind 0.02€
Dealt to Fried Berg [4s Jd]
*** PRE-FLOP *** 
Fried Berg folds
castilla1978 folds
HenriGuyBet folds
ITALIA291 folds
Fran1Oller raises 0.03€ to 0.05€
Popierre calls 0.03€
*** FLOP *** [6h 3h 7c]
Fran1Oller bets 0.03€
Popierre calls 0.03€
*** TURN *** [6h 3h 7c][As]
Fran1Oller bets 0.05€
Popierre calls 0.05€
*** RIVER *** [6h 3h 7c As][6d]
Fran1Oller checks
Popierre checks
*** SHOW DOWN ***
Popierre shows [Jh 7h] (Two pairs : 7 and 6)
Fran1Oller shows [Qs Ah] (Two pairs : Aces and 6)
Fran1Oller collected 0.23€ from pot
*** SUMMARY ***
Total pot 0.23€ | Rake 0.03€
Board: [6h 3h 7c As 6d]
Seat 1: Fran1Oller (small blind) showed [Qs Ah] and won 0.23€ with Two pairs : Aces and 6
Seat 2: Popierre (big blind) showed [Jh 7h] and lost with Two pairs : 7 and 6


Winamax Poker - HOLD-UP "Colorado" - HandId: #19116069-436283-1701512976 - Holdem no limit (0.01€/0.02€) - 2023/12/02 10:29:36 UTC
Table: 'Colorado' 6-max (real money) Seat #6 is the button
Seat 1: _ilTulipano_ (6.46€)
Seat 2: Merlus83 (2.79€)
Seat 3: Izy_River (2.78€)
Seat 4: ironman33 (0.78€)
Seat 5: Fried Berg (2.13€)
Seat 6: 2winchester (0.51€)
*** ANTE/BLINDS ***
_ilTulipano_ posts small blind 0.01€
Merlus83 posts big blind 0.02€
Dealt to Fried Berg [Kc 9h]
*** PRE-FLOP *** 
Izy_River folds
ironman33 raises 0.02€ to 0.04€
Fried Berg folds
2winchester calls 0.04€
_ilTulipano_ folds
Merlus83 folds
*** FLOP *** [Ah 9d Qd]
ironman33 bets 0.04€
2winchester calls 0.04€
*** TURN *** [Ah 9d Qd][9s]
ironman33 bets 0.04€
2winchester calls 0.04€
*** RIVER *** [Ah 9d Qd 9s][Jd]
ironman33 checks
2winchester checks
*** SHOW DOWN ***
2winchester shows [Qc Th] (Two pairs : Queens and 9)
ironman33 shows [Ad 3s] (Two pairs : Aces and 9)
ironman33 collected 0.24€ from pot
*** SUMMARY ***
Total pot 0.24€ | Rake 0.03€
Board: [Ah 9d Qd 9s Jd]
Seat 4: ironman33 showed [Ad 3s] and won 0.24€ with Two pairs : Aces and 9
Seat 6: 2winchester (button) showed [Qc Th] and lost with Two pairs : Queens and 9


Winamax Poker - HOLD-UP "Colorado" - HandId: #19116069-436290-1701512982 - Holdem no limit (0.01€/0.02€) - 2023/12/02 10:29:42 UTC
Table: 'Colorado' 6-max (real money) Seat #6 is the button
Seat 1: mea botellas (4.61€)
Seat 2: ECPulga (2.01€)
Seat 3: Fried Berg (2.13€)
Seat 4: HenriGuyBet (5.68€)
Seat 5: TheRealWill (3.19€)
Seat 6: AK2-MILIK (4.42€)
*** ANTE/BLINDS ***
mea botellas posts small blind 0.01€
ECPulga posts big blind 0.02€
Dealt to Fried Berg [4h Kd]
*** PRE-FLOP *** 
Fried Berg folds
HenriGuyBet folds
TheRealWill folds
AK2-MILIK folds
mea botellas raises 0.04€ to 0.06€
ECPulga calls 0.04€
*** FLOP *** [8s 5h Ad]
mea botellas checks
ECPulga checks
*** TURN *** [8s 5h Ad][5d]
mea botellas checks
ECPulga checks
*** RIVER *** [8s 5h Ad 5d][Jc]
mea botellas bets 0.08€
ECPulga folds
mea botellas collected 0.19€ from pot
*** SUMMARY ***
Total pot 0.19€ | Rake 0.01€
Board: [8s 5h Ad 5d Jc]
Seat 1: mea botellas (small blind) won 0.19€


Winamax Poker - HOLD-UP "Colorado" - HandId: #19116069-436294-1701512985 - Holdem no limit (0.01€/0.02€) - 2023/12/02 10:29:45 UTC
Table: 'Colorado' 6-max (real money) Seat #6 is the button
Seat 1: Fried Berg (2.13€)
Seat 2: TheRealWill (2.21€)
Seat 3: Betiegarri (1.95€)
Seat 4: e-card (2€)
Seat 5: AmazinG. (1.78€)
Seat 6: El Paellas (0.52€)
*** ANTE/BLINDS ***
Fried Berg posts small blind 0.01€
TheRealWill posts big blind 0.02€
Dealt to Fried Berg [6d Kh]
*** PRE-FLOP *** 
Betiegarri raises 0.04€ to 0.06€
e-card folds
AmazinG. folds
El Paellas folds
Fried Berg folds
TheRealWill folds
Betiegarri collected 0.09€ from pot
*** SUMMARY ***
Total pot 0.09€ | No rake
Seat 3: Betiegarri won 0.09€


Winamax Poker - HOLD-UP "Colorado" - HandId: #19116069-436297-1701512987 - Holdem no limit (0.01€/0.02€) - 2023/12/02 10:29:47 UTC
Table: 'Colorado' 6-max (real money) Seat #6 is the button
Seat 1: HenriGuyBet (5.68€)
Seat 2: Kallonys (1.93€)
Seat 3: Thequeen1205 (2€)
Seat 4: Fried Berg (2.12€)
Seat 5: e-card (2€)
Seat 6: Baston57 (2.05€)
*** ANTE/BLINDS ***
HenriGuyBet posts small blind 0.01€
Kallonys posts big blind 0.02€
Dealt to Fried Berg [Kd 9d]
*** PRE-FLOP *** 
Thequeen1205 folds
Fried Berg raises 0.02€ to 0.04€
e-card folds
Baston57 folds
HenriGuyBet folds
Kallonys folds
Fried Berg collected 0.07€ from pot
*** SUMMARY ***
Total pot 0.07€ | No rake
Seat 4: Fried Berg won 0.07€


Winamax Poker - HOLD-UP "Colorado" - HandId: #19116069-436317-1701513005 - Holdem no limit (0.01€/0.02€) - 2023/12/02 10:30:05 UTC
Table: 'Colorado' 6-max (real money) Seat #6 is the button
Seat 1: e-card (2.01€)
Seat 2: lamuerta8300 (2.06€)
Seat 3: J.C Deuces.0 (3.20€)
Seat 4: El Paellas (0.53€)
Seat 5: Fried Berg (2.15€)
Seat 6: Pas1erreur (2.03€)
*** ANTE/BLINDS ***
e-card posts small blind 0.01€
lamuerta8300 posts big blind 0.02€
Dealt to Fried Berg [As 9d]
*** PRE-FLOP *** 
J.C Deuces.0 folds
El Paellas folds
Fried Berg raises 0.02€ to 0.04€
Pas1erreur calls 0.04€
e-card folds
lamuerta8300 folds
*** FLOP *** [Ts Jh 6c]
Fried Berg checks
Pas1erreur checks
*** TURN *** [Ts Jh 6c][Kc]
Fried Berg checks
Pas1erreur checks
*** RIVER *** [Ts Jh 6c Kc][6d]
Fried Berg folds
Pas1erreur collected 0.10€ from pot
*** SUMMARY ***
Total pot 0.10€ | Rake 0.01€
Board: [Ts Jh 6c Kc 6d]
Seat 6: Pas1erreur (button) won 0.10€


Winamax Poker - HOLD-UP "Colorado" - HandId: #19116069-436386-1701513062 - Holdem no limit (0.01€/0.02€) - 2023/12/02 10:31:02 UTC
Table: 'Colorado' 6-max (real money) Seat #6 is the button
Seat 1: Fried Berg (2.11€)
Seat 2: Coq82 (2€)
Seat 3: GwenLaGrise (2.63€)
Seat 4: magnumbenji (1.12€)
Seat 5: TaBrEaMoI (3.12€)
Seat 6: Zile741 (2.03€)
*** ANTE/BLINDS ***
Fried Berg posts small blind 0.01€
Coq82 posts big blind 0.02€
Dealt to Fried Berg [Jd 8h]
*** PRE-FLOP *** 
GwenLaGrise folds
magnumbenji folds
TaBrEaMoI raises 0.04€ to 0.06€
Zile741 folds
Fried Berg folds
Coq82 folds
TaBrEaMoI collected 0.09€ from pot
*** SUMMARY ***
Total pot 0.09€ | No rake
Seat 5: TaBrEaMoI won 0.09€


Winamax Poker - HOLD-UP "Colorado" - HandId: #19116069-436410-1701513077 - Holdem no limit (0.01€/0.02€) - 2023/12/02 10:31:17 UTC
Table: 'Colorado' 6-max (real money) Seat #6 is the button
Seat 1: AmazinG. (1.68€)
Seat 2: MONEYFOREVER (2.74€)
Seat 3: 121 (4.48€)
Seat 4: Fried Berg (2.10€)
Seat 5: Td08nomotto (2€)
Seat 6: PIQSOU (3.34€)
*** ANTE/BLINDS ***
AmazinG. posts small blind 0.01€
MONEYFOREVER posts big blind 0.02€
Dealt to Fried Berg [2h 3h]
*** PRE-FLOP *** 
121 folds
Fried Berg folds
Td08nomotto folds
PIQSOU raises 0.03€ to 0.05€
AmazinG. folds
MONEYFOREVER folds
PIQSOU collected 0.08€ from pot
*** SUMMARY ***
Total pot 0.08€ | No rake
Seat 6: PIQSOU (button) won 0.08€


Winamax Poker - HOLD-UP "Colorado" - HandId: #19116069-436419-1701513083 - Holdem no limit (0.01€/0.02€) - 2023/12/02 10:31:23 UTC
Table: 'Colorado' 6-max (real money) Seat #6 is the button
Seat 1: castilla1978 (4.21€)
Seat 2: Fried Berg (2.10€)
Seat 3: LuckyLopez (4.23€)
Seat 4: TaBrEaMoI (3.15€)
Seat 5: Pas1erreur (1.75€)
Seat 6: AmazinG. (1.67€)
*** ANTE/BLINDS ***
castilla1978 posts small blind 0.01€
Fried Berg posts big blind 0.02€
Dealt to Fried Berg [Kd Jc]
*** PRE-FLOP *** 
LuckyLopez folds
TaBrEaMoI folds
Pas1erreur raises 0.03€ to 0.05€
AmazinG. folds
castilla1978 folds
Fried Berg calls 0.03€
*** FLOP *** [Qd Tc 4h]
Fried Berg checks
Pas1erreur bets 0.04€
Fried Berg calls 0.04€
*** TURN *** [Qd Tc 4h][Ad]
Fried Berg checks
Pas1erreur checks
*** RIVER *** [Qd Tc 4h Ad][9s]
Fried Berg checks
Pas1erreur checks
*** SHOW DOWN ***
Pas1erreur shows [8s 8c] (One pair : 8)
Fried Berg shows [Kd Jc] (Straight Ace high)
Fried Berg collected 0.17€ from pot
*** SUMMARY ***
Total pot 0.17€ | Rake 0.02€
Board: [Qd Tc 4h Ad 9s]
Seat 2: Fried Berg (big blind) showed [Kd Jc] and won 0.17€ with Straight Ace high
Seat 5: Pas1erreur showed [8s 8c] and lost with One pair : 8


Winamax Poker - HOLD-UP "Colorado" - HandId: #19116069-436507-1701513146 - Holdem no limit (0.01€/0.02€) - 2023/12/02 10:32:26 UTC
Table: 'Colorado' 6-max (real money) Seat #6 is the button
Seat 1: g8o8k8u (0.72€)
Seat 2: FPVrominou (1.74€)
Seat 3: Fran1Oller (4.34€)
Seat 4: Fried Berg (2.18€)
Seat 5: chouchenboy (2.10€)
Seat 6: _ilTulipano_ (4.65€)
*** ANTE/BLINDS ***
g8o8k8u posts small blind 0.01€
FPVrominou posts big blind 0.02€
Dealt to Fried Berg [Qc Qd]
*** PRE-FLOP *** 
Fran1Oller folds
Fried Berg raises 0.02€ to 0.04€
chouchenboy folds
_ilTulipano_ folds
g8o8k8u folds
FPVrominou folds
Fried Berg collected 0.07€ from pot
*** SUMMARY ***
Total pot 0.07€ | No rake
Seat 4: Fried Berg won 0.07€


Winamax Poker - HOLD-UP "Colorado" - HandId: #19116069-436519-1701513158 - Holdem no limit (0.01€/0.02€) - 2023/12/02 10:32:38 UTC
Table: 'Colorado' 6-max (real money) Seat #6 is the button
Seat 1: GwenLaGrise (3.51€)
Seat 2: toutoazar (2.16€)
Seat 3: NyKOh11 (0.50€)
Seat 4: Fran1Oller (4.33€)
Seat 5: FrappeLourde (0.52€)
Seat 6: Fried Berg (2.21€)
*** ANTE/BLINDS ***
GwenLaGrise posts small blind 0.01€
toutoazar posts big blind 0.02€
Dealt to Fried Berg [6h Ac]
*** PRE-FLOP *** 
NyKOh11 folds
Fran1Oller folds
FrappeLourde raises 0.04€ to 0.06€
Fried Berg folds
GwenLaGrise folds
toutoazar folds
FrappeLourde collected 0.09€ from pot
*** SUMMARY ***
Total pot 0.09€ | No rake
Seat 5: FrappeLourde won 0.09€


Winamax Poker - HOLD-UP "Colorado" - HandId: #19116069-436533-1701513167 - Holdem no limit (0.01€/0.02€) - 2023/12/02 10:32:47 UTC
Table: 'Colorado' 6-max (real money) Seat #6 is the button
Seat 1: TaBrEaMoI (3.99€)
Seat 2: chouchenboy (2.10€)
Seat 3: Fried Berg (2.21€)
Seat 4: mea botellas (4.90€)
Seat 5: MONEYFOREVER (2.53€)
Seat 6: Coq82 (2.03€)
*** ANTE/BLINDS ***
TaBrEaMoI posts small blind 0.01€
chouchenboy posts big blind 0.02€
Dealt to Fried Berg [5s Ad]
*** PRE-FLOP *** 
Fried Berg folds
mea botellas folds
MONEYFOREVER folds
Coq82 folds
TaBrEaMoI folds
chouchenboy collected 0.03€ from pot
*** SUMMARY ***
Total pot 0.03€ | No rake
Seat 2: chouchenboy (big blind) won 0.03€


Winamax Poker - HOLD-UP "Colorado" - HandId: #19116069-436537-1701513170 - Holdem no limit (0.01€/0.02€) - 2023/12/02 10:32:50 UTC
Table: 'Colorado' 6-max (real money) Seat #6 is the button
Seat 1: Fried Berg (2.21€)
Seat 2: mea botellas (4.90€)
Seat 3: TaBrEaMoI (3.98€)
Seat 4: MONEYFOREVER (2.53€)
Seat 5: J.C Deuces.0 (3.68€)
Seat 6: PIQSOU (2.60€)
*** ANTE/BLINDS ***
Fried Berg posts small blind 0.01€
mea botellas posts big blind 0.02€
Dealt to Fried Berg [9h 6d]
*** PRE-FLOP *** 
TaBrEaMoI folds
MONEYFOREVER raises 0.04€ to 0.06€
J.C Deuces.0 folds
PIQSOU folds
Fried Berg folds
mea botellas folds
MONEYFOREVER collected 0.09€ from pot
*** SUMMARY ***
Total pot 0.09€ | No rake
Seat 4: MONEYFOREVER won 0.09€


Winamax Poker - HOLD-UP "Colorado" - HandId: #19116069-436540-1701513172 - Holdem no limit (0.01€/0.02€) - 2023/12/02 10:32:52 UTC
Table: 'Colorado' 6-max (real money) Seat #6 is the button
Seat 1: Td08nomotto (2.02€)
Seat 2: Coq82 (2.03€)
Seat 3: Le_Pere_Plex (2.25€)
Seat 4: Lemurien-697 (0.82€)
Seat 5: Fried Berg (2.20€)
Seat 6: NyKOh11 (0.50€)
*** ANTE/BLINDS ***
Td08nomotto posts small blind 0.01€
Coq82 posts big blind 0.02€
Dealt to Fried Berg [8c 8d]
*** PRE-FLOP *** 
Le_Pere_Plex folds
Lemurien-697 folds
Fried Berg raises 0.02€ to 0.04€
NyKOh11 folds
Td08nomotto folds
Coq82 folds
Fried Berg collected 0.07€ from pot
*** SUMMARY ***
Total pot 0.07€ | No rake
Seat 5: Fried Berg won 0.07€


Winamax Poker - HOLD-UP "Colorado" - HandId: #19116069-436551-1701513181 - Holdem no limit (0.01€/0.02€) - 2023/12/02 10:33:01 UTC
Table: 'Colorado' 6-max (real money) Seat #6 is the button
Seat 1: toutoazar (2.14€)
Seat 2: 121 (4.57€)
Seat 3: Kallonys (6.01€)
Seat 4: TaBrEaMoI (3.13€)
Seat 5: Fried Berg (2.23€)
Seat 6: lamuerta8300 (2.83€)
*** ANTE/BLINDS ***
toutoazar posts small blind 0.01€
121 posts big blind 0.02€
Dealt to Fried Berg [9c 2h]
*** PRE-FLOP *** 
Kallonys folds
TaBrEaMoI raises 0.04€ to 0.06€
Fried Berg folds
lamuerta8300 folds
toutoazar calls 0.05€
121 folds
*** FLOP *** [Ad 8d 5h]
toutoazar checks
TaBrEaMoI bets 0.07€
toutoazar folds
TaBrEaMoI collected 0.20€ from pot
*** SUMMARY ***
Total pot 0.20€ | Rake 0.01€
Board: [Ad 8d 5h]
Seat 4: TaBrEaMoI won 0.20€


Winamax Poker - HOLD-UP "Colorado" - HandId: #19116069-436575-1701513200 - Holdem no limit (0.01€/0.02€) - 2023/12/02 10:33:20 UTC
Table: 'Colorado' 6-max (real money) Seat #6 is the button
Seat 1: lamuerta8300 (2.08€)
Seat 2: Baston57 (1.88€)
Seat 3: laconalostra (4.63€)
Seat 4: Fried Berg (2.23€)
Seat 5: Chacal-Punk (4.89€)
Seat 6: 121 (4.55€)
*** ANTE/BLINDS ***
lamuerta8300 posts small blind 0.01€
Baston57 posts big blind 0.02€
Dealt to Fried Berg [3d Ts]
*** PRE-FLOP *** 
laconalostra folds
Fried Berg folds
Chacal-Punk folds
121 folds
lamuerta8300 raises 0.04€ to 0.06€
Baston57 folds
lamuerta8300 collected 0.08€ from pot
*** SUMMARY ***
Total pot 0.08€ | No rake
Seat 1: lamuerta8300 (small blind) won 0.08€


Winamax Poker - HOLD-UP "Colorado" - HandId: #19116069-436581-1701513205 - Holdem no limit (0.01€/0.02€) - 2023/12/02 10:33:25 UTC
Table: 'Colorado' 6-max (real money) Seat #6 is the button
Seat 1: PIQSOU (3.37€)
Seat 2: MaryAthena (3.56€)
Seat 3: josep2170 (2.24€)
Seat 4: VGuedjo (2€)
Seat 5: g8o8k8u (0.74€)
Seat 6: Fried Berg (2.23€)
*** ANTE/BLINDS ***
PIQSOU posts small blind 0.01€
MaryAthena posts big blind 0.02€
Dealt to Fried Berg [4s 4c]
*** PRE-FLOP *** 
josep2170 folds
VGuedjo raises 0.03€ to 0.05€
g8o8k8u folds
Fried Berg calls 0.05€
PIQSOU folds
MaryAthena calls 0.03€
*** FLOP *** [2c Td 2s]
MaryAthena checks
VGuedjo bets 0.10€
Fried Berg folds
MaryAthena folds
VGuedjo collected 0.24€ from pot
*** SUMMARY ***
Total pot 0.24€ | Rake 0.02€
Board: [2c Td 2s]
Seat 4: VGuedjo won 0.24€


Winamax Poker - HOLD-UP "Colorado" - HandId: #19116069-436663-1701513258 - Holdem no limit (0.01€/0.02€) - 2023/12/02 10:34:18 UTC
Table: 'Colorado' 6-max (real money) Seat #6 is the button
Seat 1: Fried Berg (2.18€)
Seat 2: am 21 (1.88€)
Seat 3: Coq82 (2.10€)
Seat 4: chouchenboy (1.93€)
Seat 5: NyKOh11 (0.50€)
Seat 6: GwenLaGrise (2.27€)
*** ANTE/BLINDS ***
Fried Berg posts small blind 0.01€
am 21 posts big blind 0.02€
Dealt to Fried Berg [Js 4d]
*** PRE-FLOP *** 
Coq82 folds
chouchenboy folds
NyKOh11 folds
GwenLaGrise folds
Fried Berg folds
am 21 collected 0.03€ from pot
*** SUMMARY ***
Total pot 0.03€ | No rake
Seat 2: am 21 (big blind) won 0.03€


Winamax Poker - HOLD-UP "Colorado" - HandId: #19116069-436674-1701513269 - Holdem no limit (0.01€/0.02€) - 2023/12/02 10:34:29 UTC
Table: 'Colorado' 6-max (real money) Seat #6 is the button
Seat 1: GwenLaGrise (3.51€)
Seat 2: Fried Berg (2.17€)
Seat 3: Zile741 (2.02€)
Seat 4: Pas1erreur (1.52€)
Seat 5: e-card (2.26€)
Seat 6: lamuerta8300 (2.78€)
*** ANTE/BLINDS ***
GwenLaGrise posts small blind 0.01€
Fried Berg posts big blind 0.02€
Dealt to Fried Berg [4h 7h]
*** PRE-FLOP *** 
Zile741 folds
Pas1erreur folds
e-card folds
lamuerta8300 folds
GwenLaGrise raises 0.02€ to 0.04€
Fried Berg folds
GwenLaGrise collected 0.06€ from pot
*** SUMMARY ***
Total pot 0.06€ | No rake
Seat 1: GwenLaGrise (small blind) won 0.06€


Winamax Poker - HOLD-UP "Colorado" - HandId: #19116069-436690-1701513280 - Holdem no limit (0.01€/0.02€) - 2023/12/02 10:34:40 UTC
Table: 'Colorado' 6-max (real money) Seat #6 is the button
Seat 1: castilla1978 (2.49€)
Seat 2: TaBrEaMoI (3.15€)
Seat 3: Fried Berg (2.15€)
Seat 4: HenriGuyBet (6.05€)
Seat 5: g8o8k8u (0.50€)
Seat 6: JackB13 (1.54€)
*** ANTE/BLINDS ***
castilla1978 posts small blind 0.01€
TaBrEaMoI posts big blind 0.02€
Dealt to Fried Berg [3c 7s]
*** PRE-FLOP *** 
Fried Berg folds
HenriGuyBet raises 0.02€ to 0.04€
g8o8k8u folds
JackB13 folds
castilla1978 folds
TaBrEaMoI calls 0.02€
*** FLOP *** [3h 9c Jd]
TaBrEaMoI checks
HenriGuyBet bets 0.04€
TaBrEaMoI folds
HenriGuyBet collected 0.12€ from pot
*** SUMMARY ***
Total pot 0.12€ | Rake 0.01€
Board: [3h 9c Jd]
Seat 4: HenriGuyBet won 0.12€


Winamax Poker - HOLD-UP "Colorado" - HandId: #19116069-436693-1701513281 - Holdem no limit (0.01€/0.02€) - 2023/12/02 10:34:41 UTC
Table: 'Colorado' 6-max (real money) Seat #6 is the button
Seat 1: MaryAthena (3.41€)
Seat 2: Fried Berg (2.15€)
Seat 3: tichettede3 (2.48€)
Seat 4: 20enbastos (2€)
Seat 5: 357magnum (1.95€)
Seat 6: NyKOh11 (0.50€)
*** ANTE/BLINDS ***
MaryAthena posts small blind 0.01€
Fried Berg posts big blind 0.02€
Dealt to Fried Berg [7c Ah]
*** PRE-FLOP *** 
tichettede3 folds
20enbastos folds
357magnum folds
NyKOh11 raises 0.02€ to 0.04€
MaryAthena folds
Fried Berg calls 0.02€
*** FLOP *** [5c Ks Jd]
Fried Berg checks
NyKOh11 checks
*** TURN *** [5c Ks Jd][6d]
Fried Berg checks
NyKOh11 checks
*** RIVER *** [5c Ks Jd 6d][7d]
Fried Berg checks
NyKOh11 checks
*** SHOW DOWN ***
NyKOh11 shows [Ac 6c] (One pair : 6)
Fried Berg shows [7c Ah] (One pair : 7)
Fried Berg collected 0.08€ from pot
*** SUMMARY ***
Total pot 0.08€ | Rake 0.01€
Board: [5c Ks Jd 6d 7d]
Seat 2: Fried Berg (big blind) showed [7c Ah] and won 0.08€ with One pair : 7
Seat 6: NyKOh11 (button) showed [Ac 6c] and lost with One pair : 6


Winamax Poker - HOLD-UP "Colorado" - HandId: #19116069-436748-1701513317 - Holdem no limit (0.01€/0.02€) - 2023/12/02 10:35:17 UTC
Table: 'Colorado' 6-max (real money) Seat #6 is the button
Seat 1: Kito31 (7.46€)
Seat 2: MONEYFOREVER (2€)
Seat 3: slowreplay (2.80€)
Seat 4: Td08nomotto (2€)
Seat 5: Fried Berg (2.19€)
Seat 6: mea botellas (2.58€)
*** ANTE/BLINDS ***
Kito31 posts small blind 0.01€
MONEYFOREVER posts big blind 0.02€
Dealt to Fried Berg [9s As]
*** PRE-FLOP *** 
slowreplay folds
Td08nomotto folds
Fried Berg raises 0.02€ to 0.04€
mea botellas folds
Kito31 calls 0.03€
MONEYFOREVER folds
*** FLOP *** [4c 6c 2c]
Kito31 checks
Fried Berg checks
*** TURN *** [4c 6c 2c][7d]
Kito31 checks
Fried Berg checks
*** RIVER *** [4c 6c 2c 7d][Qs]
Kito31 checks
Fried Berg checks
*** SHOW DOWN ***
Fried Berg shows [9s As] (High card : Ace)
Kito31 shows [Tc 7h] (One pair : 7)
Kito31 collected 0.09€ from pot
*** SUMMARY ***
Total pot 0.09€ | Rake 0.01€
Board: [4c 6c 2c 7d Qs]
Seat 1: Kito31 (small blind) showed [Tc 7h] and won 0.09€ with One pair : 7
Seat 5: Fried Berg showed [9s As] and lost with High card : Ace


Winamax Poker - HOLD-UP "Colorado" - HandId: #19116069-436804-1701513353 - Holdem no limit (0.01€/0.02€) - 2023/12/02 10:35:53 UTC
Table: 'Colorado' 6-max (real money) Seat #6 is the button
Seat 1: g8o8k8u (0.50€)
Seat 2: castilla1978 (2.51€)
Seat 3: 20enbastos (2.01€)
Seat 4: berlinouest (1.99€)
Seat 5: Kito31 (7.51€)
Seat 6: Fried Berg (2.15€)
*** ANTE/BLINDS ***
g8o8k8u posts small blind 0.01€
castilla1978 posts big blind 0.02€
Dealt to Fried Berg [5c Jd]
*** PRE-FLOP *** 
20enbastos folds
berlinouest folds
Kito31 folds
Fried Berg folds
g8o8k8u folds
castilla1978 collected 0.03€ from pot
*** SUMMARY ***
Total pot 0.03€ | No rake
Seat 2: castilla1978 (big blind) won 0.03€


Winamax Poker - HOLD-UP "Colorado" - HandId: #19116069-436818-1701513363 - Holdem no limit (0.01€/0.02€) - 2023/12/02 10:36:03 UTC
Table: 'Colorado' 6-max (real money) Seat #6 is the button
Seat 1: Fried Berg (2.15€)
Seat 2: g8o8k8u (0.50€)
Seat 3: 20enbastos (2€)
Seat 4: chouchenboy (1.94€)
Seat 5: MaryAthena (3.30€)
Seat 6: Fushitif (2.44€)
*** ANTE/BLINDS ***
Fried Berg posts small blind 0.01€
g8o8k8u posts big blind 0.02€
Dealt to Fried Berg [Qh 4s]
*** PRE-FLOP *** 
20enbastos folds
chouchenboy folds
MaryAthena folds
Fushitif raises 0.04€ to 0.06€
Fried Berg folds
g8o8k8u folds
Fushitif collected 0.09€ from pot
*** SUMMARY ***
Total pot 0.09€ | No rake
Seat 6: Fushitif (button) won 0.09€


Winamax Poker - HOLD-UP "Colorado" - HandId: #19116069-436835-1701513373 - Holdem no limit (0.01€/0.02€) - 2023/12/02 10:36:13 UTC
Table: 'Colorado' 6-max (real money) Seat #6 is the button
Seat 1: jdeepenslip (4.44€)
Seat 2: AK2-MILIK (3.95€)
Seat 3: Nombrillus (1.39€)
Seat 4: Fried Berg (2.14€)
Seat 5: ECPulga (1.95€)
Seat 6: Fran1Oller (5.60€)
*** ANTE/BLINDS ***
jdeepenslip posts small blind 0.01€
AK2-MILIK posts big blind 0.02€
Dealt to Fried Berg [8h 8c]
*** PRE-FLOP *** 
Nombrillus folds
Fried Berg raises 0.02€ to 0.04€
ECPulga raises 0.14€ to 0.18€
Fran1Oller folds
jdeepenslip folds
AK2-MILIK folds
Fried Berg folds
ECPulga collected 0.25€ from pot
*** SUMMARY ***
Total pot 0.25€ | No rake
Seat 5: ECPulga won 0.25€


Winamax Poker - HOLD-UP "Colorado" - HandId: #19116069-436849-1701513383 - Holdem no limit (0.01€/0.02€) - 2023/12/02 10:36:23 UTC
Table: 'Colorado' 6-max (real money) Seat #6 is the button
Seat 1: Abec16 (1.79€)
Seat 2: a3onsaute (0.96€)
Seat 3: Fried Berg (2.10€)
Seat 4: AK2-MILIK (3.93€)
Seat 5: Chacal-Punk (4.82€)
Seat 6: 2winchester (0.88€)
*** ANTE/BLINDS ***
Abec16 posts small blind 0.01€
a3onsaute posts big blind 0.02€
Dealt to Fried Berg [6h Jh]
*** PRE-FLOP *** 
Fried Berg folds
AK2-MILIK folds
Chacal-Punk folds
2winchester folds
Abec16 calls 0.01€
a3onsaute checks
*** FLOP *** [2h 2s 5h]
Abec16 checks
a3onsaute checks
*** TURN *** [2h 2s 5h][Qd]
Abec16 checks
a3onsaute checks
*** RIVER *** [2h 2s 5h Qd][3c]
Abec16 checks
a3onsaute checks
*** SHOW DOWN ***
Abec16 shows [Th 9c] (One pair : 2)
a3onsaute shows [Tc Kc] (One pair : 2)
a3onsaute collected 0.04€ from pot
*** SUMMARY ***
Total pot 0.04€ | No rake
Board: [2h 2s 5h Qd 3c]
Seat 1: Abec16 (small blind) showed [Th 9c] and lost with One pair : 2
Seat 2: a3onsaute (big blind) showed [Tc Kc] and won 0.04€ with One pair : 2


Winamax Poker - HOLD-UP "Colorado" - HandId: #19116069-436857-1701513390 - Holdem no limit (0.01€/0.02€) - 2023/12/02 10:36:30 UTC
Table: 'Colorado' 6-max (real money) Seat #6 is the button
Seat 1: Td08nomotto (2.01€)
Seat 2: Fried Berg (2.10€)
Seat 3: ITALIA291 (2.03€)
Seat 4: Chacal-Punk (4.81€)
Seat 5: Team 7 (0.51€)
Seat 6: 121 (4.61€)
Hold-up to Pot: total 0.10€
*** ANTE/BLINDS ***
Td08nomotto posts small blind 0.01€
Fried Berg posts big blind 0.02€
Dealt to Fried Berg [Jh Js]
*** PRE-FLOP *** 
ITALIA291 folds
Chacal-Punk folds
Team 7 folds
121 raises 0.08€ to 0.10€
Td08nomotto calls 0.09€
Fried Berg raises 0.20€ to 0.30€
121 folds
Td08nomotto calls 0.20€
*** FLOP *** [8c Td Qs]
Td08nomotto bets 1.71€ and is all-in
Fried Berg folds
Td08nomotto collected 2.44€ from pot
*** SUMMARY ***
Total pot 2.44€ | Rake 0.07€
Board: [8c Td Qs]
Seat 1: Td08nomotto (small blind) won 2.44€


Winamax Poker - HOLD-UP "Colorado" - HandId: #19116069-436919-1701513444 - Holdem no limit (0.01€/0.02€) - 2023/12/02 10:37:24 UTC
Table: 'Colorado' 6-max (real money) Seat #6 is the button
Seat 1: a3onsaute (0.95€)
Seat 2: Abec16 (1.86€)
Seat 3: Popierre (5.07€)
Seat 4: 2winchester (0.87€)
Seat 5: Fried Berg (1.80€)
Seat 6: slowreplay (3€)
*** ANTE/BLINDS ***
a3onsaute posts small blind 0.01€
Abec16 posts big blind 0.02€
Dealt to Fried Berg [7s Kh]
*** PRE-FLOP *** 
Popierre folds
2winchester calls 0.02€
Fried Berg folds
slowreplay folds
a3onsaute calls 0.01€
Abec16 raises 0.09€ to 0.11€
2winchester calls 0.09€
a3onsaute folds
*** FLOP *** [2s 9d 3d]
Abec16 checks
2winchester bets 0.12€
Abec16 folds
2winchester collected 0.34€ from pot
*** SUMMARY ***
Total pot 0.34€ | Rake 0.02€
Board: [2s 9d 3d]
Seat 4: 2winchester won 0.34€


Winamax Poker - HOLD-UP "Colorado" - HandId: #19116069-436923-1701513448 - Holdem no limit (0.01€/0.02€) - 2023/12/02 10:37:28 UTC
Table: 'Colorado' 6-max (real money) Seat #6 is the button
Seat 1: Fried Berg (1.80€)
Seat 2: TaBrEaMoI (3.79€)
Seat 3: Td08nomotto (2.44€)
Seat 4: MONEYFOREVER (3.80€)
Seat 5: VGuedjo (1.94€)
Seat 6: laconalostra (2.10€)
*** ANTE/BLINDS ***
Fried Berg posts small blind 0.01€
TaBrEaMoI posts big blind 0.02€
Dealt to Fried Berg [2c 9h]
*** PRE-FLOP *** 
Td08nomotto folds
MONEYFOREVER folds
VGuedjo folds
laconalostra raises 0.03€ to 0.05€
Fried Berg folds
TaBrEaMoI calls 0.03€
*** FLOP *** [8s 7d 2d]
TaBrEaMoI checks
laconalostra checks
*** TURN *** [8s 7d 2d][3c]
TaBrEaMoI bets 0.07€
laconalostra calls 0.07€
*** RIVER *** [8s 7d 2d 3c][8c]
TaBrEaMoI bets 0.09€
laconalostra raises 0.17€ to 0.26€
TaBrEaMoI calls 0.17€
*** SHOW DOWN ***
laconalostra shows [Qc Kh] (One pair : 8)
TaBrEaMoI shows [9d 9c] (Two pairs : 9 and 8)
TaBrEaMoI collected 0.69€ from pot
*** SUMMARY ***
Total pot 0.69€ | Rake 0.08€
Board: [8s 7d 2d 3c 8c]
Seat 2: TaBrEaMoI (big blind) showed [9d 9c] and won 0.69€ with Two pairs : 9 and 8
Seat 6: laconalostra (button) showed [Qc Kh] and lost with One pair : 8


Winamax Poker - HOLD-UP "Colorado" - HandId: #19116069-436934-1701513458 - Holdem no limit (0.01€/0.02€) - 2023/12/02 10:37:38 UTC
Table: 'Colorado' 6-max (real money) Seat #6 is the button
Seat 1: berlinouest (1.86€)
Seat 2: VGuedjo (1.93€)
Seat 3: Fried Berg (1.79€)
Seat 4: Fushitif (2.62€)
Seat 5: TJ Podoli II (0.43€)
Seat 6: chouchenboy (0.31€)
*** ANTE/BLINDS ***
berlinouest posts small blind 0.01€
VGuedjo posts big blind 0.02€
Dealt to Fried Berg [8c 9c]
*** PRE-FLOP *** 
Fried Berg raises 0.02€ to 0.04€
Fushitif folds
TJ Podoli II folds
chouchenboy folds
berlinouest calls 0.03€
VGuedjo folds
*** FLOP *** [8s 2h Ac]
berlinouest checks
Fried Berg bets 0.06€
berlinouest folds
Fried Berg collected 0.15€ from pot
*** SUMMARY ***
Total pot 0.15€ | Rake 0.01€
Board: [8s 2h Ac]
Seat 3: Fried Berg won 0.15€


Winamax Poker - HOLD-UP "Colorado" - HandId: #19116069-436963-1701513481 - Holdem no limit (0.01€/0.02€) - 2023/12/02 10:38:01 UTC
Table: 'Colorado' 6-max (real money) Seat #6 is the button
Seat 1: josep2170 (2.42€)
Seat 2: Fried Berg (1.84€)
Seat 3: 20enbastos (7.48€)
Seat 4: Coq82 (3.17€)
Seat 5: chouchenboy (0.29€)
Seat 6: a3onsaute (0.93€)
*** ANTE/BLINDS ***
josep2170 posts small blind 0.01€
Fried Berg posts big blind 0.02€
Dealt to Fried Berg [As Jd]
*** PRE-FLOP *** 
20enbastos folds
Coq82 folds
chouchenboy folds
a3onsaute calls 0.02€
josep2170 folds
Fried Berg checks
*** FLOP *** [Qc Jh Kd]
Fried Berg bets 0.04€
a3onsaute calls 0.04€
*** TURN *** [Qc Jh Kd][Ad]
Fried Berg bets 0.08€
a3onsaute calls 0.08€
*** RIVER *** [Qc Jh Kd Ad][7h]
Fried Berg bets 0.16€
a3onsaute calls 0.16€
*** SHOW DOWN ***
Fried Berg shows [As Jd] (Two pairs : Aces and Jacks)
a3onsaute shows [Ac Kc] (Two pairs : Aces and Kings)
a3onsaute collected 0.55€ from pot
*** SUMMARY ***
Total pot 0.55€ | Rake 0.06€
Board: [Qc Jh Kd Ad 7h]
Seat 2: Fried Berg (big blind) showed [As Jd] and lost with Two pairs : Aces and Jacks
Seat 6: a3onsaute (button) showed [Ac Kc] and won 0.55€ with Two pairs : Aces and Kings


Winamax Poker - HOLD-UP "Colorado" - HandId: #19116069-437031-1701513527 - Holdem no limit (0.01€/0.02€) - 2023/12/02 10:38:47 UTC
Table: 'Colorado' 6-max (real money) Seat #6 is the button
Seat 1: slowreplay (4.48€)
Seat 2: a3onsaute (1.18€)
Seat 3: Zile741 (2.03€)
Seat 4: Fried Berg (1.54€)
Seat 5: Nombrillus (1.51€)
Seat 6: J.C Deuces.0 (6.33€)
*** ANTE/BLINDS ***
slowreplay posts small blind 0.01€
a3onsaute posts big blind 0.02€
Dealt to Fried Berg [5c 6s]
*** PRE-FLOP *** 
Zile741 folds
Fried Berg folds
Nombrillus raises 0.04€ to 0.06€
J.C Deuces.0 folds
slowreplay folds
a3onsaute folds
Nombrillus collected 0.09€ from pot
*** SUMMARY ***
Total pot 0.09€ | No rake
Seat 5: Nombrillus won 0.09€


Winamax Poker - HOLD-UP "Colorado" - HandId: #19116069-437045-1701513535 - Holdem no limit (0.01€/0.02€) - 2023/12/02 10:38:55 UTC
Table: 'Colorado' 6-max (real money) Seat #6 is the button
Seat 1: papainge (2.03€)
Seat 2: Fran1Oller (5.58€)
Seat 3: TaBrEaMoI (2.09€)
Seat 4: castilla1978 (1.85€)
Seat 5: Fried Berg (1.54€)
Seat 6: tichettede3 (2.87€)
*** ANTE/BLINDS ***
papainge posts small blind 0.01€
Fran1Oller posts big blind 0.02€
Dealt to Fried Berg [Kc 2s]
*** PRE-FLOP *** 
TaBrEaMoI folds
castilla1978 folds
Fried Berg folds
tichettede3 folds
papainge raises 0.02€ to 0.04€
Fran1Oller folds
papainge collected 0.06€ from pot
*** SUMMARY ***
Total pot 0.06€ | No rake
Seat 1: papainge (small blind) won 0.06€


Winamax Poker - HOLD-UP "Colorado" - HandId: #19116069-437054-1701513542 - Holdem no limit (0.01€/0.02€) - 2023/12/02 10:39:02 UTC
Table: 'Colorado' 6-max (real money) Seat #6 is the button
Seat 1: El Paellas (0.51€)
Seat 2: josep2170 (2.38€)
Seat 3: Fried Berg (1.54€)
Seat 4: AmazinG. (2.54€)
Seat 5: 2winchester (0.93€)
Seat 6: _ilTulipano_ (2.62€)
*** ANTE/BLINDS ***
El Paellas posts small blind 0.01€
josep2170 posts big blind 0.02€
Dealt to Fried Berg [Ac Qc]
*** PRE-FLOP *** 
Fried Berg raises 0.04€ to 0.06€
AmazinG. folds
2winchester folds
_ilTulipano_ folds
El Paellas folds
josep2170 folds
Fried Berg collected 0.09€ from pot
*** SUMMARY ***
Total pot 0.09€ | No rake
Seat 3: Fried Berg won 0.09€


Winamax Poker - HOLD-UP "Colorado" - HandId: #19116069-437072-1701513552 - Holdem no limit (0.01€/0.02€) - 2023/12/02 10:39:12 UTC
Table: 'Colorado' 6-max (real money) Seat #6 is the button
Seat 1: YannSolo1 (2.01€)
Seat 2: lamuerta8300 (3.33€)
Seat 3: 121 (3.13€)
Seat 4: El Paellas (0.50€)
Seat 5: Popierre (2.18€)
Seat 6: Fried Berg (1.57€)
*** ANTE/BLINDS ***
YannSolo1 posts small blind 0.01€
lamuerta8300 posts big blind 0.02€
Dealt to Fried Berg [7h 9h]
*** PRE-FLOP *** 
121 folds
El Paellas folds
Popierre folds
Fried Berg folds
YannSolo1 folds
lamuerta8300 collected 0.03€ from pot
*** SUMMARY ***
Total pot 0.03€ | No rake
Seat 2: lamuerta8300 (big blind) won 0.03€


Winamax Poker - HOLD-UP "Colorado" - HandId: #19116069-437089-1701513567 - Holdem no limit (0.01€/0.02€) - 2023/12/02 10:39:27 UTC
Table: 'Colorado' 6-max (real money) Seat #6 is the button
Seat 1: Betiegarri (3.60€)
Seat 2: Kito31 (7.72€)
Seat 3: _ilTulipano_ (5.87€)
Seat 4: Fried Berg (1.57€)
Seat 5: g8o8k8u (0.50€)
Seat 6: 2winchester (0.93€)
*** ANTE/BLINDS ***
Betiegarri posts small blind 0.01€
Kito31 posts big blind 0.02€
Dealt to Fried Berg [9c As]
*** PRE-FLOP *** 
_ilTulipano_ raises 0.04€ to 0.06€
Fried Berg calls 0.06€
g8o8k8u folds
2winchester folds
Betiegarri raises 0.22€ to 0.28€
Kito31 folds
_ilTulipano_ calls 0.22€
Fried Berg folds
*** FLOP *** [8s 6s 3c]
Betiegarri bets 0.51€
_ilTulipano_ raises 0.57€ to 1.08€
Betiegarri raises 2.24€ to 3.32€ and is all-in
_ilTulipano_ calls 2.24€
*** TURN *** [8s 6s 3c][Tc]
*** RIVER *** [8s 6s 3c Tc][5c]
*** SHOW DOWN ***
Betiegarri shows [Jd Jc] (One pair : Jacks)
_ilTulipano_ shows [8c 8d] (Trips of 8)
_ilTulipano_ collected 6.58€ from pot
*** SUMMARY ***
Total pot 6.58€ | Rake 0.70€
Board: [8s 6s 3c Tc 5c]
Seat 1: Betiegarri (small blind) showed [Jd Jc] and lost with One pair : Jacks
Seat 3: _ilTulipano_ showed [8c 8d] and won 6.58€ with Trips of 8


Winamax Poker - HOLD-UP "Colorado" - HandId: #19116069-437121-1701513592 - Holdem no limit (0.01€/0.02€) - 2023/12/02 10:39:52 UTC
Table: 'Colorado' 6-max (real money) Seat #6 is the button
Seat 1: laconalostra (2.04€)
Seat 2: Fried Berg (1.51€)
Seat 3: Zile741 (2.40€)
Seat 4: Pat Poker 73 (1.98€)
Seat 5: El Paellas (0.53€)
Seat 6: VGuedjo (1.23€)
*** ANTE/BLINDS ***
laconalostra posts small blind 0.01€
Fried Berg posts big blind 0.02€
Dealt to Fried Berg [4c Tc]
*** PRE-FLOP *** 
Zile741 folds
Pat Poker 73 folds
El Paellas folds
VGuedjo folds
laconalostra raises 0.02€ to 0.04€
Fried Berg folds
laconalostra collected 0.06€ from pot
*** SUMMARY ***
Total pot 0.06€ | No rake
Seat 1: laconalostra (small blind) won 0.06€


Winamax Poker - HOLD-UP "Colorado" - HandId: #19116069-437135-1701513602 - Holdem no limit (0.01€/0.02€) - 2023/12/02 10:40:02 UTC
Table: 'Colorado' 6-max (real money) Seat #6 is the button
Seat 1: castilla1978 (4.06€)
Seat 2: slowreplay (4.59€)
Seat 3: AK2-MILIK (3.91€)
Seat 4: Fried Berg (1.49€)
Seat 5: soliderock (2€)
Seat 6: Neostarz77 (1.92€)
*** ANTE/BLINDS ***
castilla1978 posts small blind 0.01€
slowreplay posts big blind 0.02€
Dealt to Fried Berg [7h Td]
*** PRE-FLOP *** 
AK2-MILIK folds
Fried Berg folds
soliderock folds
Neostarz77 raises 0.02€ to 0.04€
castilla1978 folds
slowreplay folds
Neostarz77 collected 0.07€ from pot
*** SUMMARY ***
Total pot 0.07€ | No rake
Seat 6: Neostarz77 (button) won 0.07€


Winamax Poker - HOLD-UP "Colorado" - HandId: #19116069-437141-1701513606 - Holdem no limit (0.01€/0.02€) - 2023/12/02 10:40:06 UTC
Table: 'Colorado' 6-max (real money) Seat #6 is the button
Seat 1: El Paellas (0.51€)
Seat 2: Kallonys (1.26€)
Seat 3: 20enbastos (7.34€)
Seat 4: lamuerta8300 (4.49€)
Seat 5: PIQSOU (3.67€)
Seat 6: Fried Berg (1.49€)
*** ANTE/BLINDS ***
El Paellas posts small blind 0.01€
Kallonys posts big blind 0.02€
Dealt to Fried Berg [5d 5h]
*** PRE-FLOP *** 
20enbastos folds
lamuerta8300 folds
PIQSOU folds
Fried Berg raises 0.04€ to 0.06€
El Paellas folds
Kallonys calls 0.04€
*** FLOP *** [7c 8s 2c]
Kallonys checks
Fried Berg checks
*** TURN *** [7c 8s 2c][Jc]
Kallonys checks
Fried Berg checks
*** RIVER *** [7c 8s 2c Jc][7s]
Kallonys checks
Fried Berg checks
*** SHOW DOWN ***
Kallonys shows [3d 3s] (Two pairs : 7 and 3)
Fried Berg shows [5d 5h] (Two pairs : 7 and 5)
Fried Berg collected 0.12€ from pot
*** SUMMARY ***
Total pot 0.12€ | Rake 0.01€
Board: [7c 8s 2c Jc 7s]
Seat 2: Kallonys (big blind) showed [3d 3s] and lost with Two pairs : 7 and 3
Seat 6: Fried Berg (button) showed [5d 5h] and won 0.12€ with Two pairs : 7 and 5


Winamax Poker - HOLD-UP "Colorado" - HandId: #19116069-437196-1701513648 - Holdem no limit (0.01€/0.02€) - 2023/12/02 10:40:48 UTC
Table: 'Colorado' 6-max (real money) Seat #6 is the button
Seat 1: soliderock (2€)
Seat 2: Coq82 (2.41€)
Seat 3: Fried Berg (1.55€)
Seat 4: vuesurmer (2.05€)
Seat 5: 121 (2.87€)
Seat 6: Zile741 (2.26€)
*** ANTE/BLINDS ***
soliderock posts small blind 0.01€
Coq82 posts big blind 0.02€
Dealt to Fried Berg [Ah 9s]
*** PRE-FLOP *** 
Fried Berg folds
vuesurmer raises 0.03€ to 0.05€
121 folds
Zile741 folds
soliderock folds
Coq82 folds
vuesurmer collected 0.08€ from pot
*** SUMMARY ***
Total pot 0.08€ | No rake
Seat 4: vuesurmer won 0.08€


Winamax Poker - HOLD-UP "Colorado" - HandId: #19116069-437203-1701513651 - Holdem no limit (0.01€/0.02€) - 2023/12/02 10:40:51 UTC
Table: 'Colorado' 6-max (real money) Seat #6 is the button
Seat 1: Fried Berg (1.55€)
Seat 2: _ilTulipano_ (4.48€)
Seat 3: FPVrominou (1.58€)
Seat 4: Popierre (2.12€)
Seat 5: Kallonys (1.20€)
Seat 6: 121 (2.87€)
*** ANTE/BLINDS ***
Fried Berg posts small blind 0.01€
_ilTulipano_ posts big blind 0.02€
Dealt to Fried Berg [5c 3c]
*** PRE-FLOP *** 
FPVrominou folds
Popierre folds
Kallonys folds
121 folds
Fried Berg folds
_ilTulipano_ collected 0.03€ from pot
*** SUMMARY ***
Total pot 0.03€ | No rake
Seat 2: _ilTulipano_ (big blind) won 0.03€


Winamax Poker - HOLD-UP "Colorado" - HandId: #19116069-437208-1701513654 - Holdem no limit (0.01€/0.02€) - 2023/12/02 10:40:54 UTC
Table: 'Colorado' 6-max (real money) Seat #6 is the button
Seat 1: jdeepenslip (4.76€)
Seat 2: Fried Berg (1.54€)
Seat 3: GwenLaGrise (6.43€)
Seat 4: chouchenboy (1.92€)
Seat 5: e-card (2.01€)
Seat 6: Dr.D (1.94€)
*** ANTE/BLINDS ***
jdeepenslip posts small blind 0.01€
Fried Berg posts big blind 0.02€
Dealt to Fried Berg [5d Jc]
*** PRE-FLOP *** 
GwenLaGrise folds
chouchenboy folds
e-card folds
Dr.D folds
jdeepenslip raises 0.04€ to 0.06€
Fried Berg folds
jdeepenslip collected 0.08€ from pot
*** SUMMARY ***
Total pot 0.08€ | No rake
Seat 1: jdeepenslip (small blind) won 0.08€


Winamax Poker - HOLD-UP "Colorado" - HandId: #19116069-437231-1701513668 - Holdem no limit (0.01€/0.02€) - 2023/12/02 10:41:08 UTC
Table: 'Colorado' 6-max (real money) Seat #6 is the button
Seat 1: Fried Berg (1.52€)
Seat 2: GwenLaGrise (2.11€)
Seat 3: Zile741 (2.25€)
Seat 4: FPVrominou (1.55€)
Seat 5: Chacal-Punk (4.65€)
Seat 6: Pat Poker 73 (2.01€)
*** ANTE/BLINDS ***
Fried Berg posts small blind 0.01€
GwenLaGrise posts big blind 0.02€
Dealt to Fried Berg [Jd 3h]
*** PRE-FLOP *** 
Zile741 folds
FPVrominou folds
Chacal-Punk folds
Pat Poker 73 raises 0.03€ to 0.05€
Fried Berg folds
GwenLaGrise calls 0.03€
*** FLOP *** [7d 4s As]
GwenLaGrise bets 0.04€
Pat Poker 73 calls 0.04€
*** TURN *** [7d 4s As][Kd]
GwenLaGrise checks
Pat Poker 73 bets 0.12€
GwenLaGrise calls 0.12€
*** RIVER *** [7d 4s As Kd][Ad]
GwenLaGrise checks
Pat Poker 73 bets 1.80€ and is all-in
GwenLaGrise folds
Pat Poker 73 collected 2.19€ from pot
*** SUMMARY ***
Total pot 2.19€ | Rake 0.04€
Board: [7d 4s As Kd Ad]
Seat 6: Pat Poker 73 (button) won 2.19€


Winamax Poker - HOLD-UP "Colorado" - HandId: #19116069-437238-1701513672 - Holdem no limit (0.01€/0.02€) - 2023/12/02 10:41:12 UTC
Table: 'Colorado' 6-max (real money) Seat #6 is the button
Seat 1: El Paellas (0.51€)
Seat 2: Perf-31 (2€)
Seat 3: 2winchester (0.82€)
Seat 4: mea botellas (2.66€)
Seat 5: Le_Pere_Plex (1.56€)
Seat 6: Fried Berg (1.51€)
*** ANTE/BLINDS ***
El Paellas posts small blind 0.01€
Perf-31 posts big blind 0.02€
Dealt to Fried Berg [Ad 5c]
*** PRE-FLOP *** 
2winchester folds
mea botellas folds
Le_Pere_Plex folds
Fried Berg raises 0.02€ to 0.04€
El Paellas raises 0.15€ to 0.19€
Perf-31 folds
Fried Berg folds
El Paellas collected 0.25€ from pot
*** SUMMARY ***
Total pot 0.25€ | No rake
Seat 1: El Paellas (small blind) won 0.25€


Winamax Poker - HOLD-UP "Colorado" - HandId: #19116069-437255-1701513688 - Holdem no limit (0.01€/0.02€) - 2023/12/02 10:41:28 UTC
Table: 'Colorado' 6-max (real money) Seat #6 is the button
Seat 1: Perf-31 (2€)
Seat 2: FPVrominou (1.58€)
Seat 3: Popierre (2.09€)
Seat 4: HenriGuyBet (6.09€)
Seat 5: Fried Berg (1.47€)
Seat 6: slowreplay (3.41€)
*** ANTE/BLINDS ***
Perf-31 posts small blind 0.01€
FPVrominou posts big blind 0.02€
Dealt to Fried Berg [7s 4d]
*** PRE-FLOP *** 
Popierre folds
HenriGuyBet folds
Fried Berg folds
slowreplay folds
Perf-31 folds
FPVrominou collected 0.03€ from pot
*** SUMMARY ***
Total pot 0.03€ | No rake
Seat 2: FPVrominou (big blind) won 0.03€


Winamax Poker - HOLD-UP "Colorado" - HandId: #19116069-437258-1701513690 - Holdem no limit (0.01€/0.02€) - 2023/12/02 10:41:30 UTC
Table: 'Colorado' 6-max (real money) Seat #6 is the button
Seat 1: PIQSOU (6.62€)
Seat 2: 121 (2.81€)
Seat 3: Fried Berg (1.47€)
Seat 4: El Paellas (0.57€)
Seat 5: lamuerta8300 (3.33€)
Seat 6: gagnejamais4 (4.51€)
*** ANTE/BLINDS ***
PIQSOU posts small blind 0.01€
121 posts big blind 0.02€
Dealt to Fried Berg [7s 8d]
*** PRE-FLOP *** 
Fried Berg folds
El Paellas raises 0.03€ to 0.05€
lamuerta8300 folds
gagnejamais4 raises 0.10€ to 0.15€
PIQSOU folds
121 folds
El Paellas folds
gagnejamais4 collected 0.23€ from pot
*** SUMMARY ***
Total pot 0.23€ | No rake
Seat 6: gagnejamais4 (button) won 0.23€


Winamax Poker - HOLD-UP "Colorado" - HandId: #19116069-437260-1701513692 - Holdem no limit (0.01€/0.02€) - 2023/12/02 10:41:32 UTC
Table: 'Colorado' 6-max (real money) Seat #6 is the button
Seat 1: Team 7 (0.50€)
Seat 2: Pas1erreur (1.59€)
Seat 3: _FanZ_ (1.97€)
Seat 4: popoche29 (11.46€)
Seat 5: Fried Berg (1.47€)
Seat 6: HenriGuyBet (6.09€)
*** ANTE/BLINDS ***
Team 7 posts small blind 0.01€
Pas1erreur posts big blind 0.02€
Dealt to Fried Berg [8d 4c]
*** PRE-FLOP *** 
_FanZ_ raises 0.04€ to 0.06€
popoche29 calls 0.06€
Fried Berg folds
HenriGuyBet calls 0.06€
Team 7 folds
Pas1erreur folds
*** FLOP *** [7h 9h Ah]
_FanZ_ bets 0.16€
popoche29 folds
HenriGuyBet folds
_FanZ_ collected 0.35€ from pot
*** SUMMARY ***
Total pot 0.35€ | Rake 0.02€
Board: [7h 9h Ah]
Seat 3: _FanZ_ won 0.35€


Winamax Poker - HOLD-UP "Colorado" - HandId: #19116069-437263-1701513695 - Holdem no limit (0.01€/0.02€) - 2023/12/02 10:41:35 UTC
Table: 'Colorado' 6-max (real money) Seat #6 is the button
Seat 1: laconalostra (2.71€)
Seat 2: Fried Berg (1.47€)
Seat 3: josep2170 (2.45€)
Seat 4: Zile741 (2.04€)
Seat 5: Popierre (2.09€)
Seat 6: slowreplay (3.38€)
Hold-up to Pot: total 0.10€
*** ANTE/BLINDS ***
laconalostra posts small blind 0.01€
Fried Berg posts big blind 0.02€
Dealt to Fried Berg [5c As]
*** PRE-FLOP *** 
josep2170 folds
Zile741 folds
Popierre folds
slowreplay folds
laconalostra calls 0.01€
Fried Berg raises 0.08€ to 0.10€
laconalostra folds
Fried Berg collected 0.22€ from pot
*** SUMMARY ***
Total pot 0.22€ | No rake
Seat 2: Fried Berg (big blind) won 0.22€


Winamax Poker - HOLD-UP "Colorado" - HandId: #19116069-437314-1701513736 - Holdem no limit (0.01€/0.02€) - 2023/12/02 10:42:16 UTC
Table: 'Colorado' 6-max (real money) Seat #6 is the button
Seat 1: 121 (3.88€)
Seat 2: Popierre (2.05€)
Seat 3: Retail Row (5.57€)
Seat 4: YannSolo1 (2.17€)
Seat 5: Fried Berg (1.59€)
Seat 6: Zile741 (2€)
*** ANTE/BLINDS ***
121 posts small blind 0.01€
Popierre posts big blind 0.02€
Dealt to Fried Berg [2s 4s]
*** PRE-FLOP *** 
Retail Row raises 0.04€ to 0.06€
YannSolo1 folds
Fried Berg folds
Zile741 folds
121 calls 0.05€
Popierre folds
*** FLOP *** [8h 5c Kc]
121 checks
Retail Row bets 0.07€
121 folds
Retail Row collected 0.20€ from pot
*** SUMMARY ***
Total pot 0.20€ | Rake 0.01€
Board: [8h 5c Kc]
Seat 3: Retail Row won 0.20€


Winamax Poker - HOLD-UP "Colorado" - HandId: #19116069-437321-1701513740 - Holdem no limit (0.01€/0.02€) - 2023/12/02 10:42:20 UTC
Table: 'Colorado' 6-max (real money) Seat #6 is the button
Seat 1: VGuedjo (2.07€)
Seat 2: Fran1Oller (5.45€)
Seat 3: TaBrEaMoI (4.60€)
Seat 4: Fried Berg (1.59€)
Seat 5: e-card (2.67€)
Seat 6: soliderock (2€)
*** ANTE/BLINDS ***
VGuedjo posts small blind 0.01€
Fran1Oller posts big blind 0.02€
Dealt to Fried Berg [8h 7d]
*** PRE-FLOP *** 
TaBrEaMoI folds
Fried Berg folds
e-card folds
soliderock raises 0.03€ to 0.05€
VGuedjo folds
Fran1Oller folds
soliderock collected 0.08€ from pot
*** SUMMARY ***
Total pot 0.08€ | No rake
Seat 6: soliderock (button) won 0.08€


Winamax Poker - HOLD-UP "Colorado" - HandId: #19116069-437325-1701513746 - Holdem no limit (0.01€/0.02€) - 2023/12/02 10:42:26 UTC
Table: 'Colorado' 6-max (real money) Seat #6 is the button
Seat 1: Fried Berg (1.59€)
Seat 2: chouchenboy (2.01€)
Seat 3: Baston57 (1.39€)
Seat 4: TaBrEaMoI (4.60€)
Seat 5: Abec16 (1.85€)
Seat 6: YannSolo1 (2.17€)
*** ANTE/BLINDS ***
Fried Berg posts small blind 0.01€
chouchenboy posts big blind 0.02€
Dealt to Fried Berg [Qc 5c]
*** PRE-FLOP *** 
Baston57 folds
TaBrEaMoI raises 0.04€ to 0.06€
Abec16 folds
YannSolo1 calls 0.06€
Fried Berg folds
chouchenboy calls 0.04€
*** FLOP *** [6d 2d Jh]
chouchenboy checks
TaBrEaMoI checks
YannSolo1 checks
*** TURN *** [6d 2d Jh][Ks]
chouchenboy bets 0.07€
TaBrEaMoI folds
YannSolo1 calls 0.07€
*** RIVER *** [6d 2d Jh Ks][4c]
chouchenboy bets 0.21€
YannSolo1 calls 0.21€
*** SHOW DOWN ***
chouchenboy shows [Kc Tc] (One pair : Kings)
YannSolo1 shows [Kh Qh] (One pair : Kings)
YannSolo1 collected 0.67€ from pot
*** SUMMARY ***
Total pot 0.67€ | Rake 0.08€
Board: [6d 2d Jh Ks 4c]
Seat 2: chouchenboy (big blind) showed [Kc Tc] and lost with One pair : Kings
Seat 6: YannSolo1 (button) showed [Kh Qh] and won 0.67€ with One pair : Kings


Winamax Poker - HOLD-UP "Colorado" - HandId: #19116069-437372-1701513781 - Holdem no limit (0.01€/0.02€) - 2023/12/02 10:43:01 UTC
Table: 'Colorado' 6-max (real money) Seat #6 is the button
Seat 1: Fran1Oller (5.49€)
Seat 2: a3onsaute (0.97€)
Seat 3: Fried Berg (1.58€)
Seat 4: 121 (3.81€)
Seat 5: g8o8k8u (0.50€)
Seat 6: Abec16 (1.82€)
*** ANTE/BLINDS ***
Fran1Oller posts small blind 0.01€
a3onsaute posts big blind 0.02€
Dealt to Fried Berg [8d 2h]
*** PRE-FLOP *** 
Fried Berg folds
121 folds
g8o8k8u raises 0.04€ to 0.06€
Abec16 calls 0.06€
Fran1Oller folds
a3onsaute folds
*** FLOP *** [8h 2c 6s]
g8o8k8u bets 0.44€ and is all-in
Abec16 folds
g8o8k8u collected 0.57€ from pot
*** SUMMARY ***
Total pot 0.57€ | Rake 0.02€
Board: [8h 2c 6s]
Seat 5: g8o8k8u won 0.57€


Winamax Poker - HOLD-UP "Colorado" - HandId: #19116069-437380-1701513787 - Holdem no limit (0.01€/0.02€) - 2023/12/02 10:43:07 UTC
Table: 'Colorado' 6-max (real money) Seat #6 is the button
Seat 1: Chacal-Punk (4.59€)
Seat 2: GwenLaGrise (2.89€)
Seat 3: slowreplay (2.93€)
Seat 4: Perf-31 (2.39€)
Seat 5: tichettede3 (2.84€)
Seat 6: Fried Berg (1.58€)
*** ANTE/BLINDS ***
Chacal-Punk posts small blind 0.01€
GwenLaGrise posts big blind 0.02€
Dealt to Fried Berg [2c 5d]
*** PRE-FLOP *** 
slowreplay folds
Perf-31 folds
tichettede3 folds
Fried Berg folds
Chacal-Punk folds
GwenLaGrise collected 0.03€ from pot
*** SUMMARY ***
Total pot 0.03€ | No rake
Seat 2: GwenLaGrise (big blind) won 0.03€


Winamax Poker - HOLD-UP "Colorado" - HandId: #19116069-437383-1701513789 - Holdem no limit (0.01€/0.02€) - 2023/12/02 10:43:09 UTC
Table: 'Colorado' 6-max (real money) Seat #6 is the button
Seat 1: Fried Berg (1.58€)
Seat 2: slowreplay (2.93€)
Seat 3: Zile741 (2.41€)
Seat 4: lamuerta8300 (2.28€)
Seat 5: vuesurmer (2€)
Seat 6: JeanBeauBean (2€)
*** ANTE/BLINDS ***
Fried Berg posts small blind 0.01€
slowreplay posts big blind 0.02€
Dealt to Fried Berg [8s Td]
*** PRE-FLOP *** 
Zile741 folds
lamuerta8300 folds
vuesurmer folds
JeanBeauBean folds
Fried Berg folds
slowreplay collected 0.03€ from pot
*** SUMMARY ***
Total pot 0.03€ | No rake
Seat 2: slowreplay (big blind) won 0.03€


Winamax Poker - HOLD-UP "Colorado" - HandId: #19116069-437386-1701513790 - Holdem no limit (0.01€/0.02€) - 2023/12/02 10:43:10 UTC
Table: 'Colorado' 6-max (real money) Seat #6 is the button
Seat 1: a3onsaute (0.95€)
Seat 2: _Lilli Rush (1.38€)
Seat 3: jdeepenslip (3.66€)
Seat 4: Fried Berg (1.57€)
Seat 5: J.C Deuces.0 (1.99€)
Seat 6: Baston57 (1.35€)
*** ANTE/BLINDS ***
a3onsaute posts small blind 0.01€
_Lilli Rush posts big blind 0.02€
Dealt to Fried Berg [6h Qh]
*** PRE-FLOP *** 
jdeepenslip folds
Fried Berg folds
J.C Deuces.0 folds
Baston57 folds
a3onsaute calls 0.01€
_Lilli Rush checks
*** FLOP *** [Kd 9h Jd]
a3onsaute bets 0.03€
_Lilli Rush folds
a3onsaute collected 0.07€ from pot
*** SUMMARY ***
Total pot 0.07€ | No rake
Board: [Kd 9h Jd]
Seat 1: a3onsaute (small blind) won 0.07€


Winamax Poker - HOLD-UP "Colorado" - HandId: #19116069-437391-1701513793 - Holdem no limit (0.01€/0.02€) - 2023/12/02 10:43:13 UTC
Table: 'Colorado' 6-max (real money) Seat #6 is the button
Seat 1: Pop_hop_hop (1.39€)
Seat 2: Fran1Oller (5.48€)
Seat 3: HenriGuyBet (6.02€)
Seat 4: Nombrillus (1.35€)
Seat 5: Coq82 (2.23€)
Seat 6: Fried Berg (1.57€)
*** ANTE/BLINDS ***
Pop_hop_hop posts small blind 0.01€
Fran1Oller posts big blind 0.02€
Dealt to Fried Berg [9h 4c]
*** PRE-FLOP *** 
HenriGuyBet folds
Nombrillus folds
Coq82 raises 0.03€ to 0.05€
Fried Berg folds
Pop_hop_hop calls 0.04€
Fran1Oller calls 0.03€
*** FLOP *** [7s Ts Jc]
Pop_hop_hop checks
Fran1Oller checks
Coq82 bets 0.08€
Pop_hop_hop folds
Fran1Oller folds
Coq82 collected 0.21€ from pot
*** SUMMARY ***
Total pot 0.21€ | Rake 0.02€
Board: [7s Ts Jc]
Seat 5: Coq82 won 0.21€


Winamax Poker - HOLD-UP "Colorado" - HandId: #19116069-437392-1701513795 - Holdem no limit (0.01€/0.02€) - 2023/12/02 10:43:15 UTC
Table: 'Colorado' 6-max (real money) Seat #6 is the button
Seat 1: laconalostra (2.34€)
Seat 2: Fried Berg (1.57€)
Seat 3: Mametzien (3.05€)
Seat 4: theSangoten (1.92€)
Seat 5: Popierre (2.05€)
Seat 6: Baston57 (1.35€)
*** ANTE/BLINDS ***
laconalostra posts small blind 0.01€
Fried Berg posts big blind 0.02€
Dealt to Fried Berg [6s 9d]
*** PRE-FLOP *** 
Mametzien folds
theSangoten folds
Popierre folds
Baston57 folds
laconalostra raises 0.04€ to 0.06€
Fried Berg folds
laconalostra collected 0.08€ from pot
*** SUMMARY ***
Total pot 0.08€ | No rake
Seat 1: laconalostra (small blind) won 0.08€


Winamax Poker - HOLD-UP "Colorado" - HandId: #19116069-437414-1701513807 - Holdem no limit (0.01€/0.02€) - 2023/12/02 10:43:27 UTC
Table: 'Colorado' 6-max (real money) Seat #6 is the button
Seat 1: lamuerta8300 (2.90€)
Seat 2: NyKOh11 (0.50€)
Seat 3: GwenLaGrise (2.90€)
Seat 4: PIQSOU (6.51€)
Seat 5: TaBrEaMoI (4.54€)
Seat 6: Fried Berg (1.55€)
*** ANTE/BLINDS ***
lamuerta8300 posts small blind 0.01€
NyKOh11 posts big blind 0.02€
Dealt to Fried Berg [6c 8s]
*** PRE-FLOP *** 
GwenLaGrise folds
PIQSOU raises 0.03€ to 0.05€
TaBrEaMoI folds
Fried Berg folds
lamuerta8300 calls 0.04€
NyKOh11 folds
*** FLOP *** [Ad 3c 9s]
lamuerta8300 bets 0.08€
PIQSOU folds
lamuerta8300 collected 0.19€ from pot
*** SUMMARY ***
Total pot 0.19€ | Rake 0.01€
Board: [Ad 3c 9s]
Seat 1: lamuerta8300 (small blind) won 0.19€


Winamax Poker - HOLD-UP "Colorado" - HandId: #19116069-437427-1701513816 - Holdem no limit (0.01€/0.02€) - 2023/12/02 10:43:36 UTC
Table: 'Colorado' 6-max (real money) Seat #6 is the button
Seat 1: Boccace (4.05€)
Seat 2: Pop_hop_hop (1.34€)
Seat 3: Perf-31 (2.40€)
Seat 4: slowreplay (4.84€)
Seat 5: Fried Berg (1.55€)
Seat 6: TaBrEaMoI (2.04€)
Hold-up to Pot: total 0.10€
*** ANTE/BLINDS ***
Boccace posts small blind 0.01€
Pop_hop_hop posts big blind 0.02€
Dealt to Fried Berg [2s 5s]
*** PRE-FLOP *** 
Perf-31 folds
slowreplay raises 0.04€ to 0.06€
Fried Berg folds
TaBrEaMoI calls 0.06€
Boccace calls 0.05€
Pop_hop_hop folds
*** FLOP *** [9s 2d 9d]
Boccace checks
slowreplay bets 0.15€
TaBrEaMoI folds
Boccace raises 0.15€ to 0.30€
slowreplay folds
Boccace collected 0.70€ from pot
*** SUMMARY ***
Total pot 0.70€ | Rake 0.05€
Board: [9s 2d 9d]
Seat 1: Boccace (small blind) won 0.70€


Winamax Poker - HOLD-UP "Colorado" - HandId: #19116069-437433-1701513820 - Holdem no limit (0.01€/0.02€) - 2023/12/02 10:43:40 UTC
Table: 'Colorado' 6-max (real money) Seat #6 is the button
Seat 1: Td08nomotto (2.89€)
Seat 2: Fried Berg (1.55€)
Seat 3: Baston57 (1.32€)
Seat 4: AmazinG. (1.51€)
Seat 5: tichettede3 (2.34€)
Seat 6: papainge (3.24€)
*** ANTE/BLINDS ***
Td08nomotto posts small blind 0.01€
Fried Berg posts big blind 0.02€
Dealt to Fried Berg [4c 2h]
*** PRE-FLOP *** 
Baston57 folds
AmazinG. folds
tichettede3 raises 0.03€ to 0.05€
papainge folds
Td08nomotto folds
Fried Berg folds
tichettede3 collected 0.08€ from pot
*** SUMMARY ***
Total pot 0.08€ | No rake
Seat 5: tichettede3 won 0.08€


Winamax Poker - HOLD-UP "Colorado" - HandId: #19116069-437450-1701513830 - Holdem no limit (0.01€/0.02€) - 2023/12/02 10:43:50 UTC
Table: 'Colorado' 6-max (real money) Seat #6 is the button
Seat 1: Td08nomotto (2.87€)
Seat 2: El Paellas (0.50€)
Seat 3: Fried Berg (1.53€)
Seat 4: laconalostra (2.36€)
Seat 5: JeanBeauBean (2.74€)
Seat 6: NyKOh11 (0.50€)
*** ANTE/BLINDS ***
Td08nomotto posts small blind 0.01€
El Paellas posts big blind 0.02€
Dealt to Fried Berg [Jh 8d]
*** PRE-FLOP *** 
Fried Berg folds
laconalostra folds
JeanBeauBean folds
NyKOh11 folds
Td08nomotto folds
El Paellas collected 0.03€ from pot
*** SUMMARY ***
Total pot 0.03€ | No rake
Seat 2: El Paellas (big blind) won 0.03€


Winamax Poker - HOLD-UP "Colorado" - HandId: #19116069-437457-1701513833 - Holdem no limit (0.01€/0.02€) - 2023/12/02 10:43:53 UTC
Table: 'Colorado' 6-max (real money) Seat #6 is the button
Seat 1: laconalostra (2.36€)
Seat 2: Amazigh 78 (2.16€)
Seat 3: TONETONE510 (0.59€)
Seat 4: Fried Berg (1.53€)
Seat 5: popoche29 (11.37€)
Seat 6: FPVrominou (1.17€)
*** ANTE/BLINDS ***
laconalostra posts small blind 0.01€
Amazigh 78 posts big blind 0.02€
Dealt to Fried Berg [2d Kd]
*** PRE-FLOP *** 
TONETONE510 folds
Fried Berg folds
popoche29 folds
FPVrominou raises 0.03€ to 0.05€
laconalostra folds
Amazigh 78 calls 0.03€
*** FLOP *** [3d As 2c]
Amazigh 78 checks
FPVrominou bets 0.04€
Amazigh 78 calls 0.04€
*** TURN *** [3d As 2c][8h]
Amazigh 78 checks
FPVrominou checks
*** RIVER *** [3d As 2c 8h][8c]
Amazigh 78 bets 0.19€
FPVrominou folds
Amazigh 78 collected 0.36€ from pot
*** SUMMARY ***
Total pot 0.36€ | Rake 0.02€
Board: [3d As 2c 8h 8c]
Seat 2: Amazigh 78 (big blind) won 0.36€


Winamax Poker - HOLD-UP "Colorado" - HandId: #19116069-437462-1701513836 - Holdem no limit (0.01€/0.02€) - 2023/12/02 10:43:56 UTC
Table: 'Colorado' 6-max (real money) Seat #6 is the button
Seat 1: Fried Berg (1.53€)
Seat 2: VGuedjo (1.90€)
Seat 3: YannSolo1 (2.50€)
Seat 4: vuesurmer (2€)
Seat 5: 357magnum (1.72€)
Seat 6: Pop_hop_hop (1.32€)
*** ANTE/BLINDS ***
Fried Berg posts small blind 0.01€
VGuedjo posts big blind 0.02€
Dealt to Fried Berg [Qd 7s]
*** PRE-FLOP *** 
YannSolo1 raises 0.02€ to 0.04€
vuesurmer folds
357magnum folds
Pop_hop_hop folds
Fried Berg folds
VGuedjo calls 0.02€
*** FLOP *** [8h Jd 3c]
VGuedjo bets 0.06€
YannSolo1 folds
VGuedjo collected 0.14€ from pot
*** SUMMARY ***
Total pot 0.14€ | Rake 0.01€
Board: [8h Jd 3c]
Seat 2: VGuedjo (big blind) won 0.14€


Winamax Poker - HOLD-UP "Colorado" - HandId: #19116069-437465-1701513838 - Holdem no limit (0.01€/0.02€) - 2023/12/02 10:43:58 UTC
Table: 'Colorado' 6-max (real money) Seat #6 is the button
Seat 1: jdeepenslip (3.64€)
Seat 2: 357magnum (1.72€)
Seat 3: toutoazar (2€)
Seat 4: NyKOh11 (0.50€)
Seat 5: Fried Berg (1.52€)
Seat 6: HenriGuyBet (5.98€)
*** ANTE/BLINDS ***
jdeepenslip posts small blind 0.01€
357magnum posts big blind 0.02€
Dealt to Fried Berg [5h Ah]
*** PRE-FLOP *** 
toutoazar folds
NyKOh11 folds
Fried Berg raises 0.02€ to 0.04€
HenriGuyBet folds
jdeepenslip raises 0.12€ to 0.16€
357magnum calls 0.14€
Fried Berg calls 0.12€
*** FLOP *** [As Ac Jc]
jdeepenslip checks
357magnum bets 0.72€
Fried Berg calls 0.72€
jdeepenslip folds
*** TURN *** [As Ac Jc][2c]
357magnum bets 0.84€ and is all-in
Fried Berg calls 0.64€ and is all-in
*** RIVER *** [As Ac Jc 2c][3s]
*** SHOW DOWN ***
357magnum shows [5c Ad] (Trips of Aces)
Fried Berg shows [5h Ah] (Trips of Aces)
Fried Berg collected 1.44€ from main pot
357magnum collected 1.64€ from side pot 1
*** SUMMARY ***
Total pot 3.08€ | Rake 0.32€
Board: [As Ac Jc 2c 3s]
Seat 2: 357magnum (big blind) showed [5c Ad] and won 1.64€ with Trips of Aces
Seat 5: Fried Berg showed [5h Ah] and won 1.44€ with Trips of Aces


Winamax Poker - HOLD-UP "Colorado" - HandId: #19116069-437564-1701513900 - Holdem no limit (0.01€/0.02€) - 2023/12/02 10:45:00 UTC
Table: 'Colorado' 6-max (real money) Seat #6 is the button
Seat 1: 357magnum (1.64€)
Seat 2: Fried Berg (1.44€)
Seat 3: Td08nomotto (2.98€)
Seat 4: J.C Deuces.0 (2.27€)
Seat 5: rulo_137 (2.03€)
Seat 6: Soleilwmax (0.29€)
*** ANTE/BLINDS ***
357magnum posts small blind 0.01€
Fried Berg posts big blind 0.02€
Dealt to Fried Berg [3s 2c]
*** PRE-FLOP *** 
Td08nomotto folds
J.C Deuces.0 folds
rulo_137 folds
Soleilwmax calls 0.02€
357magnum raises 0.02€ to 0.04€
Fried Berg folds
Soleilwmax calls 0.02€
*** FLOP *** [Ad 5h Qh]
357magnum bets 0.05€
Soleilwmax folds
357magnum collected 0.14€ from pot
*** SUMMARY ***
Total pot 0.14€ | Rake 0.01€
Board: [Ad 5h Qh]
Seat 1: 357magnum (small blind) won 0.14€


Winamax Poker - HOLD-UP "Colorado" - HandId: #19116069-437582-1701513912 - Holdem no limit (0.01€/0.02€) - 2023/12/02 10:45:12 UTC
Table: 'Colorado' 6-max (real money) Seat #6 is the button
Seat 1: TaBrEaMoI (4.69€)
Seat 2: Zile741 (2.22€)
Seat 3: tichettede3 (2.78€)
Seat 4: Fried Berg (1.42€)
Seat 5: Fran1Oller (3.93€)
Seat 6: Perf-31 (2.43€)
*** ANTE/BLINDS ***
TaBrEaMoI posts small blind 0.01€
Zile741 posts big blind 0.02€
Dealt to Fried Berg [Ts 3d]
*** PRE-FLOP *** 
tichettede3 folds
Fried Berg folds
Fran1Oller raises 0.04€ to 0.06€
Perf-31 folds
TaBrEaMoI folds
Zile741 calls 0.04€
*** FLOP *** [9d 8c 5h]
Zile741 checks
Fran1Oller bets 0.03€
Zile741 calls 0.03€
*** TURN *** [9d 8c 5h][9s]
Zile741 checks
Fran1Oller checks
*** RIVER *** [9d 8c 5h 9s][7d]
Zile741 checks
Fran1Oller checks
*** SHOW DOWN ***
Fran1Oller shows [Qd Kh] (One pair : 9)
Zile741 shows [3h Ah] (One pair : 9)
Zile741 collected 0.17€ from pot
*** SUMMARY ***
Total pot 0.17€ | Rake 0.02€
Board: [9d 8c 5h 9s 7d]
Seat 2: Zile741 (big blind) showed [3h Ah] and won 0.17€ with One pair : 9
Seat 5: Fran1Oller showed [Qd Kh] and lost with One pair : 9


Winamax Poker - HOLD-UP "Colorado" - HandId: #19116069-437585-1701513914 - Holdem no limit (0.01€/0.02€) - 2023/12/02 10:45:14 UTC
Table: 'Colorado' 6-max (real money) Seat #6 is the button
Seat 1: Boccace (4.57€)
Seat 2: GwenLaGrise (2.10€)
Seat 3: PIQSOU (3.64€)
Seat 4: El Paellas (0.63€)
Seat 5: VGuedjo (2.24€)
Seat 6: Fried Berg (1.42€)
*** ANTE/BLINDS ***
Boccace posts small blind 0.01€
GwenLaGrise posts big blind 0.02€
Dealt to Fried Berg [Qc 4s]
*** PRE-FLOP *** 
PIQSOU folds
El Paellas folds
VGuedjo folds
Fried Berg folds
Boccace folds
GwenLaGrise collected 0.03€ from pot
*** SUMMARY ***
Total pot 0.03€ | No rake
Seat 2: GwenLaGrise (big blind) won 0.03€


Winamax Poker - HOLD-UP "Colorado" - HandId: #19116069-437591-1701513918 - Holdem no limit (0.01€/0.02€) - 2023/12/02 10:45:18 UTC
Table: 'Colorado' 6-max (real money) Seat #6 is the button
Seat 1: theSangoten (1.64€)
Seat 2: mea botellas (8.79€)
Seat 3: JeanBeauBean (2.56€)
Seat 4: ECPulga (5.05€)
Seat 5: Fried Berg (1.42€)
Seat 6: PIQSOU (3.34€)
*** ANTE/BLINDS ***
theSangoten posts small blind 0.01€
mea botellas posts big blind 0.02€
Dealt to Fried Berg [2h 3c]
*** PRE-FLOP *** 
JeanBeauBean folds
ECPulga folds
Fried Berg folds
PIQSOU folds
theSangoten folds
mea botellas collected 0.03€ from pot
*** SUMMARY ***
Total pot 0.03€ | No rake
Seat 2: mea botellas (big blind) won 0.03€


Winamax Poker - HOLD-UP "Colorado" - HandId: #19116069-437594-1701513920 - Holdem no limit (0.01€/0.02€) - 2023/12/02 10:45:20 UTC
Table: 'Colorado' 6-max (real money) Seat #6 is the button
Seat 1: Fried Berg (1.42€)
Seat 2: I6pokerP4 (3.20€)
Seat 3: Pas1erreur (2.83€)
Seat 4: JeanBeauBean (2.56€)
Seat 5: theSangoten (1.63€)
Seat 6: Pat Poker 73 (2.21€)
*** ANTE/BLINDS ***
Fried Berg posts small blind 0.01€
I6pokerP4 posts big blind 0.02€
Dealt to Fried Berg [4c 4s]
*** PRE-FLOP *** 
Pas1erreur folds
JeanBeauBean raises 0.03€ to 0.05€
theSangoten folds
Pat Poker 73 folds
Fried Berg calls 0.04€
I6pokerP4 folds
*** FLOP *** [4h 6d Jc]
Fried Berg checks
JeanBeauBean bets 0.04€
Fried Berg calls 0.04€
*** TURN *** [4h 6d Jc][2s]
Fried Berg checks
JeanBeauBean checks
*** RIVER *** [4h 6d Jc 2s][3c]
Fried Berg bets 0.06€
JeanBeauBean folds
Fried Berg collected 0.24€ from pot
*** SUMMARY ***
Total pot 0.24€ | Rake 0.02€
Board: [4h 6d Jc 2s 3c]
Seat 1: Fried Berg (small blind) won 0.24€


Winamax Poker - HOLD-UP "Colorado" - HandId: #19116069-437659-1701513966 - Holdem no limit (0.01€/0.02€) - 2023/12/02 10:46:06 UTC
Table: 'Colorado' 6-max (real money) Seat #6 is the button
Seat 1: slowreplay (2.84€)
Seat 2: Baston57 (1.89€)
Seat 3: Fried Berg (1.51€)
Seat 4: Zile741 (2.29€)
Seat 5: mea botellas (8.80€)
Seat 6: Trevize (1.89€)
*** ANTE/BLINDS ***
slowreplay posts small blind 0.01€
Baston57 posts big blind 0.02€
Dealt to Fried Berg [6h 7h]
*** PRE-FLOP *** 
Fried Berg raises 0.02€ to 0.04€
Zile741 folds
mea botellas folds
Trevize folds
slowreplay folds
Baston57 folds
Fried Berg collected 0.07€ from pot
*** SUMMARY ***
Total pot 0.07€ | No rake
Seat 3: Fried Berg won 0.07€


Winamax Poker - HOLD-UP "Colorado" - HandId: #19116069-437674-1701513978 - Holdem no limit (0.01€/0.02€) - 2023/12/02 10:46:18 UTC
Table: 'Colorado' 6-max (real money) Seat #6 is the button
Seat 1: Mametzien (4.83€)
Seat 2: Nombrillus (1.45€)
Seat 3: slowreplay (2.83€)
Seat 4: Fran1Oller (3.83€)
Seat 5: ITALIA291 (2.56€)
Seat 6: Fried Berg (1.54€)
*** ANTE/BLINDS ***
Mametzien posts small blind 0.01€
Nombrillus posts big blind 0.02€
Dealt to Fried Berg [8d 9h]
*** PRE-FLOP *** 
slowreplay folds
Fran1Oller folds
ITALIA291 folds
Fried Berg raises 0.04€ to 0.06€
Mametzien folds
Nombrillus raises 0.18€ to 0.24€
Fried Berg folds
Nombrillus collected 0.31€ from pot
*** SUMMARY ***
Total pot 0.31€ | No rake
Seat 2: Nombrillus (big blind) won 0.31€


Winamax Poker - HOLD-UP "Colorado" - HandId: #19116069-437712-1701514001 - Holdem no limit (0.01€/0.02€) - 2023/12/02 10:46:41 UTC
Table: 'Colorado' 6-max (real money) Seat #6 is the button
Seat 1: ITALIA291 (2.54€)
Seat 2: Perf-31 (2.48€)
Seat 3: Fried Berg (1.48€)
Seat 4: papainge (2.97€)
Seat 5: _ilTulipano_ (2.70€)
Seat 6: -KrAKPAs- (1.54€)
*** ANTE/BLINDS ***
ITALIA291 posts small blind 0.01€
Perf-31 posts big blind 0.02€
Dealt to Fried Berg [9d Ad]
*** PRE-FLOP *** 
Fried Berg raises 0.02€ to 0.04€
papainge calls 0.04€
_ilTulipano_ folds
-KrAKPAs- folds
ITALIA291 folds
Perf-31 folds
*** FLOP *** [9s 3s 9c]
Fried Berg bets 0.02€
papainge folds
Fried Berg collected 0.12€ from pot
*** SUMMARY ***
Total pot 0.12€ | Rake 0.01€
Board: [9s 3s 9c]
Seat 3: Fried Berg won 0.12€


Winamax Poker - HOLD-UP "Colorado" - HandId: #19116069-437763-1701514034 - Holdem no limit (0.01€/0.02€) - 2023/12/02 10:47:14 UTC
Table: 'Colorado' 6-max (real money) Seat #6 is the button
Seat 1: mea botellas (8.83€)
Seat 2: JackB13 (1.99€)
Seat 3: tichettede3 (2.78€)
Seat 4: Baston57 (1.93€)
Seat 5: 121 (3.53€)
Seat 6: Fried Berg (1.54€)
*** ANTE/BLINDS ***
mea botellas posts small blind 0.01€
JackB13 posts big blind 0.02€
Dealt to Fried Berg [Ts Tc]
*** PRE-FLOP *** 
tichettede3 folds
Baston57 folds
121 folds
Fried Berg raises 0.04€ to 0.06€
mea botellas folds
JackB13 calls 0.04€
*** FLOP *** [Th 6c 2s]
JackB13 checks
Fried Berg bets 0.02€
JackB13 calls 0.02€
*** TURN *** [Th 6c 2s][3d]
JackB13 checks
Fried Berg bets 0.06€
JackB13 calls 0.06€
*** RIVER *** [Th 6c 2s 3d][4d]
JackB13 checks
Fried Berg bets 0.16€
JackB13 calls 0.16€
*** SHOW DOWN ***
JackB13 shows [2d Kc] (One pair : 2)
Fried Berg shows [Ts Tc] (Trips of Tens)
Fried Berg collected 0.55€ from pot
*** SUMMARY ***
Total pot 0.55€ | Rake 0.06€
Board: [Th 6c 2s 3d 4d]
Seat 2: JackB13 (big blind) showed [2d Kc] and lost with One pair : 2
Seat 6: Fried Berg (button) showed [Ts Tc] and won 0.55€ with Trips of Tens


Winamax Poker - HOLD-UP "Colorado" - HandId: #19116069-437811-1701514072 - Holdem no limit (0.01€/0.02€) - 2023/12/02 10:47:52 UTC
Table: 'Colorado' 6-max (real money) Seat #6 is the button
Seat 1: JackB13 (1.69€)
Seat 2: P.BaIkany (2.09€)
Seat 3: _ilTulipano_ (2.67€)
Seat 4: e-card (1.31€)
Seat 5: TaBrEaMoI (2.02€)
Seat 6: Fried Berg (1.79€)
*** ANTE/BLINDS ***
JackB13 posts small blind 0.01€
P.BaIkany posts big blind 0.02€
Dealt to Fried Berg [3s 9s]
*** PRE-FLOP *** 
_ilTulipano_ raises 0.04€ to 0.06€
e-card folds
TaBrEaMoI folds
Fried Berg folds
JackB13 calls 0.05€
P.BaIkany folds
*** FLOP *** [Tc 2h Kd]
JackB13 checks
_ilTulipano_ bets 0.09€
JackB13 calls 0.09€
*** TURN *** [Tc 2h Kd][Qs]
JackB13 checks
_ilTulipano_ bets 0.21€
JackB13 calls 0.21€
*** RIVER *** [Tc 2h Kd Qs][As]
JackB13 checks
_ilTulipano_ checks
*** SHOW DOWN ***
JackB13 shows [Ad 5h] (One pair : Aces)
_ilTulipano_ shows [Kc Ts] (Two pairs : Kings and Tens)
_ilTulipano_ collected 0.67€ from pot
*** SUMMARY ***
Total pot 0.67€ | Rake 0.07€
Board: [Tc 2h Kd Qs As]
Seat 1: JackB13 (small blind) showed [Ad 5h] and lost with One pair : Aces
Seat 3: _ilTulipano_ showed [Kc Ts] and won 0.67€ with Two pairs : Kings and Tens


Winamax Poker - HOLD-UP "Colorado" - HandId: #19116069-437825-1701514087 - Holdem no limit (0.01€/0.02€) - 2023/12/02 10:48:07 UTC
Table: 'Colorado' 6-max (real money) Seat #6 is the button
Seat 1: josep2170 (3.17€)
Seat 2: durba (2.07€)
Seat 3: soliderock (2.06€)
Seat 4: ITALIA291 (2.53€)
Seat 5: PIQSOU (3.24€)
Seat 6: Fried Berg (1.79€)
*** ANTE/BLINDS ***
josep2170 posts small blind 0.01€
durba posts big blind 0.02€
Dealt to Fried Berg [8h 5c]
*** PRE-FLOP *** 
soliderock folds
ITALIA291 raises 0.02€ to 0.04€
PIQSOU folds
Fried Berg folds
josep2170 calls 0.03€
durba folds
*** FLOP *** [6d 6s Ad]
josep2170 checks
ITALIA291 bets 0.10€
josep2170 calls 0.10€
*** TURN *** [6d 6s Ad][9s]
josep2170 checks
ITALIA291 checks
*** RIVER *** [6d 6s Ad 9s][7d]
josep2170 checks
ITALIA291 bets 0.20€
josep2170 calls 0.20€
*** SHOW DOWN ***
josep2170 shows [Ac Jc] (Two pairs : Aces and 6)
ITALIA291 shows [Th 8d] (Straight Ten high)
ITALIA291 collected 0.63€ from pot
*** SUMMARY ***
Total pot 0.63€ | Rake 0.07€
Board: [6d 6s Ad 9s 7d]
Seat 1: josep2170 (small blind) showed [Ac Jc] and lost with Two pairs : Aces and 6
Seat 4: ITALIA291 showed [Th 8d] and won 0.63€ with Straight Ten high


Winamax Poker - HOLD-UP "Colorado" - HandId: #19116069-437873-1701514124 - Holdem no limit (0.01€/0.02€) - 2023/12/02 10:48:44 UTC
Table: 'Colorado' 6-max (real money) Seat #6 is the button
Seat 1: Fried Berg (1.79€)
Seat 2: Pat Poker 73 (2.82€)
Seat 3: _ilTulipano_ (3.37€)
Seat 4: Mametzien (4.97€)
Seat 5: TaBrEaMoI (4.32€)
Seat 6: Amazigh 78 (2.67€)
*** ANTE/BLINDS ***
Fried Berg posts small blind 0.01€
Pat Poker 73 posts big blind 0.02€
Dealt to Fried Berg [2s 8s]
*** PRE-FLOP *** 
_ilTulipano_ folds
Mametzien calls 0.02€
TaBrEaMoI folds
Amazigh 78 folds
Fried Berg folds
Pat Poker 73 checks
*** FLOP *** [3c Qh Ah]
Pat Poker 73 checks
Mametzien checks
*** TURN *** [3c Qh Ah][3d]
Pat Poker 73 bets 0.03€
Mametzien calls 0.03€
*** RIVER *** [3c Qh Ah 3d][8d]
Pat Poker 73 checks
Mametzien bets 0.04€
Pat Poker 73 folds
Mametzien collected 0.14€ from pot
*** SUMMARY ***
Total pot 0.14€ | Rake 0.01€
Board: [3c Qh Ah 3d 8d]
Seat 4: Mametzien won 0.14€


Winamax Poker - HOLD-UP "Colorado" - HandId: #19116069-437878-1701514126 - Holdem no limit (0.01€/0.02€) - 2023/12/02 10:48:46 UTC
Table: 'Colorado' 6-max (real money) Seat #6 is the button
Seat 1: _ilTulipano_ (3.37€)
Seat 2: Fried Berg (1.78€)
Seat 3: Coq82 (2.03€)
Seat 4: El Paellas (0.50€)
Seat 5: _FanZ_ (2.25€)
Seat 6: Zile741 (2.23€)
*** ANTE/BLINDS ***
_ilTulipano_ posts small blind 0.01€
Fried Berg posts big blind 0.02€
Dealt to Fried Berg [3s 9h]
*** PRE-FLOP *** 
Coq82 raises 0.03€ to 0.05€
El Paellas folds
_FanZ_ folds
Zile741 raises 0.15€ to 0.20€
_ilTulipano_ folds
Fried Berg folds
Coq82 folds
Zile741 collected 0.28€ from pot
*** SUMMARY ***
Total pot 0.28€ | No rake
Seat 6: Zile741 (button) won 0.28€


Winamax Poker - HOLD-UP "Colorado" - HandId: #19116069-437884-1701514130 - Holdem no limit (0.01€/0.02€) - 2023/12/02 10:48:50 UTC
Table: 'Colorado' 6-max (real money) Seat #6 is the button
Seat 1: Kito31 (7.57€)
Seat 2: Popierre (2.09€)
Seat 3: Fushitif (0.59€)
Seat 4: Boccace (4.45€)
Seat 5: fifi2308 (1.89€)
Seat 6: Fried Berg (1.76€)
*** ANTE/BLINDS ***
Kito31 posts small blind 0.01€
Popierre posts big blind 0.02€
Dealt to Fried Berg [Kc Qc]
*** PRE-FLOP *** 
Fushitif calls 0.02€
Boccace folds
fifi2308 folds
Fried Berg raises 0.06€ to 0.08€
Kito31 folds
Popierre folds
Fushitif calls 0.06€
*** FLOP *** [Ah As Jd]
Fushitif checks
Fried Berg checks
*** TURN *** [Ah As Jd][Qs]
Fushitif checks
Fried Berg checks
*** RIVER *** [Ah As Jd Qs][8c]
Fushitif bets 0.51€ and is all-in
Fried Berg folds
Fushitif collected 0.68€ from pot
*** SUMMARY ***
Total pot 0.68€ | Rake 0.02€
Board: [Ah As Jd Qs 8c]
Seat 3: Fushitif won 0.68€


Winamax Poker - HOLD-UP "Colorado" - HandId: #19116069-437985-1701514196 - Holdem no limit (0.01€/0.02€) - 2023/12/02 10:49:56 UTC
Table: 'Colorado' 6-max (real money) Seat #6 is the button
Seat 1: Morri7Jack (0.92€)
Seat 2: MONEYFOREVER (5.22€)
Seat 3: TaBrEaMoI (4.67€)
Seat 4: Fried Berg (1.68€)
Seat 5: durba (1.90€)
Seat 6: _FanZ_ (1.90€)
*** ANTE/BLINDS ***
Morri7Jack posts small blind 0.01€
MONEYFOREVER posts big blind 0.02€
Dealt to Fried Berg [Kc 8s]
*** PRE-FLOP *** 
TaBrEaMoI folds
Fried Berg folds
durba folds
_FanZ_ folds
Morri7Jack folds
MONEYFOREVER collected 0.03€ from pot
*** SUMMARY ***
Total pot 0.03€ | No rake
Seat 2: MONEYFOREVER (big blind) won 0.03€


Winamax Poker - HOLD-UP "Colorado" - HandId: #19116069-437992-1701514202 - Holdem no limit (0.01€/0.02€) - 2023/12/02 10:50:02 UTC
Table: 'Colorado' 6-max (real money) Seat #6 is the button
Seat 1: _FanZ_ (1.90€)
Seat 2: P.BaIkany (2€)
Seat 3: Fried Berg (1.68€)
Seat 4: TaBrEaMoI (2.03€)
Seat 5: blie2006 (0.16€)
Seat 6: PIQSOU (6.61€)
*** ANTE/BLINDS ***
_FanZ_ posts small blind 0.01€
P.BaIkany posts big blind 0.02€
Dealt to Fried Berg [Kd 9d]
*** PRE-FLOP *** 
Fried Berg folds
TaBrEaMoI folds
blie2006 folds
PIQSOU raises 0.03€ to 0.05€
_FanZ_ folds
P.BaIkany raises 0.15€ to 0.20€
PIQSOU folds
P.BaIkany collected 0.26€ from pot
*** SUMMARY ***
Total pot 0.26€ | No rake
Seat 2: P.BaIkany (big blind) won 0.26€


Winamax Poker - HOLD-UP "Colorado" - HandId: #19116069-437994-1701514204 - Holdem no limit (0.01€/0.02€) - 2023/12/02 10:50:04 UTC
Table: 'Colorado' 6-max (real money) Seat #6 is the button
Seat 1: Fried Berg (1.68€)
Seat 2: NyKOh11 (0.50€)
Seat 3: Odieux Car4 (1.19€)
Seat 4: Zile741 (2.14€)
Seat 5: JeanBeauBean (2.74€)
Seat 6: oliveponcar (2€)
*** ANTE/BLINDS ***
Fried Berg posts small blind 0.01€
NyKOh11 posts big blind 0.02€
Dealt to Fried Berg [7c Kc]
*** PRE-FLOP *** 
Odieux Car4 folds
Zile741 folds
JeanBeauBean folds
oliveponcar folds
Fried Berg raises 0.02€ to 0.04€
NyKOh11 calls 0.02€
*** FLOP *** [6h Jd 8c]
Fried Berg checks
NyKOh11 checks
*** TURN *** [6h Jd 8c][Th]
Fried Berg checks
NyKOh11 checks
*** RIVER *** [6h Jd 8c Th][2h]
Fried Berg checks
NyKOh11 checks
*** SHOW DOWN ***
Fried Berg shows [7c Kc] (High card : King)
NyKOh11 shows [6d 4d] (One pair : 6)
NyKOh11 collected 0.07€ from pot
*** SUMMARY ***
Total pot 0.07€ | Rake 0.01€
Board: [6h Jd 8c Th 2h]
Seat 1: Fried Berg (small blind) showed [7c Kc] and lost with High card : King
Seat 2: NyKOh11 (big blind) showed [6d 4d] and won 0.07€ with One pair : 6


Winamax Poker - HOLD-UP "Colorado" - HandId: #19116069-438048-1701514245 - Holdem no limit (0.01€/0.02€) - 2023/12/02 10:50:45 UTC
Table: 'Colorado' 6-max (real money) Seat #6 is the button
Seat 1: TaBrEaMoI (4.63€)
Seat 2: Fried Berg (1.64€)
Seat 3: J.C Deuces.0 (2.44€)
Seat 4: Coq82 (7.60€)
Seat 5: NyKOh11 (0.53€)
Seat 6: LimpDoud (1.97€)
Hold-up to Pot: total 0.10€
*** ANTE/BLINDS ***
TaBrEaMoI posts small blind 0.01€
Fried Berg posts big blind 0.02€
Dealt to Fried Berg [Ah 2s]
*** PRE-FLOP *** 
J.C Deuces.0 folds
Coq82 raises 0.03€ to 0.05€
NyKOh11 folds
LimpDoud folds
TaBrEaMoI folds
Fried Berg calls 0.03€
*** FLOP *** [3c Kc 4c]
Fried Berg checks
Coq82 bets 0.11€
Fried Berg folds
Coq82 collected 0.31€ from pot
*** SUMMARY ***
Total pot 0.31€ | Rake 0.01€
Board: [3c Kc 4c]
Seat 4: Coq82 won 0.31€


Winamax Poker - HOLD-UP "Colorado" - HandId: #19116069-438092-1701514277 - Holdem no limit (0.01€/0.02€) - 2023/12/02 10:51:17 UTC
Table: 'Colorado' 6-max (real money) Seat #6 is the button
Seat 1: JFSredbaron (2.19€)
Seat 2: YannSolo1 (1.96€)
Seat 3: oliveponcar (2€)
Seat 4: lamuerta8300 (3.85€)
Seat 5: Fried Berg (1.59€)
Seat 6: Pas1erreur (3.05€)
*** ANTE/BLINDS ***
JFSredbaron posts small blind 0.01€
YannSolo1 posts big blind 0.02€
Dealt to Fried Berg [7s 6s]
*** PRE-FLOP *** 
oliveponcar raises 0.04€ to 0.06€
lamuerta8300 folds
Fried Berg calls 0.06€
Pas1erreur folds
JFSredbaron raises 0.20€ to 0.26€
YannSolo1 folds
oliveponcar raises 0.39€ to 0.65€
Fried Berg folds
JFSredbaron folds
oliveponcar collected 0.99€ from pot
*** SUMMARY ***
Total pot 0.99€ | No rake
Seat 3: oliveponcar won 0.99€


Winamax Poker - HOLD-UP "Colorado" - HandId: #19116069-438134-1701514311 - Holdem no limit (0.01€/0.02€) - 2023/12/02 10:51:51 UTC
Table: 'Colorado' 6-max (real money) Seat #6 is the button
Seat 1: slowreplay (4.54€)
Seat 2: Betiegarri (1.95€)
Seat 3: Fried Berg (1.53€)
Seat 4: oliveponcar (2.34€)
Seat 5: durba (1.79€)
Seat 6: YannSolo1 (2.70€)
*** ANTE/BLINDS ***
slowreplay posts small blind 0.01€
Betiegarri posts big blind 0.02€
Dealt to Fried Berg [3h 8d]
*** PRE-FLOP *** 
Fried Berg folds
oliveponcar raises 0.04€ to 0.06€
durba folds
YannSolo1 folds
slowreplay folds
Betiegarri folds
oliveponcar collected 0.09€ from pot
*** SUMMARY ***
Total pot 0.09€ | No rake
Seat 4: oliveponcar won 0.09€


Winamax Poker - HOLD-UP "Colorado" - HandId: #19116069-438136-1701514313 - Holdem no limit (0.01€/0.02€) - 2023/12/02 10:51:53 UTC
Table: 'Colorado' 6-max (real money) Seat #6 is the button
Seat 1: Abec16 (1.33€)
Seat 2: Fried Berg (1.53€)
Seat 3: jdeepenslip (4.28€)
Seat 4: mea botellas (9€)
Seat 5: _ilTulipano_ (5.79€)
Seat 6: durba (1.79€)
*** ANTE/BLINDS ***
Abec16 posts small blind 0.01€
Fried Berg posts big blind 0.02€
Dealt to Fried Berg [3c 3d]
*** PRE-FLOP *** 
jdeepenslip folds
mea botellas folds
_ilTulipano_ folds
durba folds
Abec16 folds
Fried Berg collected 0.03€ from pot
*** SUMMARY ***
Total pot 0.03€ | No rake
Seat 2: Fried Berg (big blind) won 0.03€


Winamax Poker - HOLD-UP "Colorado" - HandId: #19116069-438157-1701514328 - Holdem no limit (0.01€/0.02€) - 2023/12/02 10:52:08 UTC
Table: 'Colorado' 6-max (real money) Seat #6 is the button
Seat 1: _ilTulipano_ (5.79€)
Seat 2: Pas1erreur (2.64€)
Seat 3: YannSolo1 (1.90€)
Seat 4: Fried Berg (1.54€)
Seat 5: e-card (0.96€)
Seat 6: Mametzien (4.77€)
*** ANTE/BLINDS ***
_ilTulipano_ posts small blind 0.01€
Pas1erreur posts big blind 0.02€
Dealt to Fried Berg [6c 6h]
*** PRE-FLOP *** 
YannSolo1 folds
Fried Berg raises 0.02€ to 0.04€
e-card folds
Mametzien folds
_ilTulipano_ folds
Pas1erreur calls 0.02€
*** FLOP *** [3s 3d 8d]
Pas1erreur checks
Fried Berg checks
*** TURN *** [3s 3d 8d][7s]
Pas1erreur checks
Fried Berg checks
*** RIVER *** [3s 3d 8d 7s][7c]
Pas1erreur checks
Fried Berg checks
*** SHOW DOWN ***
Pas1erreur shows [9c Kc] (Two pairs : 7 and 3)
Fried Berg shows [6c 6h] (Two pairs : 7 and 6)
Fried Berg collected 0.08€ from pot
*** SUMMARY ***
Total pot 0.08€ | Rake 0.01€
Board: [3s 3d 8d 7s 7c]
Seat 2: Pas1erreur (big blind) showed [9c Kc] and lost with Two pairs : 7 and 3
Seat 4: Fried Berg showed [6c 6h] and won 0.08€ with Two pairs : 7 and 6


Winamax Poker - HOLD-UP "Colorado" - HandId: #19116069-438214-1701514369 - Holdem no limit (0.01€/0.02€) - 2023/12/02 10:52:49 UTC
Table: 'Colorado' 6-max (real money) Seat #6 is the button
Seat 1: Nombrillus (1.87€)
Seat 2: Zile741 (2.17€)
Seat 3: YannSolo1 (2.76€)
Seat 4: Fried Berg (1.58€)
Seat 5: Coq82 (8.25€)
Seat 6: Ipiz (4.27€)
*** ANTE/BLINDS ***
Nombrillus posts small blind 0.01€
Zile741 posts big blind 0.02€
Dealt to Fried Berg [Jd 3d]
*** PRE-FLOP *** 
YannSolo1 folds
Fried Berg folds
Coq82 folds
Ipiz folds
Nombrillus raises 0.03€ to 0.05€
Zile741 raises 0.17€ to 0.22€
Nombrillus folds
Zile741 collected 0.27€ from pot
*** SUMMARY ***
Total pot 0.27€ | No rake
Seat 2: Zile741 (big blind) won 0.27€


Winamax Poker - HOLD-UP "Colorado" - HandId: #19116069-438227-1701514380 - Holdem no limit (0.01€/0.02€) - 2023/12/02 10:53:00 UTC
Table: 'Colorado' 6-max (real money) Seat #6 is the button
Seat 1: Fried Berg (1.58€)
Seat 2: J.C Deuces.0 (2.31€)
Seat 3: _FanZ_ (2.29€)
Seat 4: Soleilwmax (0.64€)
Seat 5: Pop_hop_hop (1.28€)
Seat 6: 2winchester (1.70€)
*** ANTE/BLINDS ***
Fried Berg posts small blind 0.01€
J.C Deuces.0 posts big blind 0.02€
Dealt to Fried Berg [Jh Td]
*** PRE-FLOP *** 
_FanZ_ raises 0.04€ to 0.06€
Soleilwmax folds
Pop_hop_hop calls 0.06€
2winchester calls 0.06€
Fried Berg folds
J.C Deuces.0 folds
*** FLOP *** [9h As 4d]
_FanZ_ checks
Pop_hop_hop bets 0.07€
2winchester calls 0.07€
_FanZ_ folds
*** TURN *** [9h As 4d][Qc]
Pop_hop_hop checks
2winchester checks
*** RIVER *** [9h As 4d Qc][8c]
Pop_hop_hop checks
2winchester bets 0.35€
Pop_hop_hop calls 0.35€
*** SHOW DOWN ***
Pop_hop_hop shows [Jd 9d] (One pair : 9)
2winchester shows [2h Ah] (One pair : Aces)
2winchester collected 0.94€ from pot
*** SUMMARY ***
Total pot 0.94€ | Rake 0.11€
Board: [9h As 4d Qc 8c]
Seat 5: Pop_hop_hop showed [Jd 9d] and lost with One pair : 9
Seat 6: 2winchester (button) showed [2h Ah] and won 0.94€ with One pair : Aces


Winamax Poker - HOLD-UP "Colorado" - HandId: #19116069-438262-1701514402 - Holdem no limit (0.01€/0.02€) - 2023/12/02 10:53:22 UTC
Table: 'Colorado' 6-max (real money) Seat #6 is the button
Seat 1: mea botellas (2.48€)
Seat 2: PIQSOU (3.25€)
Seat 3: TaBrEaMoI (2.22€)
Seat 4: Fried Berg (1.57€)
Seat 5: Jean3776 (2€)
Seat 6: oliveponcar (2€)
*** ANTE/BLINDS ***
mea botellas posts small blind 0.01€
PIQSOU posts big blind 0.02€
Dealt to Fried Berg [6h 3c]
*** PRE-FLOP *** 
TaBrEaMoI folds
Fried Berg folds
Jean3776 raises 0.03€ to 0.05€
oliveponcar folds
mea botellas folds
PIQSOU calls 0.03€
*** FLOP *** [Ah Tc 9c]
PIQSOU checks
Jean3776 bets 0.06€
PIQSOU calls 0.06€
*** TURN *** [Ah Tc 9c][2c]
PIQSOU checks
Jean3776 checks
*** RIVER *** [Ah Tc 9c 2c][4s]
PIQSOU bets 0.17€
Jean3776 folds
PIQSOU collected 0.38€ from pot
*** SUMMARY ***
Total pot 0.38€ | Rake 0.02€
Board: [Ah Tc 9c 2c 4s]
Seat 2: PIQSOU (big blind) won 0.38€


Winamax Poker - HOLD-UP "Colorado" - HandId: #19116069-438267-1701514404 - Holdem no limit (0.01€/0.02€) - 2023/12/02 10:53:24 UTC
Table: 'Colorado' 6-max (real money) Seat #6 is the button
Seat 1: ckok (0.80€)
Seat 2: micth41 (1.69€)
Seat 3: lamuerta8300 (3.94€)
Seat 4: mea botellas (3.75€)
Seat 5: Fried Berg (1.57€)
Seat 6: slowreplay (4.76€)
*** ANTE/BLINDS ***
ckok posts small blind 0.01€
micth41 posts big blind 0.02€
Dealt to Fried Berg [7s 4c]
*** PRE-FLOP *** 
lamuerta8300 raises 0.04€ to 0.06€
mea botellas folds
Fried Berg folds
slowreplay folds
ckok raises 0.14€ to 0.20€
micth41 folds
lamuerta8300 calls 0.14€
*** FLOP *** [Jd 3h 6d]
ckok checks
lamuerta8300 checks
*** TURN *** [Jd 3h 6d][8c]
ckok bets 0.60€ and is all-in
lamuerta8300 calls 0.60€
*** RIVER *** [Jd 3h 6d 8c][9s]
*** SHOW DOWN ***
ckok shows [Kh Th] (High card : King)
lamuerta8300 shows [Kc Jc] (One pair : Jacks)
lamuerta8300 collected 1.46€ from pot
*** SUMMARY ***
Total pot 1.46€ | Rake 0.16€
Board: [Jd 3h 6d 8c 9s]
Seat 1: ckok (small blind) showed [Kh Th] and lost with High card : King
Seat 3: lamuerta8300 showed [Kc Jc] and won 1.46€ with One pair : Jacks


Winamax Poker - HOLD-UP "Colorado" - HandId: #19116069-438274-1701514408 - Holdem no limit (0.01€/0.02€) - 2023/12/02 10:53:28 UTC
Table: 'Colorado' 6-max (real money) Seat #6 is the button
Seat 1: Popierre (7.29€)
Seat 2: LIAMINE76000 (1.85€)
Seat 3: durba (1.73€)
Seat 4: Fried Berg (1.57€)
Seat 5: Betiegarri (2.17€)
Seat 6: Trevize (1.68€)
*** ANTE/BLINDS ***
Popierre posts small blind 0.01€
LIAMINE76000 posts big blind 0.02€
Dealt to Fried Berg [Ad 5d]
*** PRE-FLOP *** 
durba folds
Fried Berg raises 0.02€ to 0.04€
Betiegarri folds
Trevize folds
Popierre folds
LIAMINE76000 folds
Fried Berg collected 0.07€ from pot
*** SUMMARY ***
Total pot 0.07€ | No rake
Seat 4: Fried Berg won 0.07€


Winamax Poker - HOLD-UP "Colorado" - HandId: #19116069-438288-1701514420 - Holdem no limit (0.01€/0.02€) - 2023/12/02 10:53:40 UTC
Table: 'Colorado' 6-max (real money) Seat #6 is the button
Seat 1: Fried Berg (1.60€)
Seat 2: Ipiz (4.27€)
Seat 3: Anis_King497 (0.47€)
Seat 4: Retail Row (5.29€)
Seat 5: Abec16 (1.48€)
Seat 6: Pat Poker 73 (2.78€)
*** ANTE/BLINDS ***
Fried Berg posts small blind 0.01€
Ipiz posts big blind 0.02€
Dealt to Fried Berg [Kh 2d]
*** PRE-FLOP *** 
Anis_King497 folds
Retail Row raises 0.04€ to 0.06€
Abec16 folds
Pat Poker 73 calls 0.06€
Fried Berg folds
Ipiz folds
*** FLOP *** [As 5s Ks]
Retail Row checks
Pat Poker 73 bets 0.15€
Retail Row calls 0.15€
*** TURN *** [As 5s Ks][Th]
Retail Row checks
Pat Poker 73 checks
*** RIVER *** [As 5s Ks Th][6h]
Retail Row bets 0.23€
Pat Poker 73 folds
Retail Row collected 0.63€ from pot
*** SUMMARY ***
Total pot 0.63€ | Rake 0.05€
Board: [As 5s Ks Th 6h]
Seat 4: Retail Row won 0.63€


Winamax Poker - HOLD-UP "Colorado" - HandId: #19116069-438292-1701514423 - Holdem no limit (0.01€/0.02€) - 2023/12/02 10:53:43 UTC
Table: 'Colorado' 6-max (real money) Seat #6 is the button
Seat 1: Singhalinga (1.65€)
Seat 2: TaBrEaMoI (2.22€)
Seat 3: Fried Berg (1.59€)
Seat 4: sniper girl (5.77€)
Seat 5: Zile741 (2.07€)
Seat 6: jdeepenslip (4.77€)
Hold-up to Pot: total 0.10€
*** ANTE/BLINDS ***
Singhalinga posts small blind 0.01€
TaBrEaMoI posts big blind 0.02€
Dealt to Fried Berg [Ac Tc]
*** PRE-FLOP *** 
Fried Berg raises 0.02€ to 0.04€
sniper girl folds
Zile741 raises 0.21€ to 0.25€
jdeepenslip folds
Singhalinga folds
TaBrEaMoI folds
Fried Berg calls 0.21€
*** FLOP *** [2d Ks 3d]
Fried Berg checks
Zile741 bets 0.16€
Fried Berg folds
Zile741 collected 0.74€ from pot
*** SUMMARY ***
Total pot 0.74€ | Rake 0.05€
Board: [2d Ks 3d]
Seat 5: Zile741 won 0.74€


Winamax Poker - HOLD-UP "Colorado" - HandId: #19116069-438349-1701514466 - Holdem no limit (0.01€/0.02€) - 2023/12/02 10:54:26 UTC
Table: 'Colorado' 6-max (real money) Seat #6 is the button
Seat 1: Jean3776 (2.03€)
Seat 2: MONEYFOREVER (5.05€)
Seat 3: Coq82 (8.18€)
Seat 4: Nombrillus (1.83€)
Seat 5: popoche29 (1.59€)
Seat 6: Fried Berg (1.34€)
Hold-up to Pot: total 0.10€
*** ANTE/BLINDS ***
Jean3776 posts small blind 0.01€
MONEYFOREVER posts big blind 0.02€
Dealt to Fried Berg [As Ks]
*** PRE-FLOP *** 
Coq82 folds
Nombrillus raises 0.07€ to 0.09€
popoche29 folds
Fried Berg raises 0.18€ to 0.27€
Jean3776 folds
MONEYFOREVER folds
Nombrillus folds
Fried Berg collected 0.49€ from pot
*** SUMMARY ***
Total pot 0.49€ | No rake
Seat 6: Fried Berg (button) won 0.49€


Winamax Poker - HOLD-UP "Colorado" - HandId: #19116069-438382-1701514487 - Holdem no limit (0.01€/0.02€) - 2023/12/02 10:54:47 UTC
Table: 'Colorado' 6-max (real money) Seat #6 is the button
Seat 1: J.C Deuces.0 (2.29€)
Seat 2: Fried Berg (1.56€)
Seat 3: josep2170 (3.95€)
Seat 4: Retail Row (5.68€)
Seat 5: Nombrillus (1.74€)
Seat 6: oliveponcar (2.83€)
Hold-up to Pot: total 0.10€
*** ANTE/BLINDS ***
J.C Deuces.0 posts small blind 0.01€
Fried Berg posts big blind 0.02€
Dealt to Fried Berg [6c Qc]
*** PRE-FLOP *** 
josep2170 folds
Retail Row folds
Nombrillus calls 0.02€
oliveponcar folds
J.C Deuces.0 calls 0.01€
Fried Berg raises 0.08€ to 0.10€
Nombrillus folds
J.C Deuces.0 calls 0.08€
*** FLOP *** [6s 2s 5s]
J.C Deuces.0 checks
Fried Berg checks
*** TURN *** [6s 2s 5s][9d]
J.C Deuces.0 bets 0.24€
Fried Berg calls 0.24€
*** RIVER *** [6s 2s 5s 9d][7h]
J.C Deuces.0 checks
Fried Berg checks
*** SHOW DOWN ***
Fried Berg shows [6c Qc] (One pair : 6)
J.C Deuces.0 shows [6h 7c] (Two pairs : 7 and 6)
J.C Deuces.0 collected 0.73€ from pot
*** SUMMARY ***
Total pot 0.73€ | Rake 0.07€
Board: [6s 2s 5s 9d 7h]
Seat 1: J.C Deuces.0 (small blind) showed [6h 7c] and won 0.73€ with Two pairs : 7 and 6
Seat 2: Fried Berg (big blind) showed [6c Qc] and lost with One pair : 6


Winamax Poker - HOLD-UP "Colorado" - HandId: #19116069-438468-1701514552 - Holdem no limit (0.01€/0.02€) - 2023/12/02 10:55:52 UTC
Table: 'Colorado' 6-max (real money) Seat #6 is the button
Seat 1: NyKOh11 (0.50€)
Seat 2: _FanZ_ (2.20€)
Seat 3: Fried Berg (1.22€)
Seat 4: Baston57 (1.30€)
Seat 5: KouKou Niet (0.29€)
Seat 6: J.C Deuces.0 (2.68€)
Hold-up to Pot: total 0.10€
*** ANTE/BLINDS ***
NyKOh11 posts small blind 0.01€
_FanZ_ posts big blind 0.02€
Dealt to Fried Berg [6s 2s]
*** PRE-FLOP *** 
Fried Berg folds
Baston57 raises 1.28€ to 1.30€ and is all-in
KouKou Niet calls 0.29€ and is all-in
J.C Deuces.0 folds
NyKOh11 folds
_FanZ_ folds
*** FLOP *** [Td 7s Ad]
*** TURN *** [Td 7s Ad][4s]
*** RIVER *** [Td 7s Ad 4s][3c]
*** SHOW DOWN ***
KouKou Niet shows [Qc Kd] (High card : Ace)
Baston57 shows [Qd Ah] (One pair : Aces)
Baston57 collected 1.66€ from pot
*** SUMMARY ***
Total pot 1.66€ | Rake 0.06€
Board: [Td 7s Ad 4s 3c]
Seat 4: Baston57 showed [Qd Ah] and won 1.66€ with One pair : Aces
Seat 5: KouKou Niet showed [Qc Kd] and lost with High card : Ace


Winamax Poker - HOLD-UP "Colorado" - HandId: #19116069-438474-1701514557 - Holdem no limit (0.01€/0.02€) - 2023/12/02 10:55:57 UTC
Table: 'Colorado' 6-max (real money) Seat #6 is the button
Seat 1: slowreplay (4.83€)
Seat 2: Morri7Jack (1.10€)
Seat 3: lamuerta8300 (4.25€)
Seat 4: Fried Berg (1.22€)
Seat 5: micth41 (1.80€)
Seat 6: Jean3776 (2.01€)
*** ANTE/BLINDS ***
slowreplay posts small blind 0.01€
Morri7Jack posts big blind 0.02€
Dealt to Fried Berg [Th Jh]
*** PRE-FLOP *** 
lamuerta8300 raises 0.04€ to 0.06€
Fried Berg calls 0.06€
micth41 folds
Jean3776 calls 0.06€
slowreplay folds
Morri7Jack calls 0.04€
*** FLOP *** [8s 6d 7d]
Morri7Jack checks
lamuerta8300 bets 0.18€
Fried Berg folds
Jean3776 calls 0.18€
Morri7Jack folds
*** TURN *** [8s 6d 7d][4d]
lamuerta8300 bets 0.20€
Jean3776 calls 0.20€
*** RIVER *** [8s 6d 7d 4d][5c]
lamuerta8300 checks
Jean3776 checks
*** SHOW DOWN ***
lamuerta8300 shows [Kh Kc] (Straight 8 high)
Jean3776 shows [8h 8c] (Straight 8 high)
Jean3776 collected 0.46€ from pot
lamuerta8300 collected 0.45€ from pot
*** SUMMARY ***
Total pot 0.91€ | Rake 0.10€
Board: [8s 6d 7d 4d 5c]
Seat 3: lamuerta8300 showed [Kh Kc] and won 0.45€ with Straight 8 high
Seat 6: Jean3776 (button) showed [8h 8c] and won 0.46€ with Straight 8 high


Winamax Poker - HOLD-UP "Colorado" - HandId: #19116069-438512-1701514584 - Holdem no limit (0.01€/0.02€) - 2023/12/02 10:56:24 UTC
Table: 'Colorado' 6-max (real money) Seat #6 is the button
Seat 1: Gin freecss (0.79€)
Seat 2: Manleroc (2€)
Seat 3: Fried Berg (1.16€)
Seat 4: MaryAthena (0.24€)
Seat 5: JFSredbaron (2€)
Seat 6: Perf-31 (2.28€)
*** ANTE/BLINDS ***
Gin freecss posts small blind 0.01€
Manleroc posts big blind 0.02€
Dealt to Fried Berg [8s 4c]
*** PRE-FLOP *** 
Fried Berg folds
MaryAthena folds
JFSredbaron folds
Perf-31 folds
Gin freecss folds
Manleroc collected 0.03€ from pot
*** SUMMARY ***
Total pot 0.03€ | No rake
Seat 2: Manleroc (big blind) won 0.03€


Winamax Poker - HOLD-UP "Colorado" - HandId: #19116069-438519-1701514587 - Holdem no limit (0.01€/0.02€) - 2023/12/02 10:56:27 UTC
Table: 'Colorado' 6-max (real money) Seat #6 is the button
Seat 1: Anis_King497 (0.61€)
Seat 2: TaBrEaMoI (2.31€)
Seat 3: rulo_137 (2€)
Seat 4: PIQSOU (6.66€)
Seat 5: Fried Berg (1.16€)
Seat 6: slowreplay (3.61€)
*** ANTE/BLINDS ***
Anis_King497 posts small blind 0.01€
TaBrEaMoI posts big blind 0.02€
Dealt to Fried Berg [Ah 5h]
*** PRE-FLOP *** 
rulo_137 folds
PIQSOU raises 0.03€ to 0.05€
Fried Berg calls 0.05€
slowreplay folds
Anis_King497 folds
TaBrEaMoI folds
*** FLOP *** [8h 9d 8c]
PIQSOU checks
Fried Berg checks
*** TURN *** [8h 9d 8c][2s]
PIQSOU checks
Fried Berg checks
*** RIVER *** [8h 9d 8c 2s][Ad]
PIQSOU checks
Fried Berg bets 0.02€
PIQSOU folds
Fried Berg collected 0.14€ from pot
*** SUMMARY ***
Total pot 0.14€ | Rake 0.01€
Board: [8h 9d 8c 2s Ad]
Seat 5: Fried Berg won 0.14€


Winamax Poker - HOLD-UP "Colorado" - HandId: #19116069-438567-1701514618 - Holdem no limit (0.01€/0.02€) - 2023/12/02 10:56:58 UTC
Table: 'Colorado' 6-max (real money) Seat #6 is the button
Seat 1: Singhalinga (1.64€)
Seat 2: Jean3776 (2.16€)
Seat 3: _FanZ_ (1.77€)
Seat 4: 121 (6.64€)
Seat 5: Fried Berg (1.23€)
Seat 6: Retail Row (5.47€)
*** ANTE/BLINDS ***
Singhalinga posts small blind 0.01€
Jean3776 posts big blind 0.02€
Dealt to Fried Berg [Ah Qc]
*** PRE-FLOP *** 
_FanZ_ folds
121 folds
Fried Berg raises 0.04€ to 0.06€
Retail Row folds
Singhalinga calls 0.05€
Jean3776 folds
*** FLOP *** [7h 7c 5s]
Singhalinga checks
Fried Berg bets 0.04€
Singhalinga folds
Fried Berg collected 0.17€ from pot
*** SUMMARY ***
Total pot 0.17€ | Rake 0.01€
Board: [7h 7c 5s]
Seat 5: Fried Berg won 0.17€


Winamax Poker - HOLD-UP "Colorado" - HandId: #19116069-438614-1701514648 - Holdem no limit (0.01€/0.02€) - 2023/12/02 10:57:28 UTC
Table: 'Colorado' 6-max (real money) Seat #6 is the button
Seat 1: tichettede3 (3.01€)
Seat 2: Fried Berg (1.30€)
Seat 3: mea botellas (2.44€)
Seat 4: zefzeph (2.07€)
Seat 5: Td08nomotto (3.01€)
Seat 6: El Paellas (0.52€)
*** ANTE/BLINDS ***
tichettede3 posts small blind 0.01€
Fried Berg posts big blind 0.02€
Dealt to Fried Berg [4d As]
*** PRE-FLOP *** 
mea botellas folds
zefzeph calls 0.02€
Td08nomotto folds
El Paellas calls 0.02€
tichettede3 calls 0.01€
Fried Berg checks
*** FLOP *** [9c Kd 6c]
tichettede3 checks
Fried Berg checks
zefzeph checks
El Paellas checks
*** TURN *** [9c Kd 6c][Ac]
tichettede3 checks
Fried Berg checks
zefzeph checks
El Paellas checks
*** RIVER *** [9c Kd 6c Ac][Jh]
tichettede3 checks
Fried Berg bets 0.06€
zefzeph calls 0.06€
El Paellas folds
tichettede3 folds
*** SHOW DOWN ***
zefzeph shows [Jd 5d] (One pair : Jacks)
Fried Berg shows [4d As] (One pair : Aces)
Fried Berg collected 0.18€ from pot
*** SUMMARY ***
Total pot 0.18€ | Rake 0.02€
Board: [9c Kd 6c Ac Jh]
Seat 2: Fried Berg (big blind) showed [4d As] and won 0.18€ with One pair : Aces
Seat 4: zefzeph showed [Jd 5d] and lost with One pair : Jacks


Winamax Poker - HOLD-UP "Colorado" - HandId: #19116069-438718-1701514715 - Holdem no limit (0.01€/0.02€) - 2023/12/02 10:58:35 UTC
Table: 'Colorado' 6-max (real money) Seat #6 is the button
Seat 1: slowreplay (3.58€)
Seat 2: Fried Berg (1.40€)
Seat 3: MCGHansen (2€)
Seat 4: Retail Row (5.75€)
Seat 5: zefzeph (1.99€)
Seat 6: Jean3776 (2.16€)
*** ANTE/BLINDS ***
slowreplay posts small blind 0.01€
Fried Berg posts big blind 0.02€
Dealt to Fried Berg [8h 3h]
*** PRE-FLOP *** 
MCGHansen folds
Retail Row raises 0.04€ to 0.06€
zefzeph raises 0.12€ to 0.18€
Jean3776 folds
slowreplay folds
Fried Berg folds
Retail Row calls 0.12€
*** FLOP *** [3s 5h 6h]
Retail Row checks
zefzeph bets 0.02€
Retail Row calls 0.02€
*** TURN *** [3s 5h 6h][4s]
Retail Row checks
zefzeph bets 0.02€
Retail Row calls 0.02€
*** RIVER *** [3s 5h 6h 4s][Kh]
Retail Row checks
zefzeph checks
*** SHOW DOWN ***
zefzeph shows [Ts Ac] (High card : Ace)
Retail Row shows [4d Ad] (One pair : 4)
Retail Row collected 0.42€ from pot
*** SUMMARY ***
Total pot 0.42€ | Rake 0.05€
Board: [3s 5h 6h 4s Kh]
Seat 4: Retail Row showed [4d Ad] and won 0.42€ with One pair : 4
Seat 5: zefzeph showed [Ts Ac] and lost with High card : Ace


Winamax Poker - HOLD-UP "Colorado" - HandId: #19116069-438734-1701514724 - Holdem no limit (0.01€/0.02€) - 2023/12/02 10:58:44 UTC
Table: 'Colorado' 6-max (real money) Seat #6 is the button
Seat 1: Fried Berg (1.38€)
Seat 2: TaBrEaMoI (3.91€)
Seat 3: rulo_137 (2.08€)
Seat 4: MCGHansen (2.02€)
Seat 5: durba (1.50€)
Seat 6: popoche29 (1.66€)
*** ANTE/BLINDS ***
Fried Berg posts small blind 0.01€
TaBrEaMoI posts big blind 0.02€
Dealt to Fried Berg [8c 6c]
*** PRE-FLOP *** 
rulo_137 raises 0.04€ to 0.06€
MCGHansen folds
durba folds
popoche29 folds
Fried Berg folds
TaBrEaMoI folds
rulo_137 collected 0.09€ from pot
*** SUMMARY ***
Total pot 0.09€ | No rake
Seat 3: rulo_137 won 0.09€


Winamax Poker - HOLD-UP "Colorado" - HandId: #19116069-438759-1701514740 - Holdem no limit (0.01€/0.02€) - 2023/12/02 10:59:00 UTC
Table: 'Colorado' 6-max (real money) Seat #6 is the button
Seat 1: Abec16 (1.08€)
Seat 2: JFSredbaron (2.03€)
Seat 3: tichettede3 (3.12€)
Seat 4: Mametzien (4€)
Seat 5: josep2170 (2€)
Seat 6: Fried Berg (1.37€)
*** ANTE/BLINDS ***
Abec16 posts small blind 0.01€
JFSredbaron posts big blind 0.02€
Dealt to Fried Berg [Ad Qc]
*** PRE-FLOP *** 
tichettede3 folds
Mametzien folds
josep2170 folds
Fried Berg raises 0.02€ to 0.04€
Abec16 folds
JFSredbaron folds
Fried Berg collected 0.07€ from pot
*** SUMMARY ***
Total pot 0.07€ | No rake
Seat 6: Fried Berg (button) won 0.07€


Winamax Poker - HOLD-UP "Colorado" - HandId: #19116069-438778-1701514751 - Holdem no limit (0.01€/0.02€) - 2023/12/02 10:59:11 UTC
Table: 'Colorado' 6-max (real money) Seat #6 is the button
Seat 1: Jean3776 (2.72€)
Seat 2: mea botellas (3.99€)
Seat 3: Fried Berg (1.40€)
Seat 4: magnumbenji (5.13€)
Seat 5: AaronGil93 (1.84€)
Seat 6: durba (1.41€)
*** ANTE/BLINDS ***
Jean3776 posts small blind 0.01€
mea botellas posts big blind 0.02€
Dealt to Fried Berg [4c 5c]
*** PRE-FLOP *** 
Fried Berg folds
magnumbenji raises 0.02€ to 0.04€
AaronGil93 calls 0.04€
durba folds
Jean3776 folds
mea botellas folds
*** FLOP *** [5s 4d Kd]
magnumbenji checks
AaronGil93 checks
*** TURN *** [5s 4d Kd][Jd]
magnumbenji bets 0.02€
AaronGil93 folds
magnumbenji collected 0.12€ from pot
*** SUMMARY ***
Total pot 0.12€ | Rake 0.01€
Board: [5s 4d Kd Jd]
Seat 4: magnumbenji won 0.12€


Winamax Poker - HOLD-UP "Colorado" - HandId: #19116069-438788-1701514759 - Holdem no limit (0.01€/0.02€) - 2023/12/02 10:59:19 UTC
Table: 'Colorado' 6-max (real money) Seat #6 is the button
Seat 1: lamuerta8300 (4.57€)
Seat 2: ischia (0.50€)
Seat 3: blie2006 (0.60€)
Seat 4: Fried Berg (1.40€)
Seat 5: _FanZ_ (2.11€)
Seat 6: Holiap (2€)
*** ANTE/BLINDS ***
lamuerta8300 posts small blind 0.01€
ischia posts big blind 0.02€
Dealt to Fried Berg [7s 2s]
*** PRE-FLOP *** 
blie2006 folds
Fried Berg folds
_FanZ_ folds
Holiap raises 0.05€ to 0.07€
lamuerta8300 folds
ischia calls 0.05€
*** FLOP *** [Tc 8s Qh]
ischia bets 0.02€
Holiap raises 0.05€ to 0.07€
ischia calls 0.05€
*** TURN *** [Tc 8s Qh][3c]
ischia bets 0.02€
Holiap raises 0.10€ to 0.12€
ischia folds
Holiap collected 0.40€ from pot
*** SUMMARY ***
Total pot 0.40€ | Rake 0.03€
Board: [Tc 8s Qh 3c]
Seat 6: Holiap (button) won 0.40€


Winamax Poker - HOLD-UP "Colorado" - HandId: #19116069-438797-1701514766 - Holdem no limit (0.01€/0.02€) - 2023/12/02 10:59:26 UTC
Table: 'Colorado' 6-max (real money) Seat #6 is the button
Seat 1: Coq82 (4.63€)
Seat 2: Jean3776 (2.22€)
Seat 3: Td08nomotto (2.87€)
Seat 4: _ilTulipano_ (5.80€)
Seat 5: PIQSOU (2.02€)
Seat 6: Fried Berg (1.40€)
*** ANTE/BLINDS ***
Coq82 posts small blind 0.01€
Jean3776 posts big blind 0.02€
Dealt to Fried Berg [9h Td]
*** PRE-FLOP *** 
Td08nomotto folds
_ilTulipano_ raises 0.04€ to 0.06€
PIQSOU folds
Fried Berg folds
Coq82 folds
Jean3776 calls 0.04€
*** FLOP *** [3c 2c 2d]
Jean3776 checks
_ilTulipano_ bets 0.07€
Jean3776 folds
_ilTulipano_ collected 0.19€ from pot
*** SUMMARY ***
Total pot 0.19€ | Rake 0.01€
Board: [3c 2c 2d]
Seat 4: _ilTulipano_ won 0.19€


Winamax Poker - HOLD-UP "Colorado" - HandId: #19116069-438813-1701514776 - Holdem no limit (0.01€/0.02€) - 2023/12/02 10:59:36 UTC
Table: 'Colorado' 6-max (real money) Seat #6 is the button
Seat 1: Betiegarri (2.05€)
Seat 2: 357magnum (3.70€)
Seat 3: TaBrEaMoI (4.80€)
Seat 4: franckyrud (3.73€)
Seat 5: Fried Berg (1.40€)
Seat 6: josep2170 (4.11€)
*** ANTE/BLINDS ***
Betiegarri posts small blind 0.01€
357magnum posts big blind 0.02€
Dealt to Fried Berg [5c 7s]
*** PRE-FLOP *** 
TaBrEaMoI folds
franckyrud raises 0.03€ to 0.05€
Fried Berg folds
josep2170 folds
Betiegarri raises 0.12€ to 0.17€
357magnum folds
franckyrud folds
Betiegarri collected 0.24€ from pot
*** SUMMARY ***
Total pot 0.24€ | No rake
Seat 1: Betiegarri (small blind) won 0.24€


Winamax Poker - HOLD-UP "Colorado" - HandId: #19116069-438842-1701514794 - Holdem no limit (0.01€/0.02€) - 2023/12/02 10:59:54 UTC
Table: 'Colorado' 6-max (real money) Seat #6 is the button
Seat 1: Mametzien (3.99€)
Seat 2: mea botellas (3€)
Seat 3: TaBrEaMoI (3.88€)
Seat 4: 121 (8.87€)
Seat 5: Perf-31 (2.75€)
Seat 6: Fried Berg (1.40€)
*** ANTE/BLINDS ***
Mametzien posts small blind 0.01€
mea botellas posts big blind 0.02€
Dealt to Fried Berg [8h Qc]
*** PRE-FLOP *** 
TaBrEaMoI folds
121 folds
Perf-31 folds
Fried Berg folds
Mametzien folds
mea botellas collected 0.03€ from pot
*** SUMMARY ***
Total pot 0.03€ | No rake
Seat 2: mea botellas (big blind) won 0.03€


Winamax Poker - HOLD-UP "Colorado" - HandId: #19116069-438865-1701514805 - Holdem no limit (0.01€/0.02€) - 2023/12/02 11:00:05 UTC
Table: 'Colorado' 6-max (real money) Seat #6 is the button
Seat 1: J.C Deuces.0 (2.15€)
Seat 2: NyKOh11 (0.61€)
Seat 3: Abec16 (1.42€)
Seat 4: Chacal-Punk (4.98€)
Seat 5: g8o8k8u (0.50€)
Seat 6: Fried Berg (1.40€)
*** ANTE/BLINDS ***
J.C Deuces.0 posts small blind 0.01€
NyKOh11 posts big blind 0.02€
Dealt to Fried Berg [Qc 4h]
*** PRE-FLOP *** 
Abec16 folds
Chacal-Punk folds
g8o8k8u folds
Fried Berg folds
J.C Deuces.0 calls 0.01€
NyKOh11 checks
*** FLOP *** [3d 9d Kh]
J.C Deuces.0 bets 0.02€
NyKOh11 folds
J.C Deuces.0 collected 0.06€ from pot
*** SUMMARY ***
Total pot 0.06€ | No rake
Board: [3d 9d Kh]
Seat 1: J.C Deuces.0 (small blind) won 0.06€


Winamax Poker - HOLD-UP "Colorado" - HandId: #19116069-438871-1701514810 - Holdem no limit (0.01€/0.02€) - 2023/12/02 11:00:10 UTC
Table: 'Colorado' 6-max (real money) Seat #6 is the button
Seat 1: Fried Berg (1.40€)
Seat 2: Abec16 (1.42€)
Seat 3: ours_34 (2€)
Seat 4: Chacal-Punk (4.98€)
Seat 5: ischia (0.35€)
Seat 6: 2winchester (2.28€)
*** ANTE/BLINDS ***
Fried Berg posts small blind 0.01€
Abec16 posts big blind 0.02€
Dealt to Fried Berg [5h 6d]
*** PRE-FLOP *** 
ours_34 folds
Chacal-Punk folds
ischia folds
2winchester folds
Fried Berg folds
Abec16 collected 0.03€ from pot
*** SUMMARY ***
Total pot 0.03€ | No rake
Seat 2: Abec16 (big blind) won 0.03€


Winamax Poker - HOLD-UP "Colorado" - HandId: #19116069-438883-1701514818 - Holdem no limit (0.01€/0.02€) - 2023/12/02 11:00:18 UTC
Table: 'Colorado' 6-max (real money) Seat #6 is the button
Seat 1: josep2170 (4.09€)
Seat 2: Fried Berg (1.39€)
Seat 3: Nombrillus (2€)
Seat 4: slowreplay (2.60€)
Seat 5: Morri7Jack (1.18€)
Seat 6: ours_34 (2€)
*** ANTE/BLINDS ***
josep2170 posts small blind 0.01€
Fried Berg posts big blind 0.02€
Dealt to Fried Berg [5d Jc]
*** PRE-FLOP *** 
Nombrillus folds
slowreplay folds
Morri7Jack folds
ours_34 raises 0.04€ to 0.06€
josep2170 folds
Fried Berg folds
ours_34 collected 0.09€ from pot
*** SUMMARY ***
Total pot 0.09€ | No rake
Seat 6: ours_34 (button) won 0.09€


Winamax Poker - HOLD-UP "Colorado" - HandId: #19116069-438892-1701514824 - Holdem no limit (0.01€/0.02€) - 2023/12/02 11:00:24 UTC
Table: 'Colorado' 6-max (real money) Seat #6 is the button
Seat 1: Fried Berg (1.37€)
Seat 2: Fushitif (2.86€)
Seat 3: JFSredbaron (2.44€)
Seat 4: AlexGreaturn (2€)
Seat 5: Abec16 (1.43€)
Seat 6: TaBrEaMoI (4.86€)
*** ANTE/BLINDS ***
Fried Berg posts small blind 0.01€
Fushitif posts big blind 0.02€
Dealt to Fried Berg [2h 7s]
*** PRE-FLOP *** 
JFSredbaron raises 0.04€ to 0.06€
AlexGreaturn folds
Abec16 folds
TaBrEaMoI folds
Fried Berg folds
Fushitif calls 0.04€
*** FLOP *** [Jc Ks 7h]
Fushitif checks
JFSredbaron checks
*** TURN *** [Jc Ks 7h][2d]
Fushitif checks
JFSredbaron checks
*** RIVER *** [Jc Ks 7h 2d][5s]
Fushitif checks
JFSredbaron checks
*** SHOW DOWN ***
JFSredbaron shows [4h 4c] (One pair : 4)
Fushitif shows [Jh Qc] (One pair : Jacks)
Fushitif collected 0.12€ from pot
*** SUMMARY ***
Total pot 0.12€ | Rake 0.01€
Board: [Jc Ks 7h 2d 5s]
Seat 2: Fushitif (big blind) showed [Jh Qc] and won 0.12€ with One pair : Jacks
Seat 3: JFSredbaron showed [4h 4c] and lost with One pair : 4


Winamax Poker - HOLD-UP "Colorado" - HandId: #19116069-438907-1701514833 - Holdem no limit (0.01€/0.02€) - 2023/12/02 11:00:33 UTC
Table: 'Colorado' 6-max (real money) Seat #6 is the button
Seat 1: Abec16 (1.43€)
Seat 2: Thequeen1205 (4.42€)
Seat 3: sAArtouKK (2.22€)
Seat 4: lamuerta8300 (1.99€)
Seat 5: Fried Berg (1.36€)
Seat 6: 121 (8.84€)
*** ANTE/BLINDS ***
Abec16 posts small blind 0.01€
Thequeen1205 posts big blind 0.02€
Dealt to Fried Berg [Jd 9c]
*** PRE-FLOP *** 
sAArtouKK folds
lamuerta8300 folds
Fried Berg folds
121 folds
Abec16 raises 0.03€ to 0.05€
Thequeen1205 calls 0.03€
*** FLOP *** [3c 3h Ks]
Abec16 checks
Thequeen1205 bets 0.03€
Abec16 folds
Thequeen1205 collected 0.12€ from pot
*** SUMMARY ***
Total pot 0.12€ | Rake 0.01€
Board: [3c 3h Ks]
Seat 2: Thequeen1205 (big blind) won 0.12€


Winamax Poker - HOLD-UP "Colorado" - HandId: #19116069-438910-1701514835 - Holdem no limit (0.01€/0.02€) - 2023/12/02 11:00:35 UTC
Table: 'Colorado' 6-max (real money) Seat #6 is the button
Seat 1: oliveponcar (2.33€)
Seat 2: Fried Berg (1.36€)
Seat 3: papainge (2.48€)
Seat 4: Coq82 (8.36€)
Seat 5: go_fl0p (1.97€)
Seat 6: ITALIA291 (2€)
*** ANTE/BLINDS ***
oliveponcar posts small blind 0.01€
Fried Berg posts big blind 0.02€
Dealt to Fried Berg [6h 9d]
*** PRE-FLOP *** 
papainge folds
Coq82 folds
go_fl0p raises 0.02€ to 0.04€
ITALIA291 calls 0.04€
oliveponcar folds
Fried Berg folds
*** FLOP *** [5s Qs 7c]
go_fl0p bets 0.03€
ITALIA291 folds
go_fl0p collected 0.13€ from pot
*** SUMMARY ***
Total pot 0.13€ | Rake 0.01€
Board: [5s Qs 7c]
Seat 5: go_fl0p won 0.13€


Winamax Poker - HOLD-UP "Colorado" - HandId: #19116069-438920-1701514843 - Holdem no limit (0.01€/0.02€) - 2023/12/02 11:00:43 UTC
Table: 'Colorado' 6-max (real money) Seat #6 is the button
Seat 1: Fried Berg (1.34€)
Seat 2: papainge (2€)
Seat 3: Anis_King497 (0.47€)
Seat 4: MCGHansen (2€)
Seat 5: Zile741 (2.36€)
Seat 6: A.soto5 (0.46€)
*** ANTE/BLINDS ***
Fried Berg posts small blind 0.01€
papainge posts big blind 0.02€
Dealt to Fried Berg [9s 5d]
*** PRE-FLOP *** 
Anis_King497 calls 0.02€
MCGHansen folds
Zile741 folds
A.soto5 calls 0.02€
Fried Berg folds
papainge checks
*** FLOP *** [6s 4s Kc]
papainge checks
Anis_King497 checks
A.soto5 checks
*** TURN *** [6s 4s Kc][7s]
papainge bets 0.02€
Anis_King497 folds
A.soto5 calls 0.02€
*** RIVER *** [6s 4s Kc 7s][2c]
papainge checks
A.soto5 checks
*** SHOW DOWN ***
papainge shows [6d 9c] (One pair : 6)
A.soto5 shows [2s 2h] (Trips of 2)
A.soto5 collected 0.10€ from pot
*** SUMMARY ***
Total pot 0.10€ | Rake 0.01€
Board: [6s 4s Kc 7s 2c]
Seat 2: papainge (big blind) showed [6d 9c] and lost with One pair : 6
Seat 6: A.soto5 (button) showed [2s 2h] and won 0.10€ with Trips of 2


Winamax Poker - HOLD-UP "Colorado" - HandId: #19116069-438922-1701514844 - Holdem no limit (0.01€/0.02€) - 2023/12/02 11:00:44 UTC
Table: 'Colorado' 6-max (real money) Seat #6 is the button
Seat 1: Captain_JL (0.46€)
Seat 2: AaronGil93 (1.88€)
Seat 3: lamuerta8300 (4.62€)
Seat 4: El Paellas (0.51€)
Seat 5: Fried Berg (1.33€)
Seat 6: micth41 (2.36€)
Hold-up to Pot: total 0.10€
*** ANTE/BLINDS ***
Captain_JL posts small blind 0.01€
AaronGil93 posts big blind 0.02€
Dealt to Fried Berg [Ac 9s]
*** PRE-FLOP *** 
lamuerta8300 folds
El Paellas folds
Fried Berg raises 0.02€ to 0.04€
micth41 calls 0.04€
Captain_JL calls 0.03€
AaronGil93 calls 0.02€
*** FLOP *** [9c 8d 2s]
Captain_JL checks
AaronGil93 checks
Fried Berg bets 0.08€
micth41 folds
Captain_JL folds
AaronGil93 calls 0.08€
*** TURN *** [9c 8d 2s][9d]
AaronGil93 checks
Fried Berg bets 0.16€
AaronGil93 calls 0.16€
*** RIVER *** [9c 8d 2s 9d][7s]
AaronGil93 checks
Fried Berg checks
*** SHOW DOWN ***
AaronGil93 shows [Js Kc] (One pair : 9)
Fried Berg shows [Ac 9s] (Trips of 9)
Fried Berg collected 0.68€ from pot
*** SUMMARY ***
Total pot 0.68€ | Rake 0.06€
Board: [9c 8d 2s 9d 7s]
Seat 2: AaronGil93 (big blind) showed [Js Kc] and lost with One pair : 9
Seat 5: Fried Berg showed [Ac 9s] and won 0.68€ with Trips of 9


Winamax Poker - HOLD-UP "Colorado" - HandId: #19116069-439006-1701514905 - Holdem no limit (0.01€/0.02€) - 2023/12/02 11:01:45 UTC
Table: 'Colorado' 6-max (real money) Seat #6 is the button
Seat 1: AaronGil93 (1.60€)
Seat 2: MCGHansen (2.31€)
Seat 3: Captain_JL (0.42€)
Seat 4: Fried Berg (1.73€)
Seat 5: tichettede3 (3.08€)
Seat 6: Merlus83 (2.59€)
*** ANTE/BLINDS ***
AaronGil93 posts small blind 0.01€
MCGHansen posts big blind 0.02€
Dealt to Fried Berg [Ad 2s]
*** PRE-FLOP *** 
Captain_JL calls 0.02€
Fried Berg folds
tichettede3 folds
Merlus83 folds
AaronGil93 calls 0.01€
MCGHansen checks
*** FLOP *** [3d 7s 9s]
AaronGil93 checks
MCGHansen bets 0.03€
Captain_JL folds
AaronGil93 calls 0.03€
*** TURN *** [3d 7s 9s][4s]
AaronGil93 checks
MCGHansen checks
*** RIVER *** [3d 7s 9s 4s][Kc]
AaronGil93 bets 0.08€
MCGHansen folds
AaronGil93 collected 0.19€ from pot
*** SUMMARY ***
Total pot 0.19€ | Rake 0.01€
Board: [3d 7s 9s 4s Kc]
Seat 1: AaronGil93 (small blind) won 0.19€


Winamax Poker - HOLD-UP "Colorado" - HandId: #19116069-439026-1701514917 - Holdem no limit (0.01€/0.02€) - 2023/12/02 11:01:57 UTC
Table: 'Colorado' 6-max (real money) Seat #6 is the button
Seat 1: edfcain (2.01€)
Seat 2: El Paellas (0.55€)
Seat 3: Fried Berg (1.73€)
Seat 4: TaBrEaMoI (2.22€)
Seat 5: MP_Shelby17 (1.48€)
Seat 6: Jean3776 (2.09€)
*** ANTE/BLINDS ***
edfcain posts small blind 0.01€
El Paellas posts big blind 0.02€
Dealt to Fried Berg [4d Tc]
*** PRE-FLOP *** 
Fried Berg folds
TaBrEaMoI folds
MP_Shelby17 folds
Jean3776 raises 0.03€ to 0.05€
edfcain folds
El Paellas folds
Jean3776 collected 0.08€ from pot
*** SUMMARY ***
Total pot 0.08€ | No rake
Seat 6: Jean3776 (button) won 0.08€


Winamax Poker - HOLD-UP "Colorado" - HandId: #19116069-439032-1701514920 - Holdem no limit (0.01€/0.02€) - 2023/12/02 11:02:00 UTC
Table: 'Colorado' 6-max (real money) Seat #6 is the button
Seat 1: JFSredbaron (2.27€)
Seat 2: Trevize (1.73€)
Seat 3: Fried Berg (1.73€)
Seat 4: ours_34 (1.11€)
Seat 5: AAM_ON_XTC (2.27€)
Seat 6: Mametzien (3.89€)
*** ANTE/BLINDS ***
JFSredbaron posts small blind 0.01€
Trevize posts big blind 0.02€
Dealt to Fried Berg [As 3c]
*** PRE-FLOP *** 
Fried Berg folds
ours_34 folds
AAM_ON_XTC folds
Mametzien folds
JFSredbaron folds
Trevize collected 0.03€ from pot
*** SUMMARY ***
Total pot 0.03€ | No rake
Seat 2: Trevize (big blind) won 0.03€


Winamax Poker - HOLD-UP "Colorado" - HandId: #19116069-439036-1701514922 - Holdem no limit (0.01€/0.02€) - 2023/12/02 11:02:02 UTC
Table: 'Colorado' 6-max (real money) Seat #6 is the button
Seat 1: J.C Deuces.0 (1.64€)
Seat 2: B&CLYDE (0.50€)
Seat 3: BrokeForever (1.72€)
Seat 4: sAArtouKK (2.26€)
Seat 5: Fried Berg (1.73€)
Seat 6: ours_34 (1.11€)
*** ANTE/BLINDS ***
J.C Deuces.0 posts small blind 0.01€
B&CLYDE posts big blind 0.02€
Dealt to Fried Berg [Ad 4s]
*** PRE-FLOP *** 
BrokeForever folds
sAArtouKK raises 0.03€ to 0.05€
Fried Berg folds
ours_34 folds
J.C Deuces.0 raises 0.15€ to 0.20€
B&CLYDE folds
sAArtouKK folds
J.C Deuces.0 collected 0.27€ from pot
*** SUMMARY ***
Total pot 0.27€ | No rake
Seat 1: J.C Deuces.0 (small blind) won 0.27€


Winamax Poker - HOLD-UP "Colorado" - HandId: #19116069-439048-1701514930 - Holdem no limit (0.01€/0.02€) - 2023/12/02 11:02:10 UTC
Table: 'Colorado' 6-max (real money) Seat #6 is the button
Seat 1: AAM_ON_XTC (2.25€)
Seat 2: Fried Berg (1.73€)
Seat 3: olivess67 (0.96€)
Seat 4: micth41 (2.36€)
Seat 5: PIQSOU (2.01€)
Seat 6: BrokeForever (1.72€)
*** ANTE/BLINDS ***
AAM_ON_XTC posts small blind 0.01€
Fried Berg posts big blind 0.02€
Dealt to Fried Berg [7s 6d]
*** PRE-FLOP *** 
olivess67 calls 0.02€
micth41 folds
PIQSOU folds
BrokeForever folds
AAM_ON_XTC calls 0.01€
Fried Berg checks
*** FLOP *** [5c 3d 8s]
AAM_ON_XTC checks
Fried Berg checks
olivess67 checks
*** TURN *** [5c 3d 8s][4s]
AAM_ON_XTC bets 0.03€
Fried Berg calls 0.03€
olivess67 calls 0.03€
*** RIVER *** [5c 3d 8s 4s][7h]
AAM_ON_XTC checks
Fried Berg bets 0.06€
olivess67 calls 0.06€
AAM_ON_XTC folds
*** SHOW DOWN ***
olivess67 shows [Qh Ts] (High card : Queen)
Fried Berg shows [7s 6d] (Straight 8 high)
Fried Berg collected 0.24€ from pot
*** SUMMARY ***
Total pot 0.24€ | Rake 0.03€
Board: [5c 3d 8s 4s 7h]
Seat 2: Fried Berg (big blind) showed [7s 6d] and won 0.24€ with Straight 8 high
Seat 3: olivess67 showed [Qh Ts] and lost with High card : Queen


Winamax Poker - HOLD-UP "Colorado" - HandId: #19116069-439134-1701514990 - Holdem no limit (0.01€/0.02€) - 2023/12/02 11:03:10 UTC
Table: 'Colorado' 6-max (real money) Seat #6 is the button
Seat 1: sniper girl (7.03€)
Seat 2: TaBrEaMoI (3.10€)
Seat 3: Pas1erreur (2.86€)
Seat 4: magnumbenji (4.99€)
Seat 5: El Paellas (0.50€)
Seat 6: Fried Berg (1.86€)
*** ANTE/BLINDS ***
sniper girl posts small blind 0.01€
TaBrEaMoI posts big blind 0.02€
Dealt to Fried Berg [8c 5s]
*** PRE-FLOP *** 
Pas1erreur folds
magnumbenji folds
El Paellas folds
Fried Berg folds
sniper girl raises 0.02€ to 0.04€
TaBrEaMoI calls 0.02€
*** FLOP *** [7d 8d 3c]
sniper girl bets 0.05€
TaBrEaMoI raises 0.07€ to 0.12€
sniper girl calls 0.07€
*** TURN *** [7d 8d 3c][Kh]
sniper girl bets 0.11€
TaBrEaMoI calls 0.11€
*** RIVER *** [7d 8d 3c Kh][Th]
sniper girl bets 0.19€
TaBrEaMoI raises 0.53€ to 0.72€
sniper girl folds
TaBrEaMoI collected 1.36€ from pot
*** SUMMARY ***
Total pot 1.36€ | Rake 0.09€
Board: [7d 8d 3c Kh Th]
Seat 2: TaBrEaMoI (big blind) won 1.36€


Winamax Poker - HOLD-UP "Colorado" - HandId: #19116069-439149-1701515003 - Holdem no limit (0.01€/0.02€) - 2023/12/02 11:03:23 UTC
Table: 'Colorado' 6-max (real money) Seat #6 is the button
Seat 1: Fried Berg (1.86€)
Seat 2: tichettede3 (3.18€)
Seat 3: Zile741 (3.49€)
Seat 4: Manleroc (1.51€)
Seat 5: olivess67 (0.85€)
Seat 6: KingSoto (1.77€)
*** ANTE/BLINDS ***
Fried Berg posts small blind 0.01€
tichettede3 posts big blind 0.02€
Dealt to Fried Berg [8s 5c]
*** PRE-FLOP *** 
Zile741 folds
Manleroc calls 0.02€
olivess67 calls 0.02€
KingSoto raises 0.04€ to 0.06€
Fried Berg folds
tichettede3 folds
Manleroc calls 0.04€
olivess67 calls 0.04€
*** FLOP *** [Kd 3s 8d]
Manleroc bets 0.02€
olivess67 calls 0.02€
KingSoto calls 0.02€
*** TURN *** [Kd 3s 8d][Ts]
Manleroc checks
olivess67 checks
KingSoto bets 0.18€
Manleroc calls 0.18€
olivess67 folds
*** RIVER *** [Kd 3s 8d Ts][7c]
Manleroc checks
KingSoto checks
*** SHOW DOWN ***
Manleroc shows [Td 4d] (One pair : Tens)
KingSoto shows [9h Kh] (One pair : Kings)
KingSoto collected 0.57€ from pot
*** SUMMARY ***
Total pot 0.57€ | Rake 0.06€
Board: [Kd 3s 8d Ts 7c]
Seat 4: Manleroc showed [Td 4d] and lost with One pair : Tens
Seat 6: KingSoto (button) showed [9h Kh] and won 0.57€ with One pair : Kings


Winamax Poker - HOLD-UP "Colorado" - HandId: #19116069-439184-1701515028 - Holdem no limit (0.01€/0.02€) - 2023/12/02 11:03:48 UTC
Table: 'Colorado' 6-max (real money) Seat #6 is the button
Seat 1: Jean3776 (2.21€)
Seat 2: Kallonys (2€)
Seat 3: go_fl0p (3.41€)
Seat 4: Fried Berg (1.85€)
Seat 5: Pas1erreur (2.44€)
Seat 6: Gin freecss (0.35€)
Hold-up to Pot: total 0.20€
*** ANTE/BLINDS ***
Jean3776 posts small blind 0.01€
Kallonys posts big blind 0.02€
Dealt to Fried Berg [2c 3d]
*** PRE-FLOP *** 
go_fl0p folds
Fried Berg folds
Pas1erreur raises 0.03€ to 0.05€
Gin freecss raises 0.30€ to 0.35€ and is all-in
Jean3776 folds
Kallonys folds
Pas1erreur folds
Gin freecss collected 0.63€ from pot
*** SUMMARY ***
Total pot 0.63€ | No rake
Seat 6: Gin freecss (button) won 0.63€


Winamax Poker - HOLD-UP "Colorado" - HandId: #19116069-439189-1701515032 - Holdem no limit (0.01€/0.02€) - 2023/12/02 11:03:52 UTC
Table: 'Colorado' 6-max (real money) Seat #6 is the button
Seat 1: Ipiz (3.97€)
Seat 2: Kipyomag (2.03€)
Seat 3: B&CLYDE (0.41€)
Seat 4: tichettede3 (3.16€)
Seat 5: PIQSOU (6.78€)
Seat 6: Fried Berg (1.85€)
*** ANTE/BLINDS ***
Ipiz posts small blind 0.01€
Kipyomag posts big blind 0.02€
Dealt to Fried Berg [Jd 8d]
*** PRE-FLOP *** 
B&CLYDE folds
tichettede3 folds
PIQSOU folds
Fried Berg raises 0.02€ to 0.04€
Ipiz folds
Kipyomag calls 0.02€
*** FLOP *** [Qh 2h Qs]
Kipyomag checks
Fried Berg checks
*** TURN *** [Qh 2h Qs][Qc]
Kipyomag checks
Fried Berg checks
*** RIVER *** [Qh 2h Qs Qc][Js]
Kipyomag bets 0.03€
Fried Berg raises 0.03€ to 0.06€
Kipyomag calls 0.03€
*** SHOW DOWN ***
Kipyomag shows [6c 6h] (Full of Queens and 6)
Fried Berg shows [Jd 8d] (Full of Queens and Jacks)
Fried Berg collected 0.19€ from pot
*** SUMMARY ***
Total pot 0.19€ | Rake 0.02€
Board: [Qh 2h Qs Qc Js]
Seat 2: Kipyomag (big blind) showed [6c 6h] and lost with Full of Queens and 6
Seat 6: Fried Berg (button) showed [Jd 8d] and won 0.19€ with Full of Queens and Jacks


Winamax Poker - HOLD-UP "Colorado" - HandId: #19116069-439263-1701515088 - Holdem no limit (0.01€/0.02€) - 2023/12/02 11:04:48 UTC
Table: 'Colorado' 6-max (real money) Seat #6 is the button
Seat 1: JFSredbaron (2.99€)
Seat 2: PIQSOU (4.70€)
Seat 3: rulo_137 (2€)
Seat 4: papainge (2.08€)
Seat 5: Fried Berg (1.94€)
Seat 6: Coq82 (8.62€)
*** ANTE/BLINDS ***
JFSredbaron posts small blind 0.01€
PIQSOU posts big blind 0.02€
Dealt to Fried Berg [8c Tc]
*** PRE-FLOP *** 
rulo_137 folds
papainge folds
Fried Berg raises 0.02€ to 0.04€
Coq82 folds
JFSredbaron calls 0.03€
PIQSOU folds
*** FLOP *** [Qd 9s 3s]
JFSredbaron checks
Fried Berg checks
*** TURN *** [Qd 9s 3s][Qs]
JFSredbaron checks
Fried Berg checks
*** RIVER *** [Qd 9s 3s Qs][Ah]
JFSredbaron bets 0.03€
Fried Berg folds
JFSredbaron collected 0.12€ from pot
*** SUMMARY ***
Total pot 0.12€ | Rake 0.01€
Board: [Qd 9s 3s Qs Ah]
Seat 1: JFSredbaron (small blind) won 0.12€


Winamax Poker - HOLD-UP "Colorado" - HandId: #19116069-439317-1701515126 - Holdem no limit (0.01€/0.02€) - 2023/12/02 11:05:26 UTC
Table: 'Colorado' 6-max (real money) Seat #6 is the button
Seat 1: J.C Deuces.0 (1.74€)
Seat 2: WonderPoul (2€)
Seat 3: Pas1erreur (2.74€)
Seat 4: Fried Berg (1.90€)
Seat 5: TaBrEaMoI (5.19€)
Seat 6: zefzeph (2.18€)
*** ANTE/BLINDS ***
J.C Deuces.0 posts small blind 0.01€
WonderPoul posts big blind 0.02€
Dealt to Fried Berg [Jc Kd]
*** PRE-FLOP *** 
Pas1erreur raises 0.03€ to 0.05€
Fried Berg calls 0.05€
TaBrEaMoI folds
zefzeph raises 0.18€ to 0.23€
J.C Deuces.0 folds
WonderPoul folds
Pas1erreur calls 0.18€
Fried Berg folds
*** FLOP *** [8c 6h 3h]
Pas1erreur checks
zefzeph bets 0.19€
Pas1erreur folds
zefzeph collected 0.68€ from pot
*** SUMMARY ***
Total pot 0.68€ | Rake 0.05€
Board: [8c 6h 3h]
Seat 6: zefzeph (button) won 0.68€


Winamax Poker - HOLD-UP "Colorado" - HandId: #19116069-439377-1701515164 - Holdem no limit (0.01€/0.02€) - 2023/12/02 11:06:04 UTC
Table: 'Colorado' 6-max (real money) Seat #6 is the button
Seat 1: cygoud (2€)
Seat 2: Wolfert (3.53€)
Seat 3: JFSredbaron (2€)
Seat 4: zefzeph (2.44€)
Seat 5: J.C Deuces.0 (2€)
Seat 6: Fried Berg (1.85€)
*** ANTE/BLINDS ***
cygoud posts small blind 0.01€
Wolfert posts big blind 0.02€
Dealt to Fried Berg [4c 6s]
*** PRE-FLOP *** 
JFSredbaron raises 0.04€ to 0.06€
zefzeph folds
J.C Deuces.0 folds
Fried Berg folds
cygoud folds
Wolfert calls 0.04€
*** FLOP *** [3d 7c 8s]
Wolfert checks
JFSredbaron checks
*** TURN *** [3d 7c 8s][9h]
Wolfert bets 0.05€
JFSredbaron folds
Wolfert collected 0.17€ from pot
*** SUMMARY ***
Total pot 0.17€ | Rake 0.01€
Board: [3d 7c 8s 9h]
Seat 2: Wolfert (big blind) won 0.17€


Winamax Poker - HOLD-UP "Colorado" - HandId: #19116069-439389-1701515174 - Holdem no limit (0.01€/0.02€) - 2023/12/02 11:06:14 UTC
Table: 'Colorado' 6-max (real money) Seat #6 is the button
Seat 1: BrokeForever (0.99€)
Seat 2: Fried Berg (1.85€)
Seat 3: Perf-31 (2.92€)
Seat 4: rulo_137 (2€)
Seat 5: Holiap (2€)
Seat 6: Pas1erreur (2.50€)
*** ANTE/BLINDS ***
BrokeForever posts small blind 0.01€
Fried Berg posts big blind 0.02€
Dealt to Fried Berg [Td 5h]
*** PRE-FLOP *** 
Perf-31 raises 0.05€ to 0.07€
rulo_137 folds
Holiap folds
Pas1erreur folds
BrokeForever folds
Fried Berg folds
Perf-31 collected 0.10€ from pot
*** SUMMARY ***
Total pot 0.10€ | No rake
Seat 3: Perf-31 won 0.10€


Winamax Poker - HOLD-UP "Colorado" - HandId: #19116069-439406-1701515185 - Holdem no limit (0.01€/0.02€) - 2023/12/02 11:06:25 UTC
Table: 'Colorado' 6-max (real money) Seat #6 is the button
Seat 1: Fried Berg (1.83€)
Seat 2: BNC (0.50€)
Seat 3: Chacal-Punk (4.94€)
Seat 4: Pas1erreur (2.50€)
Seat 5: Kallonys (2.63€)
Seat 6: lamuerta8300 (2.57€)
*** ANTE/BLINDS ***
Fried Berg posts small blind 0.01€
BNC posts big blind 0.02€
Dealt to Fried Berg [Qd 2d]
*** PRE-FLOP *** 
Chacal-Punk folds
Pas1erreur folds
Kallonys folds
lamuerta8300 folds
Fried Berg folds
BNC collected 0.03€ from pot
*** SUMMARY ***
Total pot 0.03€ | No rake
Seat 2: BNC (big blind) won 0.03€


Winamax Poker - HOLD-UP "Colorado" - HandId: #19116069-439408-1701515187 - Holdem no limit (0.01€/0.02€) - 2023/12/02 11:06:27 UTC
Table: 'Colorado' 6-max (real money) Seat #6 is the button
Seat 1: TaBrEaMoI (3.41€)
Seat 2: jdeepenslip (2.17€)
Seat 3: Fried Berg (1.82€)
Seat 4: MCGHansen (2.16€)
Seat 5: Td08nomotto (2.80€)
Seat 6: Chacal-Punk (4.94€)
*** ANTE/BLINDS ***
TaBrEaMoI posts small blind 0.01€
jdeepenslip posts big blind 0.02€
Dealt to Fried Berg [7d Jh]
*** PRE-FLOP *** 
Fried Berg folds
MCGHansen raises 0.04€ to 0.06€
Td08nomotto folds
Chacal-Punk folds
TaBrEaMoI folds
jdeepenslip folds
MCGHansen collected 0.09€ from pot
*** SUMMARY ***
Total pot 0.09€ | No rake
Seat 4: MCGHansen won 0.09€


Winamax Poker - HOLD-UP "Colorado" - HandId: #19116069-439411-1701515189 - Holdem no limit (0.01€/0.02€) - 2023/12/02 11:06:29 UTC
Table: 'Colorado' 6-max (real money) Seat #6 is the button
Seat 1: TaBrEaMoI (3.40€)
Seat 2: Fried Berg (1.82€)
Seat 3: myloveisgone (2.17€)
Seat 4: Td08nomotto (2.80€)
Seat 5: go_fl0p (2.60€)
Seat 6: Zile741 (3.66€)
*** ANTE/BLINDS ***
TaBrEaMoI posts small blind 0.01€
Fried Berg posts big blind 0.02€
Dealt to Fried Berg [5h Tc]
*** PRE-FLOP *** 
myloveisgone folds
Td08nomotto folds
go_fl0p folds
Zile741 raises 0.03€ to 0.05€
TaBrEaMoI folds
Fried Berg folds
Zile741 collected 0.08€ from pot
*** SUMMARY ***
Total pot 0.08€ | No rake
Seat 6: Zile741 (button) won 0.08€


Winamax Poker - HOLD-UP "Colorado" - HandId: #19116069-439422-1701515198 - Holdem no limit (0.01€/0.02€) - 2023/12/02 11:06:38 UTC
Table: 'Colorado' 6-max (real money) Seat #6 is the button
Seat 1: BNC (0.51€)
Seat 2: papainge (2.17€)
Seat 3: Fried Berg (1.80€)
Seat 4: magnumbenji (5.10€)
Seat 5: YannSolo1 (4.48€)
Seat 6: PIQSOU (4.50€)
*** ANTE/BLINDS ***
BNC posts small blind 0.01€
papainge posts big blind 0.02€
Dealt to Fried Berg [4s 2h]
*** PRE-FLOP *** 
Fried Berg folds
magnumbenji folds
YannSolo1 raises 0.04€ to 0.06€
PIQSOU folds
BNC folds
papainge calls 0.04€
*** FLOP *** [4d 5c 7c]
papainge checks
YannSolo1 bets 0.05€
papainge calls 0.05€
*** TURN *** [4d 5c 7c][9h]
papainge checks
YannSolo1 checks
*** RIVER *** [4d 5c 7c 9h][Qc]
papainge checks
YannSolo1 checks
*** SHOW DOWN ***
papainge shows [Js Ad] (High card : Ace)
YannSolo1 shows [As Qd] (One pair : Queens)
YannSolo1 collected 0.21€ from pot
*** SUMMARY ***
Total pot 0.21€ | Rake 0.02€
Board: [4d 5c 7c 9h Qc]
Seat 2: papainge (big blind) showed [Js Ad] and lost with High card : Ace
Seat 5: YannSolo1 showed [As Qd] and won 0.21€ with One pair : Queens


Winamax Poker - HOLD-UP "Colorado" - HandId: #19116069-439426-1701515201 - Holdem no limit (0.01€/0.02€) - 2023/12/02 11:06:41 UTC
Table: 'Colorado' 6-max (real money) Seat #6 is the button
Seat 1: El Paellas (0.56€)
Seat 2: Zile741 (2.85€)
Seat 3: DeX70 (2.03€)
Seat 4: Fried Berg (1.80€)
Seat 5: NyKOh11 (0.52€)
Seat 6: jdeepenslip (2.15€)
*** ANTE/BLINDS ***
El Paellas posts small blind 0.01€
Zile741 posts big blind 0.02€
Dealt to Fried Berg [9c Jd]
*** PRE-FLOP *** 
DeX70 folds
Fried Berg folds
NyKOh11 folds
jdeepenslip folds
El Paellas folds
Zile741 collected 0.03€ from pot
*** SUMMARY ***
Total pot 0.03€ | No rake
Seat 2: Zile741 (big blind) won 0.03€


Winamax Poker - HOLD-UP "Colorado" - HandId: #19116069-439430-1701515203 - Holdem no limit (0.01€/0.02€) - 2023/12/02 11:06:43 UTC
Table: 'Colorado' 6-max (real money) Seat #6 is the button
Seat 1: Jean3776 (2€)
Seat 2: NyKOh11 (0.52€)
Seat 3: Morri7Jack (1.31€)
Seat 4: Fried Berg (1.80€)
Seat 5: oliveponcar (3.62€)
Seat 6: cecilon (0.42€)
Hold-up to Pot: total 0.10€
*** ANTE/BLINDS ***
Jean3776 posts small blind 0.01€
NyKOh11 posts big blind 0.02€
Dealt to Fried Berg [8d Kc]
*** PRE-FLOP *** 
Morri7Jack raises 0.02€ to 0.04€
Fried Berg folds
oliveponcar folds
cecilon folds
Jean3776 calls 0.03€
NyKOh11 folds
*** FLOP *** [Qd Ks 3s]
Jean3776 checks
Morri7Jack bets 0.07€
Jean3776 folds
Morri7Jack collected 0.26€ from pot
*** SUMMARY ***
Total pot 0.26€ | Rake 0.01€
Board: [Qd Ks 3s]
Seat 3: Morri7Jack won 0.26€


Winamax Poker - HOLD-UP "Colorado" - HandId: #19116069-439444-1701515211 - Holdem no limit (0.01€/0.02€) - 2023/12/02 11:06:51 UTC
Table: 'Colorado' 6-max (real money) Seat #6 is the button
Seat 1: Fried Berg (1.80€)
Seat 2: fifi2308 (1.94€)
Seat 3: El Paellas (0.50€)
Seat 4: go_fl0p (3.21€)
Seat 5: theSangoten (1.83€)
Seat 6: rulo_137 (2.83€)
*** ANTE/BLINDS ***
Fried Berg posts small blind 0.01€
fifi2308 posts big blind 0.02€
Dealt to Fried Berg [2h Ks]
*** PRE-FLOP *** 
El Paellas folds
go_fl0p folds
theSangoten folds
rulo_137 folds
Fried Berg folds
fifi2308 collected 0.03€ from pot
*** SUMMARY ***
Total pot 0.03€ | No rake
Seat 2: fifi2308 (big blind) won 0.03€


Winamax Poker - HOLD-UP "Colorado" - HandId: #19116069-439446-1701515212 - Holdem no limit (0.01€/0.02€) - 2023/12/02 11:06:52 UTC
Table: 'Colorado' 6-max (real money) Seat #6 is the button
Seat 1: Betiegarri (3.34€)
Seat 2: franckyrud (1.63€)
Seat 3: oliveponcar (2.39€)
Seat 4: theSangoten (1.83€)
Seat 5: Fried Berg (1.79€)
Seat 6: cygoud (2€)
Hold-up to Pot: total 0.10€
*** ANTE/BLINDS ***
Betiegarri posts small blind 0.01€
franckyrud posts big blind 0.02€
Dealt to Fried Berg [Qc Kh]
*** PRE-FLOP *** 
oliveponcar folds
theSangoten folds
Fried Berg raises 0.02€ to 0.04€
cygoud calls 0.04€
Betiegarri folds
franckyrud calls 0.02€
*** FLOP *** [Ks 8c 5h]
franckyrud checks
Fried Berg bets 0.10€
cygoud folds
franckyrud folds
Fried Berg collected 0.32€ from pot
*** SUMMARY ***
Total pot 0.32€ | Rake 0.01€
Board: [Ks 8c 5h]
Seat 5: Fried Berg won 0.32€


Winamax Poker - HOLD-UP "Colorado" - HandId: #19116069-439506-1701515254 - Holdem no limit (0.01€/0.02€) - 2023/12/02 11:07:34 UTC
Table: 'Colorado' 6-max (real money) Seat #6 is the button
Seat 1: ckok (0.56€)
Seat 2: Jean3776 (2.01€)
Seat 3: KingSoto (2.34€)
Seat 4: rulo_137 (2.77€)
Seat 5: Fried Berg (1.97€)
Seat 6: PIQSOU (4.52€)
*** ANTE/BLINDS ***
ckok posts small blind 0.01€
Jean3776 posts big blind 0.02€
Dealt to Fried Berg [Qc Jd]
*** PRE-FLOP *** 
KingSoto folds
rulo_137 folds
Fried Berg raises 0.02€ to 0.04€
PIQSOU calls 0.04€
ckok folds
Jean3776 folds
*** FLOP *** [Th As Ah]
Fried Berg checks
PIQSOU bets 0.06€
Fried Berg calls 0.06€
*** TURN *** [Th As Ah][9c]
Fried Berg checks
PIQSOU bets 0.17€
Fried Berg calls 0.17€
*** RIVER *** [Th As Ah 9c][4d]
Fried Berg checks
PIQSOU checks
*** SHOW DOWN ***
Fried Berg shows [Qc Jd] (One pair : Aces)
PIQSOU shows [Js Kc] (One pair : Aces)
PIQSOU collected 0.51€ from pot
*** SUMMARY ***
Total pot 0.51€ | Rake 0.06€
Board: [Th As Ah 9c 4d]
Seat 5: Fried Berg showed [Qc Jd] and lost with One pair : Aces
Seat 6: PIQSOU (button) showed [Js Kc] and won 0.51€ with One pair : Aces


Winamax Poker - HOLD-UP "Colorado" - HandId: #19116069-439610-1701515316 - Holdem no limit (0.01€/0.02€) - 2023/12/02 11:08:36 UTC
Table: 'Colorado' 6-max (real money) Seat #6 is the button
Seat 1: cygoud (2.28€)
Seat 2: PIQSOU (4.76€)
Seat 3: Fried Berg (1.70€)
Seat 4: MCGHansen (2.19€)
Seat 5: Perf-31 (2€)
Seat 6: Zile741 (2.91€)
*** ANTE/BLINDS ***
cygoud posts small blind 0.01€
PIQSOU posts big blind 0.02€
Dealt to Fried Berg [8d 2c]
*** PRE-FLOP *** 
Fried Berg folds
MCGHansen folds
Perf-31 folds
Zile741 raises 0.03€ to 0.05€
cygoud folds
PIQSOU folds
Zile741 collected 0.08€ from pot
*** SUMMARY ***
Total pot 0.08€ | No rake
Seat 6: Zile741 (button) won 0.08€


Winamax Poker - HOLD-UP "Colorado" - HandId: #19116069-439616-1701515321 - Holdem no limit (0.01€/0.02€) - 2023/12/02 11:08:41 UTC
Table: 'Colorado' 6-max (real money) Seat #6 is the button
Seat 1: YannSolo1 (4.63€)
Seat 2: Fried Berg (1.70€)
Seat 3: Abec16 (9.23€)
Seat 4: Retail Row (6.44€)
Seat 5: Td08nomotto (2€)
Seat 6: Wolfert (3.52€)
*** ANTE/BLINDS ***
YannSolo1 posts small blind 0.01€
Fried Berg posts big blind 0.02€
Dealt to Fried Berg [6d 9h]
*** PRE-FLOP *** 
Abec16 folds
Retail Row raises 0.04€ to 0.06€
Td08nomotto folds
Wolfert folds
YannSolo1 folds
Fried Berg folds
Retail Row collected 0.09€ from pot
*** SUMMARY ***
Total pot 0.09€ | No rake
Seat 4: Retail Row won 0.09€


Winamax Poker - HOLD-UP "Colorado" - HandId: #19116069-439632-1701515334 - Holdem no limit (0.01€/0.02€) - 2023/12/02 11:08:54 UTC
Table: 'Colorado' 6-max (real money) Seat #6 is the button
Seat 1: 121 (7.71€)
Seat 2: TaBrEaMoI (2.49€)
Seat 3: Fushitif (2.26€)
Seat 4: Fried Berg (1.68€)
Seat 5: Poironer (2.20€)
Seat 6: MCGHansen (2.19€)
*** ANTE/BLINDS ***
121 posts small blind 0.01€
TaBrEaMoI posts big blind 0.02€
Dealt to Fried Berg [2h 4h]
*** PRE-FLOP *** 
Fushitif calls 0.02€
Fried Berg folds
Poironer folds
MCGHansen folds
121 raises 0.06€ to 0.08€
TaBrEaMoI folds
Fushitif calls 0.06€
*** FLOP *** [6c Kh 6d]
121 bets 0.07€
Fushitif calls 0.07€
*** TURN *** [6c Kh 6d][3s]
121 checks
Fushitif checks
*** RIVER *** [6c Kh 6d 3s][Ad]
121 bets 0.11€
Fushitif folds
121 collected 0.40€ from pot
*** SUMMARY ***
Total pot 0.40€ | Rake 0.03€
Board: [6c Kh 6d 3s Ad]
Seat 1: 121 (small blind) won 0.40€


Winamax Poker - HOLD-UP "Colorado" - HandId: #19116069-439652-1701515348 - Holdem no limit (0.01€/0.02€) - 2023/12/02 11:09:08 UTC
Table: 'Colorado' 6-max (real money) Seat #6 is the button
Seat 1: Ipiz (3.85€)
Seat 2: WonderPoul (2€)
Seat 3: Td08nomotto (2.02€)
Seat 4: Fried Berg (1.68€)
Seat 5: rulo_137 (2€)
Seat 6: Zile741 (3.30€)
*** ANTE/BLINDS ***
Ipiz posts small blind 0.01€
WonderPoul posts big blind 0.02€
Dealt to Fried Berg [Ac 7h]
*** PRE-FLOP *** 
Td08nomotto folds
Fried Berg calls 0.02€
rulo_137 folds
Zile741 folds
Ipiz folds
WonderPoul checks
*** FLOP *** [3h 2d Qs]
WonderPoul checks
Fried Berg checks
*** TURN *** [3h 2d Qs][8s]
WonderPoul checks
Fried Berg checks
*** RIVER *** [3h 2d Qs 8s][Kh]
WonderPoul checks
Fried Berg bets 0.02€
WonderPoul folds
Fried Berg collected 0.06€ from pot
*** SUMMARY ***
Total pot 0.06€ | Rake 0.01€
Board: [3h 2d Qs 8s Kh]
Seat 4: Fried Berg won 0.06€


Winamax Poker - HOLD-UP "Colorado" - HandId: #19116069-439736-1701515412 - Holdem no limit (0.01€/0.02€) - 2023/12/02 11:10:12 UTC
Table: 'Colorado' 6-max (real money) Seat #6 is the button
Seat 1: Fried Berg (1.70€)
Seat 2: BrokeForever (1.99€)
Seat 3: franckyrud (2.83€)
Seat 4: JFSredbaron (2.04€)
Seat 5: Chacal-Punk (4.72€)
Seat 6: Merlus83 (3.44€)
*** ANTE/BLINDS ***
Fried Berg posts small blind 0.01€
BrokeForever posts big blind 0.02€
Dealt to Fried Berg [3h Qs]
*** PRE-FLOP *** 
franckyrud folds
JFSredbaron raises 0.04€ to 0.06€
Chacal-Punk folds
Merlus83 folds
Fried Berg folds
BrokeForever calls 0.04€
*** FLOP *** [6c 5s 8h]
BrokeForever checks
JFSredbaron checks
*** TURN *** [6c 5s 8h][As]
BrokeForever checks
JFSredbaron bets 0.08€
BrokeForever folds
JFSredbaron collected 0.20€ from pot
*** SUMMARY ***
Total pot 0.20€ | Rake 0.01€
Board: [6c 5s 8h As]
Seat 4: JFSredbaron won 0.20€


Winamax Poker - HOLD-UP "Colorado" - HandId: #19116069-439755-1701515424 - Holdem no limit (0.01€/0.02€) - 2023/12/02 11:10:24 UTC
Table: 'Colorado' 6-max (real money) Seat #6 is the button
Seat 1: Fried Berg (1.69€)
Seat 2: cygoud (2.06€)
Seat 3: Captain_JL (0.63€)
Seat 4: Ipiz (3.58€)
Seat 5: Holiap (2.09€)
Seat 6: jdeepenslip (2.69€)
*** ANTE/BLINDS ***
Fried Berg posts small blind 0.01€
cygoud posts big blind 0.02€
Dealt to Fried Berg [5d Kh]
*** PRE-FLOP *** 
Captain_JL raises 0.02€ to 0.04€
Ipiz folds
Holiap folds
jdeepenslip folds
Fried Berg folds
cygoud folds
Captain_JL collected 0.07€ from pot
*** SUMMARY ***
Total pot 0.07€ | No rake
Seat 3: Captain_JL won 0.07€


Winamax Poker - HOLD-UP "Colorado" - HandId: #19116069-439772-1701515436 - Holdem no limit (0.01€/0.02€) - 2023/12/02 11:10:36 UTC
Table: 'Colorado' 6-max (real money) Seat #6 is the button
Seat 1: jdeepenslip (2.69€)
Seat 2: MP_Shelby17 (1.65€)
Seat 3: Pas1erreur (2.48€)
Seat 4: Td08nomotto (2.65€)
Seat 5: Fried Berg (1.68€)
Seat 6: DeX70 (2.12€)
*** ANTE/BLINDS ***
jdeepenslip posts small blind 0.01€
MP_Shelby17 posts big blind 0.02€
Dealt to Fried Berg [Td Tc]
*** PRE-FLOP *** 
Pas1erreur folds
Td08nomotto folds
Fried Berg raises 0.04€ to 0.06€
DeX70 folds
jdeepenslip calls 0.05€
MP_Shelby17 folds
*** FLOP *** [Th 7s 9h]
jdeepenslip checks
Fried Berg bets 0.04€
jdeepenslip folds
Fried Berg collected 0.17€ from pot
*** SUMMARY ***
Total pot 0.17€ | Rake 0.01€
Board: [Th 7s 9h]
Seat 5: Fried Berg won 0.17€


Winamax Poker - HOLD-UP "Colorado" - HandId: #19116069-439806-1701515456 - Holdem no limit (0.01€/0.02€) - 2023/12/02 11:10:56 UTC
Table: 'Colorado' 6-max (real money) Seat #6 is the button
Seat 1: Abec16 (9.21€)
Seat 2: El Paellas (0.50€)
Seat 3: cygoud (2€)
Seat 4: JFSredbaron (2.02€)
Seat 5: calypso3094 (2.03€)
Seat 6: Fried Berg (1.75€)
*** ANTE/BLINDS ***
Abec16 posts small blind 0.01€
El Paellas posts big blind 0.02€
Dealt to Fried Berg [5d Kh]
*** PRE-FLOP *** 
cygoud folds
JFSredbaron raises 0.03€ to 0.05€
calypso3094 folds
Fried Berg folds
Abec16 folds
El Paellas folds
JFSredbaron collected 0.08€ from pot
*** SUMMARY ***
Total pot 0.08€ | No rake
Seat 4: JFSredbaron won 0.08€


Winamax Poker - HOLD-UP "Colorado" - HandId: #19116069-439821-1701515465 - Holdem no limit (0.01€/0.02€) - 2023/12/02 11:11:05 UTC
Table: 'Colorado' 6-max (real money) Seat #6 is the button
Seat 1: YannSolo1 (0.86€)
Seat 2: MCGHansen (2.58€)
Seat 3: Fried Berg (1.75€)
Seat 4: Jimbiosis (2.18€)
Seat 5: Trevize (1.55€)
Seat 6: _ilTulipano_ (5.64€)
*** ANTE/BLINDS ***
YannSolo1 posts small blind 0.01€
MCGHansen posts big blind 0.02€
Dealt to Fried Berg [7c 9h]
*** PRE-FLOP *** 
Fried Berg folds
Jimbiosis folds
Trevize raises 0.04€ to 0.06€
_ilTulipano_ folds
YannSolo1 folds
MCGHansen folds
Trevize collected 0.09€ from pot
*** SUMMARY ***
Total pot 0.09€ | No rake
Seat 5: Trevize won 0.09€


Winamax Poker - HOLD-UP "Colorado" - HandId: #19116069-439824-1701515467 - Holdem no limit (0.01€/0.02€) - 2023/12/02 11:11:07 UTC
Table: 'Colorado' 6-max (real money) Seat #6 is the button
Seat 1: YannSolo1 (0.85€)
Seat 2: cygoud (2€)
Seat 3: swag-Morue73 (0.58€)
Seat 4: TianzeLC (2.12€)
Seat 5: Fried Berg (1.75€)
Seat 6: Chacal-Punk (4.64€)
*** ANTE/BLINDS ***
YannSolo1 posts small blind 0.01€
cygoud posts big blind 0.02€
Dealt to Fried Berg [Kd 4c]
*** PRE-FLOP *** 
swag-Morue73 folds
TianzeLC folds
Fried Berg folds
Chacal-Punk folds
YannSolo1 folds
cygoud collected 0.03€ from pot
*** SUMMARY ***
Total pot 0.03€ | No rake
Seat 2: cygoud (big blind) won 0.03€


Winamax Poker - HOLD-UP "Colorado" - HandId: #19116069-439840-1701515477 - Holdem no limit (0.01€/0.02€) - 2023/12/02 11:11:17 UTC
Table: 'Colorado' 6-max (real money) Seat #6 is the button
Seat 1: Chacal-Punk (4.64€)
Seat 2: NyKOh11 (0.50€)
Seat 3: PIQSOU (3.86€)
Seat 4: Perf-31 (2.34€)
Seat 5: lamuerta8300 (7.64€)
Seat 6: Fried Berg (1.75€)
*** ANTE/BLINDS ***
Chacal-Punk posts small blind 0.01€
NyKOh11 posts big blind 0.02€
Dealt to Fried Berg [3h 2d]
*** PRE-FLOP *** 
PIQSOU folds
Perf-31 raises 0.04€ to 0.06€
lamuerta8300 raises 0.12€ to 0.18€
Fried Berg folds
Chacal-Punk folds
NyKOh11 folds
Perf-31 calls 0.12€
*** FLOP *** [8d 5c 6h]
Perf-31 checks
lamuerta8300 checks
*** TURN *** [8d 5c 6h][8s]
Perf-31 bets 0.25€
lamuerta8300 folds
Perf-31 collected 0.60€ from pot
*** SUMMARY ***
Total pot 0.60€ | Rake 0.04€
Board: [8d 5c 6h 8s]
Seat 4: Perf-31 won 0.60€


Winamax Poker - HOLD-UP "Colorado" - HandId: #19116069-439854-1701515488 - Holdem no limit (0.01€/0.02€) - 2023/12/02 11:11:28 UTC
Table: 'Colorado' 6-max (real money) Seat #6 is the button
Seat 1: gagnejamais4 (7.61€)
Seat 2: Fried Berg (1.75€)
Seat 3: MCGHansen (2.55€)
Seat 4: Homer14510 (1.97€)
Seat 5: fifi2308 (1.84€)
Seat 6: papainge (2€)
*** ANTE/BLINDS ***
gagnejamais4 posts small blind 0.01€
Fried Berg posts big blind 0.02€
Dealt to Fried Berg [5d 3h]
*** PRE-FLOP *** 
MCGHansen folds
Homer14510 folds
fifi2308 folds
papainge folds
gagnejamais4 folds
Fried Berg collected 0.03€ from pot
*** SUMMARY ***
Total pot 0.03€ | No rake
Seat 2: Fried Berg (big blind) won 0.03€


Winamax Poker - HOLD-UP "Colorado" - HandId: #19116069-439865-1701515495 - Holdem no limit (0.01€/0.02€) - 2023/12/02 11:11:35 UTC
Table: 'Colorado' 6-max (real money) Seat #6 is the button
Seat 1: Fried Berg (1.76€)
Seat 2: hello7585 (2€)
Seat 3: micth41 (3.74€)
Seat 4: Homer14510 (2€)
Seat 5: 121 (8.06€)
Seat 6: toutoazar (2.32€)
*** ANTE/BLINDS ***
Fried Berg posts small blind 0.01€
hello7585 posts big blind 0.02€
Dealt to Fried Berg [Ah 9c]
*** PRE-FLOP *** 
micth41 folds
Homer14510 folds
121 folds
toutoazar folds
Fried Berg raises 0.02€ to 0.04€
hello7585 calls 0.02€
*** FLOP *** [7s Ks 5d]
Fried Berg checks
hello7585 checks
*** TURN *** [7s Ks 5d][8c]
Fried Berg checks
hello7585 bets 0.03€
Fried Berg calls 0.03€
*** RIVER *** [7s Ks 5d 8c][Qh]
Fried Berg checks
hello7585 bets 0.05€
Fried Berg folds
hello7585 collected 0.18€ from pot
*** SUMMARY ***
Total pot 0.18€ | Rake 0.01€
Board: [7s Ks 5d 8c Qh]
Seat 2: hello7585 (big blind) won 0.18€


Winamax Poker - HOLD-UP "Colorado" - HandId: #19116069-439921-1701515534 - Holdem no limit (0.01€/0.02€) - 2023/12/02 11:12:14 UTC
Table: 'Colorado' 6-max (real money) Seat #6 is the button
Seat 1: iam_cid (2.01€)
Seat 2: MCGHansen (2.62€)
Seat 3: El Paellas (0.50€)
Seat 4: lamuerta8300 (2.53€)
Seat 5: BNC (0.65€)
Seat 6: Fried Berg (1.69€)
*** ANTE/BLINDS ***
iam_cid posts small blind 0.01€
MCGHansen posts big blind 0.02€
Dealt to Fried Berg [2c Td]
*** PRE-FLOP *** 
El Paellas folds
lamuerta8300 folds
BNC folds
Fried Berg folds
iam_cid folds
MCGHansen collected 0.03€ from pot
*** SUMMARY ***
Total pot 0.03€ | No rake
Seat 2: MCGHansen (big blind) won 0.03€


Winamax Poker - HOLD-UP "Colorado" - HandId: #19116069-439928-1701515538 - Holdem no limit (0.01€/0.02€) - 2023/12/02 11:12:18 UTC
Table: 'Colorado' 6-max (real money) Seat #6 is the button
Seat 1: PIQSOU (2€)
Seat 2: JOK-R777 (3.57€)
Seat 3: Fried Berg (1.69€)
Seat 4: iam_cid (2€)
Seat 5: Jean3776 (2€)
Seat 6: NyKOh11 (0.50€)
*** ANTE/BLINDS ***
PIQSOU posts small blind 0.01€
JOK-R777 posts big blind 0.02€
Dealt to Fried Berg [Jh Js]
*** PRE-FLOP *** 
Fried Berg raises 0.04€ to 0.06€
iam_cid folds
Jean3776 folds
NyKOh11 folds
PIQSOU folds
JOK-R777 calls 0.04€
*** FLOP *** [7c 5h Ts]
JOK-R777 checks
Fried Berg bets 0.06€
JOK-R777 raises 0.14€ to 0.20€
Fried Berg calls 0.14€
*** TURN *** [7c 5h Ts][6c]
JOK-R777 bets 0.34€
Fried Berg calls 0.34€
*** RIVER *** [7c 5h Ts 6c][Tc]
JOK-R777 bets 0.16€
Fried Berg raises 0.16€ to 0.32€
JOK-R777 calls 0.16€
*** SHOW DOWN ***
JOK-R777 shows [7s 5s] (Two pairs : Tens and 7)
Fried Berg shows [Jh Js] (Two pairs : Jacks and Tens)
Fried Berg collected 1.66€ from pot
*** SUMMARY ***
Total pot 1.66€ | Rake 0.19€
Board: [7c 5h Ts 6c Tc]
Seat 2: JOK-R777 (big blind) showed [7s 5s] and lost with Two pairs : Tens and 7
Seat 3: Fried Berg showed [Jh Js] and won 1.66€ with Two pairs : Jacks and Tens


Winamax Poker - HOLD-UP "Colorado" - HandId: #19116069-440022-1701515596 - Holdem no limit (0.01€/0.02€) - 2023/12/02 11:13:16 UTC
Table: 'Colorado' 6-max (real money) Seat #6 is the button
Seat 1: JOK-R777 (2.65€)
Seat 2: YannSolo1 (4.93€)
Seat 3: Fried Berg (2.43€)
Seat 4: Spyrale7 (1.43€)
Seat 5: SkyZii52 (1.90€)
Seat 6: Td08nomotto (2.27€)
*** ANTE/BLINDS ***
JOK-R777 posts small blind 0.01€
YannSolo1 posts big blind 0.02€
Dealt to Fried Berg [Kc 9s]
*** PRE-FLOP *** 
Fried Berg folds
Spyrale7 folds
SkyZii52 folds
Td08nomotto folds
JOK-R777 folds
YannSolo1 collected 0.03€ from pot
*** SUMMARY ***
Total pot 0.03€ | No rake
Seat 2: YannSolo1 (big blind) won 0.03€


Winamax Poker - HOLD-UP "Colorado" - HandId: #19116069-440035-1701515604 - Holdem no limit (0.01€/0.02€) - 2023/12/02 11:13:24 UTC
Table: 'Colorado' 6-max (real money) Seat #6 is the button
Seat 1: Captain_JL (0.55€)
Seat 2: El Paellas (0.50€)
Seat 3: Jean3776 (2€)
Seat 4: Fried Berg (2.43€)
Seat 5: Kallonys (4.16€)
Seat 6: hello7585 (2€)
*** ANTE/BLINDS ***
Captain_JL posts small blind 0.01€
El Paellas posts big blind 0.02€
Dealt to Fried Berg [Ac 4c]
*** PRE-FLOP *** 
Jean3776 raises 0.03€ to 0.05€
Fried Berg calls 0.05€
Kallonys folds
hello7585 folds
Captain_JL folds
El Paellas folds
*** FLOP *** [7s Qd Kd]
Jean3776 checks
Fried Berg checks
*** TURN *** [7s Qd Kd][Ts]
Jean3776 bets 0.07€
Fried Berg folds
Jean3776 collected 0.19€ from pot
*** SUMMARY ***
Total pot 0.19€ | Rake 0.01€
Board: [7s Qd Kd Ts]
Seat 3: Jean3776 won 0.19€


Winamax Poker - HOLD-UP "Colorado" - HandId: #19116069-440080-1701515642 - Holdem no limit (0.01€/0.02€) - 2023/12/02 11:14:02 UTC
Table: 'Colorado' 6-max (real money) Seat #6 is the button
Seat 1: Abec16 (8.89€)
Seat 2: hello7585 (2.25€)
Seat 3: magnumbenji (5.06€)
Seat 4: J.C Deuces.0 (3.22€)
Seat 5: Fried Berg (2.38€)
Seat 6: TaBrEaMoI (4.58€)
*** ANTE/BLINDS ***
Abec16 posts small blind 0.01€
hello7585 posts big blind 0.02€
Dealt to Fried Berg [Kc 4c]
*** PRE-FLOP *** 
magnumbenji calls 0.02€
J.C Deuces.0 raises 0.06€ to 0.08€
Fried Berg folds
TaBrEaMoI calls 0.08€
Abec16 folds
hello7585 folds
magnumbenji folds
*** FLOP *** [9h Qs 2h]
J.C Deuces.0 bets 0.07€
TaBrEaMoI calls 0.07€
*** TURN *** [9h Qs 2h][Td]
J.C Deuces.0 bets 0.28€
TaBrEaMoI folds
J.C Deuces.0 collected 0.59€ from pot
*** SUMMARY ***
Total pot 0.59€ | Rake 0.04€
Board: [9h Qs 2h Td]
Seat 4: J.C Deuces.0 won 0.59€


Winamax Poker - HOLD-UP "Colorado" - HandId: #19116069-440093-1701515651 - Holdem no limit (0.01€/0.02€) - 2023/12/02 11:14:11 UTC
Table: 'Colorado' 6-max (real money) Seat #6 is the button
Seat 1: Fried Berg (2.38€)
Seat 2: MCGHansen (2.58€)
Seat 3: Fushitif (3.30€)
Seat 4: papainge (2.41€)
Seat 5: hello7585 (2.05€)
Seat 6: swag-Morue73 (0.30€)
*** ANTE/BLINDS ***
Fried Berg posts small blind 0.01€
MCGHansen posts big blind 0.02€
Dealt to Fried Berg [7d 5s]
*** PRE-FLOP *** 
Fushitif raises 0.04€ to 0.06€
papainge folds
hello7585 folds
swag-Morue73 folds
Fried Berg folds
MCGHansen folds
Fushitif collected 0.09€ from pot
*** SUMMARY ***
Total pot 0.09€ | No rake
Seat 3: Fushitif won 0.09€


Winamax Poker - HOLD-UP "Colorado" - HandId: #19116069-440115-1701515664 - Holdem no limit (0.01€/0.02€) - 2023/12/02 11:14:24 UTC
Table: 'Colorado' 6-max (real money) Seat #6 is the button
Seat 1: NyKOh11 (0.55€)
Seat 2: Fried Berg (2.37€)
Seat 3: 121 (8.04€)
Seat 4: Jaloux88737 (1.97€)
Seat 5: iam_cid (2.42€)
Seat 6: Jimbiosis (2€)
*** ANTE/BLINDS ***
NyKOh11 posts small blind 0.01€
Fried Berg posts big blind 0.02€
Dealt to Fried Berg [9d Qc]
*** PRE-FLOP *** 
121 folds
Jaloux88737 raises 0.03€ to 0.05€
iam_cid folds
Jimbiosis folds
NyKOh11 folds
Fried Berg folds
Jaloux88737 collected 0.08€ from pot
*** SUMMARY ***
Total pot 0.08€ | No rake
Seat 4: Jaloux88737 won 0.08€


Winamax Poker - HOLD-UP "Colorado" - HandId: #19116069-440128-1701515671 - Holdem no limit (0.01€/0.02€) - 2023/12/02 11:14:31 UTC
Table: 'Colorado' 6-max (real money) Seat #6 is the button
Seat 1: Flog1312 (0.89€)
Seat 2: warnic40 (2.73€)
Seat 3: MCGHansen (2.08€)
Seat 4: Fried Berg (2.35€)
Seat 5: PIQSOU (2.56€)
Seat 6: NyKOh11 (0.53€)
*** ANTE/BLINDS ***
Flog1312 posts small blind 0.01€
warnic40 posts big blind 0.02€
Dealt to Fried Berg [8s 3c]
*** PRE-FLOP *** 
MCGHansen folds
Fried Berg folds
PIQSOU raises 0.03€ to 0.05€
NyKOh11 folds
Flog1312 folds
warnic40 folds
PIQSOU collected 0.08€ from pot
*** SUMMARY ***
Total pot 0.08€ | No rake
Seat 5: PIQSOU won 0.08€


Winamax Poker - HOLD-UP "Colorado" - HandId: #19116069-440135-1701515675 - Holdem no limit (0.01€/0.02€) - 2023/12/02 11:14:35 UTC
Table: 'Colorado' 6-max (real money) Seat #6 is the button
Seat 1: Jimbiosis (2.18€)
Seat 2: NyKOh11 (0.53€)
Seat 3: metamex (1.96€)
Seat 4: Fried Berg (2.35€)
Seat 5: _ilTulipano_ (2.69€)
Seat 6: Jaloux88737 (2€)
*** ANTE/BLINDS ***
Jimbiosis posts small blind 0.01€
NyKOh11 posts big blind 0.02€
Dealt to Fried Berg [4h 2c]
*** PRE-FLOP *** 
metamex folds
Fried Berg folds
_ilTulipano_ folds
Jaloux88737 folds
Jimbiosis folds
NyKOh11 collected 0.03€ from pot
*** SUMMARY ***
Total pot 0.03€ | No rake
Seat 2: NyKOh11 (big blind) won 0.03€


Winamax Poker - HOLD-UP "Colorado" - HandId: #19116069-440139-1701515678 - Holdem no limit (0.01€/0.02€) - 2023/12/02 11:14:38 UTC
Table: 'Colorado' 6-max (real money) Seat #6 is the button
Seat 1: Chacal-Punk (4.73€)
Seat 2: Baston57 (2.13€)
Seat 3: sniper girl (5.76€)
Seat 4: SkyZii52 (1.32€)
Seat 5: Fried Berg (2.35€)
Seat 6: Holiap (2.12€)
*** ANTE/BLINDS ***
Chacal-Punk posts small blind 0.01€
Baston57 posts big blind 0.02€
Dealt to Fried Berg [Qc 6c]
*** PRE-FLOP *** 
sniper girl folds
SkyZii52 folds
Fried Berg calls 0.02€
Holiap folds
Chacal-Punk folds
Baston57 checks
*** FLOP *** [Tc 5s 7d]
Baston57 checks
Fried Berg checks
*** TURN *** [Tc 5s 7d][Qh]
Baston57 checks
Fried Berg bets 0.02€
Baston57 folds
Fried Berg collected 0.06€ from pot
*** SUMMARY ***
Total pot 0.06€ | Rake 0.01€
Board: [Tc 5s 7d Qh]
Seat 5: Fried Berg won 0.06€


Winamax Poker - HOLD-UP "Colorado" - HandId: #19116069-440170-1701515699 - Holdem no limit (0.01€/0.02€) - 2023/12/02 11:14:59 UTC
Table: 'Colorado' 6-max (real money) Seat #6 is the button
Seat 1: tichettede3 (3.97€)
Seat 2: Fried Berg (2.37€)
Seat 3: Quenelles (2.06€)
Seat 4: BrokeForever (1.88€)
Seat 5: fifi2308 (1.81€)
Seat 6: J.C Deuces.0 (3.38€)
*** ANTE/BLINDS ***
tichettede3 posts small blind 0.01€
Fried Berg posts big blind 0.02€
Dealt to Fried Berg [2h 8s]
*** PRE-FLOP *** 
Quenelles folds
BrokeForever folds
fifi2308 folds
J.C Deuces.0 raises 0.03€ to 0.05€
tichettede3 folds
Fried Berg folds
J.C Deuces.0 collected 0.08€ from pot
*** SUMMARY ***
Total pot 0.08€ | No rake
Seat 6: J.C Deuces.0 (button) won 0.08€


Winamax Poker - HOLD-UP "Colorado" - HandId: #19116069-440189-1701515711 - Holdem no limit (0.01€/0.02€) - 2023/12/02 11:15:11 UTC
Table: 'Colorado' 6-max (real money) Seat #6 is the button
Seat 1: Perf-31 (2.42€)
Seat 2: Td08nomotto (2.42€)
Seat 3: PIQSOU (4.99€)
Seat 4: Chacal-Punk (4.66€)
Seat 5: Fried Berg (2.35€)
Seat 6: popoche29 (1.40€)
*** ANTE/BLINDS ***
Perf-31 posts small blind 0.01€
Td08nomotto posts big blind 0.02€
Dealt to Fried Berg [6h Ah]
*** PRE-FLOP *** 
PIQSOU folds
Chacal-Punk folds
Fried Berg raises 0.02€ to 0.04€
popoche29 folds
Perf-31 folds
Td08nomotto folds
Fried Berg collected 0.07€ from pot
*** SUMMARY ***
Total pot 0.07€ | No rake
Seat 5: Fried Berg won 0.07€


Winamax Poker - HOLD-UP "Colorado" - HandId: #19116069-440203-1701515722 - Holdem no limit (0.01€/0.02€) - 2023/12/02 11:15:22 UTC
Table: 'Colorado' 6-max (real money) Seat #6 is the button
Seat 1: lASASin (1.90€)
Seat 2: JFSredbaron (2.03€)
Seat 3: Fried Berg (2.38€)
Seat 4: papainge (2.03€)
Seat 5: NyKOh11 (0.54€)
Seat 6: Jean3776 (2€)
*** ANTE/BLINDS ***
lASASin posts small blind 0.01€
JFSredbaron posts big blind 0.02€
Dealt to Fried Berg [2h 3h]
*** PRE-FLOP *** 
Fried Berg raises 0.02€ to 0.04€
papainge folds
NyKOh11 folds
Jean3776 calls 0.04€
lASASin folds
JFSredbaron folds
*** FLOP *** [Jh Tc 2d]
Fried Berg checks
Jean3776 checks
*** TURN *** [Jh Tc 2d][4c]
Fried Berg checks
Jean3776 bets 0.06€
Fried Berg folds
Jean3776 collected 0.16€ from pot
*** SUMMARY ***
Total pot 0.16€ | Rake 0.01€
Board: [Jh Tc 2d 4c]
Seat 6: Jean3776 (button) won 0.16€


Winamax Poker - HOLD-UP "Colorado" - HandId: #19116069-440243-1701515754 - Holdem no limit (0.01€/0.02€) - 2023/12/02 11:15:54 UTC
Table: 'Colorado' 6-max (real money) Seat #6 is the button
Seat 1: papainge (2€)
Seat 2: Fried Berg (2.34€)
Seat 3: popoche29 (1.43€)
Seat 4: TaBrEaMoI (3.27€)
Seat 5: DeX70 (1.20€)
Seat 6: MCGHansen (2.89€)
*** ANTE/BLINDS ***
papainge posts small blind 0.01€
Fried Berg posts big blind 0.02€
Dealt to Fried Berg [8h 7d]
*** PRE-FLOP *** 
popoche29 folds
TaBrEaMoI raises 0.04€ to 0.06€
DeX70 folds
MCGHansen folds
papainge calls 0.05€
Fried Berg folds
*** FLOP *** [Kd 8d Qs]
papainge checks
TaBrEaMoI bets 0.07€
papainge calls 0.07€
*** TURN *** [Kd 8d Qs][3d]
papainge checks
TaBrEaMoI checks
*** RIVER *** [Kd 8d Qs 3d][5d]
papainge bets 0.10€
TaBrEaMoI folds
papainge collected 0.35€ from pot
*** SUMMARY ***
Total pot 0.35€ | Rake 0.03€
Board: [Kd 8d Qs 3d 5d]
Seat 1: papainge (small blind) won 0.35€


Winamax Poker - HOLD-UP "Colorado" - HandId: #19116069-440290-1701515786 - Holdem no limit (0.01€/0.02€) - 2023/12/02 11:16:26 UTC
Table: 'Colorado' 6-max (real money) Seat #6 is the button
Seat 1: Fried Berg (2.32€)
Seat 2: tichettede3 (3.87€)
Seat 3: PIQSOU (7.28€)
Seat 4: elsrab (2€)
Seat 5: jdeepenslip (2.35€)
Seat 6: Jimbiosis (2.21€)
*** ANTE/BLINDS ***
Fried Berg posts small blind 0.01€
tichettede3 posts big blind 0.02€
Dealt to Fried Berg [4s Qd]
*** PRE-FLOP *** 
PIQSOU folds
elsrab folds
jdeepenslip folds
Jimbiosis folds
Fried Berg folds
tichettede3 collected 0.03€ from pot
*** SUMMARY ***
Total pot 0.03€ | No rake
Seat 2: tichettede3 (big blind) won 0.03€


Winamax Poker - HOLD-UP "Colorado" - HandId: #19116069-440295-1701515789 - Holdem no limit (0.01€/0.02€) - 2023/12/02 11:16:29 UTC
Table: 'Colorado' 6-max (real money) Seat #6 is the button
Seat 1: Td08nomotto (2.30€)
Seat 2: Jimbiosis (2.21€)
Seat 3: Fried Berg (2.31€)
Seat 4: Elyotony57 (0.47€)
Seat 5: KingSoto (2.44€)
Seat 6: Wolfert (2.74€)
*** ANTE/BLINDS ***
Td08nomotto posts small blind 0.01€
Jimbiosis posts big blind 0.02€
Dealt to Fried Berg [Kc Ks]
*** PRE-FLOP *** 
Fried Berg raises 0.04€ to 0.06€
Elyotony57 folds
KingSoto calls 0.06€
Wolfert raises 0.12€ to 0.18€
Td08nomotto folds
Jimbiosis calls 0.16€
Fried Berg calls 0.12€
KingSoto calls 0.12€
*** FLOP *** [Th 5d 3s]
Jimbiosis checks
Fried Berg bets 0.30€
KingSoto folds
Wolfert calls 0.30€
Jimbiosis folds
*** TURN *** [Th 5d 3s][5c]
Fried Berg bets 0.30€
Wolfert raises 1.96€ to 2.26€ and is all-in
Fried Berg calls 1.53€ and is all-in
*** RIVER *** [Th 5d 3s 5c][6d]
*** SHOW DOWN ***
Fried Berg shows [Kc Ks] (Two pairs : Kings and 5)
Wolfert shows [9d 9h] (Two pairs : 9 and 5)
Wolfert collected 0.43€ from side pot 1
Fried Berg collected 4.49€ from main pot
*** SUMMARY ***
Total pot 4.92€ | Rake 0.50€
Board: [Th 5d 3s 5c 6d]
Seat 3: Fried Berg showed [Kc Ks] and won 4.49€ with Two pairs : Kings and 5
Seat 6: Wolfert (button) showed [9d 9h] and won 0.43€ with Two pairs : 9 and 5


Winamax Poker - HOLD-UP "Colorado" - HandId: #19116069-440444-1701515886 - Holdem no limit (0.01€/0.02€) - 2023/12/02 11:18:06 UTC
Table: 'Colorado' 6-max (real money) Seat #6 is the button
Seat 1: lamuerta8300 (7.18€)
Seat 2: Corleone154 (0.53€)
Seat 3: Endha_ (2.02€)
Seat 4: Ebahi_40430 (1.12€)
Seat 5: Fried Berg (4.49€)
Seat 6: YannSolo1 (1.42€)
*** ANTE/BLINDS ***
lamuerta8300 posts small blind 0.01€
Corleone154 posts big blind 0.02€
Dealt to Fried Berg [Qs Qh]
*** PRE-FLOP *** 
Endha_ folds
Ebahi_40430 calls 0.02€
Fried Berg raises 0.04€ to 0.06€
YannSolo1 folds
lamuerta8300 folds
Corleone154 folds
Ebahi_40430 calls 0.04€
*** FLOP *** [3c 8h 6c]
Ebahi_40430 bets 0.02€
Fried Berg raises 0.22€ to 0.24€
Ebahi_40430 calls 0.22€
*** TURN *** [3c 8h 6c][Jd]
Ebahi_40430 checks
Fried Berg checks
*** RIVER *** [3c 8h 6c Jd][3h]
Ebahi_40430 checks
Fried Berg checks
*** SHOW DOWN ***
Ebahi_40430 shows [6d 7c] (Two pairs : 6 and 3)
Fried Berg shows [Qs Qh] (Two pairs : Queens and 3)
Fried Berg collected 0.57€ from pot
*** SUMMARY ***
Total pot 0.57€ | Rake 0.06€
Board: [3c 8h 6c Jd 3h]
Seat 4: Ebahi_40430 showed [6d 7c] and lost with Two pairs : 6 and 3
Seat 5: Fried Berg showed [Qs Qh] and won 0.57€ with Two pairs : Queens and 3


Winamax Poker - HOLD-UP "Colorado" - HandId: #19116069-440547-1701515957 - Holdem no limit (0.01€/0.02€) - 2023/12/02 11:19:17 UTC
Table: 'Colorado' 6-max (real money) Seat #6 is the button
Seat 1: Fried Berg (4.76€)
Seat 2: Ebahi_40430 (0.82€)
Seat 3: JFSredbaron (2.37€)
Seat 4: POUILLE72 (2.04€)
Seat 5: Itashi.95 (2€)
Seat 6: papainge (3.47€)
*** ANTE/BLINDS ***
Fried Berg posts small blind 0.01€
Ebahi_40430 posts big blind 0.02€
Dealt to Fried Berg [5h 4s]
*** PRE-FLOP *** 
JFSredbaron folds
POUILLE72 calls 0.02€
Itashi.95 folds
papainge folds
Fried Berg folds
Ebahi_40430 checks
*** FLOP *** [3d 9h 7h]
Ebahi_40430 checks
POUILLE72 checks
*** TURN *** [3d 9h 7h][9s]
Ebahi_40430 checks
POUILLE72 checks
*** RIVER *** [3d 9h 7h 9s][5d]
Ebahi_40430 bets 0.04€
POUILLE72 folds
Ebahi_40430 collected 0.08€ from pot
*** SUMMARY ***
Total pot 0.08€ | Rake 0.01€
Board: [3d 9h 7h 9s 5d]
Seat 2: Ebahi_40430 (big blind) won 0.08€


Winamax Poker - HOLD-UP "Colorado" - HandId: #19116069-440928-1701516196 - Holdem no limit (0.01€/0.02€) - 2023/12/02 11:23:16 UTC
Table: 'Colorado' 6-max (real money) Seat #6 is the button
Seat 1: Jean3776 (2€)
Seat 2: Fried Berg (0.50€)
Seat 3: Pwinpwin (2.06€)
Seat 4: Endha_ (2€)
Seat 5: Holiap (2€)
Seat 6: Td08nomotto (2.19€)
*** ANTE/BLINDS ***
Jean3776 posts small blind 0.01€
Fried Berg posts big blind 0.02€
Dealt to Fried Berg [Ts 3c]
*** PRE-FLOP *** 
Pwinpwin folds
Endha_ folds
Holiap folds
Td08nomotto folds
Jean3776 raises 0.03€ to 0.05€
Fried Berg folds
Jean3776 collected 0.07€ from pot
*** SUMMARY ***
Total pot 0.07€ | No rake
Seat 1: Jean3776 (small blind) won 0.07€


Winamax Poker - HOLD-UP "Colorado" - HandId: #19116069-440949-1701516208 - Holdem no limit (0.01€/0.02€) - 2023/12/02 11:23:28 UTC
Table: 'Colorado' 6-max (real money) Seat #6 is the button
Seat 1: Fried Berg (0.48€)
Seat 2: Corleone154 (1.02€)
Seat 3: tichettede3 (3.28€)
Seat 4: cecilon (0.48€)
Seat 5: jdeepenslip (2.48€)
Seat 6: 1trospecti0n (2€)
*** ANTE/BLINDS ***
Fried Berg posts small blind 0.01€
Corleone154 posts big blind 0.02€
Dealt to Fried Berg [3s 6h]
*** PRE-FLOP *** 
tichettede3 raises 0.03€ to 0.05€
cecilon folds
jdeepenslip folds
1trospecti0n folds
Fried Berg folds
Corleone154 folds
tichettede3 collected 0.08€ from pot
*** SUMMARY ***
Total pot 0.08€ | No rake
Seat 3: tichettede3 won 0.08€


Winamax Poker - HOLD-UP "Colorado" - HandId: #19116069-440953-1701516212 - Holdem no limit (0.01€/0.02€) - 2023/12/02 11:23:32 UTC
Table: 'Colorado' 6-max (real money) Seat #6 is the button
Seat 1: Corleone154 (1€)
Seat 2: cecilon (0.48€)
Seat 3: Fried Berg (0.47€)
Seat 4: Spyrale7 (1.09€)
Seat 5: Endha_ (2€)
Seat 6: El Paellas (0.53€)
*** ANTE/BLINDS ***
Corleone154 posts small blind 0.01€
cecilon posts big blind 0.02€
Dealt to Fried Berg [2d 9d]
*** PRE-FLOP *** 
Fried Berg folds
Spyrale7 folds
Endha_ folds
El Paellas folds
Corleone154 calls 0.01€
cecilon checks
*** FLOP *** [Ks 5h Ts]
Corleone154 bets 0.02€
cecilon folds
Corleone154 collected 0.06€ from pot
*** SUMMARY ***
Total pot 0.06€ | No rake
Board: [Ks 5h Ts]
Seat 1: Corleone154 (small blind) won 0.06€


Winamax Poker - HOLD-UP "Colorado" - HandId: #19116069-440959-1701516216 - Holdem no limit (0.01€/0.02€) - 2023/12/02 11:23:36 UTC
Table: 'Colorado' 6-max (real money) Seat #6 is the button
Seat 1: hello7585 (2.16€)
Seat 2: bachir71 (1.06€)
Seat 3: Bastoufl91 (2.11€)
Seat 4: Fried Berg (0.47€)
Seat 5: Kallonys (4.27€)
Seat 6: Perf-31 (2.55€)
*** ANTE/BLINDS ***
hello7585 posts small blind 0.01€
bachir71 posts big blind 0.02€
Dealt to Fried Berg [Jd 3h]
*** PRE-FLOP *** 
Bastoufl91 calls 0.02€
Fried Berg folds
Kallonys folds
Perf-31 folds
hello7585 raises 0.04€ to 0.06€
bachir71 raises 1€ to 1.06€ and is all-in
Bastoufl91 folds
hello7585 calls 1€
*** FLOP *** [Qs 6d Th]
*** TURN *** [Qs 6d Th][5c]
*** RIVER *** [Qs 6d Th 5c][2s]
*** SHOW DOWN ***
bachir71 shows [8c Tc] (One pair : Tens)
hello7585 shows [Kh Kd] (One pair : Kings)
hello7585 collected 1.93€ from pot
*** SUMMARY ***
Total pot 1.93€ | Rake 0.21€
Board: [Qs 6d Th 5c 2s]
Seat 1: hello7585 (small blind) showed [Kh Kd] and won 1.93€ with One pair : Kings
Seat 2: bachir71 (big blind) showed [8c Tc] and lost with One pair : Tens


Winamax Poker - HOLD-UP "Colorado" - HandId: #19116069-440964-1701516221 - Holdem no limit (0.01€/0.02€) - 2023/12/02 11:23:41 UTC
Table: 'Colorado' 6-max (real money) Seat #6 is the button
Seat 1: Jean3776 (2.19€)
Seat 2: Holiap (2€)
Seat 3: Samuelillo07 (2.10€)
Seat 4: metamex (1.89€)
Seat 5: Fried Berg (0.47€)
Seat 6: Endha_ (2.82€)
*** ANTE/BLINDS ***
Jean3776 posts small blind 0.01€
Holiap posts big blind 0.02€
Dealt to Fried Berg [Ks 3h]
*** PRE-FLOP *** 
Samuelillo07 folds
metamex raises 0.04€ to 0.06€
Fried Berg folds
Endha_ folds
Jean3776 folds
Holiap folds
metamex collected 0.09€ from pot
*** SUMMARY ***
Total pot 0.09€ | No rake
Seat 4: metamex won 0.09€


Winamax Poker - HOLD-UP "Colorado" - HandId: #19116069-440968-1701516224 - Holdem no limit (0.01€/0.02€) - 2023/12/02 11:23:44 UTC
Table: 'Colorado' 6-max (real money) Seat #6 is the button
Seat 1: TaBrEaMoI (2.71€)
Seat 2: 1trospecti0n (2€)
Seat 3: KOMParHASARD (2€)
Seat 4: 14cruyff14 (0.50€)
Seat 5: PIQSOU (2.09€)
Seat 6: Fried Berg (0.47€)
*** ANTE/BLINDS ***
TaBrEaMoI posts small blind 0.01€
1trospecti0n posts big blind 0.02€
Dealt to Fried Berg [5c Ah]
*** PRE-FLOP *** 
KOMParHASARD folds
14cruyff14 folds
PIQSOU folds
Fried Berg raises 0.02€ to 0.04€
TaBrEaMoI folds
1trospecti0n calls 0.02€
*** FLOP *** [Jh Jd 7s]
1trospecti0n checks
Fried Berg checks
*** TURN *** [Jh Jd 7s][2d]
1trospecti0n bets 0.03€
Fried Berg folds
1trospecti0n collected 0.11€ from pot
*** SUMMARY ***
Total pot 0.11€ | Rake 0.01€
Board: [Jh Jd 7s 2d]
Seat 2: 1trospecti0n (big blind) won 0.11€


Winamax Poker - HOLD-UP "Colorado" - HandId: #19116069-441039-1701516269 - Holdem no limit (0.01€/0.02€) - 2023/12/02 11:24:29 UTC
Table: 'Colorado' 6-max (real money) Seat #6 is the button
Seat 1: TheNerd (3.67€)
Seat 2: JFSredbaron (2.14€)
Seat 3: elsrab (2.12€)
Seat 4: MONEYFOREVER (6.19€)
Seat 5: lamuerta8300 (7.12€)
Seat 6: Fried Berg (0.43€)
*** ANTE/BLINDS ***
TheNerd posts small blind 0.01€
JFSredbaron posts big blind 0.02€
Dealt to Fried Berg [Qs Ah]
*** PRE-FLOP *** 
elsrab folds
MONEYFOREVER raises 0.04€ to 0.06€
lamuerta8300 folds
Fried Berg raises 0.12€ to 0.18€
TheNerd folds
JFSredbaron folds
MONEYFOREVER raises 0.39€ to 0.57€
Fried Berg calls 0.25€ and is all-in
*** FLOP *** [7d 5d 8c]
*** TURN *** [7d 5d 8c][4s]
*** RIVER *** [7d 5d 8c 4s][6h]
*** SHOW DOWN ***
MONEYFOREVER shows [Kd Ad] (Straight 8 high)
Fried Berg shows [Qs Ah] (Straight 8 high)
Fried Berg collected 0.40€ from main pot
MONEYFOREVER collected 0.54€ from side pot 1
*** SUMMARY ***
Total pot 0.94€ | Rake 0.09€
Board: [7d 5d 8c 4s 6h]
Seat 4: MONEYFOREVER showed [Kd Ad] and won 0.54€ with Straight 8 high
Seat 6: Fried Berg (button) showed [Qs Ah] and won 0.40€ with Straight 8 high


Winamax Poker - HOLD-UP "Colorado" - HandId: #19116069-441097-1701516307 - Holdem no limit (0.01€/0.02€) - 2023/12/02 11:25:07 UTC
Table: 'Colorado' 6-max (real money) Seat #6 is the button
Seat 1: TheNerd (3.64€)
Seat 2: Fried Berg (0.40€)
Seat 3: MONEYFOREVER (6.16€)
Seat 4: YannSolo1 (1.82€)
Seat 5: Pwinpwin (2.15€)
Seat 6: Samuelillo07 (2.79€)
Hold-up to Pot: total 0.10€
*** ANTE/BLINDS ***
TheNerd posts small blind 0.01€
Fried Berg posts big blind 0.02€
Dealt to Fried Berg [6d 7s]
*** PRE-FLOP *** 
MONEYFOREVER raises 0.04€ to 0.06€
YannSolo1 folds
Pwinpwin raises 0.14€ to 0.20€
Samuelillo07 folds
TheNerd folds
Fried Berg folds
MONEYFOREVER folds
Pwinpwin collected 0.39€ from pot
*** SUMMARY ***
Total pot 0.39€ | No rake
Seat 5: Pwinpwin won 0.39€


Winamax Poker - HOLD-UP "Colorado" - HandId: #19116069-441129-1701516327 - Holdem no limit (0.01€/0.02€) - 2023/12/02 11:25:27 UTC
Table: 'Colorado' 6-max (real money) Seat #6 is the button
Seat 1: Fried Berg (0.38€)
Seat 2: _ilTulipano_ (3.36€)
Seat 3: Corleone154 (1.02€)
Seat 4: Ipiz (6.20€)
Seat 5: Nonik1987 (0.09€)
Seat 6: papainge (2.83€)
*** ANTE/BLINDS ***
Fried Berg posts small blind 0.01€
_ilTulipano_ posts big blind 0.02€
Dealt to Fried Berg [7c 7s]
*** PRE-FLOP *** 
Corleone154 folds
Ipiz folds
Nonik1987 calls 0.02€
papainge folds
Fried Berg raises 0.02€ to 0.04€
_ilTulipano_ calls 0.02€
Nonik1987 calls 0.02€
*** FLOP *** [6h Js 2c]
Fried Berg checks
_ilTulipano_ checks
Nonik1987 checks
*** TURN *** [6h Js 2c][Ad]
Fried Berg checks
_ilTulipano_ checks
Nonik1987 checks
*** RIVER *** [6h Js 2c Ad][3h]
Fried Berg checks
_ilTulipano_ bets 0.06€
Nonik1987 folds
Fried Berg calls 0.06€
*** SHOW DOWN ***
Fried Berg shows [7c 7s] (One pair : 7)
_ilTulipano_ shows [8c Ah] (One pair : Aces)
_ilTulipano_ collected 0.22€ from pot
*** SUMMARY ***
Total pot 0.22€ | Rake 0.02€
Board: [6h Js 2c Ad 3h]
Seat 1: Fried Berg (small blind) showed [7c 7s] and lost with One pair : 7
Seat 2: _ilTulipano_ (big blind) showed [8c Ah] and won 0.22€ with One pair : Aces


Winamax Poker - HOLD-UP "Colorado" - HandId: #19116069-441233-1701516392 - Holdem no limit (0.01€/0.02€) - 2023/12/02 11:26:32 UTC
Table: 'Colorado' 6-max (real money) Seat #6 is the button
Seat 1: _ilTulipano_ (3.48€)
Seat 2: MONEYFOREVER (6.09€)
Seat 3: Fried Berg (0.28€)
Seat 4: Samuelillo07 (2.26€)
Seat 5: cecilon (0.48€)
Seat 6: NyKOh11 (0.67€)
Hold-up to Pot: total 0.10€
*** ANTE/BLINDS ***
_ilTulipano_ posts small blind 0.01€
MONEYFOREVER posts big blind 0.02€
Dealt to Fried Berg [7d 4s]
*** PRE-FLOP *** 
Fried Berg folds
Samuelillo07 folds
cecilon folds
NyKOh11 folds
_ilTulipano_ raises 0.04€ to 0.06€
MONEYFOREVER folds
_ilTulipano_ collected 0.18€ from pot
*** SUMMARY ***
Total pot 0.18€ | No rake
Seat 1: _ilTulipano_ (small blind) won 0.18€


Winamax Poker - HOLD-UP "Colorado" - HandId: #19116069-441241-1701516398 - Holdem no limit (0.01€/0.02€) - 2023/12/02 11:26:38 UTC
Table: 'Colorado' 6-max (real money) Seat #6 is the button
Seat 1: YannSolo1 (1.73€)
Seat 2: herakles76 (1.17€)
Seat 3: 14cruyff14 (0.50€)
Seat 4: Fried Berg (0.28€)
Seat 5: Ipiz (6.28€)
Seat 6: Samuelillo07 (2.26€)
*** ANTE/BLINDS ***
YannSolo1 posts small blind 0.01€
herakles76 posts big blind 0.02€
Dealt to Fried Berg [Qs Ts]
*** PRE-FLOP *** 
14cruyff14 folds
Fried Berg raises 0.02€ to 0.04€
Ipiz folds
Samuelillo07 folds
YannSolo1 folds
herakles76 folds
Fried Berg collected 0.07€ from pot
*** SUMMARY ***
Total pot 0.07€ | No rake
Seat 4: Fried Berg won 0.07€


Winamax Poker - HOLD-UP "Colorado" - HandId: #19116069-441276-1701516417 - Holdem no limit (0.01€/0.02€) - 2023/12/02 11:26:57 UTC
Table: 'Colorado' 6-max (real money) Seat #6 is the button
Seat 1: TaBrEaMoI (2.57€)
Seat 2: YannSolo1 (1.75€)
Seat 3: tichettede3 (2.71€)
Seat 4: Lefiy (2.01€)
Seat 5: Fried Berg (0.31€)
Seat 6: Pwinpwin (2.28€)
Hold-up to Pot: total 0.10€
*** ANTE/BLINDS ***
TaBrEaMoI posts small blind 0.01€
YannSolo1 posts big blind 0.02€
Dealt to Fried Berg [7h Th]
*** PRE-FLOP *** 
tichettede3 raises 0.03€ to 0.05€
Lefiy calls 0.05€
Fried Berg folds
Pwinpwin folds
TaBrEaMoI folds
YannSolo1 folds
*** FLOP *** [Jc Kd Td]
tichettede3 bets 0.15€
Lefiy folds
tichettede3 collected 0.37€ from pot
*** SUMMARY ***
Total pot 0.37€ | Rake 0.01€
Board: [Jc Kd Td]
Seat 3: tichettede3 won 0.37€


Winamax Poker - HOLD-UP "Colorado" - HandId: #19116069-441285-1701516423 - Holdem no limit (0.01€/0.02€) - 2023/12/02 11:27:03 UTC
Table: 'Colorado' 6-max (real money) Seat #6 is the button
Seat 1: 14cruyff14 (0.50€)
Seat 2: x spoony (2€)
Seat 3: _ilTulipano_ (3.60€)
Seat 4: Fried Berg (0.31€)
Seat 5: PIQSOU (7.46€)
Seat 6: Zile741 (5.55€)
*** ANTE/BLINDS ***
14cruyff14 posts small blind 0.01€
x spoony posts big blind 0.02€
Dealt to Fried Berg [Qd Jd]
*** PRE-FLOP *** 
_ilTulipano_ folds
Fried Berg raises 0.02€ to 0.04€
PIQSOU folds
Zile741 folds
14cruyff14 folds
x spoony folds
Fried Berg collected 0.07€ from pot
*** SUMMARY ***
Total pot 0.07€ | No rake
Seat 4: Fried Berg won 0.07€


Winamax Poker - HOLD-UP "Colorado" - HandId: #19116069-441319-1701516441 - Holdem no limit (0.01€/0.02€) - 2023/12/02 11:27:21 UTC
Table: 'Colorado' 6-max (real money) Seat #6 is the button
Seat 1: JOK-R777 (1.97€)
Seat 2: Fried Berg (0.34€)
Seat 3: _ilTulipano_ (2.83€)
Seat 4: Zile741 (2€)
Seat 5: Pwinpwin (2.25€)
Seat 6: Kipyomag (2.57€)
*** ANTE/BLINDS ***
JOK-R777 posts small blind 0.01€
Fried Berg posts big blind 0.02€
Dealt to Fried Berg [Kh 5c]
*** PRE-FLOP *** 
_ilTulipano_ raises 0.04€ to 0.06€
Zile741 raises 0.18€ to 0.24€
Pwinpwin folds
Kipyomag folds
JOK-R777 folds
Fried Berg folds
_ilTulipano_ calls 0.18€
*** FLOP *** [9d 9c 8d]
_ilTulipano_ checks
Zile741 bets 0.33€
_ilTulipano_ folds
Zile741 collected 0.79€ from pot
*** SUMMARY ***
Total pot 0.79€ | Rake 0.05€
Board: [9d 9c 8d]
Seat 4: Zile741 won 0.79€


Winamax Poker - HOLD-UP "Colorado" - HandId: #19116069-441340-1701516453 - Holdem no limit (0.01€/0.02€) - 2023/12/02 11:27:33 UTC
Table: 'Colorado' 6-max (real money) Seat #6 is the button
Seat 1: Fried Berg (0.32€)
Seat 2: iam_cid (2.63€)
Seat 3: parysking (1.91€)
Seat 4: Jean3776 (2.61€)
Seat 5: hello7585 (2.65€)
Seat 6: Wolfert (2.18€)
*** ANTE/BLINDS ***
Fried Berg posts small blind 0.01€
iam_cid posts big blind 0.02€
Dealt to Fried Berg [Js 7d]
*** PRE-FLOP *** 
parysking calls 0.02€
Jean3776 folds
hello7585 folds
Wolfert raises 0.03€ to 0.05€
Fried Berg folds
iam_cid folds
parysking calls 0.03€
*** FLOP *** [4c 2s 3d]
parysking checks
Wolfert checks
*** TURN *** [4c 2s 3d][Td]
parysking checks
Wolfert checks
*** RIVER *** [4c 2s 3d Td][5h]
parysking checks
Wolfert checks
*** SHOW DOWN ***
Wolfert shows [Kc 9c] (High card : King)
parysking shows [Jh Kh] (High card : King)
parysking collected 0.12€ from pot
*** SUMMARY ***
Total pot 0.12€ | Rake 0.01€
Board: [4c 2s 3d Td 5h]
Seat 3: parysking showed [Jh Kh] and won 0.12€ with High card : King
Seat 6: Wolfert (button) showed [Kc 9c] and lost with High card : King


Winamax Poker - HOLD-UP "Colorado" - HandId: #19116069-441345-1701516455 - Holdem no limit (0.01€/0.02€) - 2023/12/02 11:27:35 UTC
Table: 'Colorado' 6-max (real money) Seat #6 is the button
Seat 1: 1trospecti0n (2.24€)
Seat 2: hello7585 (2.65€)
Seat 3: Jacop0113 (0.50€)
Seat 4: cecilon (0.42€)
Seat 5: Fried Berg (0.31€)
Seat 6: Endha_ (2€)
*** ANTE/BLINDS ***
1trospecti0n posts small blind 0.01€
hello7585 posts big blind 0.02€
Dealt to Fried Berg [Jc 5d]
*** PRE-FLOP *** 
Jacop0113 folds
cecilon folds
Fried Berg folds
Endha_ raises 0.03€ to 0.05€
1trospecti0n folds
hello7585 folds
Endha_ collected 0.08€ from pot
*** SUMMARY ***
Total pot 0.08€ | No rake
Seat 6: Endha_ (button) won 0.08€


Winamax Poker - HOLD-UP "Colorado" - HandId: #19116069-441348-1701516457 - Holdem no limit (0.01€/0.02€) - 2023/12/02 11:27:37 UTC
Table: 'Colorado' 6-max (real money) Seat #6 is the button
Seat 1: JFSredbaron (5.69€)
Seat 2: TaBrEaMoI (4.55€)
Seat 3: Fried Berg (0.31€)
Seat 4: Jacop0113 (0.50€)
Seat 5: Jean3776 (2.60€)
Seat 6: cecilon (0.42€)
*** ANTE/BLINDS ***
JFSredbaron posts small blind 0.01€
TaBrEaMoI posts big blind 0.02€
Dealt to Fried Berg [Qd 3h]
*** PRE-FLOP *** 
Fried Berg folds
Jacop0113 calls 0.02€
Jean3776 folds
cecilon folds
JFSredbaron raises 0.04€ to 0.06€
TaBrEaMoI calls 0.04€
Jacop0113 calls 0.04€
*** FLOP *** [9c 5h Th]
JFSredbaron bets 0.12€
TaBrEaMoI folds
Jacop0113 calls 0.12€
*** TURN *** [9c 5h Th][5d]
JFSredbaron bets 5.51€ and is all-in
Jacop0113 folds
JFSredbaron collected 5.89€ from pot
*** SUMMARY ***
Total pot 5.89€ | Rake 0.04€
Board: [9c 5h Th 5d]
Seat 1: JFSredbaron (small blind) won 5.89€


Winamax Poker - HOLD-UP "Colorado" - HandId: #19116069-441352-1701516458 - Holdem no limit (0.01€/0.02€) - 2023/12/02 11:27:38 UTC
Table: 'Colorado' 6-max (real money) Seat #6 is the button
Seat 1: Itashi.95 (2.14€)
Seat 2: PIQSOU (7.49€)
Seat 3: Jean3776 (2.60€)
Seat 4: cecilon (0.42€)
Seat 5: gagnejamais4 (1.63€)
Seat 6: Fried Berg (0.31€)
*** ANTE/BLINDS ***
Itashi.95 posts small blind 0.01€
PIQSOU posts big blind 0.02€
Dealt to Fried Berg [6s 5d]
*** PRE-FLOP *** 
Jean3776 folds
cecilon folds
gagnejamais4 raises 0.04€ to 0.06€
Fried Berg folds
Itashi.95 calls 0.05€
PIQSOU folds
*** FLOP *** [5h 4d Ad]
Itashi.95 checks
gagnejamais4 checks
*** TURN *** [5h 4d Ad][4s]
Itashi.95 checks
gagnejamais4 checks
*** RIVER *** [5h 4d Ad 4s][Th]
Itashi.95 bets 0.05€
gagnejamais4 folds
Itashi.95 collected 0.18€ from pot
*** SUMMARY ***
Total pot 0.18€ | Rake 0.01€
Board: [5h 4d Ad 4s Th]
Seat 1: Itashi.95 (small blind) won 0.18€


Winamax Poker - HOLD-UP "Colorado" - HandId: #19116069-441365-1701516464 - Holdem no limit (0.01€/0.02€) - 2023/12/02 11:27:44 UTC
Table: 'Colorado' 6-max (real money) Seat #6 is the button
Seat 1: muespachois1 (3.09€)
Seat 2: Fried Berg (0.31€)
Seat 3: NyKOh11 (0.69€)
Seat 4: oliveponcar (2.02€)
Seat 5: Pwinpwin (2.25€)
Seat 6: herakles76 (1.22€)
*** ANTE/BLINDS ***
muespachois1 posts small blind 0.01€
Fried Berg posts big blind 0.02€
Dealt to Fried Berg [Ac 8d]
*** PRE-FLOP *** 
NyKOh11 folds
oliveponcar folds
Pwinpwin folds
herakles76 folds
muespachois1 calls 0.01€
Fried Berg checks
*** FLOP *** [Jd 7h 7c]
muespachois1 checks
Fried Berg checks
*** TURN *** [Jd 7h 7c][5h]
muespachois1 checks
Fried Berg checks
*** RIVER *** [Jd 7h 7c 5h][5s]
muespachois1 checks
Fried Berg checks
*** SHOW DOWN ***
muespachois1 shows [Tc Qc] (Two pairs : 7 and 5)
Fried Berg shows [Ac 8d] (Two pairs : 7 and 5)
Fried Berg collected 0.04€ from pot
*** SUMMARY ***
Total pot 0.04€ | No rake
Board: [Jd 7h 7c 5h 5s]
Seat 1: muespachois1 (small blind) showed [Tc Qc] and lost with Two pairs : 7 and 5
Seat 2: Fried Berg (big blind) showed [Ac 8d] and won 0.04€ with Two pairs : 7 and 5


Winamax Poker - HOLD-UP "Colorado" - HandId: #19116069-441396-1701516481 - Holdem no limit (0.01€/0.02€) - 2023/12/02 11:28:01 UTC
Table: 'Colorado' 6-max (real money) Seat #6 is the button
Seat 1: Black-Bull (2.40€)
Seat 2: JOK-R777 (1.96€)
Seat 3: Pwinpwin (2.23€)
Seat 4: Fried Berg (0.33€)
Seat 5: 1trospecti0n (2.24€)
Seat 6: iam_cid (2.06€)
*** ANTE/BLINDS ***
Black-Bull posts small blind 0.01€
JOK-R777 posts big blind 0.02€
Dealt to Fried Berg [Qd 4h]
*** PRE-FLOP *** 
Pwinpwin folds
Fried Berg folds
1trospecti0n folds
iam_cid raises 0.03€ to 0.05€
Black-Bull folds
JOK-R777 calls 0.03€
*** FLOP *** [Ts Jh Kh]
JOK-R777 checks
iam_cid checks
*** TURN *** [Ts Jh Kh][8c]
JOK-R777 bets 0.04€
iam_cid folds
JOK-R777 collected 0.14€ from pot
*** SUMMARY ***
Total pot 0.14€ | Rake 0.01€
Board: [Ts Jh Kh 8c]
Seat 2: JOK-R777 (big blind) won 0.14€


Winamax Poker - HOLD-UP "Colorado" - HandId: #19116069-441404-1701516485 - Holdem no limit (0.01€/0.02€) - 2023/12/02 11:28:05 UTC
Table: 'Colorado' 6-max (real money) Seat #6 is the button
Seat 1: x spoony (2€)
Seat 2: hello7585 (3.06€)
Seat 3: Fried Berg (0.33€)
Seat 4: KOMParHASARD (2.06€)
Seat 5: Endha_ (2.03€)
Seat 6: Pwinpwin (2.19€)
*** ANTE/BLINDS ***
x spoony posts small blind 0.01€
hello7585 posts big blind 0.02€
Dealt to Fried Berg [5d 5h]
*** PRE-FLOP *** 
Fried Berg folds
KOMParHASARD folds
Endha_ folds
Pwinpwin raises 0.03€ to 0.05€
x spoony raises 0.10€ to 0.15€
hello7585 folds
Pwinpwin raises 0.25€ to 0.40€
x spoony folds
Pwinpwin collected 0.57€ from pot
*** SUMMARY ***
Total pot 0.57€ | No rake
Seat 6: Pwinpwin (button) won 0.57€


Winamax Poker - HOLD-UP "Colorado" - HandId: #19116069-441408-1701516488 - Holdem no limit (0.01€/0.02€) - 2023/12/02 11:28:08 UTC
Table: 'Colorado' 6-max (real money) Seat #6 is the button
Seat 1: Fried Berg (0.33€)
Seat 2: benzappa (2.60€)
Seat 3: 14cruyff14 (0.51€)
Seat 4: Endha_ (2.58€)
Seat 5: cecilon (0.40€)
Seat 6: elsrab (1.78€)
*** ANTE/BLINDS ***
Fried Berg posts small blind 0.01€
benzappa posts big blind 0.02€
Dealt to Fried Berg [Ah 2h]
*** PRE-FLOP *** 
14cruyff14 folds
Endha_ raises 0.04€ to 0.06€
cecilon folds
elsrab calls 0.06€
Fried Berg calls 0.05€
benzappa folds
*** FLOP *** [5s 3c 6s]
Fried Berg checks
Endha_ bets 0.13€
elsrab folds
Fried Berg folds
Endha_ collected 0.31€ from pot
*** SUMMARY ***
Total pot 0.31€ | Rake 0.02€
Board: [5s 3c 6s]
Seat 4: Endha_ won 0.31€


Winamax Poker - HOLD-UP "Colorado" - HandId: #19116069-441510-1701516546 - Holdem no limit (0.01€/0.02€) - 2023/12/02 11:29:06 UTC
Table: 'Colorado' 6-max (real money) Seat #6 is the button
Seat 1: jdeepenslip (4.53€)
Seat 2: iam_cid (2.57€)
Seat 3: fidjy1964 (0.77€)
Seat 4: Samuelillo07 (2.23€)
Seat 5: Fried Berg (0.27€)
Seat 6: Pwinpwin (2.37€)
*** ANTE/BLINDS ***
jdeepenslip posts small blind 0.01€
iam_cid posts big blind 0.02€
Dealt to Fried Berg [Ks Tc]
*** PRE-FLOP *** 
fidjy1964 folds
Samuelillo07 folds
Fried Berg raises 0.02€ to 0.04€
Pwinpwin folds
jdeepenslip folds
iam_cid folds
Fried Berg collected 0.07€ from pot
*** SUMMARY ***
Total pot 0.07€ | No rake
Seat 5: Fried Berg won 0.07€


Winamax Poker - HOLD-UP "Colorado" - HandId: #19116069-441541-1701516566 - Holdem no limit (0.01€/0.02€) - 2023/12/02 11:29:26 UTC
Table: 'Colorado' 6-max (real money) Seat #6 is the button
Seat 1: JFSredbaron (4.94€)
Seat 2: Malva-125593 (2.64€)
Seat 3: sniper girl (0.84€)
Seat 4: Fried Berg (0.30€)
Seat 5: 14cruyff14 (0.53€)
Seat 6: oliveponcar (2.04€)
*** ANTE/BLINDS ***
JFSredbaron posts small blind 0.01€
Malva-125593 posts big blind 0.02€
Dealt to Fried Berg [7s Qd]
*** PRE-FLOP *** 
sniper girl folds
Fried Berg folds
14cruyff14 folds
oliveponcar folds
JFSredbaron folds
Malva-125593 collected 0.03€ from pot
*** SUMMARY ***
Total pot 0.03€ | No rake
Seat 2: Malva-125593 (big blind) won 0.03€


Winamax Poker - HOLD-UP "Colorado" - HandId: #19116069-441550-1701516571 - Holdem no limit (0.01€/0.02€) - 2023/12/02 11:29:31 UTC
Table: 'Colorado' 6-max (real money) Seat #6 is the button
Seat 1: Fried Berg (0.30€)
Seat 2: Samuelillo07 (2.26€)
Seat 3: x spoony (2€)
Seat 4: Perf-31 (2.21€)
Seat 5: 14cruyff14 (0.53€)
Seat 6: oliveponcar (2.04€)
*** ANTE/BLINDS ***
Fried Berg posts small blind 0.01€
Samuelillo07 posts big blind 0.02€
Dealt to Fried Berg [4h 5d]
*** PRE-FLOP *** 
x spoony folds
Perf-31 folds
14cruyff14 folds
oliveponcar folds
Fried Berg folds
Samuelillo07 collected 0.03€ from pot
*** SUMMARY ***
Total pot 0.03€ | No rake
Seat 2: Samuelillo07 (big blind) won 0.03€


Winamax Poker - HOLD-UP "Colorado" - HandId: #19116069-441556-1701516574 - Holdem no limit (0.01€/0.02€) - 2023/12/02 11:29:34 UTC
Table: 'Colorado' 6-max (real money) Seat #6 is the button
Seat 1: Jean3776 (2.61€)
Seat 2: Fried Berg (0.29€)
Seat 3: jdeepenslip (2.54€)
Seat 4: Endha_ (3.03€)
Seat 5: oliveponcar (2€)
Seat 6: elsrab (1.72€)
*** ANTE/BLINDS ***
Jean3776 posts small blind 0.01€
Fried Berg posts big blind 0.02€
Dealt to Fried Berg [Jd 6c]
*** PRE-FLOP *** 
jdeepenslip raises 0.03€ to 0.05€
Endha_ folds
oliveponcar folds
elsrab folds
Jean3776 folds
Fried Berg folds
jdeepenslip collected 0.08€ from pot
*** SUMMARY ***
Total pot 0.08€ | No rake
Seat 3: jdeepenslip won 0.08€


Winamax Poker - HOLD-UP "Colorado" - HandId: #19116069-441578-1701516587 - Holdem no limit (0.01€/0.02€) - 2023/12/02 11:29:47 UTC
Table: 'Colorado' 6-max (real money) Seat #6 is the button
Seat 1: oliveponcar (2.01€)
Seat 2: Kallonys (4.16€)
Seat 3: 14cruyff14 (0.50€)
Seat 4: PIQSOU (5.72€)
Seat 5: Leboeuf51 (0.50€)
Seat 6: Fried Berg (0.27€)
*** ANTE/BLINDS ***
oliveponcar posts small blind 0.01€
Kallonys posts big blind 0.02€
Dealt to Fried Berg [Kh Qs]
*** PRE-FLOP *** 
14cruyff14 folds
PIQSOU raises 0.03€ to 0.05€
Leboeuf51 calls 0.05€
Fried Berg raises 0.10€ to 0.15€
oliveponcar folds
Kallonys folds
PIQSOU folds
Leboeuf51 folds
Fried Berg collected 0.28€ from pot
*** SUMMARY ***
Total pot 0.28€ | No rake
Seat 6: Fried Berg (button) won 0.28€


Winamax Poker - HOLD-UP "Colorado" - HandId: #19116069-441644-1701516628 - Holdem no limit (0.01€/0.02€) - 2023/12/02 11:30:28 UTC
Table: 'Colorado' 6-max (real money) Seat #6 is the button
Seat 1: Jean3776 (2.53€)
Seat 2: El Paellas (0.50€)
Seat 3: Fried Berg (0.40€)
Seat 4: x spoony (2.07€)
Seat 5: Pwinpwin (2.17€)
Seat 6: Davidoo36 (0.50€)
*** ANTE/BLINDS ***
Jean3776 posts small blind 0.01€
El Paellas posts big blind 0.02€
Dealt to Fried Berg [8c 4d]
*** PRE-FLOP *** 
Fried Berg folds
x spoony folds
Pwinpwin folds
Davidoo36 folds
Jean3776 folds
El Paellas collected 0.03€ from pot
*** SUMMARY ***
Total pot 0.03€ | No rake
Seat 2: El Paellas (big blind) won 0.03€


Winamax Poker - HOLD-UP "Colorado" - HandId: #19116069-441668-1701516641 - Holdem no limit (0.01€/0.02€) - 2023/12/02 11:30:41 UTC
Table: 'Colorado' 6-max (real money) Seat #6 is the button
Seat 1: gagnejamais4 (0.78€)
Seat 2: muespachois1 (3.03€)
Seat 3: Stackbystack (2€)
Seat 4: Samuelillo07 (2.01€)
Seat 5: Bastoufl91 (2.92€)
Seat 6: Fried Berg (0.40€)
*** ANTE/BLINDS ***
gagnejamais4 posts small blind 0.01€
muespachois1 posts big blind 0.02€
Dealt to Fried Berg [4h 9c]
*** PRE-FLOP *** 
Stackbystack folds
Samuelillo07 raises 0.04€ to 0.06€
Bastoufl91 calls 0.06€
Fried Berg folds
gagnejamais4 folds
muespachois1 calls 0.04€
*** FLOP *** [2s Ah Ad]
muespachois1 checks
Samuelillo07 checks
Bastoufl91 checks
*** TURN *** [2s Ah Ad][Jd]
muespachois1 checks
Samuelillo07 checks
Bastoufl91 checks
*** RIVER *** [2s Ah Ad Jd][9d]
muespachois1 checks
Samuelillo07 checks
Bastoufl91 checks
*** SHOW DOWN ***
muespachois1 shows [Qc Kc] (One pair : Aces)
Samuelillo07 shows [7s 7d] (Two pairs : Aces and 7)
Bastoufl91 shows [Jh 6s] (Two pairs : Aces and Jacks)
Bastoufl91 collected 0.17€ from pot
*** SUMMARY ***
Total pot 0.17€ | Rake 0.02€
Board: [2s Ah Ad Jd 9d]
Seat 2: muespachois1 (big blind) showed [Qc Kc] and lost with One pair : Aces
Seat 4: Samuelillo07 showed [7s 7d] and lost with Two pairs : Aces and 7
Seat 5: Bastoufl91 showed [Jh 6s] and won 0.17€ with Two pairs : Aces and Jacks


Winamax Poker - HOLD-UP "Colorado" - HandId: #19116069-441678-1701516651 - Holdem no limit (0.01€/0.02€) - 2023/12/02 11:30:51 UTC
Table: 'Colorado' 6-max (real money) Seat #6 is the button
Seat 1: la mathisso (1.89€)
Seat 2: Lefiy (2.76€)
Seat 3: Itashi.95 (2.09€)
Seat 4: iam_cid (2.39€)
Seat 5: El Paellas (0.53€)
Seat 6: Fried Berg (0.40€)
*** ANTE/BLINDS ***
la mathisso posts small blind 0.01€
Lefiy posts big blind 0.02€
Dealt to Fried Berg [7h 5d]
*** PRE-FLOP *** 
Itashi.95 folds
iam_cid raises 0.04€ to 0.06€
El Paellas folds
Fried Berg folds
la mathisso calls 0.05€
Lefiy calls 0.04€
*** FLOP *** [9c Th 4h]
la mathisso bets 0.12€
Lefiy calls 0.12€
iam_cid folds
*** TURN *** [9c Th 4h][2h]
la mathisso checks
Lefiy bets 0.42€
la mathisso calls 0.42€
*** RIVER *** [9c Th 4h 2h][Ts]
la mathisso checks
Lefiy bets 2.16€ and is all-in
la mathisso calls 1.29€ and is all-in
*** SHOW DOWN ***
la mathisso shows [Ks Kc] (Two pairs : Kings and Tens)
Lefiy shows [9d Ah] (Two pairs : Tens and 9)
Lefiy collected 0.87€ from side pot 1
la mathisso collected 3.46€ from main pot
*** SUMMARY ***
Total pot 4.33€ | Rake 0.38€
Board: [9c Th 4h 2h Ts]
Seat 1: la mathisso (small blind) showed [Ks Kc] and won 3.46€ with Two pairs : Kings and Tens
Seat 2: Lefiy (big blind) showed [9d Ah] and won 0.87€ with Two pairs : Tens and 9


Winamax Poker - HOLD-UP "Colorado" - HandId: #19116069-441680-1701516653 - Holdem no limit (0.01€/0.02€) - 2023/12/02 11:30:53 UTC
Table: 'Colorado' 6-max (real money) Seat #6 is the button
Seat 1: NumaCo (2.57€)
Seat 2: DONpere (1.60€)
Seat 3: 1trospecti0n (5.03€)
Seat 4: x spoony (2.07€)
Seat 5: Fried Berg (0.40€)
Seat 6: lASASin (1.37€)
*** ANTE/BLINDS ***
NumaCo posts small blind 0.01€
DONpere posts big blind 0.02€
Dealt to Fried Berg [9c 9s]
*** PRE-FLOP *** 
1trospecti0n folds
x spoony folds
Fried Berg raises 0.02€ to 0.04€
lASASin calls 0.04€
NumaCo folds
DONpere calls 0.02€
*** FLOP *** [9h Kh 8d]
DONpere checks
Fried Berg bets 0.10€
lASASin folds
DONpere calls 0.10€
*** TURN *** [9h Kh 8d][As]
DONpere checks
Fried Berg bets 0.26€ and is all-in
DONpere calls 0.26€
*** RIVER *** [9h Kh 8d As][5h]
*** SHOW DOWN ***
DONpere shows [Ac 9d] (Two pairs : Aces and 9)
Fried Berg shows [9c 9s] (Trips of 9)
Fried Berg collected 0.76€ from pot
*** SUMMARY ***
Total pot 0.76€ | Rake 0.09€
Board: [9h Kh 8d As 5h]
Seat 2: DONpere (big blind) showed [Ac 9d] and lost with Two pairs : Aces and 9
Seat 5: Fried Berg showed [9c 9s] and won 0.76€ with Trips of 9


Winamax Poker - HOLD-UP "Colorado" - HandId: #19116069-441759-1701516699 - Holdem no limit (0.01€/0.02€) - 2023/12/02 11:31:39 UTC
Table: 'Colorado' 6-max (real money) Seat #6 is the button
Seat 1: NyKOh11 (0.67€)
Seat 2: Fried Berg (0.76€)
Seat 3: Totolebarj (2€)
Seat 4: 1trospecti0n (2.04€)
Seat 5: PIQSOU (5.58€)
Seat 6: x spoony (2€)
*** ANTE/BLINDS ***
NyKOh11 posts small blind 0.01€
Fried Berg posts big blind 0.02€
Dealt to Fried Berg [2d 9d]
*** PRE-FLOP *** 
Totolebarj folds
1trospecti0n folds
PIQSOU folds
x spoony raises 0.04€ to 0.06€
NyKOh11 folds
Fried Berg folds
x spoony collected 0.09€ from pot
*** SUMMARY ***
Total pot 0.09€ | No rake
Seat 6: x spoony (button) won 0.09€


Winamax Poker - HOLD-UP "Colorado" - HandId: #19116069-441778-1701516710 - Holdem no limit (0.01€/0.02€) - 2023/12/02 11:31:50 UTC
Table: 'Colorado' 6-max (real money) Seat #6 is the button
Seat 1: Fried Berg (0.74€)
Seat 2: 1trospecti0n (2€)
Seat 3: Polanskii (1.44€)
Seat 4: 14cruyff14 (0.56€)
Seat 5: POUILLE72 (2.08€)
Seat 6: KingSoto (2.82€)
*** ANTE/BLINDS ***
Fried Berg posts small blind 0.01€
1trospecti0n posts big blind 0.02€
Dealt to Fried Berg [4s 3s]
*** PRE-FLOP *** 
Polanskii folds
14cruyff14 folds
POUILLE72 raises 0.03€ to 0.05€
KingSoto folds
Fried Berg folds
1trospecti0n folds
POUILLE72 collected 0.08€ from pot
*** SUMMARY ***
Total pot 0.08€ | No rake
Seat 5: POUILLE72 won 0.08€


Winamax Poker - HOLD-UP "Colorado" - HandId: #19116069-441817-1701516732 - Holdem no limit (0.01€/0.02€) - 2023/12/02 11:32:12 UTC
Table: 'Colorado' 6-max (real money) Seat #6 is the button
Seat 1: hello7585 (2.79€)
Seat 2: tichettede3 (3.57€)
Seat 3: Fried Berg (0.73€)
Seat 4: lASASin (1.22€)
Seat 5: Samuelillo07 (2.05€)
Seat 6: Perf-31 (2.17€)
*** ANTE/BLINDS ***
hello7585 posts small blind 0.01€
tichettede3 posts big blind 0.02€
Dealt to Fried Berg [3h Ts]
*** PRE-FLOP *** 
Fried Berg folds
lASASin folds
Samuelillo07 folds
Perf-31 folds
hello7585 folds
tichettede3 collected 0.03€ from pot
*** SUMMARY ***
Total pot 0.03€ | No rake
Seat 2: tichettede3 (big blind) won 0.03€


Winamax Poker - HOLD-UP "Colorado" - HandId: #19116069-441820-1701516733 - Holdem no limit (0.01€/0.02€) - 2023/12/02 11:32:13 UTC
Table: 'Colorado' 6-max (real money) Seat #6 is the button
Seat 1: Perf-31 (2.17€)
Seat 2: 1trospecti0n (2€)
Seat 3: hello7585 (2.78€)
Seat 4: Fried Berg (0.73€)
Seat 5: StourmyFab (1.34€)
Seat 6: DONpere (1.87€)
*** ANTE/BLINDS ***
Perf-31 posts small blind 0.01€
1trospecti0n posts big blind 0.02€
Dealt to Fried Berg [Js Qh]
*** PRE-FLOP *** 
hello7585 folds
Fried Berg raises 0.02€ to 0.04€
StourmyFab folds
DONpere folds
Perf-31 folds
1trospecti0n folds
Fried Berg collected 0.07€ from pot
*** SUMMARY ***
Total pot 0.07€ | No rake
Seat 4: Fried Berg won 0.07€


Winamax Poker - HOLD-UP "Colorado" - HandId: #19116069-441844-1701516746 - Holdem no limit (0.01€/0.02€) - 2023/12/02 11:32:26 UTC
Table: 'Colorado' 6-max (real money) Seat #6 is the button
Seat 1: Pwinpwin (2.01€)
Seat 2: wmx-6j46k48 (0.50€)
Seat 3: benzappa (3.09€)
Seat 4: El Paellas (0.53€)
Seat 5: Fried Berg (0.76€)
Seat 6: x spoony (2€)
*** ANTE/BLINDS ***
Pwinpwin posts small blind 0.01€
wmx-6j46k48 posts big blind 0.02€
Dealt to Fried Berg [8c 5s]
*** PRE-FLOP *** 
benzappa folds
El Paellas folds
Fried Berg folds
x spoony raises 0.04€ to 0.06€
Pwinpwin folds
wmx-6j46k48 calls 0.04€
*** FLOP *** [Jh 3c 6h]
wmx-6j46k48 bets 0.02€
x spoony folds
wmx-6j46k48 collected 0.14€ from pot
*** SUMMARY ***
Total pot 0.14€ | Rake 0.01€
Board: [Jh 3c 6h]
Seat 2: wmx-6j46k48 (big blind) won 0.14€


Winamax Poker - HOLD-UP "Colorado" - HandId: #19116069-441864-1701516761 - Holdem no limit (0.01€/0.02€) - 2023/12/02 11:32:41 UTC
Table: 'Colorado' 6-max (real money) Seat #6 is the button
Seat 1: ridiculuss (2.01€)
Seat 2: oliveponcar (2€)
Seat 3: muespachois1 (2.92€)
Seat 4: Stackbystack (2€)
Seat 5: Fried Berg (0.76€)
Seat 6: YannSolo1 (3.06€)
*** ANTE/BLINDS ***
ridiculuss posts small blind 0.01€
oliveponcar posts big blind 0.02€
Dealt to Fried Berg [Qd Jh]
*** PRE-FLOP *** 
muespachois1 folds
Stackbystack folds
Fried Berg raises 0.02€ to 0.04€
YannSolo1 folds
ridiculuss folds
oliveponcar folds
Fried Berg collected 0.07€ from pot
*** SUMMARY ***
Total pot 0.07€ | No rake
Seat 5: Fried Berg won 0.07€


Winamax Poker - HOLD-UP "Colorado" - HandId: #19116069-441935-1701516804 - Holdem no limit (0.01€/0.02€) - 2023/12/02 11:33:24 UTC
Table: 'Colorado' 6-max (real money) Seat #6 is the button
Seat 1: PIQSOU (5.50€)
Seat 2: Fried Berg (0.79€)
Seat 3: NumaCo (3.13€)
Seat 4: Totolebarj (1.95€)
Seat 5: Black-Bull (2.54€)
Seat 6: Wolfert (2.12€)
Hold-up to Pot: total 0.10€
*** ANTE/BLINDS ***
PIQSOU posts small blind 0.01€
Fried Berg posts big blind 0.02€
Dealt to Fried Berg [Qh Ac]
*** PRE-FLOP *** 
NumaCo raises 0.09€ to 0.11€
Totolebarj folds
Black-Bull folds
Wolfert folds
PIQSOU folds
Fried Berg raises 0.22€ to 0.33€
NumaCo raises 2.80€ to 3.13€ and is all-in
Fried Berg calls 0.46€ and is all-in
*** FLOP *** [Qc Qd Ah]
*** TURN *** [Qc Qd Ah][Ks]
*** RIVER *** [Qc Qd Ah Ks][9d]
*** SHOW DOWN ***
Fried Berg shows [Qh Ac] (Full of Queens and Aces)
NumaCo shows [Ad As] (Full of Aces and Queens)
NumaCo collected 3.87€ from pot
*** SUMMARY ***
Total pot 3.87€ | Rake 0.16€
Board: [Qc Qd Ah Ks 9d]
Seat 2: Fried Berg (big blind) showed [Qh Ac] and lost with Full of Queens and Aces
Seat 3: NumaCo showed [Ad As] and won 3.87€ with Full of Aces and Queens


Winamax Poker - HOLD-UP "Colorado" - HandId: #19116069-442017-1701516853 - Holdem no limit (0.01€/0.02€) - 2023/12/02 11:34:13 UTC
Table: 'Colorado' 6-max (real money) Seat #6 is the button
Seat 1: DONpere (1.60€)
Seat 2: fidjy1964 (1.15€)
Seat 3: elsrab (2.60€)
Seat 4: Fried Berg (0.50€)
Seat 5: P.BaIkany (2.05€)
Seat 6: Pwinpwin (2.01€)
*** ANTE/BLINDS ***
DONpere posts small blind 0.01€
fidjy1964 posts big blind 0.02€
Dealt to Fried Berg [3s 9h]
*** PRE-FLOP *** 
elsrab folds
Fried Berg folds
P.BaIkany raises 0.04€ to 0.06€
Pwinpwin folds
DONpere folds
fidjy1964 folds
P.BaIkany collected 0.09€ from pot
*** SUMMARY ***
Total pot 0.09€ | No rake
Seat 5: P.BaIkany won 0.09€


Winamax Poker - HOLD-UP "Colorado" - HandId: #19116069-442027-1701516859 - Holdem no limit (0.01€/0.02€) - 2023/12/02 11:34:19 UTC
Table: 'Colorado' 6-max (real money) Seat #6 is the button
Seat 1: Fried Berg (0.50€)
Seat 2: elsrab (1.79€)
Seat 3: JFSredbaron (5.74€)
Seat 4: TaBrEaMoI (4.69€)
Seat 5: Samuelillo07 (2.31€)
Seat 6: Zile741 (4.57€)
*** ANTE/BLINDS ***
Fried Berg posts small blind 0.01€
elsrab posts big blind 0.02€
Dealt to Fried Berg [Ah 6c]
*** PRE-FLOP *** 
JFSredbaron raises 0.04€ to 0.06€
TaBrEaMoI calls 0.06€
Samuelillo07 folds
Zile741 folds
Fried Berg folds
elsrab folds
*** FLOP *** [Jc 8h 5s]
JFSredbaron checks
TaBrEaMoI checks
*** TURN *** [Jc 8h 5s][Ts]
JFSredbaron checks
TaBrEaMoI checks
*** RIVER *** [Jc 8h 5s Ts][9h]
JFSredbaron bets 0.05€
TaBrEaMoI calls 0.05€
*** SHOW DOWN ***
TaBrEaMoI shows [7c 7d] (Straight Jack high)
JFSredbaron shows [Qd Ac] (Straight Queen high)
JFSredbaron collected 0.22€ from pot
*** SUMMARY ***
Total pot 0.22€ | Rake 0.03€
Board: [Jc 8h 5s Ts 9h]
Seat 3: JFSredbaron showed [Qd Ac] and won 0.22€ with Straight Queen high
Seat 4: TaBrEaMoI showed [7c 7d] and lost with Straight Jack high


Winamax Poker - HOLD-UP "Colorado" - HandId: #19116069-442058-1701516876 - Holdem no limit (0.01€/0.02€) - 2023/12/02 11:34:36 UTC
Table: 'Colorado' 6-max (real money) Seat #6 is the button
Seat 1: Td08nomotto (2.11€)
Seat 2: 14cruyff14 (0.50€)
Seat 3: Fried Berg (0.49€)
Seat 4: tichettede3 (3.53€)
Seat 5: Pwinpwin (3.96€)
Seat 6: parysking (2.87€)
*** ANTE/BLINDS ***
Td08nomotto posts small blind 0.01€
14cruyff14 posts big blind 0.02€
Dealt to Fried Berg [5d Jd]
*** PRE-FLOP *** 
Fried Berg folds
tichettede3 raises 0.03€ to 0.05€
Pwinpwin folds
parysking calls 0.05€
Td08nomotto folds
14cruyff14 folds
*** FLOP *** [Js Ac 2h]
tichettede3 bets 0.08€
parysking folds
tichettede3 collected 0.20€ from pot
*** SUMMARY ***
Total pot 0.20€ | Rake 0.01€
Board: [Js Ac 2h]
Seat 4: tichettede3 won 0.20€


Winamax Poker - HOLD-UP "Colorado" - HandId: #19116069-442061-1701516879 - Holdem no limit (0.01€/0.02€) - 2023/12/02 11:34:39 UTC
Table: 'Colorado' 6-max (real money) Seat #6 is the button
Seat 1: Zile741 (5.51€)
Seat 2: ridiculuss (2€)
Seat 3: Upswing11 (2€)
Seat 4: Pwinpwin (2.23€)
Seat 5: Rue115 (1.29€)
Seat 6: Fried Berg (0.49€)
*** ANTE/BLINDS ***
Zile741 posts small blind 0.01€
ridiculuss posts big blind 0.02€
Dealt to Fried Berg [Qh 7s]
*** PRE-FLOP *** 
Upswing11 folds
Pwinpwin raises 0.03€ to 0.05€
Rue115 folds
Fried Berg folds
Zile741 folds
ridiculuss folds
Pwinpwin collected 0.08€ from pot
*** SUMMARY ***
Total pot 0.08€ | No rake
Seat 4: Pwinpwin won 0.08€


Winamax Poker - HOLD-UP "Colorado" - HandId: #19116069-442076-1701516889 - Holdem no limit (0.01€/0.02€) - 2023/12/02 11:34:49 UTC
Table: 'Colorado' 6-max (real money) Seat #6 is the button
Seat 1: Kallonys (3.36€)
Seat 2: muespachois1 (2.87€)
Seat 3: Zile741 (5.50€)
Seat 4: El Paellas (0.52€)
Seat 5: Td08nomotto (2.19€)
Seat 6: Fried Berg (0.49€)
*** ANTE/BLINDS ***
Kallonys posts small blind 0.01€
muespachois1 posts big blind 0.02€
Dealt to Fried Berg [8c 6c]
*** PRE-FLOP *** 
Zile741 folds
El Paellas raises 0.03€ to 0.05€
Td08nomotto folds
Fried Berg folds
Kallonys folds
muespachois1 calls 0.03€
*** FLOP *** [Kh 5h 9d]
muespachois1 checks
El Paellas bets 0.07€
muespachois1 raises 2.75€ to 2.82€ and is all-in
El Paellas calls 0.40€ and is all-in
*** TURN *** [Kh 5h 9d][3h]
*** RIVER *** [Kh 5h 9d 3h][Jd]
*** SHOW DOWN ***
muespachois1 shows [Kd Ad] (One pair : Kings)
El Paellas shows [Ks As] (One pair : Kings)
El Paellas collected 0.47€ from main pot
muespachois1 collected 2.82€ from side pot 1
*** SUMMARY ***
Total pot 3.29€ | Rake 0.11€
Board: [Kh 5h 9d 3h Jd]
Seat 2: muespachois1 (big blind) showed [Kd Ad] and won 2.82€ with One pair : Kings
Seat 4: El Paellas showed [Ks As] and won 0.47€ with One pair : Kings


Winamax Poker - HOLD-UP "Colorado" - HandId: #19116069-442115-1701516915 - Holdem no limit (0.01€/0.02€) - 2023/12/02 11:35:15 UTC
Table: 'Colorado' 6-max (real money) Seat #6 is the button
Seat 1: KingSoto (2.98€)
Seat 2: Boomba___555 (2.27€)
Seat 3: Fried Berg (0.49€)
Seat 4: gagnejamais4 (1.96€)
Seat 5: YannSolo1 (4.71€)
Seat 6: JFSredbaron (5.85€)
*** ANTE/BLINDS ***
KingSoto posts small blind 0.01€
Boomba___555 posts big blind 0.02€
Dealt to Fried Berg [As Qh]
*** PRE-FLOP *** 
Fried Berg raises 0.02€ to 0.04€
gagnejamais4 folds
YannSolo1 folds
JFSredbaron calls 0.04€
KingSoto folds
Boomba___555 calls 0.02€
*** FLOP *** [4h 7d 9s]
Boomba___555 checks
Fried Berg bets 0.06€
JFSredbaron folds
Boomba___555 raises 0.06€ to 0.12€
Fried Berg calls 0.06€
*** TURN *** [4h 7d 9s][8d]
Boomba___555 bets 0.37€
Fried Berg folds
Boomba___555 collected 0.70€ from pot
*** SUMMARY ***
Total pot 0.70€ | Rake 0.04€
Board: [4h 7d 9s 8d]
Seat 2: Boomba___555 (big blind) won 0.70€


Winamax Poker - HOLD-UP "Colorado" - HandId: #19116069-442243-1701516994 - Holdem no limit (0.01€/0.02€) - 2023/12/02 11:36:34 UTC
Table: 'Colorado' 6-max (real money) Seat #6 is the button
Seat 1: JFSredbaron (4.73€)
Seat 2: Fried Berg (0.33€)
Seat 3: P.BaIkany (2.22€)
Seat 4: 14cruyff14 (0.50€)
Seat 5: Endha_ (2.52€)
Seat 6: Td08nomotto (2€)
*** ANTE/BLINDS ***
JFSredbaron posts small blind 0.01€
Fried Berg posts big blind 0.02€
Dealt to Fried Berg [Ad 2h]
*** PRE-FLOP *** 
P.BaIkany folds
14cruyff14 raises 0.04€ to 0.06€
Endha_ folds
Td08nomotto folds
JFSredbaron folds
Fried Berg folds
14cruyff14 collected 0.09€ from pot
*** SUMMARY ***
Total pot 0.09€ | No rake
Seat 4: 14cruyff14 won 0.09€


Winamax Poker - HOLD-UP "Colorado" - HandId: #19116069-442275-1701517014 - Holdem no limit (0.01€/0.02€) - 2023/12/02 11:36:54 UTC
Table: 'Colorado' 6-max (real money) Seat #6 is the button
Seat 1: Fried Berg (0.31€)
Seat 2: KON-2-PEUTE (2€)
Seat 3: JFSredbaron (4.72€)
Seat 4: LordShiva (0.81€)
Seat 5: Pwinpwin (4.09€)
Seat 6: StourmyFab (1.18€)
*** ANTE/BLINDS ***
Fried Berg posts small blind 0.01€
KON-2-PEUTE posts big blind 0.02€
Dealt to Fried Berg [4h Jh]
*** PRE-FLOP *** 
JFSredbaron folds
LordShiva folds
Pwinpwin raises 0.03€ to 0.05€
StourmyFab calls 0.05€
Fried Berg folds
KON-2-PEUTE folds
*** FLOP *** [Ah 3s Js]
Pwinpwin checks
StourmyFab bets 0.08€
Pwinpwin folds
StourmyFab collected 0.20€ from pot
*** SUMMARY ***
Total pot 0.20€ | Rake 0.01€
Board: [Ah 3s Js]
Seat 6: StourmyFab (button) won 0.20€


Winamax Poker - HOLD-UP "Colorado" - HandId: #19116069-442306-1701517036 - Holdem no limit (0.01€/0.02€) - 2023/12/02 11:37:16 UTC
Table: 'Colorado' 6-max (real money) Seat #6 is the button
Seat 1: Endha_ (4.59€)
Seat 2: Dame de pik (6.97€)
Seat 3: hello7585 (3.29€)
Seat 4: fifi2308 (1.80€)
Seat 5: Fried Berg (0.30€)
Seat 6: oliveponcar (3.62€)
Hold-up to Pot: total 0.10€
*** ANTE/BLINDS ***
Endha_ posts small blind 0.01€
Dame de pik posts big blind 0.02€
Dealt to Fried Berg [Qc Td]
*** PRE-FLOP *** 
hello7585 folds
fifi2308 folds
Fried Berg raises 0.02€ to 0.04€
oliveponcar folds
Endha_ calls 0.03€
Dame de pik calls 0.02€
*** FLOP *** [Ks 5h 3h]
Endha_ checks
Dame de pik checks
Fried Berg checks
*** TURN *** [Ks 5h 3h][4c]
Endha_ bets 0.14€
Dame de pik folds
Fried Berg folds
Endha_ collected 0.35€ from pot
*** SUMMARY ***
Total pot 0.35€ | Rake 0.01€
Board: [Ks 5h 3h 4c]
Seat 1: Endha_ (small blind) won 0.35€


Winamax Poker - HOLD-UP "Colorado" - HandId: #19116069-442394-1701517091 - Holdem no limit (0.01€/0.02€) - 2023/12/02 11:38:11 UTC
Table: 'Colorado' 6-max (real money) Seat #6 is the button
Seat 1: Boomba___555 (2.45€)
Seat 2: metamex (1.80€)
Seat 3: TaBrEaMoI (3.80€)
Seat 4: Fried Berg (0.26€)
Seat 5: Kallonys (2.04€)
Seat 6: Samuelillo07 (2.46€)
*** ANTE/BLINDS ***
Boomba___555 posts small blind 0.01€
metamex posts big blind 0.02€
Dealt to Fried Berg [Kc 9h]
*** PRE-FLOP *** 
TaBrEaMoI folds
Fried Berg folds
Kallonys folds
Samuelillo07 folds
Boomba___555 calls 0.01€
metamex checks
*** FLOP *** [3c 5c 8s]
Boomba___555 bets 0.03€
metamex calls 0.03€
*** TURN *** [3c 5c 8s][9d]
Boomba___555 checks
metamex checks
*** RIVER *** [3c 5c 8s 9d][4h]
Boomba___555 bets 0.10€
metamex folds
Boomba___555 collected 0.19€ from pot
*** SUMMARY ***
Total pot 0.19€ | Rake 0.01€
Board: [3c 5c 8s 9d 4h]
Seat 1: Boomba___555 (small blind) won 0.19€


Winamax Poker - HOLD-UP "Colorado" - HandId: #19116069-442396-1701517093 - Holdem no limit (0.01€/0.02€) - 2023/12/02 11:38:13 UTC
Table: 'Colorado' 6-max (real money) Seat #6 is the button
Seat 1: Zile741 (5.31€)
Seat 2: Fefekalome (2.28€)
Seat 3: Fried Berg (0.26€)
Seat 4: Mercuryllo (2.03€)
Seat 5: Bloodgold666 (2.09€)
Seat 6: Kibrouki58 (3.73€)
*** ANTE/BLINDS ***
Zile741 posts small blind 0.01€
Fefekalome posts big blind 0.02€
Dealt to Fried Berg [Th Ah]
*** PRE-FLOP *** 
Fried Berg raises 0.02€ to 0.04€
Mercuryllo folds
Bloodgold666 folds
Kibrouki58 folds
Zile741 folds
Fefekalome calls 0.02€
*** FLOP *** [2c 6s 8s]
Fefekalome checks
Fried Berg bets 0.16€
Fefekalome folds
Fried Berg collected 0.24€ from pot
*** SUMMARY ***
Total pot 0.24€ | Rake 0.01€
Board: [2c 6s 8s]
Seat 3: Fried Berg won 0.24€


Winamax Poker - HOLD-UP "Colorado" - HandId: #19116069-442464-1701517140 - Holdem no limit (0.01€/0.02€) - 2023/12/02 11:39:00 UTC
Table: 'Colorado' 6-max (real money) Seat #6 is the button
Seat 1: Snakesolid56 (2.14€)
Seat 2: Fried Berg (0.30€)
Seat 3: TaBrEaMoI (6.93€)
Seat 4: Upswing11 (2.32€)
Seat 5: Boomba___555 (2.52€)
Seat 6: P.BaIkany (2.70€)
*** ANTE/BLINDS ***
Snakesolid56 posts small blind 0.01€
Fried Berg posts big blind 0.02€
Dealt to Fried Berg [4d 6s]
*** PRE-FLOP *** 
TaBrEaMoI folds
Upswing11 folds
Boomba___555 raises 0.03€ to 0.05€
P.BaIkany folds
Snakesolid56 raises 0.12€ to 0.17€
Fried Berg folds
Boomba___555 calls 0.12€
*** FLOP *** [Kc Td 5h]
Snakesolid56 bets 0.23€
Boomba___555 calls 0.23€
*** TURN *** [Kc Td 5h][Jd]
Snakesolid56 bets 0.29€
Boomba___555 calls 0.29€
*** RIVER *** [Kc Td 5h Jd][Qh]
Snakesolid56 bets 1.45€ and is all-in
Boomba___555 folds
Snakesolid56 collected 2.71€ from pot
*** SUMMARY ***
Total pot 2.71€ | Rake 0.14€
Board: [Kc Td 5h Jd Qh]
Seat 1: Snakesolid56 (small blind) won 2.71€


Winamax Poker - HOLD-UP "Colorado" - HandId: #19116069-442483-1701517152 - Holdem no limit (0.01€/0.02€) - 2023/12/02 11:39:12 UTC
Table: 'Colorado' 6-max (real money) Seat #6 is the button
Seat 1: Fried Berg (0.28€)
Seat 2: NyKOh11 (0.50€)
Seat 3: Fefekalome (2.06€)
Seat 4: Samuelillo07 (2.09€)
Seat 5: tichettede3 (3.54€)
Seat 6: JFSredbaron (2€)
*** ANTE/BLINDS ***
Fried Berg posts small blind 0.01€
NyKOh11 posts big blind 0.02€
Dealt to Fried Berg [Ts Tc]
*** PRE-FLOP *** 
Fefekalome folds
Samuelillo07 folds
tichettede3 folds
JFSredbaron folds
Fried Berg raises 0.02€ to 0.04€
NyKOh11 calls 0.02€
*** FLOP *** [2c 4d 5d]
Fried Berg bets 0.08€
NyKOh11 folds
Fried Berg collected 0.15€ from pot
*** SUMMARY ***
Total pot 0.15€ | Rake 0.01€
Board: [2c 4d 5d]
Seat 1: Fried Berg (small blind) won 0.15€


Winamax Poker - HOLD-UP "Colorado" - HandId: #19116069-442520-1701517176 - Holdem no limit (0.01€/0.02€) - 2023/12/02 11:39:36 UTC
Table: 'Colorado' 6-max (real money) Seat #6 is the button
Seat 1: Td08nomotto (2€)
Seat 2: Quenelles (2€)
Seat 3: Zile741 (2.29€)
Seat 4: vuesurmer (2.06€)
Seat 5: P.BaIkany (2€)
Seat 6: Fried Berg (0.31€)
*** ANTE/BLINDS ***
Td08nomotto posts small blind 0.01€
Quenelles posts big blind 0.02€
Dealt to Fried Berg [2h Ah]
*** PRE-FLOP *** 
Zile741 raises 0.04€ to 0.06€
vuesurmer folds
P.BaIkany folds
Fried Berg calls 0.06€
Td08nomotto folds
Quenelles calls 0.04€
*** FLOP *** [Tc 7s 3d]
Quenelles checks
Zile741 checks
Fried Berg checks
*** TURN *** [Tc 7s 3d][7h]
Quenelles checks
Zile741 checks
Fried Berg checks
*** RIVER *** [Tc 7s 3d 7h][Qh]
Quenelles checks
Zile741 checks
Fried Berg checks
*** SHOW DOWN ***
Quenelles shows [9c 8c] (One pair : 7)
Fried Berg shows [2h Ah] (One pair : 7)
Zile741 shows [Ac Js] (One pair : 7)
Zile741 collected 0.17€ from pot
*** SUMMARY ***
Total pot 0.17€ | Rake 0.02€
Board: [Tc 7s 3d 7h Qh]
Seat 2: Quenelles (big blind) showed [9c 8c] and lost with One pair : 7
Seat 3: Zile741 showed [Ac Js] and won 0.17€ with One pair : 7
Seat 6: Fried Berg (button) showed [2h Ah] and lost with One pair : 7


Winamax Poker - HOLD-UP "Colorado" - HandId: #19116069-442589-1701517219 - Holdem no limit (0.01€/0.02€) - 2023/12/02 11:40:19 UTC
Table: 'Colorado' 6-max (real money) Seat #6 is the button
Seat 1: Td08nomotto (2€)
Seat 2: El Paellas (0.50€)
Seat 3: magnumbenji (4.21€)
Seat 4: Fried Berg (0.25€)
Seat 5: Kipyomag (2€)
Seat 6: gagnejamais4 (2.21€)
*** ANTE/BLINDS ***
Td08nomotto posts small blind 0.01€
El Paellas posts big blind 0.02€
Dealt to Fried Berg [6s As]
*** PRE-FLOP *** 
magnumbenji folds
Fried Berg raises 0.02€ to 0.04€
Kipyomag folds
gagnejamais4 calls 0.04€
Td08nomotto folds
El Paellas folds
*** FLOP *** [Jd 7s 2c]
Fried Berg checks
gagnejamais4 bets 0.11€
Fried Berg folds
gagnejamais4 collected 0.21€ from pot
*** SUMMARY ***
Total pot 0.21€ | Rake 0.01€
Board: [Jd 7s 2c]
Seat 6: gagnejamais4 (button) won 0.21€


Winamax Poker - HOLD-UP "Colorado" - HandId: #19116069-442650-1701517257 - Holdem no limit (0.01€/0.02€) - 2023/12/02 11:40:57 UTC
Table: 'Colorado' 6-max (real money) Seat #6 is the button
Seat 1: Zile741 (2.41€)
Seat 2: Td08nomotto (2.01€)
Seat 3: chaketovibet (2.15€)
Seat 4: JOK-R777 (3.44€)
Seat 5: Fried Berg (0.21€)
Seat 6: PoKKer_sAAn (2€)
*** ANTE/BLINDS ***
Zile741 posts small blind 0.01€
Td08nomotto posts big blind 0.02€
Dealt to Fried Berg [Ks 5s]
*** PRE-FLOP *** 
chaketovibet folds
JOK-R777 raises 0.03€ to 0.05€
Fried Berg folds
PoKKer_sAAn calls 0.05€
Zile741 folds
Td08nomotto folds
*** FLOP *** [9s 2s 8h]
JOK-R777 checks
PoKKer_sAAn bets 0.13€
JOK-R777 folds
PoKKer_sAAn collected 0.25€ from pot
*** SUMMARY ***
Total pot 0.25€ | Rake 0.01€
Board: [9s 2s 8h]
Seat 6: PoKKer_sAAn (button) won 0.25€


Winamax Poker - HOLD-UP "Colorado" - HandId: #19116069-442663-1701517267 - Holdem no limit (0.01€/0.02€) - 2023/12/02 11:41:07 UTC
Table: 'Colorado' 6-max (real money) Seat #6 is the button
Seat 1: El Paellas (0.50€)
Seat 2: laconalostra (2€)
Seat 3: TaBrEaMoI (3.09€)
Seat 4: Ambientador0 (0.37€)
Seat 5: Fried Berg (0.21€)
Seat 6: PIQSOU (2.32€)
*** ANTE/BLINDS ***
El Paellas posts small blind 0.01€
laconalostra posts big blind 0.02€
Dealt to Fried Berg [5s Ac]
*** PRE-FLOP *** 
TaBrEaMoI folds
Ambientador0 folds
Fried Berg folds
PIQSOU folds
El Paellas folds
laconalostra collected 0.03€ from pot
*** SUMMARY ***
Total pot 0.03€ | No rake
Seat 2: laconalostra (big blind) won 0.03€


Winamax Poker - HOLD-UP "Colorado" - HandId: #19116069-442668-1701517271 - Holdem no limit (0.01€/0.02€) - 2023/12/02 11:41:11 UTC
Table: 'Colorado' 6-max (real money) Seat #6 is the button
Seat 1: ridiculuss (2.01€)
Seat 2: Stackbystack (2.38€)
Seat 3: Fried Berg (0.21€)
Seat 4: TaBrEaMoI (8.23€)
Seat 5: PIQSOU (2.32€)
Seat 6: muespachois1 (2.54€)
*** ANTE/BLINDS ***
ridiculuss posts small blind 0.01€
Stackbystack posts big blind 0.02€
Dealt to Fried Berg [Ac 5h]
*** PRE-FLOP *** 
Fried Berg folds
TaBrEaMoI folds
PIQSOU folds
muespachois1 folds
ridiculuss folds
Stackbystack collected 0.03€ from pot
*** SUMMARY ***
Total pot 0.03€ | No rake
Seat 2: Stackbystack (big blind) won 0.03€


Winamax Poker - HOLD-UP "Colorado" - HandId: #19116069-442669-1701517272 - Holdem no limit (0.01€/0.02€) - 2023/12/02 11:41:12 UTC
Table: 'Colorado' 6-max (real money) Seat #6 is the button
Seat 1: Fried Berg (0.21€)
Seat 2: 14cruyff14 (0.50€)
Seat 3: Endha_ (2.23€)
Seat 4: durba (1.87€)
Seat 5: NyKOh11 (0.55€)
Seat 6: ridiculuss (2€)
*** ANTE/BLINDS ***
Fried Berg posts small blind 0.01€
14cruyff14 posts big blind 0.02€
Dealt to Fried Berg [6d Qs]
*** PRE-FLOP *** 
Endha_ folds
durba folds
NyKOh11 folds
ridiculuss folds
Fried Berg folds
14cruyff14 collected 0.03€ from pot
*** SUMMARY ***
Total pot 0.03€ | No rake
Seat 2: 14cruyff14 (big blind) won 0.03€


Winamax Poker - HOLD-UP "Colorado" - HandId: #19116069-442673-1701517274 - Holdem no limit (0.01€/0.02€) - 2023/12/02 11:41:14 UTC
Table: 'Colorado' 6-max (real money) Seat #6 is the button
Seat 1: popoche29 (2.09€)
Seat 2: Fried Berg (0.20€)
Seat 3: tichettede3 (3.49€)
Seat 4: NumaCo (2.66€)
Seat 5: TaBrEaMoI (4.58€)
Seat 6: pedrohxx (1.87€)
*** ANTE/BLINDS ***
popoche29 posts small blind 0.01€
Fried Berg posts big blind 0.02€
Dealt to Fried Berg [Jc 6h]
*** PRE-FLOP *** 
tichettede3 folds
NumaCo folds
TaBrEaMoI folds
pedrohxx folds
popoche29 folds
Fried Berg collected 0.03€ from pot
*** SUMMARY ***
Total pot 0.03€ | No rake
Seat 2: Fried Berg (big blind) won 0.03€


Winamax Poker - HOLD-UP "Colorado" - HandId: #19116069-442688-1701517286 - Holdem no limit (0.01€/0.02€) - 2023/12/02 11:41:26 UTC
Table: 'Colorado' 6-max (real money) Seat #6 is the button
Seat 1: P.BaIkany (2€)
Seat 2: JFSredbaron (2.94€)
Seat 3: NyKOh11 (0.52€)
Seat 4: Fried Berg (0.21€)
Seat 5: El Paellas (0.67€)
Seat 6: Mercuryllo (2€)
*** ANTE/BLINDS ***
P.BaIkany posts small blind 0.01€
JFSredbaron posts big blind 0.02€
Dealt to Fried Berg [2h 7s]
*** PRE-FLOP *** 
NyKOh11 folds
Fried Berg folds
El Paellas folds
Mercuryllo folds
P.BaIkany folds
JFSredbaron collected 0.03€ from pot
*** SUMMARY ***
Total pot 0.03€ | No rake
Seat 2: JFSredbaron (big blind) won 0.03€


Winamax Poker - HOLD-UP "Colorado" - HandId: #19116069-442695-1701517291 - Holdem no limit (0.01€/0.02€) - 2023/12/02 11:41:31 UTC
Table: 'Colorado' 6-max (real money) Seat #6 is the button
Seat 1: Td08nomotto (2.20€)
Seat 2: Baston57 (4.03€)
Seat 3: Lxs01 (3.48€)
Seat 4: Pwinpwin (3.94€)
Seat 5: Stackbystack (2.49€)
Seat 6: Fried Berg (0.21€)
*** ANTE/BLINDS ***
Td08nomotto posts small blind 0.01€
Baston57 posts big blind 0.02€
Dealt to Fried Berg [Qh 2h]
*** PRE-FLOP *** 
Lxs01 raises 0.03€ to 0.05€
Pwinpwin folds
Stackbystack folds
Fried Berg folds
Td08nomotto folds
Baston57 calls 0.03€
*** FLOP *** [3c 2d 6h]
Baston57 checks
Lxs01 bets 0.11€
Baston57 calls 0.11€
*** TURN *** [3c 2d 6h][Kc]
Baston57 checks
Lxs01 bets 0.12€
Baston57 calls 0.12€
*** RIVER *** [3c 2d 6h Kc][9d]
Baston57 bets 3.75€ and is all-in
Lxs01 folds
Baston57 collected 4.26€ from pot
*** SUMMARY ***
Total pot 4.26€ | Rake 0.06€
Board: [3c 2d 6h Kc 9d]
Seat 2: Baston57 (big blind) won 4.26€


Winamax Poker - HOLD-UP "Colorado" - HandId: #19116069-442700-1701517294 - Holdem no limit (0.01€/0.02€) - 2023/12/02 11:41:34 UTC
Table: 'Colorado' 6-max (real money) Seat #6 is the button
Seat 1: popoche29 (2.06€)
Seat 2: Black-Bull (2.49€)
Seat 3: TaBrEaMoI (4.57€)
Seat 4: Fried Berg (0.21€)
Seat 5: NumaCo (2.66€)
Seat 6: Ambientador0 (0.35€)
*** ANTE/BLINDS ***
popoche29 posts small blind 0.01€
Black-Bull posts big blind 0.02€
Dealt to Fried Berg [9s 8d]
*** PRE-FLOP *** 
TaBrEaMoI folds
Fried Berg folds
NumaCo raises 0.04€ to 0.06€
Ambientador0 folds
popoche29 folds
Black-Bull folds
NumaCo collected 0.09€ from pot
*** SUMMARY ***
Total pot 0.09€ | No rake
Seat 5: NumaCo won 0.09€


Winamax Poker - HOLD-UP "Colorado" - HandId: #19116069-442704-1701517296 - Holdem no limit (0.01€/0.02€) - 2023/12/02 11:41:36 UTC
Table: 'Colorado' 6-max (real money) Seat #6 is the button
Seat 1: Kallonys (3.16€)
Seat 2: Fried Berg (0.21€)
Seat 3: lASASin (2.30€)
Seat 4: P.BaIkany (2€)
Seat 5: TaBrEaMoI (4.57€)
Seat 6: Td08nomotto (2€)
*** ANTE/BLINDS ***
Kallonys posts small blind 0.01€
Fried Berg posts big blind 0.02€
Dealt to Fried Berg [Js Qd]
*** PRE-FLOP *** 
lASASin raises 0.04€ to 0.06€
P.BaIkany folds
TaBrEaMoI folds
Td08nomotto folds
Kallonys folds
Fried Berg raises 0.12€ to 0.18€
lASASin folds
Fried Berg collected 0.25€ from pot
*** SUMMARY ***
Total pot 0.25€ | No rake
Seat 2: Fried Berg (big blind) won 0.25€


Winamax Poker - HOLD-UP "Colorado" - HandId: #19116069-442727-1701517312 - Holdem no limit (0.01€/0.02€) - 2023/12/02 11:41:52 UTC
Table: 'Colorado' 6-max (real money) Seat #6 is the button
Seat 1: Fried Berg (0.28€)
Seat 2: Stackbystack (2€)
Seat 3: P.BaIkany (2.61€)
Seat 4: l artiste ho (1.90€)
Seat 5: Td08nomotto (2.17€)
Seat 6: lASASin (1.41€)
*** ANTE/BLINDS ***
Fried Berg posts small blind 0.01€
Stackbystack posts big blind 0.02€
Dealt to Fried Berg [Jc Tc]
*** PRE-FLOP *** 
P.BaIkany raises 0.04€ to 0.06€
l artiste ho folds
Td08nomotto folds
lASASin calls 0.06€
Fried Berg calls 0.05€
Stackbystack calls 0.04€
*** FLOP *** [Jh Jd 8c]
Fried Berg bets 0.06€
Stackbystack folds
P.BaIkany calls 0.06€
lASASin calls 0.06€
*** TURN *** [Jh Jd 8c][2s]
Fried Berg bets 0.16€ and is all-in
P.BaIkany calls 0.16€
lASASin calls 0.16€
*** RIVER *** [Jh Jd 8c 2s][Js]
P.BaIkany checks
lASASin bets 0.16€
P.BaIkany calls 0.16€
*** SHOW DOWN ***
lASASin shows [8h 8s] (Full of Jacks and 8)
Fried Berg shows [Jc Tc] (Quads of Jacks)
P.BaIkany shows [Qc Qd] (Full of Jacks and Queens)
P.BaIkany collected 0.29€ from side pot 1
Fried Berg collected 0.81€ from main pot
*** SUMMARY ***
Total pot 1.10€ | Rake 0.12€
Board: [Jh Jd 8c 2s Js]
Seat 1: Fried Berg (small blind) showed [Jc Tc] and won 0.81€ with Quads of Jacks
Seat 3: P.BaIkany showed [Qc Qd] and won 0.29€ with Full of Jacks and Queens
Seat 6: lASASin (button) showed [8h 8s] and lost with Full of Jacks and 8


Winamax Poker - HOLD-UP "Colorado" - HandId: #19116069-442812-1701517370 - Holdem no limit (0.01€/0.02€) - 2023/12/02 11:42:50 UTC
Table: 'Colorado' 6-max (real money) Seat #6 is the button
Seat 1: Td08nomotto (2.12€)
Seat 2: P.BaIkany (2.46€)
Seat 3: -Y4V- (2.38€)
Seat 4: Hall-in8z (1.63€)
Seat 5: Fried Berg (0.81€)
Seat 6: jdeepenslip (3.98€)
*** ANTE/BLINDS ***
Td08nomotto posts small blind 0.01€
P.BaIkany posts big blind 0.02€
Dealt to Fried Berg [8c Js]
*** PRE-FLOP *** 
-Y4V- raises 0.04€ to 0.06€
Hall-in8z folds
Fried Berg folds
jdeepenslip folds
Td08nomotto folds
P.BaIkany calls 0.04€
*** FLOP *** [Ks Ts Ad]
P.BaIkany checks
-Y4V- checks
*** TURN *** [Ks Ts Ad][5s]
P.BaIkany checks
-Y4V- checks
*** RIVER *** [Ks Ts Ad 5s][Jh]
P.BaIkany bets 0.10€
-Y4V- folds
P.BaIkany collected 0.22€ from pot
*** SUMMARY ***
Total pot 0.22€ | Rake 0.01€
Board: [Ks Ts Ad 5s Jh]
Seat 2: P.BaIkany (big blind) won 0.22€


Winamax Poker - HOLD-UP "Colorado" - HandId: #19116069-442822-1701517378 - Holdem no limit (0.01€/0.02€) - 2023/12/02 11:42:58 UTC
Table: 'Colorado' 6-max (real money) Seat #6 is the button
Seat 1: vuesurmer (2.23€)
Seat 2: durba (1.82€)
Seat 3: Fried Berg (0.81€)
Seat 4: LordShiva (0.62€)
Seat 5: Mercuryllo (2€)
Seat 6: KON-2-PEUTE (2€)
*** ANTE/BLINDS ***
vuesurmer posts small blind 0.01€
durba posts big blind 0.02€
Dealt to Fried Berg [7s 3c]
*** PRE-FLOP *** 
Fried Berg folds
LordShiva folds
Mercuryllo folds
KON-2-PEUTE folds
vuesurmer folds
durba collected 0.03€ from pot
*** SUMMARY ***
Total pot 0.03€ | No rake
Seat 2: durba (big blind) won 0.03€


Winamax Poker - HOLD-UP "Colorado" - HandId: #19116069-442828-1701517383 - Holdem no limit (0.01€/0.02€) - 2023/12/02 11:43:03 UTC
Table: 'Colorado' 6-max (real money) Seat #6 is the button
Seat 1: theSangoten (1.86€)
Seat 2: Wolfert (2.27€)
Seat 3: jello420 (2.06€)
Seat 4: p4ppysl4m (1.25€)
Seat 5: YannSolo1 (3.13€)
Seat 6: Fried Berg (0.81€)
*** ANTE/BLINDS ***
theSangoten posts small blind 0.01€
Wolfert posts big blind 0.02€
Dealt to Fried Berg [Ad 7c]
*** PRE-FLOP *** 
jello420 folds
p4ppysl4m folds
YannSolo1 folds
Fried Berg raises 0.02€ to 0.04€
theSangoten calls 0.03€
Wolfert folds
*** FLOP *** [3d 3c Qc]
theSangoten checks
Fried Berg checks
*** TURN *** [3d 3c Qc][Ah]
theSangoten checks
Fried Berg checks
*** RIVER *** [3d 3c Qc Ah][9d]
theSangoten bets 0.05€
Fried Berg calls 0.05€
*** SHOW DOWN ***
theSangoten shows [7d Ac] (Two pairs : Aces and 3)
Fried Berg shows [Ad 7c] (Two pairs : Aces and 3)
Fried Berg collected 0.09€ from pot
theSangoten collected 0.09€ from pot
*** SUMMARY ***
Total pot 0.18€ | Rake 0.02€
Board: [3d 3c Qc Ah 9d]
Seat 1: theSangoten (small blind) showed [7d Ac] and won 0.09€ with Two pairs : Aces and 3
Seat 6: Fried Berg (button) showed [Ad 7c] and won 0.09€ with Two pairs : Aces and 3


Winamax Poker - HOLD-UP "Colorado" - HandId: #19116069-442862-1701517404 - Holdem no limit (0.01€/0.02€) - 2023/12/02 11:43:24 UTC
Table: 'Colorado' 6-max (real money) Seat #6 is the button
Seat 1: Babi78_ (2.22€)
Seat 2: jdeepenslip (4.11€)
Seat 3: theSangoten (1.86€)
Seat 4: Itashi.95 (2.27€)
Seat 5: Fried Berg (0.81€)
Seat 6: vuesurmer (2.22€)
*** ANTE/BLINDS ***
Babi78_ posts small blind 0.01€
jdeepenslip posts big blind 0.02€
Dealt to Fried Berg [7d 5h]
*** PRE-FLOP *** 
theSangoten folds
Itashi.95 folds
Fried Berg folds
vuesurmer folds
Babi78_ calls 0.01€
jdeepenslip raises 0.10€ to 0.12€
Babi78_ calls 0.10€
*** FLOP *** [7c 6h 3d]
Babi78_ checks
jdeepenslip checks
*** TURN *** [7c 6h 3d][9d]
Babi78_ checks
jdeepenslip checks
*** RIVER *** [7c 6h 3d 9d][Ah]
Babi78_ bets 0.08€
jdeepenslip folds
Babi78_ collected 0.30€ from pot
*** SUMMARY ***
Total pot 0.30€ | Rake 0.02€
Board: [7c 6h 3d 9d Ah]
Seat 1: Babi78_ (small blind) won 0.30€


Winamax Poker - HOLD-UP "Colorado" - HandId: #19116069-442867-1701517408 - Holdem no limit (0.01€/0.02€) - 2023/12/02 11:43:28 UTC
Table: 'Colorado' 6-max (real money) Seat #6 is the button
Seat 1: muespachois1 (2.39€)
Seat 2: ridiculuss (2.46€)
Seat 3: Fried Berg (0.81€)
Seat 4: -Y4V- (2.32€)
Seat 5: Zile741 (3.67€)
Seat 6: Td08nomotto (2.06€)
*** ANTE/BLINDS ***
muespachois1 posts small blind 0.01€
ridiculuss posts big blind 0.02€
Dealt to Fried Berg [Ac As]
*** PRE-FLOP *** 
Fried Berg raises 0.04€ to 0.06€
-Y4V- folds
Zile741 folds
Td08nomotto folds
muespachois1 folds
ridiculuss raises 0.13€ to 0.19€
Fried Berg raises 0.14€ to 0.33€
ridiculuss raises 2.13€ to 2.46€ and is all-in
Fried Berg calls 0.48€ and is all-in
*** FLOP *** [4s Ad Jc]
*** TURN *** [4s Ad Jc][9h]
*** RIVER *** [4s Ad Jc 9h][2c]
*** SHOW DOWN ***
ridiculuss shows [Kd Kh] (One pair : Kings)
Fried Berg shows [Ac As] (Trips of Aces)
Fried Berg collected 1.47€ from main pot
ridiculuss collected 1.65€ from side pot 1
*** SUMMARY ***
Total pot 3.12€ | Rake 0.16€
Board: [4s Ad Jc 9h 2c]
Seat 2: ridiculuss (big blind) showed [Kd Kh] and won 1.65€ with One pair : Kings
Seat 3: Fried Berg showed [Ac As] and won 1.47€ with Trips of Aces


Winamax Poker - HOLD-UP "Colorado" - HandId: #19116069-442948-1701517453 - Holdem no limit (0.01€/0.02€) - 2023/12/02 11:44:13 UTC
Table: 'Colorado' 6-max (real money) Seat #6 is the button
Seat 1: ridiculuss (1.65€)
Seat 2: Fried Berg (1.47€)
Seat 3: Samuelillo07 (2.43€)
Seat 4: metamex (1.63€)
Seat 5: Stackbystack (2.27€)
Seat 6: TaBrEaMoI (3.24€)
*** ANTE/BLINDS ***
ridiculuss posts small blind 0.01€
Fried Berg posts big blind 0.02€
Dealt to Fried Berg [Ts Kh]
*** PRE-FLOP *** 
Samuelillo07 folds
metamex folds
Stackbystack folds
TaBrEaMoI raises 0.04€ to 0.06€
ridiculuss folds
Fried Berg folds
TaBrEaMoI collected 0.09€ from pot
*** SUMMARY ***
Total pot 0.09€ | No rake
Seat 6: TaBrEaMoI (button) won 0.09€


Winamax Poker - HOLD-UP "Colorado" - HandId: #19116069-442968-1701517466 - Holdem no limit (0.01€/0.02€) - 2023/12/02 11:44:26 UTC
Table: 'Colorado' 6-max (real money) Seat #6 is the button
Seat 1: vuesurmer (2.16€)
Seat 2: Jimbiosis (2.57€)
Seat 3: Ambientador0 (0.71€)
Seat 4: Fried Berg (1.45€)
Seat 5: Samuelillo07 (3.94€)
Seat 6: JFSredbaron (4.30€)
*** ANTE/BLINDS ***
vuesurmer posts small blind 0.01€
Jimbiosis posts big blind 0.02€
Dealt to Fried Berg [9h Tc]
*** PRE-FLOP *** 
Ambientador0 folds
Fried Berg folds
Samuelillo07 folds
JFSredbaron folds
vuesurmer raises 0.04€ to 0.06€
Jimbiosis calls 0.04€
*** FLOP *** [2h Kh 6s]
vuesurmer checks
Jimbiosis checks
*** TURN *** [2h Kh 6s][3h]
vuesurmer bets 0.08€
Jimbiosis folds
vuesurmer collected 0.19€ from pot
*** SUMMARY ***
Total pot 0.19€ | Rake 0.01€
Board: [2h Kh 6s 3h]
Seat 1: vuesurmer (small blind) won 0.19€


Winamax Poker - HOLD-UP "Colorado" - HandId: #19116069-442983-1701517473 - Holdem no limit (0.01€/0.02€) - 2023/12/02 11:44:33 UTC
Table: 'Colorado' 6-max (real money) Seat #6 is the button
Seat 1: Fried Berg (1.45€)
Seat 2: Pwinpwin (2€)
Seat 3: popoche29 (1.04€)
Seat 4: benzappa (2.94€)
Seat 5: Td08nomotto (2€)
Seat 6: jdeepenslip (3.99€)
*** ANTE/BLINDS ***
Fried Berg posts small blind 0.01€
Pwinpwin posts big blind 0.02€
Dealt to Fried Berg [8c 3s]
*** PRE-FLOP *** 
popoche29 folds
benzappa folds
Td08nomotto folds
jdeepenslip folds
Fried Berg folds
Pwinpwin collected 0.03€ from pot
*** SUMMARY ***
Total pot 0.03€ | No rake
Seat 2: Pwinpwin (big blind) won 0.03€


Winamax Poker - HOLD-UP "Colorado" - HandId: #19116069-442990-1701517478 - Holdem no limit (0.01€/0.02€) - 2023/12/02 11:44:38 UTC
Table: 'Colorado' 6-max (real money) Seat #6 is the button
Seat 1: Samuelillo07 (3.69€)
Seat 2: benzappa (2.94€)
Seat 3: Fried Berg (1.44€)
Seat 4: El Paellas (0.50€)
Seat 5: Nonik1987 (0.40€)
Seat 6: laconalostra (2.09€)
*** ANTE/BLINDS ***
Samuelillo07 posts small blind 0.01€
benzappa posts big blind 0.02€
Dealt to Fried Berg [7s 6c]
*** PRE-FLOP *** 
Fried Berg folds
El Paellas raises 0.03€ to 0.05€
Nonik1987 calls 0.05€
laconalostra folds
Samuelillo07 folds
benzappa folds
*** FLOP *** [9d 5s 8s]
El Paellas checks
Nonik1987 checks
*** TURN *** [9d 5s 8s][Ac]
El Paellas bets 0.08€
Nonik1987 folds
El Paellas collected 0.20€ from pot
*** SUMMARY ***
Total pot 0.20€ | Rake 0.01€
Board: [9d 5s 8s Ac]
Seat 4: El Paellas won 0.20€


Winamax Poker - HOLD-UP "Colorado" - HandId: #19116069-442993-1701517480 - Holdem no limit (0.01€/0.02€) - 2023/12/02 11:44:40 UTC
Table: 'Colorado' 6-max (real money) Seat #6 is the button
Seat 1: Endha_ (2.43€)
Seat 2: TheNerd (2€)
Seat 3: P.BaIkany (2.69€)
Seat 4: TaBrEaMoI (4.56€)
Seat 5: Fried Berg (1.44€)
Seat 6: durba (1.67€)
*** ANTE/BLINDS ***
Endha_ posts small blind 0.01€
TheNerd posts big blind 0.02€
Dealt to Fried Berg [Qh 7d]
*** PRE-FLOP *** 
P.BaIkany folds
TaBrEaMoI folds
Fried Berg folds
durba folds
Endha_ folds
TheNerd collected 0.03€ from pot
*** SUMMARY ***
Total pot 0.03€ | No rake
Seat 2: TheNerd (big blind) won 0.03€


Winamax Poker - HOLD-UP "Colorado" - HandId: #19116069-443004-1701517487 - Holdem no limit (0.01€/0.02€) - 2023/12/02 11:44:47 UTC
Table: 'Colorado' 6-max (real money) Seat #6 is the button
Seat 1: tichettede3 (2.91€)
Seat 2: Fried Berg (1.44€)
Seat 3: JFSredbaron (5.59€)
Seat 4: jdeepenslip (3.98€)
Seat 5: Ambientador0 (0.54€)
Seat 6: Td08nomotto (2.03€)
*** ANTE/BLINDS ***
tichettede3 posts small blind 0.01€
Fried Berg posts big blind 0.02€
Dealt to Fried Berg [Th 2s]
*** PRE-FLOP *** 
JFSredbaron folds
jdeepenslip raises 0.03€ to 0.05€
Ambientador0 folds
Td08nomotto folds
tichettede3 folds
Fried Berg folds
jdeepenslip collected 0.08€ from pot
*** SUMMARY ***
Total pot 0.08€ | No rake
Seat 4: jdeepenslip won 0.08€


Winamax Poker - HOLD-UP "Colorado" - HandId: #19116069-443019-1701517496 - Holdem no limit (0.01€/0.02€) - 2023/12/02 11:44:56 UTC
Table: 'Colorado' 6-max (real money) Seat #6 is the button
Seat 1: Kekoke (0.42€)
Seat 2: Dit_Bondour (2€)
Seat 3: TaBrEaMoI (3.26€)
Seat 4: Fried Berg (1.42€)
Seat 5: metamex (1.57€)
Seat 6: Stackbystack (2.42€)
*** ANTE/BLINDS ***
Kekoke posts small blind 0.01€
Dit_Bondour posts big blind 0.02€
Dealt to Fried Berg [Tc 6c]
*** PRE-FLOP *** 
TaBrEaMoI folds
Fried Berg folds
metamex folds
Stackbystack calls 0.02€
Kekoke calls 0.01€
Dit_Bondour checks
*** FLOP *** [Ts Ah 2c]
Kekoke checks
Dit_Bondour checks
Stackbystack checks
*** TURN *** [Ts Ah 2c][2d]
Kekoke checks
Dit_Bondour checks
Stackbystack checks
*** RIVER *** [Ts Ah 2c 2d][4d]
Kekoke checks
Dit_Bondour checks
Stackbystack checks
*** SHOW DOWN ***
Kekoke shows [9d Qc] (One pair : 2)
Dit_Bondour shows [7c 9c] (One pair : 2)
Stackbystack shows [3s 3d] (Two pairs : 3 and 2)
Stackbystack collected 0.05€ from pot
*** SUMMARY ***
Total pot 0.05€ | Rake 0.01€
Board: [Ts Ah 2c 2d 4d]
Seat 1: Kekoke (small blind) showed [9d Qc] and lost with One pair : 2
Seat 2: Dit_Bondour (big blind) showed [7c 9c] and lost with One pair : 2
Seat 6: Stackbystack (button) showed [3s 3d] and won 0.05€ with Two pairs : 3 and 2


Winamax Poker - HOLD-UP "Colorado" - HandId: #19116069-443038-1701517507 - Holdem no limit (0.01€/0.02€) - 2023/12/02 11:45:07 UTC
Table: 'Colorado' 6-max (real money) Seat #6 is the button
Seat 1: Fried Berg (1.42€)
Seat 2: -KrAKPAs- (2.67€)
Seat 3: Wolfert (2.20€)
Seat 4: Wiwidu78 (2.45€)
Seat 5: tichettede3 (2.89€)
Seat 6: Zile741 (3.75€)
*** ANTE/BLINDS ***
Fried Berg posts small blind 0.01€
-KrAKPAs- posts big blind 0.02€
Dealt to Fried Berg [6s 4c]
*** PRE-FLOP *** 
Wolfert folds
Wiwidu78 raises 0.04€ to 0.06€
tichettede3 folds
Zile741 folds
Fried Berg folds
-KrAKPAs- calls 0.04€
*** FLOP *** [5h 9h Kc]
-KrAKPAs- bets 0.08€
Wiwidu78 calls 0.08€
*** TURN *** [5h 9h Kc][8c]
-KrAKPAs- bets 0.10€
Wiwidu78 calls 0.10€
*** RIVER *** [5h 9h Kc 8c][7d]
-KrAKPAs- checks
Wiwidu78 checks
*** SHOW DOWN ***
-KrAKPAs- shows [3d 9d] (One pair : 9)
Wiwidu78 shows [Kh Jd] (One pair : Kings)
Wiwidu78 collected 0.44€ from pot
*** SUMMARY ***
Total pot 0.44€ | Rake 0.05€
Board: [5h 9h Kc 8c 7d]
Seat 2: -KrAKPAs- (big blind) showed [3d 9d] and lost with One pair : 9
Seat 4: Wiwidu78 showed [Kh Jd] and won 0.44€ with One pair : Kings


Winamax Poker - HOLD-UP "Colorado" - HandId: #19116069-443053-1701517514 - Holdem no limit (0.01€/0.02€) - 2023/12/02 11:45:14 UTC
Table: 'Colorado' 6-max (real money) Seat #6 is the button
Seat 1: TaBrEaMoI (3.24€)
Seat 2: Pwinpwin (2.57€)
Seat 3: jdeepenslip (3.99€)
Seat 4: Fried Berg (1.41€)
Seat 5: 14cruyff14 (0.52€)
Seat 6: MaryAthena (0.61€)
*** ANTE/BLINDS ***
TaBrEaMoI posts small blind 0.01€
Pwinpwin posts big blind 0.02€
Dealt to Fried Berg [3c 7h]
*** PRE-FLOP *** 
jdeepenslip folds
Fried Berg folds
14cruyff14 folds
MaryAthena calls 0.02€
TaBrEaMoI folds
Pwinpwin checks
*** FLOP *** [2h Kd 5d]
Pwinpwin checks
MaryAthena checks
*** TURN *** [2h Kd 5d][9c]
Pwinpwin checks
MaryAthena checks
*** RIVER *** [2h Kd 5d 9c][3h]
Pwinpwin checks
MaryAthena bets 0.02€
Pwinpwin folds
MaryAthena collected 0.06€ from pot
*** SUMMARY ***
Total pot 0.06€ | Rake 0.01€
Board: [2h Kd 5d 9c 3h]
Seat 6: MaryAthena (button) won 0.06€


Winamax Poker - HOLD-UP "Colorado" - HandId: #19116069-443059-1701517518 - Holdem no limit (0.01€/0.02€) - 2023/12/02 11:45:18 UTC
Table: 'Colorado' 6-max (real money) Seat #6 is the button
Seat 1: DONpere (1.61€)
Seat 2: JFSredbaron (5.83€)
Seat 3: jdeepenslip (3.99€)
Seat 4: Endha_ (2.39€)
Seat 5: TaBrEaMoI (3.23€)
Seat 6: Fried Berg (1.41€)
*** ANTE/BLINDS ***
DONpere posts small blind 0.01€
JFSredbaron posts big blind 0.02€
Dealt to Fried Berg [6c 6s]
*** PRE-FLOP *** 
jdeepenslip folds
Endha_ folds
TaBrEaMoI folds
Fried Berg raises 0.04€ to 0.06€
DONpere folds
JFSredbaron raises 0.13€ to 0.19€
Fried Berg calls 0.13€
*** FLOP *** [5c 5d Ac]
JFSredbaron bets 0.14€
Fried Berg calls 0.14€
*** TURN *** [5c 5d Ac][3c]
JFSredbaron bets 0.44€
Fried Berg folds
JFSredbaron collected 1.04€ from pot
*** SUMMARY ***
Total pot 1.04€ | Rake 0.07€
Board: [5c 5d Ac 3c]
Seat 2: JFSredbaron (big blind) won 1.04€


Winamax Poker - HOLD-UP "Colorado" - HandId: #19116069-443123-1701517562 - Holdem no limit (0.01€/0.02€) - 2023/12/02 11:46:02 UTC
Table: 'Colorado' 6-max (real money) Seat #6 is the button
Seat 1: 14cruyff14 (0.50€)
Seat 2: Black-Bull (2€)
Seat 3: El Paellas (0.53€)
Seat 4: Dit_Bondour (2€)
Seat 5: Samuelillo07 (3.63€)
Seat 6: Fried Berg (1.08€)
*** ANTE/BLINDS ***
14cruyff14 posts small blind 0.01€
Black-Bull posts big blind 0.02€
Dealt to Fried Berg [3h 2s]
*** PRE-FLOP *** 
El Paellas folds
Dit_Bondour folds
Samuelillo07 folds
Fried Berg folds
14cruyff14 folds
Black-Bull collected 0.03€ from pot
*** SUMMARY ***
Total pot 0.03€ | No rake
Seat 2: Black-Bull (big blind) won 0.03€


Winamax Poker - HOLD-UP "Colorado" - HandId: #19116069-443129-1701517567 - Holdem no limit (0.01€/0.02€) - 2023/12/02 11:46:07 UTC
Table: 'Colorado' 6-max (real money) Seat #6 is the button
Seat 1: Dit_Bondour (2.51€)
Seat 2: El Paellas (0.53€)
Seat 3: Abec16 (3.33€)
Seat 4: Samuelillo07 (3.63€)
Seat 5: Fried Berg (1.08€)
Seat 6: Babi78_ (2.32€)
*** ANTE/BLINDS ***
Dit_Bondour posts small blind 0.01€
El Paellas posts big blind 0.02€
Dealt to Fried Berg [8s 5s]
*** PRE-FLOP *** 
Abec16 raises 0.03€ to 0.05€
Samuelillo07 folds
Fried Berg folds
Babi78_ folds
Dit_Bondour folds
El Paellas folds
Abec16 collected 0.08€ from pot
*** SUMMARY ***
Total pot 0.08€ | No rake
Seat 3: Abec16 won 0.08€


Winamax Poker - HOLD-UP "Colorado" - HandId: #19116069-443141-1701517575 - Holdem no limit (0.01€/0.02€) - 2023/12/02 11:46:15 UTC
Table: 'Colorado' 6-max (real money) Seat #6 is the button
Seat 1: 14cruyff14 (0.50€)
Seat 2: DONpere (1.60€)
Seat 3: Fried Berg (1.08€)
Seat 4: Nonik1987 (0.34€)
Seat 5: JOK-R777 (3.44€)
Seat 6: TaBrEaMoI (3.43€)
Hold-up to Pot: total 0.20€
*** ANTE/BLINDS ***
14cruyff14 posts small blind 0.01€
DONpere posts big blind 0.02€
Dealt to Fried Berg [4h Ks]
*** PRE-FLOP *** 
Fried Berg folds
Nonik1987 folds
JOK-R777 raises 0.04€ to 0.06€
TaBrEaMoI calls 0.06€
14cruyff14 calls 0.05€
DONpere folds
*** FLOP *** [Kd Kh 2d]
14cruyff14 checks
JOK-R777 checks
TaBrEaMoI checks
*** TURN *** [Kd Kh 2d][9s]
14cruyff14 checks
JOK-R777 bets 0.09€
TaBrEaMoI folds
14cruyff14 folds
JOK-R777 collected 0.47€ from pot
*** SUMMARY ***
Total pot 0.47€ | Rake 0.02€
Board: [Kd Kh 2d 9s]
Seat 5: JOK-R777 won 0.47€


Winamax Poker - HOLD-UP "Colorado" - HandId: #19116069-443149-1701517580 - Holdem no limit (0.01€/0.02€) - 2023/12/02 11:46:20 UTC
Table: 'Colorado' 6-max (real money) Seat #6 is the button
Seat 1: TheNerd (2.05€)
Seat 2: Fried Berg (1.08€)
Seat 3: Samuelillo07 (2.03€)
Seat 4: tichettede3 (3.78€)
Seat 5: benzappa (2.91€)
Seat 6: jdeepenslip (3.92€)
Hold-up to Pot: total 0.20€
*** ANTE/BLINDS ***
TheNerd posts small blind 0.01€
Fried Berg posts big blind 0.02€
Dealt to Fried Berg [Kh 6h]
*** PRE-FLOP *** 
Samuelillo07 folds
tichettede3 raises 0.03€ to 0.05€
benzappa calls 0.05€
jdeepenslip raises 0.38€ to 0.43€
TheNerd folds
Fried Berg folds
tichettede3 raises 3.35€ to 3.78€ and is all-in
benzappa folds
jdeepenslip folds
tichettede3 collected 4.49€ from pot
*** SUMMARY ***
Total pot 4.49€ | No rake
Seat 4: tichettede3 won 4.49€


Winamax Poker - HOLD-UP "Colorado" - HandId: #19116069-443163-1701517588 - Holdem no limit (0.01€/0.02€) - 2023/12/02 11:46:28 UTC
Table: 'Colorado' 6-max (real money) Seat #6 is the button
Seat 1: Dit_Bondour (2.50€)
Seat 2: -Y4V- (2.31€)
Seat 3: vuesurmer (2.08€)
Seat 4: Td08nomotto (2.09€)
Seat 5: Nobru.7793 (0.44€)
Seat 6: Fried Berg (1.06€)
*** ANTE/BLINDS ***
Dit_Bondour posts small blind 0.01€
-Y4V- posts big blind 0.02€
Dealt to Fried Berg [5s 6h]
*** PRE-FLOP *** 
vuesurmer folds
Td08nomotto folds
Nobru.7793 calls 0.02€
Fried Berg folds
Dit_Bondour folds
-Y4V- checks
*** FLOP *** [Ad Ks 4s]
-Y4V- checks
Nobru.7793 bets 0.42€ and is all-in
-Y4V- folds
Nobru.7793 collected 0.46€ from pot
*** SUMMARY ***
Total pot 0.46€ | Rake 0.01€
Board: [Ad Ks 4s]
Seat 5: Nobru.7793 won 0.46€


Winamax Poker - HOLD-UP "Colorado" - HandId: #19116069-443172-1701517594 - Holdem no limit (0.01€/0.02€) - 2023/12/02 11:46:34 UTC
Table: 'Colorado' 6-max (real money) Seat #6 is the button
Seat 1: Babi78_ (2.30€)
Seat 2: Zile741 (2.52€)
Seat 3: Endha_ (2.03€)
Seat 4: Fried Berg (1.06€)
Seat 5: JFSredbaron (6.13€)
Seat 6: Td08nomotto (2.09€)
Hold-up to Pot: total 0.10€
*** ANTE/BLINDS ***
Babi78_ posts small blind 0.01€
Zile741 posts big blind 0.02€
Dealt to Fried Berg [Jc Tc]
*** PRE-FLOP *** 
Endha_ folds
Fried Berg raises 0.02€ to 0.04€
JFSredbaron folds
Td08nomotto folds
Babi78_ folds
Zile741 folds
Fried Berg collected 0.17€ from pot
*** SUMMARY ***
Total pot 0.17€ | No rake
Seat 4: Fried Berg won 0.17€


Winamax Poker - HOLD-UP "Colorado" - HandId: #19116069-443231-1701517630 - Holdem no limit (0.01€/0.02€) - 2023/12/02 11:47:10 UTC
Table: 'Colorado' 6-max (real money) Seat #6 is the button
Seat 1: Fried Berg (1.19€)
Seat 2: 14cruyff14 (0.50€)
Seat 3: benzappa (3.94€)
Seat 4: Quenelles (2€)
Seat 5: TaBrEaMoI (3.20€)
Seat 6: LordShiva (0.55€)
*** ANTE/BLINDS ***
Fried Berg posts small blind 0.01€
14cruyff14 posts big blind 0.02€
Dealt to Fried Berg [8c Qh]
*** PRE-FLOP *** 
benzappa folds
Quenelles folds
TaBrEaMoI folds
LordShiva folds
Fried Berg folds
14cruyff14 collected 0.03€ from pot
*** SUMMARY ***
Total pot 0.03€ | No rake
Seat 2: 14cruyff14 (big blind) won 0.03€


Winamax Poker - HOLD-UP "Colorado" - HandId: #19116069-443244-1701517637 - Holdem no limit (0.01€/0.02€) - 2023/12/02 11:47:17 UTC
Table: 'Colorado' 6-max (real money) Seat #6 is the button
Seat 1: Fried Berg (1.18€)
Seat 2: ridiculuss (2.62€)
Seat 3: Betiegarri (1.95€)
Seat 4: YannSolo1 (4.31€)
Seat 5: JOK-R777 (3.76€)
Seat 6: Wiwidu78 (2.56€)
*** ANTE/BLINDS ***
Fried Berg posts small blind 0.01€
ridiculuss posts big blind 0.02€
Dealt to Fried Berg [Th 9h]
*** PRE-FLOP *** 
Betiegarri folds
YannSolo1 raises 0.02€ to 0.04€
JOK-R777 folds
Wiwidu78 folds
Fried Berg calls 0.03€
ridiculuss folds
*** FLOP *** [4c 3h 9s]
Fried Berg bets 0.04€
YannSolo1 calls 0.04€
*** TURN *** [4c 3h 9s][7h]
Fried Berg checks
YannSolo1 checks
*** RIVER *** [4c 3h 9s 7h][As]
Fried Berg checks
YannSolo1 bets 0.09€
Fried Berg calls 0.09€
*** SHOW DOWN ***
Fried Berg shows [Th 9h] (One pair : 9)
YannSolo1 shows [9d Ac] (Two pairs : Aces and 9)
YannSolo1 collected 0.32€ from pot
*** SUMMARY ***
Total pot 0.32€ | Rake 0.04€
Board: [4c 3h 9s 7h As]
Seat 1: Fried Berg (small blind) showed [Th 9h] and lost with One pair : 9
Seat 4: YannSolo1 showed [9d Ac] and won 0.32€ with Two pairs : Aces and 9


Winamax Poker - HOLD-UP "Colorado" - HandId: #19116069-443328-1701517686 - Holdem no limit (0.01€/0.02€) - 2023/12/02 11:48:06 UTC
Table: 'Colorado' 6-max (real money) Seat #6 is the button
Seat 1: Td08nomotto (2.01€)
Seat 2: Fried Berg (1.01€)
Seat 3: YannSolo1 (4.46€)
Seat 4: Yumkaa (4.72€)
Seat 5: Upswing11 (2.57€)
Seat 6: tichettede3 (2€)
*** ANTE/BLINDS ***
Td08nomotto posts small blind 0.01€
Fried Berg posts big blind 0.02€
Dealt to Fried Berg [Kc Qc]
*** PRE-FLOP *** 
YannSolo1 folds
Yumkaa folds
Upswing11 folds
tichettede3 folds
Td08nomotto folds
Fried Berg collected 0.03€ from pot
*** SUMMARY ***
Total pot 0.03€ | No rake
Seat 2: Fried Berg (big blind) won 0.03€


Winamax Poker - HOLD-UP "Colorado" - HandId: #19116069-443360-1701517705 - Holdem no limit (0.01€/0.02€) - 2023/12/02 11:48:25 UTC
Table: 'Colorado' 6-max (real money) Seat #6 is the button
Seat 1: YannSolo1 (4.46€)
Seat 2: PIQSOU (2.33€)
Seat 3: Fried Berg (1.02€)
Seat 4: mincia 2019 (1.06€)
Seat 5: Stackbystack (4.78€)
Seat 6: Merlus83 (3.40€)
*** ANTE/BLINDS ***
YannSolo1 posts small blind 0.01€
PIQSOU posts big blind 0.02€
Dealt to Fried Berg [2d 4h]
*** PRE-FLOP *** 
Fried Berg folds
mincia 2019 calls 0.02€
Stackbystack calls 0.02€
Merlus83 folds
YannSolo1 folds
PIQSOU checks
*** FLOP *** [Tc Jc 8d]
PIQSOU checks
mincia 2019 bets 0.07€
Stackbystack folds
PIQSOU folds
mincia 2019 collected 0.13€ from pot
*** SUMMARY ***
Total pot 0.13€ | Rake 0.01€
Board: [Tc Jc 8d]
Seat 4: mincia 2019 won 0.13€


Winamax Poker - HOLD-UP "Colorado" - HandId: #19116069-443363-1701517707 - Holdem no limit (0.01€/0.02€) - 2023/12/02 11:48:27 UTC
Table: 'Colorado' 6-max (real money) Seat #6 is the button
Seat 1: Zile741 (4.96€)
Seat 2: NyKOh11 (0.50€)
Seat 3: Kibrouki58 (2.54€)
Seat 4: benzappa (3.91€)
Seat 5: Fried Berg (1.02€)
Seat 6: TaBrEaMoI (8.72€)
*** ANTE/BLINDS ***
Zile741 posts small blind 0.01€
NyKOh11 posts big blind 0.02€
Dealt to Fried Berg [3c Kc]
*** PRE-FLOP *** 
Kibrouki58 calls 0.02€
benzappa folds
Fried Berg folds
TaBrEaMoI calls 0.02€
Zile741 folds
NyKOh11 checks
*** FLOP *** [2c Jc 8c]
NyKOh11 checks
Kibrouki58 bets 0.02€
TaBrEaMoI folds
NyKOh11 folds
Kibrouki58 collected 0.08€ from pot
*** SUMMARY ***
Total pot 0.08€ | Rake 0.01€
Board: [2c Jc 8c]
Seat 3: Kibrouki58 won 0.08€


Winamax Poker - HOLD-UP "Colorado" - HandId: #19116069-443374-1701517714 - Holdem no limit (0.01€/0.02€) - 2023/12/02 11:48:34 UTC
Table: 'Colorado' 6-max (real money) Seat #6 is the button
Seat 1: gagnejamais4 (2.34€)
Seat 2: Quenelles (2€)
Seat 3: P.BaIkany (3.19€)
Seat 4: Kipyomag (3.25€)
Seat 5: warnic40 (7.80€)
Seat 6: Fried Berg (1.02€)
Hold-up to Pot: total 0.10€
*** ANTE/BLINDS ***
gagnejamais4 posts small blind 0.01€
Quenelles posts big blind 0.02€
Dealt to Fried Berg [As Kh]
*** PRE-FLOP *** 
P.BaIkany folds
Kipyomag raises 0.04€ to 0.06€
warnic40 folds
Fried Berg raises 0.12€ to 0.18€
gagnejamais4 calls 0.17€
Quenelles folds
Kipyomag calls 0.12€
*** FLOP *** [Tc 4d 2d]
gagnejamais4 checks
Kipyomag checks
Fried Berg bets 0.30€
gagnejamais4 folds
Kipyomag folds
Fried Berg collected 0.90€ from pot
*** SUMMARY ***
Total pot 0.90€ | Rake 0.06€
Board: [Tc 4d 2d]
Seat 6: Fried Berg (button) won 0.90€


Winamax Poker - HOLD-UP "Colorado" - HandId: #19116069-443439-1701517759 - Holdem no limit (0.01€/0.02€) - 2023/12/02 11:49:19 UTC
Table: 'Colorado' 6-max (real money) Seat #6 is the button
Seat 1: P.BaIkany (3.11€)
Seat 2: Fried Berg (1.44€)
Seat 3: Kallonys (1.42€)
Seat 4: Upswing11 (2.54€)
Seat 5: KPZK (1.59€)
Seat 6: LEDesTAKeuR3 (2.12€)
*** ANTE/BLINDS ***
P.BaIkany posts small blind 0.01€
Fried Berg posts big blind 0.02€
Dealt to Fried Berg [5h 4d]
*** PRE-FLOP *** 
Kallonys folds
Upswing11 folds
KPZK folds
LEDesTAKeuR3 raises 0.02€ to 0.04€
P.BaIkany folds
Fried Berg folds
LEDesTAKeuR3 collected 0.07€ from pot
*** SUMMARY ***
Total pot 0.07€ | No rake
Seat 6: LEDesTAKeuR3 (button) won 0.07€


Winamax Poker - HOLD-UP "Colorado" - HandId: #19116069-443455-1701517770 - Holdem no limit (0.01€/0.02€) - 2023/12/02 11:49:30 UTC
Table: 'Colorado' 6-max (real money) Seat #6 is the button
Seat 1: Fried Berg (1.42€)
Seat 2: jdeepenslip (3.98€)
Seat 3: JFSredbaron (4.29€)
Seat 4: P.BaIkany (2.65€)
Seat 5: 14cruyff14 (0.51€)
Seat 6: El Paellas (0.51€)
*** ANTE/BLINDS ***
Fried Berg posts small blind 0.01€
jdeepenslip posts big blind 0.02€
Dealt to Fried Berg [7c Kh]
*** PRE-FLOP *** 
JFSredbaron folds
P.BaIkany folds
14cruyff14 raises 0.04€ to 0.06€
El Paellas folds
Fried Berg folds
jdeepenslip raises 0.18€ to 0.24€
14cruyff14 folds
jdeepenslip collected 0.31€ from pot
*** SUMMARY ***
Total pot 0.31€ | No rake
Seat 2: jdeepenslip (big blind) won 0.31€


Winamax Poker - HOLD-UP "Colorado" - HandId: #19116069-443468-1701517782 - Holdem no limit (0.01€/0.02€) - 2023/12/02 11:49:42 UTC
Table: 'Colorado' 6-max (real money) Seat #6 is the button
Seat 1: benzappa (3.08€)
Seat 2: haouuum28 (2€)
Seat 3: Fried Berg (1.41€)
Seat 4: Pwinpwin (2.44€)
Seat 5: PoKKer_sAAn (4.15€)
Seat 6: El Paellas (0.51€)
*** ANTE/BLINDS ***
benzappa posts small blind 0.01€
haouuum28 posts big blind 0.02€
Dealt to Fried Berg [5h Td]
*** PRE-FLOP *** 
Fried Berg folds
Pwinpwin folds
PoKKer_sAAn raises 0.05€ to 0.07€
El Paellas folds
benzappa folds
haouuum28 folds
PoKKer_sAAn collected 0.10€ from pot
*** SUMMARY ***
Total pot 0.10€ | No rake
Seat 5: PoKKer_sAAn won 0.10€


Winamax Poker - HOLD-UP "Colorado" - HandId: #19116069-443472-1701517785 - Holdem no limit (0.01€/0.02€) - 2023/12/02 11:49:45 UTC
Table: 'Colorado' 6-max (real money) Seat #6 is the button
Seat 1: Zile741 (3.95€)
Seat 2: popoche29 (0.86€)
Seat 3: benzappa (3.07€)
Seat 4: Fried Berg (1.41€)
Seat 5: Pwinpwin (2.44€)
Seat 6: TheNerd (2.41€)
*** ANTE/BLINDS ***
Zile741 posts small blind 0.01€
popoche29 posts big blind 0.02€
Dealt to Fried Berg [3d Ks]
*** PRE-FLOP *** 
benzappa folds
Fried Berg folds
Pwinpwin raises 0.03€ to 0.05€
TheNerd raises 0.12€ to 0.17€
Zile741 folds
popoche29 folds
Pwinpwin folds
TheNerd collected 0.25€ from pot
*** SUMMARY ***
Total pot 0.25€ | No rake
Seat 6: TheNerd (button) won 0.25€


Winamax Poker - HOLD-UP "Colorado" - HandId: #19116069-443475-1701517787 - Holdem no limit (0.01€/0.02€) - 2023/12/02 11:49:47 UTC
Table: 'Colorado' 6-max (real money) Seat #6 is the button
Seat 1: LordShiva (0.51€)
Seat 2: pyrat64 (2.40€)
Seat 3: Abec16 (4.04€)
Seat 4: tichettede3 (4.31€)
Seat 5: Fried Berg (1.41€)
Seat 6: Stackbystack (2.09€)
*** ANTE/BLINDS ***
LordShiva posts small blind 0.01€
pyrat64 posts big blind 0.02€
Dealt to Fried Berg [Kd 4h]
*** PRE-FLOP *** 
Abec16 folds
tichettede3 folds
Fried Berg folds
Stackbystack folds
LordShiva raises 0.03€ to 0.05€
pyrat64 folds
LordShiva collected 0.07€ from pot
*** SUMMARY ***
Total pot 0.07€ | No rake
Seat 1: LordShiva (small blind) won 0.07€


Winamax Poker - HOLD-UP "Colorado" - HandId: #19116069-443477-1701517788 - Holdem no limit (0.01€/0.02€) - 2023/12/02 11:49:48 UTC
Table: 'Colorado' 6-max (real money) Seat #6 is the button
Seat 1: le papayou (1.98€)
Seat 2: Fried Berg (1.41€)
Seat 3: laconalostra (2€)
Seat 4: metamex (1.60€)
Seat 5: benzappa (3.82€)
Seat 6: Black-Bull (2.14€)
*** ANTE/BLINDS ***
le papayou posts small blind 0.01€
Fried Berg posts big blind 0.02€
Dealt to Fried Berg [Ac Jc]
*** PRE-FLOP *** 
laconalostra raises 0.03€ to 0.05€
metamex folds
benzappa calls 0.05€
Black-Bull raises 0.19€ to 0.24€
le papayou folds
Fried Berg calls 0.22€
laconalostra calls 0.19€
benzappa folds
*** FLOP *** [2c 7d 2d]
Fried Berg checks
laconalostra checks
Black-Bull bets 0.20€
Fried Berg folds
laconalostra calls 0.20€
*** TURN *** [2c 7d 2d][4c]
laconalostra checks
Black-Bull checks
*** RIVER *** [2c 7d 2d 4c][Qc]
laconalostra checks
Black-Bull checks
*** SHOW DOWN ***
Black-Bull shows [6d Ad] (One pair : 2)
laconalostra shows [8d 8h] (Two pairs : 8 and 2)
laconalostra collected 1.06€ from pot
*** SUMMARY ***
Total pot 1.06€ | Rake 0.12€
Board: [2c 7d 2d 4c Qc]
Seat 3: laconalostra showed [8d 8h] and won 1.06€ with Two pairs : 8 and 2
Seat 6: Black-Bull (button) showed [6d Ad] and lost with One pair : 2


Winamax Poker - HOLD-UP "Colorado" - HandId: #19116069-443588-1701517873 - Holdem no limit (0.01€/0.02€) - 2023/12/02 11:51:13 UTC
Table: 'Colorado' 6-max (real money) Seat #6 is the button
Seat 1: le papayou (1.81€)
Seat 2: Dit_Bondour (2€)
Seat 3: mincia 2019 (1.21€)
Seat 4: Pwinpwin (2.25€)
Seat 5: Fried Berg (1.17€)
Seat 6: tichettede3 (2€)
*** ANTE/BLINDS ***
le papayou posts small blind 0.01€
Dit_Bondour posts big blind 0.02€
Dealt to Fried Berg [Jc Ac]
*** PRE-FLOP *** 
mincia 2019 folds
Pwinpwin folds
Fried Berg raises 0.04€ to 0.06€
tichettede3 calls 0.06€
le papayou raises 0.15€ to 0.21€
Dit_Bondour folds
Fried Berg calls 0.15€
tichettede3 calls 0.15€
*** FLOP *** [8c Qc 7h]
le papayou checks
Fried Berg checks
tichettede3 checks
*** TURN *** [8c Qc 7h][4h]
le papayou bets 0.42€
Fried Berg folds
tichettede3 folds
le papayou collected 1€ from pot
*** SUMMARY ***
Total pot 1€ | Rake 0.07€
Board: [8c Qc 7h 4h]
Seat 1: le papayou (small blind) won 1€


Winamax Poker - HOLD-UP "Colorado" - HandId: #19116069-443695-1701517945 - Holdem no limit (0.01€/0.02€) - 2023/12/02 11:52:25 UTC
Table: 'Colorado' 6-max (real money) Seat #6 is the button
Seat 1: jdeepenslip (2.09€)
Seat 2: Stackbystack (2.43€)
Seat 3: Fried Berg (0.96€)
Seat 4: El Paellas (0.56€)
Seat 5: WHYNOTJAZZ (0.44€)
Seat 6: Kipyomag (2.90€)
*** ANTE/BLINDS ***
jdeepenslip posts small blind 0.01€
Stackbystack posts big blind 0.02€
Dealt to Fried Berg [8h Ad]
*** PRE-FLOP *** 
Fried Berg folds
El Paellas folds
WHYNOTJAZZ folds
Kipyomag raises 0.04€ to 0.06€
jdeepenslip folds
Stackbystack folds
Kipyomag collected 0.09€ from pot
*** SUMMARY ***
Total pot 0.09€ | No rake
Seat 6: Kipyomag (button) won 0.09€


Winamax Poker - HOLD-UP "Colorado" - HandId: #19116069-443699-1701517949 - Holdem no limit (0.01€/0.02€) - 2023/12/02 11:52:29 UTC
Table: 'Colorado' 6-max (real money) Seat #6 is the button
Seat 1: lamuerta8300 (2€)
Seat 2: mincia 2019 (0.60€)
Seat 3: KON-2-PEUTE (2.10€)
Seat 4: Fried Berg (0.96€)
Seat 5: Babi78_ (2.17€)
Seat 6: WHYNOTJAZZ (0.44€)
*** ANTE/BLINDS ***
lamuerta8300 posts small blind 0.01€
mincia 2019 posts big blind 0.02€
Dealt to Fried Berg [Ts Kc]
*** PRE-FLOP *** 
KON-2-PEUTE raises 0.03€ to 0.05€
Fried Berg folds
Babi78_ folds
WHYNOTJAZZ calls 0.05€
lamuerta8300 folds
mincia 2019 folds
*** FLOP *** [2c Th Qh]
KON-2-PEUTE checks
WHYNOTJAZZ bets 0.08€
KON-2-PEUTE calls 0.08€
*** TURN *** [2c Th Qh][4d]
KON-2-PEUTE checks
WHYNOTJAZZ checks
*** RIVER *** [2c Th Qh 4d][Kh]
KON-2-PEUTE checks
WHYNOTJAZZ checks
*** SHOW DOWN ***
WHYNOTJAZZ shows [7h 7s] (One pair : 7)
KON-2-PEUTE shows [As Kd] (One pair : Kings)
KON-2-PEUTE collected 0.26€ from pot
*** SUMMARY ***
Total pot 0.26€ | Rake 0.03€
Board: [2c Th Qh 4d Kh]
Seat 3: KON-2-PEUTE showed [As Kd] and won 0.26€ with One pair : Kings
Seat 6: WHYNOTJAZZ (button) showed [7h 7s] and lost with One pair : 7


Winamax Poker - HOLD-UP "Colorado" - HandId: #19116069-443704-1701517952 - Holdem no limit (0.01€/0.02€) - 2023/12/02 11:52:32 UTC
Table: 'Colorado' 6-max (real money) Seat #6 is the button
Seat 1: Fried Berg (0.96€)
Seat 2: DONpere (1.60€)
Seat 3: l artiste ho (1.69€)
Seat 4: vuesurmer (3.67€)
Seat 5: chaketovibet (2.47€)
Seat 6: Jimbiosis (2.41€)
*** ANTE/BLINDS ***
Fried Berg posts small blind 0.01€
DONpere posts big blind 0.02€
Dealt to Fried Berg [Ks 9h]
*** PRE-FLOP *** 
l artiste ho folds
vuesurmer folds
chaketovibet folds
Jimbiosis folds
Fried Berg folds
DONpere collected 0.03€ from pot
*** SUMMARY ***
Total pot 0.03€ | No rake
Seat 2: DONpere (big blind) won 0.03€


Winamax Poker - HOLD-UP "Colorado" - HandId: #19116069-443708-1701517954 - Holdem no limit (0.01€/0.02€) - 2023/12/02 11:52:34 UTC
Table: 'Colorado' 6-max (real money) Seat #6 is the button
Seat 1: TaBrEaMoI (3.29€)
Seat 2: 14cruyff14 (0.50€)
Seat 3: Betiegarri (1.97€)
Seat 4: blie2006 (0.59€)
Seat 5: Black-Bull (2.03€)
Seat 6: Fried Berg (0.95€)
*** ANTE/BLINDS ***
TaBrEaMoI posts small blind 0.01€
14cruyff14 posts big blind 0.02€
Dealt to Fried Berg [6c Kc]
*** PRE-FLOP *** 
Betiegarri folds
blie2006 raises 0.02€ to 0.04€
Black-Bull folds
Fried Berg calls 0.04€
TaBrEaMoI folds
14cruyff14 calls 0.02€
*** FLOP *** [8d 8c 5h]
14cruyff14 checks
blie2006 checks
Fried Berg checks
*** TURN *** [8d 8c 5h][Qh]
14cruyff14 checks
blie2006 checks
Fried Berg checks
*** RIVER *** [8d 8c 5h Qh][2d]
14cruyff14 checks
blie2006 checks
Fried Berg checks
*** SHOW DOWN ***
14cruyff14 shows [3h 6h] (One pair : 8)
Fried Berg shows [6c Kc] (One pair : 8)
blie2006 shows [Ac 7d] (One pair : 8)
blie2006 collected 0.12€ from pot
*** SUMMARY ***
Total pot 0.12€ | Rake 0.01€
Board: [8d 8c 5h Qh 2d]
Seat 2: 14cruyff14 (big blind) showed [3h 6h] and lost with One pair : 8
Seat 4: blie2006 showed [Ac 7d] and won 0.12€ with One pair : 8
Seat 6: Fried Berg (button) showed [6c Kc] and lost with One pair : 8


Winamax Poker - HOLD-UP "Colorado" - HandId: #19116069-443797-1701518014 - Holdem no limit (0.01€/0.02€) - 2023/12/02 11:53:34 UTC
Table: 'Colorado' 6-max (real money) Seat #6 is the button
Seat 1: jdeepenslip (2.33€)
Seat 2: Abec16 (3.93€)
Seat 3: gegvio38 (1.84€)
Seat 4: Fried Berg (0.91€)
Seat 5: vuesurmer (2€)
Seat 6: haouuum28 (2.10€)
*** ANTE/BLINDS ***
jdeepenslip posts small blind 0.01€
Abec16 posts big blind 0.02€
Dealt to Fried Berg [7h 6d]
*** PRE-FLOP *** 
gegvio38 folds
Fried Berg folds
vuesurmer folds
haouuum28 raises 0.02€ to 0.04€
jdeepenslip folds
Abec16 folds
haouuum28 collected 0.07€ from pot
*** SUMMARY ***
Total pot 0.07€ | No rake
Seat 6: haouuum28 (button) won 0.07€


Winamax Poker - HOLD-UP "Colorado" - HandId: #19116069-443805-1701518021 - Holdem no limit (0.01€/0.02€) - 2023/12/02 11:53:41 UTC
Table: 'Colorado' 6-max (real money) Seat #6 is the button
Seat 1: JFSredbaron (2.63€)
Seat 2: Quenelles (2.49€)
Seat 3: KON-2-PEUTE (2.54€)
Seat 4: P.BaIkany (3.37€)
Seat 5: Kipyomag (2.98€)
Seat 6: Fried Berg (0.91€)
*** ANTE/BLINDS ***
JFSredbaron posts small blind 0.01€
Quenelles posts big blind 0.02€
Dealt to Fried Berg [5s Ac]
*** PRE-FLOP *** 
KON-2-PEUTE folds
P.BaIkany folds
Kipyomag folds
Fried Berg raises 0.02€ to 0.04€
JFSredbaron folds
Quenelles folds
Fried Berg collected 0.07€ from pot
*** SUMMARY ***
Total pot 0.07€ | No rake
Seat 6: Fried Berg (button) won 0.07€


Winamax Poker - HOLD-UP "Colorado" - HandId: #19116069-443822-1701518032 - Holdem no limit (0.01€/0.02€) - 2023/12/02 11:53:52 UTC
Table: 'Colorado' 6-max (real money) Seat #6 is the button
Seat 1: muespachois1 (1.66€)
Seat 2: theSangoten (1.58€)
Seat 3: Fried Berg (0.94€)
Seat 4: pedrohxx (1.79€)
Seat 5: PIQSOU (2.15€)
Seat 6: Td08nomotto (2.01€)
*** ANTE/BLINDS ***
muespachois1 posts small blind 0.01€
theSangoten posts big blind 0.02€
Dealt to Fried Berg [Td Jd]
*** PRE-FLOP *** 
Fried Berg raises 0.02€ to 0.04€
pedrohxx folds
PIQSOU folds
Td08nomotto folds
muespachois1 calls 0.03€
theSangoten calls 0.02€
*** FLOP *** [Kh 2s 6s]
muespachois1 checks
theSangoten checks
Fried Berg bets 0.02€
muespachois1 calls 0.02€
theSangoten folds
*** TURN *** [Kh 2s 6s][5h]
muespachois1 checks
Fried Berg checks
*** RIVER *** [Kh 2s 6s 5h][7d]
muespachois1 checks
Fried Berg checks
*** SHOW DOWN ***
Fried Berg shows [Td Jd] (High card : King)
muespachois1 shows [Ac Ts] (High card : Ace)
muespachois1 collected 0.14€ from pot
*** SUMMARY ***
Total pot 0.14€ | Rake 0.02€
Board: [Kh 2s 6s 5h 7d]
Seat 1: muespachois1 (small blind) showed [Ac Ts] and won 0.14€ with High card : Ace
Seat 3: Fried Berg showed [Td Jd] and lost with High card : King


Winamax Poker - HOLD-UP "Colorado" - HandId: #19116069-443883-1701518065 - Holdem no limit (0.01€/0.02€) - 2023/12/02 11:54:25 UTC
Table: 'Colorado' 6-max (real money) Seat #6 is the button
Seat 1: Edlas (2.01€)
Seat 2: Stackbystack (2.42€)
Seat 3: vuesurmer (2.29€)
Seat 4: PIQSOU (2.14€)
Seat 5: Fried Berg (0.88€)
Seat 6: Polanskii (1.71€)
*** ANTE/BLINDS ***
Edlas posts small blind 0.01€
Stackbystack posts big blind 0.02€
Dealt to Fried Berg [Qd 6d]
*** PRE-FLOP *** 
vuesurmer raises 0.03€ to 0.05€
PIQSOU raises 0.15€ to 0.20€
Fried Berg folds
Polanskii folds
Edlas folds
Stackbystack folds
vuesurmer calls 0.15€
*** FLOP *** [Js 5d 2d]
vuesurmer checks
PIQSOU checks
*** TURN *** [Js 5d 2d][9h]
vuesurmer bets 0.26€
PIQSOU folds
vuesurmer collected 0.65€ from pot
*** SUMMARY ***
Total pot 0.65€ | Rake 0.04€
Board: [Js 5d 2d 9h]
Seat 3: vuesurmer won 0.65€


Winamax Poker - HOLD-UP "Colorado" - HandId: #19116069-443898-1701518074 - Holdem no limit (0.01€/0.02€) - 2023/12/02 11:54:34 UTC
Table: 'Colorado' 6-max (real money) Seat #6 is the button
Seat 1: Dame de pik (7.82€)
Seat 2: Fried Berg (0.88€)
Seat 3: FlyIndeSky (0.48€)
Seat 4: laconalostra (2.16€)
Seat 5: muespachois1 (1.72€)
Seat 6: HR691. (0.31€)
*** ANTE/BLINDS ***
Dame de pik posts small blind 0.01€
Fried Berg posts big blind 0.02€
Dealt to Fried Berg [8d Kc]
*** PRE-FLOP *** 
FlyIndeSky folds
laconalostra folds
muespachois1 raises 0.05€ to 0.07€
HR691. folds
Dame de pik folds
Fried Berg folds
muespachois1 collected 0.10€ from pot
*** SUMMARY ***
Total pot 0.10€ | No rake
Seat 5: muespachois1 won 0.10€


Winamax Poker - HOLD-UP "Colorado" - HandId: #19116069-443909-1701518080 - Holdem no limit (0.01€/0.02€) - 2023/12/02 11:54:40 UTC
Table: 'Colorado' 6-max (real money) Seat #6 is the button
Seat 1: gagnejamais4 (4.03€)
Seat 2: P.BaIkany (3.42€)
Seat 3: Nobru.7793 (2.23€)
Seat 4: Bastoufl91 (3.36€)
Seat 5: Fried Berg (0.86€)
Seat 6: Edlas (2€)
*** ANTE/BLINDS ***
gagnejamais4 posts small blind 0.01€
P.BaIkany posts big blind 0.02€
Dealt to Fried Berg [Th 2h]
*** PRE-FLOP *** 
Nobru.7793 calls 0.02€
Bastoufl91 calls 0.02€
Fried Berg folds
Edlas folds
gagnejamais4 folds
P.BaIkany checks
*** FLOP *** [Qh 2c Jc]
P.BaIkany checks
Nobru.7793 checks
Bastoufl91 checks
*** TURN *** [Qh 2c Jc][Js]
P.BaIkany checks
Nobru.7793 checks
Bastoufl91 checks
*** RIVER *** [Qh 2c Jc Js][8d]
P.BaIkany checks
Nobru.7793 checks
Bastoufl91 checks
*** SHOW DOWN ***
Nobru.7793 shows [Ah 4s] (One pair : Jacks)
Bastoufl91 shows [3d Kc] (One pair : Jacks)
P.BaIkany shows [5h 2s] (Two pairs : Jacks and 2)
P.BaIkany collected 0.06€ from pot
*** SUMMARY ***
Total pot 0.06€ | Rake 0.01€
Board: [Qh 2c Jc Js 8d]
Seat 2: P.BaIkany (big blind) showed [5h 2s] and won 0.06€ with Two pairs : Jacks and 2
Seat 3: Nobru.7793 showed [Ah 4s] and lost with One pair : Jacks
Seat 4: Bastoufl91 showed [3d Kc] and lost with One pair : Jacks


Winamax Poker - HOLD-UP "Colorado" - HandId: #19116069-443914-1701518082 - Holdem no limit (0.01€/0.02€) - 2023/12/02 11:54:42 UTC
Table: 'Colorado' 6-max (real money) Seat #6 is the button
Seat 1: le papayou (1.99€)
Seat 2: gagnejamais4 (4.02€)
Seat 3: Polanskii (1.71€)
Seat 4: Pwinpwin (4.02€)
Seat 5: l artiste ho (1.66€)
Seat 6: Fried Berg (0.86€)
*** ANTE/BLINDS ***
le papayou posts small blind 0.01€
gagnejamais4 posts big blind 0.02€
Dealt to Fried Berg [Kd Jd]
*** PRE-FLOP *** 
Polanskii folds
Pwinpwin folds
l artiste ho folds
Fried Berg raises 0.02€ to 0.04€
le papayou calls 0.03€
gagnejamais4 folds
*** FLOP *** [2d 2h Ad]
le papayou checks
Fried Berg checks
*** TURN *** [2d 2h Ad][Jc]
le papayou checks
Fried Berg checks
*** RIVER *** [2d 2h Ad Jc][5h]
le papayou checks
Fried Berg bets 0.04€
le papayou folds
Fried Berg collected 0.13€ from pot
*** SUMMARY ***
Total pot 0.13€ | Rake 0.01€
Board: [2d 2h Ad Jc 5h]
Seat 6: Fried Berg (button) won 0.13€


Winamax Poker - HOLD-UP "Colorado" - HandId: #19116069-443957-1701518112 - Holdem no limit (0.01€/0.02€) - 2023/12/02 11:55:12 UTC
Table: 'Colorado' 6-max (real money) Seat #6 is the button
Seat 1: Fried Berg (0.91€)
Seat 2: tichettede3 (4.21€)
Seat 3: Dit_Bondour (2.12€)
Seat 4: S-aaron24 (2€)
Seat 5: jritxal (2.06€)
Seat 6: Merlus83 (3.26€)
*** ANTE/BLINDS ***
Fried Berg posts small blind 0.01€
tichettede3 posts big blind 0.02€
Dealt to Fried Berg [Kd 2c]
*** PRE-FLOP *** 
Dit_Bondour folds
S-aaron24 folds
jritxal folds
Merlus83 folds
Fried Berg folds
tichettede3 collected 0.03€ from pot
*** SUMMARY ***
Total pot 0.03€ | No rake
Seat 2: tichettede3 (big blind) won 0.03€


Winamax Poker - HOLD-UP "Colorado" - HandId: #19116069-443981-1701518129 - Holdem no limit (0.01€/0.02€) - 2023/12/02 11:55:29 UTC
Table: 'Colorado' 6-max (real money) Seat #6 is the button
Seat 1: Patxuco (0.49€)
Seat 2: gegvio38 (1.76€)
Seat 3: haouuum28 (3.06€)
Seat 4: Fried Berg (0.90€)
Seat 5: TouTeK (1.65€)
Seat 6: KingSoto (2.19€)
*** ANTE/BLINDS ***
Patxuco posts small blind 0.01€
gegvio38 posts big blind 0.02€
Dealt to Fried Berg [2s As]
*** PRE-FLOP *** 
haouuum28 folds
Fried Berg raises 0.02€ to 0.04€
TouTeK folds
KingSoto folds
Patxuco folds
gegvio38 calls 0.02€
*** FLOP *** [7d 4s Ts]
gegvio38 checks
Fried Berg checks
*** TURN *** [7d 4s Ts][Qd]
gegvio38 checks
Fried Berg checks
*** RIVER *** [7d 4s Ts Qd][6c]
gegvio38 checks
Fried Berg checks
*** SHOW DOWN ***
gegvio38 shows [Js 9s] (High card : Queen)
Fried Berg shows [2s As] (High card : Ace)
Fried Berg collected 0.08€ from pot
*** SUMMARY ***
Total pot 0.08€ | Rake 0.01€
Board: [7d 4s Ts Qd 6c]
Seat 2: gegvio38 (big blind) showed [Js 9s] and lost with High card : Queen
Seat 4: Fried Berg showed [2s As] and won 0.08€ with High card : Ace


Winamax Poker - HOLD-UP "Colorado" - HandId: #19116069-444025-1701518156 - Holdem no limit (0.01€/0.02€) - 2023/12/02 11:55:56 UTC
Table: 'Colorado' 6-max (real money) Seat #6 is the button
Seat 1: gegvio38 (1.72€)
Seat 2: Fried Berg (0.94€)
Seat 3: Dit_Bondour (2.51€)
Seat 4: Zile741 (2.84€)
Seat 5: P.BaIkany (2.52€)
Seat 6: Cat-fish64 (0.75€)
*** ANTE/BLINDS ***
gegvio38 posts small blind 0.01€
Fried Berg posts big blind 0.02€
Dealt to Fried Berg [Kd 9h]
*** PRE-FLOP *** 
Dit_Bondour folds
Zile741 folds
P.BaIkany folds
Cat-fish64 folds
gegvio38 calls 0.01€
Fried Berg checks
*** FLOP *** [Jd 5d 7c]
gegvio38 checks
Fried Berg checks
*** TURN *** [Jd 5d 7c][Kh]
gegvio38 checks
Fried Berg checks
*** RIVER *** [Jd 5d 7c Kh][7d]
gegvio38 checks
Fried Berg bets 0.02€
gegvio38 calls 0.02€
*** SHOW DOWN ***
gegvio38 shows [8c 5h] (Two pairs : 7 and 5)
Fried Berg shows [Kd 9h] (Two pairs : Kings and 7)
Fried Berg collected 0.07€ from pot
*** SUMMARY ***
Total pot 0.07€ | Rake 0.01€
Board: [Jd 5d 7c Kh 7d]
Seat 1: gegvio38 (small blind) showed [8c 5h] and lost with Two pairs : 7 and 5
Seat 2: Fried Berg (big blind) showed [Kd 9h] and won 0.07€ with Two pairs : Kings and 7


Winamax Poker - HOLD-UP "Colorado" - HandId: #19116069-444094-1701518197 - Holdem no limit (0.01€/0.02€) - 2023/12/02 11:56:37 UTC
Table: 'Colorado' 6-max (real money) Seat #6 is the button
Seat 1: Fried Berg (0.97€)
Seat 2: KPZK (1.49€)
Seat 3: gegvio38 (1.68€)
Seat 4: Stackbystack (3.16€)
Seat 5: jdeepenslip (4.05€)
Seat 6: S-aaron24 (2€)
*** ANTE/BLINDS ***
Fried Berg posts small blind 0.01€
KPZK posts big blind 0.02€
Dealt to Fried Berg [Qh Kd]
*** PRE-FLOP *** 
gegvio38 folds
Stackbystack folds
jdeepenslip raises 0.03€ to 0.05€
S-aaron24 raises 0.13€ to 0.18€
Fried Berg calls 0.17€
KPZK folds
jdeepenslip folds
*** FLOP *** [Tc 8c 3c]
Fried Berg checks
S-aaron24 checks
*** TURN *** [Tc 8c 3c][Ts]
Fried Berg checks
S-aaron24 bets 0.15€
Fried Berg folds
S-aaron24 collected 0.54€ from pot
*** SUMMARY ***
Total pot 0.54€ | Rake 0.04€
Board: [Tc 8c 3c Ts]
Seat 6: S-aaron24 (button) won 0.54€


Winamax Poker - HOLD-UP "Colorado" - HandId: #19116069-444185-1701518254 - Holdem no limit (0.01€/0.02€) - 2023/12/02 11:57:34 UTC
Table: 'Colorado' 6-max (real money) Seat #6 is the button
Seat 1: bachir71 (0.48€)
Seat 2: lamuerta8300 (2.63€)
Seat 3: Fried Berg (0.79€)
Seat 4: JFSredbaron (5.49€)
Seat 5: RhinoLibre99 (2.88€)
Seat 6: metamex (1.93€)
*** ANTE/BLINDS ***
bachir71 posts small blind 0.01€
lamuerta8300 posts big blind 0.02€
Dealt to Fried Berg [As 9h]
*** PRE-FLOP *** 
Fried Berg raises 0.02€ to 0.04€
JFSredbaron folds
RhinoLibre99 calls 0.04€
metamex folds
bachir71 raises 0.44€ to 0.48€ and is all-in
lamuerta8300 folds
Fried Berg folds
RhinoLibre99 calls 0.44€
*** FLOP *** [3d 9c Jc]
*** TURN *** [3d 9c Jc][7h]
*** RIVER *** [3d 9c Jc 7h][Jh]
*** SHOW DOWN ***
bachir71 shows [4d 7d] (Two pairs : Jacks and 7)
RhinoLibre99 shows [Ah 7c] (Two pairs : Jacks and 7)
RhinoLibre99 collected 0.92€ from pot
*** SUMMARY ***
Total pot 0.92€ | Rake 0.10€
Board: [3d 9c Jc 7h Jh]
Seat 1: bachir71 (small blind) showed [4d 7d] and lost with Two pairs : Jacks and 7
Seat 5: RhinoLibre99 showed [Ah 7c] and won 0.92€ with Two pairs : Jacks and 7


Winamax Poker - HOLD-UP "Colorado" - HandId: #19116069-444209-1701518270 - Holdem no limit (0.01€/0.02€) - 2023/12/02 11:57:50 UTC
Table: 'Colorado' 6-max (real money) Seat #6 is the button
Seat 1: Dit_Bondour (2€)
Seat 2: TaBrEaMoI (2.62€)
Seat 3: Fried Berg (0.75€)
Seat 4: haouuum28 (1.78€)
Seat 5: PANDIKORNIO (2.14€)
Seat 6: FH-LYON-OR (0.53€)
*** ANTE/BLINDS ***
Dit_Bondour posts small blind 0.01€
TaBrEaMoI posts big blind 0.02€
Dealt to Fried Berg [4h Kc]
*** PRE-FLOP *** 
Fried Berg folds
haouuum28 folds
PANDIKORNIO raises 0.04€ to 0.06€
FH-LYON-OR folds
Dit_Bondour folds
TaBrEaMoI folds
PANDIKORNIO collected 0.09€ from pot
*** SUMMARY ***
Total pot 0.09€ | No rake
Seat 5: PANDIKORNIO won 0.09€


Winamax Poker - HOLD-UP "Colorado" - HandId: #19116069-444219-1701518276 - Holdem no limit (0.01€/0.02€) - 2023/12/02 11:57:56 UTC
Table: 'Colorado' 6-max (real money) Seat #6 is the button
Seat 1: Anubis1983 (1.18€)
Seat 2: LT_Mage70994 (1.97€)
Seat 3: JOK-R777 (3.93€)
Seat 4: mincia 2019 (0.41€)
Seat 5: Fried Berg (0.75€)
Seat 6: Zile741 (5.97€)
*** ANTE/BLINDS ***
Anubis1983 posts small blind 0.01€
LT_Mage70994 posts big blind 0.02€
Dealt to Fried Berg [Td Js]
*** PRE-FLOP *** 
JOK-R777 folds
mincia 2019 raises 0.05€ to 0.07€
Fried Berg calls 0.07€
Zile741 folds
Anubis1983 folds
LT_Mage70994 calls 0.05€
*** FLOP *** [Th 9s Kd]
LT_Mage70994 checks
mincia 2019 bets 0.34€ and is all-in
Fried Berg folds
LT_Mage70994 folds
mincia 2019 collected 0.54€ from pot
*** SUMMARY ***
Total pot 0.54€ | Rake 0.02€
Board: [Th 9s Kd]
Seat 4: mincia 2019 won 0.54€


Winamax Poker - HOLD-UP "Colorado" - HandId: #19116069-444254-1701518300 - Holdem no limit (0.01€/0.02€) - 2023/12/02 11:58:20 UTC
Table: 'Colorado' 6-max (real money) Seat #6 is the button
Seat 1: Td08nomotto (2.18€)
Seat 2: jdeepenslip (2.43€)
Seat 3: IsmaTazz (0.55€)
Seat 4: Anubis1983 (1.18€)
Seat 5: 14cruyff14 (0.50€)
Seat 6: Fried Berg (0.68€)
*** ANTE/BLINDS ***
Td08nomotto posts small blind 0.01€
jdeepenslip posts big blind 0.02€
Dealt to Fried Berg [Qc 4h]
*** PRE-FLOP *** 
IsmaTazz calls 0.02€
Anubis1983 folds
14cruyff14 folds
Fried Berg folds
Td08nomotto folds
jdeepenslip raises 0.08€ to 0.10€
IsmaTazz calls 0.08€
*** FLOP *** [7s Jd Td]
jdeepenslip bets 0.14€
IsmaTazz raises 0.31€ to 0.45€ and is all-in
jdeepenslip calls 0.31€
*** TURN *** [7s Jd Td][9c]
*** RIVER *** [7s Jd Td 9c][8s]
*** SHOW DOWN ***
jdeepenslip shows [Jc Jh] (Straight Jack high)
IsmaTazz shows [Tc 7c] (Straight Jack high)
IsmaTazz collected 0.50€ from pot
jdeepenslip collected 0.50€ from pot
*** SUMMARY ***
Total pot 1€ | Rake 0.11€
Board: [7s Jd Td 9c 8s]
Seat 2: jdeepenslip (big blind) showed [Jc Jh] and won 0.50€ with Straight Jack high
Seat 3: IsmaTazz showed [Tc 7c] and won 0.50€ with Straight Jack high


Winamax Poker - HOLD-UP "Colorado" - HandId: #19116069-444259-1701518302 - Holdem no limit (0.01€/0.02€) - 2023/12/02 11:58:22 UTC
Table: 'Colorado' 6-max (real money) Seat #6 is the button
Seat 1: mincia 2019 (0.54€)
Seat 2: pedrohxx (1.48€)
Seat 3: le papayou (2.56€)
Seat 4: Lunau (2.06€)
Seat 5: LordShiva (0.49€)
Seat 6: Fried Berg (0.68€)
*** ANTE/BLINDS ***
mincia 2019 posts small blind 0.01€
pedrohxx posts big blind 0.02€
Dealt to Fried Berg [Js 4d]
*** PRE-FLOP *** 
le papayou folds
Lunau folds
LordShiva folds
Fried Berg folds
mincia 2019 calls 0.01€
pedrohxx checks
*** FLOP *** [3s Ac 5c]
mincia 2019 bets 0.02€
pedrohxx folds
mincia 2019 collected 0.06€ from pot
*** SUMMARY ***
Total pot 0.06€ | No rake
Board: [3s Ac 5c]
Seat 1: mincia 2019 (small blind) won 0.06€


Winamax Poker - HOLD-UP "Colorado" - HandId: #19116069-444262-1701518304 - Holdem no limit (0.01€/0.02€) - 2023/12/02 11:58:24 UTC
Table: 'Colorado' 6-max (real money) Seat #6 is the button
Seat 1: jritxal (2.21€)
Seat 2: Fried Berg (0.68€)
Seat 3: l artiste ho (1.57€)
Seat 4: Dame de pik (4.64€)
Seat 5: JFSredbaron (5.48€)
Seat 6: le papayou (2.56€)
*** ANTE/BLINDS ***
jritxal posts small blind 0.01€
Fried Berg posts big blind 0.02€
Dealt to Fried Berg [6h Jh]
*** PRE-FLOP *** 
l artiste ho folds
Dame de pik folds
JFSredbaron folds
le papayou folds
jritxal folds
Fried Berg collected 0.03€ from pot
*** SUMMARY ***
Total pot 0.03€ | No rake
Seat 2: Fried Berg (big blind) won 0.03€


Winamax Poker - HOLD-UP "Colorado" - HandId: #19116069-444283-1701518315 - Holdem no limit (0.01€/0.02€) - 2023/12/02 11:58:35 UTC
Table: 'Colorado' 6-max (real money) Seat #6 is the button
Seat 1: Fried Berg (0.69€)
Seat 2: theSangoten (1.41€)
Seat 3: Caindymion99 (2€)
Seat 4: metamex (1.87€)
Seat 5: Odieux Car4 (1.10€)
Seat 6: Td08nomotto (2.17€)
*** ANTE/BLINDS ***
Fried Berg posts small blind 0.01€
theSangoten posts big blind 0.02€
Dealt to Fried Berg [6s Ah]
*** PRE-FLOP *** 
Caindymion99 folds
metamex folds
Odieux Car4 raises 0.03€ to 0.05€
Td08nomotto folds
Fried Berg folds
theSangoten folds
Odieux Car4 collected 0.08€ from pot
*** SUMMARY ***
Total pot 0.08€ | No rake
Seat 5: Odieux Car4 won 0.08€


Winamax Poker - HOLD-UP "Colorado" - HandId: #19116069-444311-1701518330 - Holdem no limit (0.01€/0.02€) - 2023/12/02 11:58:50 UTC
Table: 'Colorado' 6-max (real money) Seat #6 is the button
Seat 1: NOT AT ALL (1.01€)
Seat 2: Jaloux88737 (4.18€)
Seat 3: theSangoten (1.39€)
Seat 4: -Y4V- (2.50€)
Seat 5: BMWTPM (1.91€)
Seat 6: Fried Berg (0.68€)
*** ANTE/BLINDS ***
NOT AT ALL posts small blind 0.01€
Jaloux88737 posts big blind 0.02€
Dealt to Fried Berg [4c 6h]
*** PRE-FLOP *** 
theSangoten folds
-Y4V- raises 0.03€ to 0.05€
BMWTPM folds
Fried Berg folds
NOT AT ALL folds
Jaloux88737 calls 0.03€
*** FLOP *** [8s Qd Kd]
Jaloux88737 checks
-Y4V- checks
*** TURN *** [8s Qd Kd][2s]
Jaloux88737 checks
-Y4V- checks
*** RIVER *** [8s Qd Kd 2s][Ks]
Jaloux88737 checks
-Y4V- checks
*** SHOW DOWN ***
Jaloux88737 shows [3c Ad] (One pair : Kings)
-Y4V- shows [7c 7d] (Two pairs : Kings and 7)
-Y4V- collected 0.10€ from pot
*** SUMMARY ***
Total pot 0.10€ | Rake 0.01€
Board: [8s Qd Kd 2s Ks]
Seat 2: Jaloux88737 (big blind) showed [3c Ad] and lost with One pair : Kings
Seat 4: -Y4V- showed [7c 7d] and won 0.10€ with Two pairs : Kings and 7


Winamax Poker - HOLD-UP "Colorado" - HandId: #19116069-444314-1701518331 - Holdem no limit (0.01€/0.02€) - 2023/12/02 11:58:51 UTC
Table: 'Colorado' 6-max (real money) Seat #6 is the button
Seat 1: 14cruyff14 (0.50€)
Seat 2: Pwinpwin (2.13€)
Seat 3: Fried Berg (0.68€)
Seat 4: P.BaIkany (2.07€)
Seat 5: Dit_Bondour (2.22€)
Seat 6: lamuerta8300 (2.71€)
*** ANTE/BLINDS ***
14cruyff14 posts small blind 0.01€
Pwinpwin posts big blind 0.02€
Dealt to Fried Berg [6d Js]
*** PRE-FLOP *** 
Fried Berg folds
P.BaIkany raises 0.04€ to 0.06€
Dit_Bondour folds
lamuerta8300 folds
14cruyff14 folds
Pwinpwin folds
P.BaIkany collected 0.09€ from pot
*** SUMMARY ***
Total pot 0.09€ | No rake
Seat 4: P.BaIkany won 0.09€


Winamax Poker - HOLD-UP "Colorado" - HandId: #19116069-444317-1701518333 - Holdem no limit (0.01€/0.02€) - 2023/12/02 11:58:53 UTC
Table: 'Colorado' 6-max (real money) Seat #6 is the button
Seat 1: _NimpAmax_ (0.51€)
Seat 2: lamuerta8300 (2.71€)
Seat 3: JFSredbaron (2.69€)
Seat 4: Fried Berg (0.68€)
Seat 5: pedrohxx (1.46€)
Seat 6: tichettede3 (3.05€)
*** ANTE/BLINDS ***
_NimpAmax_ posts small blind 0.01€
lamuerta8300 posts big blind 0.02€
Dealt to Fried Berg [2h 8c]
*** PRE-FLOP *** 
JFSredbaron folds
Fried Berg folds
pedrohxx folds
tichettede3 folds
_NimpAmax_ folds
lamuerta8300 collected 0.03€ from pot
*** SUMMARY ***
Total pot 0.03€ | No rake
Seat 2: lamuerta8300 (big blind) won 0.03€


Winamax Poker - HOLD-UP "Colorado" - HandId: #19116069-444321-1701518336 - Holdem no limit (0.01€/0.02€) - 2023/12/02 11:58:56 UTC
Table: 'Colorado' 6-max (real money) Seat #6 is the button
Seat 1: vuesurmer (2.13€)
Seat 2: tranquillouv (1.05€)
Seat 3: yep80 (2.50€)
Seat 4: Fried Berg (0.68€)
Seat 5: tichettede3 (3.05€)
Seat 6: nico9588 (1.74€)
*** ANTE/BLINDS ***
vuesurmer posts small blind 0.01€
tranquillouv posts big blind 0.02€
Dealt to Fried Berg [Ad 5s]
*** PRE-FLOP *** 
yep80 raises 0.03€ to 0.05€
Fried Berg folds
tichettede3 folds
nico9588 calls 0.05€
vuesurmer calls 0.04€
tranquillouv folds
*** FLOP *** [Th As 7d]
vuesurmer checks
yep80 bets 0.11€
nico9588 folds
vuesurmer folds
yep80 collected 0.26€ from pot
*** SUMMARY ***
Total pot 0.26€ | Rake 0.02€
Board: [Th As 7d]
Seat 3: yep80 won 0.26€


Winamax Poker - HOLD-UP "Colorado" - HandId: #19116069-444328-1701518340 - Holdem no limit (0.01€/0.02€) - 2023/12/02 11:59:00 UTC
Table: 'Colorado' 6-max (real money) Seat #6 is the button
Seat 1: Lunau (2.04€)
Seat 2: Fried Berg (0.68€)
Seat 3: LordShiva (0.44€)
Seat 4: Itashi.95 (5.17€)
Seat 5: gagnejamais4 (5.10€)
Seat 6: KingSoto (2.79€)
*** ANTE/BLINDS ***
Lunau posts small blind 0.01€
Fried Berg posts big blind 0.02€
Dealt to Fried Berg [3c Js]
*** PRE-FLOP *** 
LordShiva folds
Itashi.95 raises 0.03€ to 0.05€
gagnejamais4 folds
KingSoto folds
Lunau raises 0.15€ to 0.20€
Fried Berg folds
Itashi.95 folds
Lunau collected 0.27€ from pot
*** SUMMARY ***
Total pot 0.27€ | No rake
Seat 1: Lunau (small blind) won 0.27€


Winamax Poker - HOLD-UP "Colorado" - HandId: #19116069-444331-1701518343 - Holdem no limit (0.01€/0.02€) - 2023/12/02 11:59:03 UTC
Table: 'Colorado' 6-max (real money) Seat #6 is the button
Seat 1: Fried Berg (0.66€)
Seat 2: chaketovibet (2.68€)
Seat 3: gagnejamais4 (5.10€)
Seat 4: NOT AT ALL (1€)
Seat 5: muespachois1 (1.28€)
Seat 6: LordShiva (0.44€)
*** ANTE/BLINDS ***
Fried Berg posts small blind 0.01€
chaketovibet posts big blind 0.02€
Dealt to Fried Berg [Qs Kd]
*** PRE-FLOP *** 
gagnejamais4 folds
NOT AT ALL folds
muespachois1 folds
LordShiva folds
Fried Berg raises 0.02€ to 0.04€
chaketovibet folds
Fried Berg collected 0.06€ from pot
*** SUMMARY ***
Total pot 0.06€ | No rake
Seat 1: Fried Berg (small blind) won 0.06€


Winamax Poker - HOLD-UP "Colorado" - HandId: #19116069-444347-1701518352 - Holdem no limit (0.01€/0.02€) - 2023/12/02 11:59:12 UTC
Table: 'Colorado' 6-max (real money) Seat #6 is the button
Seat 1: Itashi.95 (5.12€)
Seat 2: tichettede3 (2.41€)
Seat 3: lamuerta8300 (2.71€)
Seat 4: 14cruyff14 (0.91€)
Seat 5: Fried Berg (0.68€)
Seat 6: LT_Mage70994 (1.98€)
*** ANTE/BLINDS ***
Itashi.95 posts small blind 0.01€
tichettede3 posts big blind 0.02€
Dealt to Fried Berg [Js Kc]
*** PRE-FLOP *** 
lamuerta8300 folds
14cruyff14 folds
Fried Berg raises 0.02€ to 0.04€
LT_Mage70994 folds
Itashi.95 calls 0.03€
tichettede3 calls 0.02€
*** FLOP *** [9c 5d Kh]
Itashi.95 checks
tichettede3 checks
Fried Berg bets 0.04€
Itashi.95 folds
tichettede3 folds
Fried Berg collected 0.15€ from pot
*** SUMMARY ***
Total pot 0.15€ | Rake 0.01€
Board: [9c 5d Kh]
Seat 5: Fried Berg won 0.15€


Winamax Poker - HOLD-UP "Colorado" - HandId: #19116069-444386-1701518382 - Holdem no limit (0.01€/0.02€) - 2023/12/02 11:59:42 UTC
Table: 'Colorado' 6-max (real money) Seat #6 is the button
Seat 1: Zile741 (6€)
Seat 2: Fried Berg (0.75€)
Seat 3: S-aaron24 (2€)
Seat 4: Nobru.7793 (2.65€)
Seat 5: gagnejamais4 (5.59€)
Seat 6: NyKOh11 (0.50€)
*** ANTE/BLINDS ***
Zile741 posts small blind 0.01€
Fried Berg posts big blind 0.02€
Dealt to Fried Berg [7d Ad]
*** PRE-FLOP *** 
S-aaron24 raises 0.03€ to 0.05€
Nobru.7793 folds
gagnejamais4 folds
NyKOh11 folds
Zile741 folds
Fried Berg calls 0.03€
*** FLOP *** [2s 9c Ah]
Fried Berg checks
S-aaron24 bets 0.06€
Fried Berg calls 0.06€
*** TURN *** [2s 9c Ah][6s]
Fried Berg checks
S-aaron24 checks
*** RIVER *** [2s 9c Ah 6s][7c]
Fried Berg bets 0.12€
S-aaron24 calls 0.12€
*** SHOW DOWN ***
S-aaron24 shows [Jc As] (One pair : Aces)
Fried Berg shows [7d Ad] (Two pairs : Aces and 7)
Fried Berg collected 0.42€ from pot
*** SUMMARY ***
Total pot 0.42€ | Rake 0.05€
Board: [2s 9c Ah 6s 7c]
Seat 2: Fried Berg (big blind) showed [7d Ad] and won 0.42€ with Two pairs : Aces and 7
Seat 3: S-aaron24 showed [Jc As] and lost with One pair : Aces


Winamax Poker - HOLD-UP "Colorado" - HandId: #19116069-444456-1701518425 - Holdem no limit (0.01€/0.02€) - 2023/12/02 12:00:25 UTC
Table: 'Colorado' 6-max (real money) Seat #6 is the button
Seat 1: Itashi.95 (5.19€)
Seat 2: jdeepenslip (2.45€)
Seat 3: Fried Berg (0.94€)
Seat 4: S-aaron24 (2€)
Seat 5: Baston57 (5.12€)
Seat 6: Lunau (2.45€)
*** ANTE/BLINDS ***
Itashi.95 posts small blind 0.01€
jdeepenslip posts big blind 0.02€
Dealt to Fried Berg [Kd 3h]
*** PRE-FLOP *** 
Fried Berg folds
S-aaron24 folds
Baston57 folds
Lunau folds
Itashi.95 raises 0.03€ to 0.05€
jdeepenslip folds
Itashi.95 collected 0.07€ from pot
*** SUMMARY ***
Total pot 0.07€ | No rake
Seat 1: Itashi.95 (small blind) won 0.07€


Winamax Poker - HOLD-UP "Colorado" - HandId: #19116069-444475-1701518435 - Holdem no limit (0.01€/0.02€) - 2023/12/02 12:00:35 UTC
Table: 'Colorado' 6-max (real money) Seat #6 is the button
Seat 1: Fried Berg (0.94€)
Seat 2: Holiap (2.71€)
Seat 3: PIQSOU (2.26€)
Seat 4: Babi78_ (1.83€)
Seat 5: Lunau (2.02€)
Seat 6: Deep Thought (2€)
*** ANTE/BLINDS ***
Fried Berg posts small blind 0.01€
Holiap posts big blind 0.02€
Dealt to Fried Berg [9d 8d]
*** PRE-FLOP *** 
PIQSOU folds
Babi78_ folds
Lunau folds
Deep Thought raises 0.03€ to 0.05€
Fried Berg calls 0.04€
Holiap folds
*** FLOP *** [Th 3s Qc]
Fried Berg checks
Deep Thought checks
*** TURN *** [Th 3s Qc][Kc]
Fried Berg checks
Deep Thought checks
*** RIVER *** [Th 3s Qc Kc][Jd]
Fried Berg bets 0.06€
Deep Thought raises 0.06€ to 0.12€
Fried Berg calls 0.06€
*** SHOW DOWN ***
Fried Berg shows [9d 8d] (Straight King high)
Deep Thought shows [Ac 8s] (Straight Ace high)
Deep Thought collected 0.32€ from pot
*** SUMMARY ***
Total pot 0.32€ | Rake 0.04€
Board: [Th 3s Qc Kc Jd]
Seat 1: Fried Berg (small blind) showed [9d 8d] and lost with Straight King high
Seat 6: Deep Thought (button) showed [Ac 8s] and won 0.32€ with Straight Ace high


Winamax Poker - HOLD-UP "Colorado" - HandId: #19116069-444557-1701518483 - Holdem no limit (0.01€/0.02€) - 2023/12/02 12:01:23 UTC
Table: 'Colorado' 6-max (real money) Seat #6 is the button
Seat 1: TaBrEaMoI (9.19€)
Seat 2: ridiculuss (2.15€)
Seat 3: Pwinpwin (2.07€)
Seat 4: Fried Berg (0.77€)
Seat 5: PANDIKORNIO (1.38€)
Seat 6: Abec16 (3.87€)
*** ANTE/BLINDS ***
TaBrEaMoI posts small blind 0.01€
ridiculuss posts big blind 0.02€
Dealt to Fried Berg [5d 5c]
*** PRE-FLOP *** 
Pwinpwin folds
Fried Berg folds
PANDIKORNIO folds
Abec16 folds
TaBrEaMoI folds
ridiculuss collected 0.03€ from pot
*** SUMMARY ***
Total pot 0.03€ | No rake
Seat 2: ridiculuss (big blind) won 0.03€


Winamax Poker - HOLD-UP "Colorado" - HandId: #19116069-444571-1701518492 - Holdem no limit (0.01€/0.02€) - 2023/12/02 12:01:32 UTC
Table: 'Colorado' 6-max (real money) Seat #6 is the button
Seat 1: Quenelles (4.55€)
Seat 2: Deep Thought (2€)
Seat 3: Lunau (2.65€)
Seat 4: Td08nomotto (2.14€)
Seat 5: Fried Berg (0.77€)
Seat 6: Baston57 (5.17€)
*** ANTE/BLINDS ***
Quenelles posts small blind 0.01€
Deep Thought posts big blind 0.02€
Dealt to Fried Berg [7s Kd]
*** PRE-FLOP *** 
Lunau folds
Td08nomotto calls 0.02€
Fried Berg folds
Baston57 folds
Quenelles folds
Deep Thought checks
*** FLOP *** [Js Jd Ah]
Deep Thought checks
Td08nomotto checks
*** TURN *** [Js Jd Ah][8c]
Deep Thought checks
Td08nomotto checks
*** RIVER *** [Js Jd Ah 8c][6h]
Deep Thought checks
Td08nomotto checks
*** SHOW DOWN ***
Deep Thought shows [8s 2c] (Two pairs : Jacks and 8)
Td08nomotto shows [9s 9c] (Two pairs : Jacks and 9)
Td08nomotto collected 0.04€ from pot
*** SUMMARY ***
Total pot 0.04€ | Rake 0.01€
Board: [Js Jd Ah 8c 6h]
Seat 2: Deep Thought (big blind) showed [8s 2c] and lost with Two pairs : Jacks and 8
Seat 4: Td08nomotto showed [9s 9c] and won 0.04€ with Two pairs : Jacks and 9


Winamax Poker - HOLD-UP "Colorado" - HandId: #19116069-444577-1701518495 - Holdem no limit (0.01€/0.02€) - 2023/12/02 12:01:35 UTC
Table: 'Colorado' 6-max (real money) Seat #6 is the button
Seat 1: BMWTPM (1.96€)
Seat 2: Dame de pik (4.03€)
Seat 3: Pwinpwin (2.03€)
Seat 4: tichettede3 (2.93€)
Seat 5: Lunau (2.02€)
Seat 6: Fried Berg (0.77€)
*** ANTE/BLINDS ***
BMWTPM posts small blind 0.01€
Dame de pik posts big blind 0.02€
Dealt to Fried Berg [3c Ah]
*** PRE-FLOP *** 
Pwinpwin folds
tichettede3 folds
Lunau folds
Fried Berg folds
BMWTPM folds
Dame de pik collected 0.03€ from pot
*** SUMMARY ***
Total pot 0.03€ | No rake
Seat 2: Dame de pik (big blind) won 0.03€


Winamax Poker - HOLD-UP "Colorado" - HandId: #19116069-444581-1701518498 - Holdem no limit (0.01€/0.02€) - 2023/12/02 12:01:38 UTC
Table: 'Colorado' 6-max (real money) Seat #6 is the button
Seat 1: muespachois1 (1.40€)
Seat 2: Black-Bull (2.01€)
Seat 3: le papayou (2.78€)
Seat 4: Fried Berg (0.77€)
Seat 5: Zile741 (2.55€)
Seat 6: Kekoke (0.70€)
*** ANTE/BLINDS ***
muespachois1 posts small blind 0.01€
Black-Bull posts big blind 0.02€
Dealt to Fried Berg [Tc 6d]
*** PRE-FLOP *** 
le papayou folds
Fried Berg folds
Zile741 folds
Kekoke calls 0.02€
muespachois1 folds
Black-Bull checks
*** FLOP *** [5c 9s 8s]
Black-Bull checks
Kekoke bets 0.05€
Black-Bull folds
Kekoke collected 0.09€ from pot
*** SUMMARY ***
Total pot 0.09€ | Rake 0.01€
Board: [5c 9s 8s]
Seat 6: Kekoke (button) won 0.09€


Winamax Poker - HOLD-UP "Colorado" - HandId: #19116069-444583-1701518499 - Holdem no limit (0.01€/0.02€) - 2023/12/02 12:01:39 UTC
Table: 'Colorado' 6-max (real money) Seat #6 is the button
Seat 1: Merlus83 (4.62€)
Seat 2: blie2006 (0.77€)
Seat 3: Fried Berg (0.77€)
Seat 4: TaBrEaMoI (3.02€)
Seat 5: NyKOh11 (0.50€)
Seat 6: Anubis1983 (0.80€)
*** ANTE/BLINDS ***
Merlus83 posts small blind 0.01€
blie2006 posts big blind 0.02€
Dealt to Fried Berg [3h Jh]
*** PRE-FLOP *** 
Fried Berg folds
TaBrEaMoI folds
NyKOh11 folds
Anubis1983 raises 0.04€ to 0.06€
Merlus83 folds
blie2006 folds
Anubis1983 collected 0.09€ from pot
*** SUMMARY ***
Total pot 0.09€ | No rake
Seat 6: Anubis1983 (button) won 0.09€


Winamax Poker - HOLD-UP "Colorado" - HandId: #19116069-444588-1701518502 - Holdem no limit (0.01€/0.02€) - 2023/12/02 12:01:42 UTC
Table: 'Colorado' 6-max (real money) Seat #6 is the button
Seat 1: Fried Berg (0.77€)
Seat 2: Caindymion99 (2.03€)
Seat 3: metamex (1.78€)
Seat 4: Zile741 (2.55€)
Seat 5: Lunau (2.43€)
Seat 6: le papayou (2.78€)
*** ANTE/BLINDS ***
Fried Berg posts small blind 0.01€
Caindymion99 posts big blind 0.02€
Dealt to Fried Berg [8s 7h]
*** PRE-FLOP *** 
metamex raises 0.04€ to 0.06€
Zile741 folds
Lunau folds
le papayou folds
Fried Berg folds
Caindymion99 calls 0.04€
*** FLOP *** [3c 8d Qh]
Caindymion99 checks
metamex bets 0.07€
Caindymion99 calls 0.07€
*** TURN *** [3c 8d Qh][Td]
Caindymion99 checks
metamex bets 0.14€
Caindymion99 calls 0.14€
*** RIVER *** [3c 8d Qh Td][9h]
Caindymion99 checks
metamex checks
*** SHOW DOWN ***
metamex shows [Qc Kh] (One pair : Queens)
Caindymion99 shows [Qd Ah] (One pair : Queens)
Caindymion99 collected 0.49€ from pot
*** SUMMARY ***
Total pot 0.49€ | Rake 0.06€
Board: [3c 8d Qh Td 9h]
Seat 2: Caindymion99 (big blind) showed [Qd Ah] and won 0.49€ with One pair : Queens
Seat 3: metamex showed [Qc Kh] and lost with One pair : Queens


Winamax Poker - HOLD-UP "Colorado" - HandId: #19116069-444594-1701518506 - Holdem no limit (0.01€/0.02€) - 2023/12/02 12:01:46 UTC
Table: 'Colorado' 6-max (real money) Seat #6 is the button
Seat 1: TaBrEaMoI (3.81€)
Seat 2: Fried Berg (0.76€)
Seat 3: RhinoLibre99 (4.87€)
Seat 4: Kipyomag (2.14€)
Seat 5: S-aaron24 (2.02€)
Seat 6: Nonik1987 (0.38€)
Hold-up to Pot: total 0.10€
*** ANTE/BLINDS ***
TaBrEaMoI posts small blind 0.01€
Fried Berg posts big blind 0.02€
Dealt to Fried Berg [7d 4d]
*** PRE-FLOP *** 
RhinoLibre99 calls 0.02€
Kipyomag folds
S-aaron24 folds
Nonik1987 raises 0.36€ to 0.38€ and is all-in
TaBrEaMoI folds
Fried Berg folds
RhinoLibre99 folds
Nonik1987 collected 0.53€ from pot
*** SUMMARY ***
Total pot 0.53€ | No rake
Seat 6: Nonik1987 (button) won 0.53€


Winamax Poker - HOLD-UP "Colorado" - HandId: #19116069-444613-1701518517 - Holdem no limit (0.01€/0.02€) - 2023/12/02 12:01:57 UTC
Table: 'Colorado' 6-max (real money) Seat #6 is the button
Seat 1: p4ppysl4m (2.76€)
Seat 2: TheNerd (2.35€)
Seat 3: KON-2-PEUTE (2.44€)
Seat 4: LMG22_23 (2.07€)
Seat 5: galettedesKK (4.23€)
Seat 6: Fried Berg (0.74€)
*** ANTE/BLINDS ***
p4ppysl4m posts small blind 0.01€
TheNerd posts big blind 0.02€
Dealt to Fried Berg [Kd 4c]
*** PRE-FLOP *** 
KON-2-PEUTE folds
LMG22_23 folds
galettedesKK raises 0.05€ to 0.07€
Fried Berg folds
p4ppysl4m folds
TheNerd folds
galettedesKK collected 0.10€ from pot
*** SUMMARY ***
Total pot 0.10€ | No rake
Seat 5: galettedesKK won 0.10€


Winamax Poker - HOLD-UP "Colorado" - HandId: #19116069-444616-1701518519 - Holdem no limit (0.01€/0.02€) - 2023/12/02 12:01:59 UTC
Table: 'Colorado' 6-max (real money) Seat #6 is the button
Seat 1: P.BaIkany (2€)
Seat 2: nico9588 (1.54€)
Seat 3: muespachois1 (1.35€)
Seat 4: TaBrEaMoI (3.80€)
Seat 5: Fried Berg (0.74€)
Seat 6: lamuerta8300 (2.02€)
Hold-up to Pot: total 0.10€
*** ANTE/BLINDS ***
P.BaIkany posts small blind 0.01€
nico9588 posts big blind 0.02€
Dealt to Fried Berg [2c 7c]
*** PRE-FLOP *** 
muespachois1 folds
TaBrEaMoI raises 0.04€ to 0.06€
Fried Berg folds
lamuerta8300 calls 0.06€
P.BaIkany raises 0.30€ to 0.36€
nico9588 folds
TaBrEaMoI calls 0.30€
lamuerta8300 folds
*** FLOP *** [Qs Tc Qc]
P.BaIkany checks
TaBrEaMoI bets 0.45€
P.BaIkany folds
TaBrEaMoI collected 1.27€ from pot
*** SUMMARY ***
Total pot 1.27€ | Rake 0.08€
Board: [Qs Tc Qc]
Seat 4: TaBrEaMoI won 1.27€


Winamax Poker - HOLD-UP "Colorado" - HandId: #19116069-444623-1701518525 - Holdem no limit (0.01€/0.02€) - 2023/12/02 12:02:05 UTC
Table: 'Colorado' 6-max (real money) Seat #6 is the button
Seat 1: haouuum28 (3.11€)
Seat 2: fifi2308 (2.12€)
Seat 3: -Y4V- (3.48€)
Seat 4: Fried Berg (0.74€)
Seat 5: pedrohxx (1.41€)
Seat 6: Jaloux88737 (4.37€)
*** ANTE/BLINDS ***
haouuum28 posts small blind 0.01€
fifi2308 posts big blind 0.02€
Dealt to Fried Berg [Tc 4h]
*** PRE-FLOP *** 
-Y4V- folds
Fried Berg folds
pedrohxx raises 0.02€ to 0.04€
Jaloux88737 folds
haouuum28 folds
fifi2308 raises 2€ to 2.04€
pedrohxx folds
fifi2308 collected 2.09€ from pot
*** SUMMARY ***
Total pot 2.09€ | No rake
Seat 2: fifi2308 (big blind) won 2.09€


Winamax Poker - HOLD-UP "Colorado" - HandId: #19116069-444626-1701518527 - Holdem no limit (0.01€/0.02€) - 2023/12/02 12:02:07 UTC
Table: 'Colorado' 6-max (real money) Seat #6 is the button
Seat 1: -Y4V- (3.48€)
Seat 2: blie2006 (0.60€)
Seat 3: Abec16 (3.63€)
Seat 4: toutoazar (2.36€)
Seat 5: Fried Berg (0.74€)
Seat 6: magicfido (0.98€)
*** ANTE/BLINDS ***
-Y4V- posts small blind 0.01€
blie2006 posts big blind 0.02€
Dealt to Fried Berg [9s 6h]
*** PRE-FLOP *** 
Abec16 raises 0.03€ to 0.05€
toutoazar folds
Fried Berg folds
magicfido folds
-Y4V- folds
blie2006 calls 0.03€
*** FLOP *** [6s Qs 3h]
blie2006 checks
Abec16 checks
*** TURN *** [6s Qs 3h][Jc]
blie2006 bets 0.02€
Abec16 folds
blie2006 collected 0.12€ from pot
*** SUMMARY ***
Total pot 0.12€ | Rake 0.01€
Board: [6s Qs 3h Jc]
Seat 2: blie2006 (big blind) won 0.12€


Winamax Poker - HOLD-UP "Colorado" - HandId: #19116069-444631-1701518529 - Holdem no limit (0.01€/0.02€) - 2023/12/02 12:02:09 UTC
Table: 'Colorado' 6-max (real money) Seat #6 is the button
Seat 1: magicfido (0.98€)
Seat 2: toutoazar (2.36€)
Seat 3: Fried Berg (0.74€)
Seat 4: TheNerd (2.33€)
Seat 5: NyKOh11 (0.60€)
Seat 6: Pwinpwin (3.43€)
*** ANTE/BLINDS ***
magicfido posts small blind 0.01€
toutoazar posts big blind 0.02€
Dealt to Fried Berg [7s Qd]
*** PRE-FLOP *** 
Fried Berg folds
TheNerd folds
NyKOh11 folds
Pwinpwin folds
magicfido raises 0.04€ to 0.06€
toutoazar folds
magicfido collected 0.08€ from pot
*** SUMMARY ***
Total pot 0.08€ | No rake
Seat 1: magicfido (small blind) won 0.08€


Winamax Poker - HOLD-UP "Colorado" - HandId: #19116069-444635-1701518531 - Holdem no limit (0.01€/0.02€) - 2023/12/02 12:02:11 UTC
Table: 'Colorado' 6-max (real money) Seat #6 is the button
Seat 1: Fried Berg (0.74€)
Seat 2: LEDesTAKeuR3 (2.05€)
Seat 3: LMG22_23 (1.94€)
Seat 4: LT_Mage70994 (2.08€)
Seat 5: haouuum28 (2.29€)
Seat 6: TheNerd (2.33€)
*** ANTE/BLINDS ***
Fried Berg posts small blind 0.01€
LEDesTAKeuR3 posts big blind 0.02€
Dealt to Fried Berg [6s 9d]
*** PRE-FLOP *** 
LMG22_23 folds
LT_Mage70994 folds
haouuum28 folds
TheNerd folds
Fried Berg folds
LEDesTAKeuR3 collected 0.03€ from pot
*** SUMMARY ***
Total pot 0.03€ | No rake
Seat 2: LEDesTAKeuR3 (big blind) won 0.03€


Winamax Poker - HOLD-UP "Colorado" - HandId: #19116069-444638-1701518533 - Holdem no limit (0.01€/0.02€) - 2023/12/02 12:02:13 UTC
Table: 'Colorado' 6-max (real money) Seat #6 is the button
Seat 1: Wolfert (3.54€)
Seat 2: Fried Berg (0.73€)
Seat 3: ridiculuss (1.88€)
Seat 4: douchka1973 (1.65€)
Seat 5: Pwinpwin (2€)
Seat 6: NyKOh11 (0.60€)
Hold-up to Pot: total 0.10€
*** ANTE/BLINDS ***
Wolfert posts small blind 0.01€
Fried Berg posts big blind 0.02€
Dealt to Fried Berg [Jh Ac]
*** PRE-FLOP *** 
ridiculuss raises 0.04€ to 0.06€
douchka1973 raises 1.59€ to 1.65€ and is all-in
Pwinpwin folds
NyKOh11 folds
Wolfert folds
Fried Berg folds
ridiculuss calls 1.59€
*** FLOP *** [9d 4h Kd]
*** TURN *** [9d 4h Kd][9h]
*** RIVER *** [9d 4h Kd 9h][3d]
*** SHOW DOWN ***
douchka1973 shows [Ts Ad] (One pair : 9)
ridiculuss shows [8c 9c] (Trips of 9)
ridiculuss collected 3.10€ from pot
*** SUMMARY ***
Total pot 3.10€ | Rake 0.33€
Board: [9d 4h Kd 9h 3d]
Seat 3: ridiculuss showed [8c 9c] and won 3.10€ with Trips of 9
Seat 4: douchka1973 showed [Ts Ad] and lost with One pair : 9


Winamax Poker - HOLD-UP "Colorado" - HandId: #19116069-444663-1701518550 - Holdem no limit (0.01€/0.02€) - 2023/12/02 12:02:30 UTC
Table: 'Colorado' 6-max (real money) Seat #6 is the button
Seat 1: Td08nomotto (2€)
Seat 2: lamuerta8300 (3.41€)
Seat 3: Baston57 (5.17€)
Seat 4: Caindymion99 (2.24€)
Seat 5: Fried Berg (0.71€)
Seat 6: Abec16 (3.55€)
*** ANTE/BLINDS ***
Td08nomotto posts small blind 0.01€
lamuerta8300 posts big blind 0.02€
Dealt to Fried Berg [9c Kh]
*** PRE-FLOP *** 
Baston57 folds
Caindymion99 folds
Fried Berg folds
Abec16 folds
Td08nomotto folds
lamuerta8300 collected 0.03€ from pot
*** SUMMARY ***
Total pot 0.03€ | No rake
Seat 2: lamuerta8300 (big blind) won 0.03€


Winamax Poker - HOLD-UP "Colorado" - HandId: #19116069-444668-1701518554 - Holdem no limit (0.01€/0.02€) - 2023/12/02 12:02:34 UTC
Table: 'Colorado' 6-max (real money) Seat #6 is the button
Seat 1: Merlus83 (4.65€)
Seat 2: haouuum28 (2.28€)
Seat 3: Td08nomotto (2€)
Seat 4: Fried Berg (0.71€)
Seat 5: Quenelles (4.49€)
Seat 6: vuesurmer (2€)
*** ANTE/BLINDS ***
Merlus83 posts small blind 0.01€
haouuum28 posts big blind 0.02€
Dealt to Fried Berg [Th Kc]
*** PRE-FLOP *** 
Td08nomotto folds
Fried Berg folds
Quenelles folds
vuesurmer folds
Merlus83 calls 0.01€
haouuum28 checks
*** FLOP *** [Js Ad 7h]
Merlus83 bets 0.02€
haouuum28 folds
Merlus83 collected 0.06€ from pot
*** SUMMARY ***
Total pot 0.06€ | No rake
Board: [Js Ad 7h]
Seat 1: Merlus83 (small blind) won 0.06€


Winamax Poker - HOLD-UP "Colorado" - HandId: #19116069-444672-1701518557 - Holdem no limit (0.01€/0.02€) - 2023/12/02 12:02:37 UTC
Table: 'Colorado' 6-max (real money) Seat #6 is the button
Seat 1: lamuerta8300 (3.42€)
Seat 2: KON-2-PEUTE (2.43€)
Seat 3: LT_Mage70994 (2.08€)
Seat 4: S-aaron24 (2€)
Seat 5: El Paellas (0.50€)
Seat 6: Fried Berg (0.71€)
*** ANTE/BLINDS ***
lamuerta8300 posts small blind 0.01€
KON-2-PEUTE posts big blind 0.02€
Dealt to Fried Berg [3c 3h]
*** PRE-FLOP *** 
LT_Mage70994 folds
S-aaron24 raises 0.03€ to 0.05€
El Paellas folds
Fried Berg calls 0.05€
lamuerta8300 calls 0.04€
KON-2-PEUTE folds
*** FLOP *** [4c 7s 7h]
lamuerta8300 checks
S-aaron24 checks
Fried Berg checks
*** TURN *** [4c 7s 7h][Ts]
lamuerta8300 checks
S-aaron24 checks
Fried Berg checks
*** RIVER *** [4c 7s 7h Ts][8s]
lamuerta8300 checks
S-aaron24 checks
Fried Berg checks
*** SHOW DOWN ***
lamuerta8300 shows [Qc 9c] (One pair : 7)
S-aaron24 shows [Jh Ah] (One pair : 7)
Fried Berg shows [3c 3h] (Two pairs : 7 and 3)
Fried Berg collected 0.15€ from pot
*** SUMMARY ***
Total pot 0.15€ | Rake 0.02€
Board: [4c 7s 7h Ts 8s]
Seat 1: lamuerta8300 (small blind) showed [Qc 9c] and lost with One pair : 7
Seat 4: S-aaron24 showed [Jh Ah] and lost with One pair : 7
Seat 6: Fried Berg (button) showed [3c 3h] and won 0.15€ with Two pairs : 7 and 3


Winamax Poker - HOLD-UP "Colorado" - HandId: #19116069-444771-1701518639 - Holdem no limit (0.01€/0.02€) - 2023/12/02 12:03:59 UTC
Table: 'Colorado' 6-max (real money) Seat #6 is the button
Seat 1: Fried Berg (0.81€)
Seat 2: vuesurmer (4.41€)
Seat 3: lamuerta8300 (3.37€)
Seat 4: S-aaron24 (2€)
Seat 5: JFSredbaron (2.78€)
Seat 6: nico9588 (1.92€)
*** ANTE/BLINDS ***
Fried Berg posts small blind 0.01€
vuesurmer posts big blind 0.02€
Dealt to Fried Berg [Ts 8h]
*** PRE-FLOP *** 
lamuerta8300 folds
S-aaron24 folds
JFSredbaron folds
nico9588 raises 0.03€ to 0.05€
Fried Berg folds
vuesurmer folds
nico9588 collected 0.08€ from pot
*** SUMMARY ***
Total pot 0.08€ | No rake
Seat 6: nico9588 (button) won 0.08€


Winamax Poker - HOLD-UP "Colorado" - HandId: #19116069-444788-1701518650 - Holdem no limit (0.01€/0.02€) - 2023/12/02 12:04:10 UTC
Table: 'Colorado' 6-max (real money) Seat #6 is the button
Seat 1: Lunau (2.58€)
Seat 2: Deep Thought (2€)
Seat 3: metamex (1.84€)
Seat 4: Mercuryllo (2.13€)
Seat 5: Zile741 (2.63€)
Seat 6: Fried Berg (0.80€)
*** ANTE/BLINDS ***
Lunau posts small blind 0.01€
Deep Thought posts big blind 0.02€
Dealt to Fried Berg [6h Kh]
*** PRE-FLOP *** 
metamex folds
Mercuryllo folds
Zile741 folds
Fried Berg raises 0.02€ to 0.04€
Lunau calls 0.03€
Deep Thought folds
*** FLOP *** [Jd Qs 7s]
Lunau checks
Fried Berg checks
*** TURN *** [Jd Qs 7s][5h]
Lunau checks
Fried Berg checks
*** RIVER *** [Jd Qs 7s 5h][6s]
Lunau checks
Fried Berg checks
*** SHOW DOWN ***
Lunau shows [2h 2d] (One pair : 2)
Fried Berg shows [6h Kh] (One pair : 6)
Fried Berg collected 0.09€ from pot
*** SUMMARY ***
Total pot 0.09€ | Rake 0.01€
Board: [Jd Qs 7s 5h 6s]
Seat 1: Lunau (small blind) showed [2h 2d] and lost with One pair : 2
Seat 6: Fried Berg (button) showed [6h Kh] and won 0.09€ with One pair : 6


Winamax Poker - HOLD-UP "Colorado" - HandId: #19116069-444851-1701518688 - Holdem no limit (0.01€/0.02€) - 2023/12/02 12:04:48 UTC
Table: 'Colorado' 6-max (real money) Seat #6 is the button
Seat 1: le papayou (1.73€)
Seat 2: Fried Berg (0.85€)
Seat 3: muespachois1 (1.83€)
Seat 4: P.BaIkany (2.28€)
Seat 5: jdeepenslip (2.41€)
Seat 6: FlyIndeSky (0.53€)
*** ANTE/BLINDS ***
le papayou posts small blind 0.01€
Fried Berg posts big blind 0.02€
Dealt to Fried Berg [4s Qc]
*** PRE-FLOP *** 
muespachois1 folds
P.BaIkany folds
jdeepenslip folds
FlyIndeSky folds
le papayou folds
Fried Berg collected 0.03€ from pot
*** SUMMARY ***
Total pot 0.03€ | No rake
Seat 2: Fried Berg (big blind) won 0.03€


Winamax Poker - HOLD-UP "Colorado" - HandId: #19116069-444860-1701518695 - Holdem no limit (0.01€/0.02€) - 2023/12/02 12:04:55 UTC
Table: 'Colorado' 6-max (real money) Seat #6 is the button
Seat 1: Quenelles (4.12€)
Seat 2: lamuerta8300 (1.80€)
Seat 3: le papayou (1.72€)
Seat 4: liseau5312 (2€)
Seat 5: Fried Berg (0.86€)
Seat 6: Deep Thought (2€)
*** ANTE/BLINDS ***
Quenelles posts small blind 0.01€
lamuerta8300 posts big blind 0.02€
Dealt to Fried Berg [4c Th]
*** PRE-FLOP *** 
le papayou folds
liseau5312 folds
Fried Berg folds
Deep Thought folds
Quenelles folds
lamuerta8300 collected 0.03€ from pot
*** SUMMARY ***
Total pot 0.03€ | No rake
Seat 2: lamuerta8300 (big blind) won 0.03€


Winamax Poker - HOLD-UP "Colorado" - HandId: #19116069-444870-1701518701 - Holdem no limit (0.01€/0.02€) - 2023/12/02 12:05:01 UTC
Table: 'Colorado' 6-max (real money) Seat #6 is the button
Seat 1: P.BaIkany (2.29€)
Seat 2: Quenelles (2.82€)
Seat 3: S-aaron24 (2€)
Seat 4: Pwinpwin (3.67€)
Seat 5: TaBrEaMoI (9.17€)
Seat 6: Fried Berg (0.86€)
*** ANTE/BLINDS ***
P.BaIkany posts small blind 0.01€
Quenelles posts big blind 0.02€
Dealt to Fried Berg [8c Ts]
*** PRE-FLOP *** 
S-aaron24 folds
Pwinpwin folds
TaBrEaMoI folds
Fried Berg folds
P.BaIkany raises 0.05€ to 0.07€
Quenelles folds
P.BaIkany collected 0.09€ from pot
*** SUMMARY ***
Total pot 0.09€ | No rake
Seat 1: P.BaIkany (small blind) won 0.09€


Winamax Poker - HOLD-UP "Colorado" - HandId: #19116069-444890-1701518711 - Holdem no limit (0.01€/0.02€) - 2023/12/02 12:05:11 UTC
Table: 'Colorado' 6-max (real money) Seat #6 is the button
Seat 1: Zile741 (2.40€)
Seat 2: FlyIndeSky (0.98€)
Seat 3: Fried Berg (0.86€)
Seat 4: KON-2-PEUTE (2.53€)
Seat 5: vuesurmer (2€)
Seat 6: ridiculuss (2.78€)
*** ANTE/BLINDS ***
Zile741 posts small blind 0.01€
FlyIndeSky posts big blind 0.02€
Dealt to Fried Berg [5s 8d]
*** PRE-FLOP *** 
Fried Berg folds
KON-2-PEUTE folds
vuesurmer folds
ridiculuss folds
Zile741 raises 0.04€ to 0.06€
FlyIndeSky folds
Zile741 collected 0.08€ from pot
*** SUMMARY ***
Total pot 0.08€ | No rake
Seat 1: Zile741 (small blind) won 0.08€


Winamax Poker - HOLD-UP "Colorado" - HandId: #19116069-444892-1701518712 - Holdem no limit (0.01€/0.02€) - 2023/12/02 12:05:12 UTC
Table: 'Colorado' 6-max (real money) Seat #6 is the button
Seat 1: Holiap (2.61€)
Seat 2: Betiegarri (2.14€)
Seat 3: JFSredbaron (2.43€)
Seat 4: Fried Berg (0.86€)
Seat 5: ridiculuss (2.78€)
Seat 6: KON-2-PEUTE (2.53€)
*** ANTE/BLINDS ***
Holiap posts small blind 0.01€
Betiegarri posts big blind 0.02€
Dealt to Fried Berg [Jd Jc]
*** PRE-FLOP *** 
JFSredbaron folds
Fried Berg raises 0.02€ to 0.04€
ridiculuss folds
KON-2-PEUTE folds
Holiap folds
Betiegarri calls 0.02€
*** FLOP *** [5h Kh As]
Betiegarri checks
Fried Berg bets 0.06€
Betiegarri calls 0.06€
*** TURN *** [5h Kh As][Jh]
Betiegarri checks
Fried Berg checks
*** RIVER *** [5h Kh As Jh][7d]
Betiegarri checks
Fried Berg checks
*** SHOW DOWN ***
Betiegarri shows [9d Ks] (One pair : Kings)
Fried Berg shows [Jd Jc] (Trips of Jacks)
Fried Berg collected 0.19€ from pot
*** SUMMARY ***
Total pot 0.19€ | Rake 0.02€
Board: [5h Kh As Jh 7d]
Seat 2: Betiegarri (big blind) showed [9d Ks] and lost with One pair : Kings
Seat 4: Fried Berg showed [Jd Jc] and won 0.19€ with Trips of Jacks


Winamax Poker - HOLD-UP "Colorado" - HandId: #19116069-444954-1701518749 - Holdem no limit (0.01€/0.02€) - 2023/12/02 12:05:49 UTC
Table: 'Colorado' 6-max (real money) Seat #6 is the button
Seat 1: Betiegarri (2.17€)
Seat 2: Fried Berg (0.95€)
Seat 3: Holiap (2.33€)
Seat 4: Lunau (4.30€)
Seat 5: JFSredbaron (5.50€)
Seat 6: Zile741 (3.84€)
*** ANTE/BLINDS ***
Betiegarri posts small blind 0.01€
Fried Berg posts big blind 0.02€
Dealt to Fried Berg [3s 2h]
*** PRE-FLOP *** 
Holiap folds
Lunau folds
JFSredbaron folds
Zile741 folds
Betiegarri folds
Fried Berg collected 0.03€ from pot
*** SUMMARY ***
Total pot 0.03€ | No rake
Seat 2: Fried Berg (big blind) won 0.03€


Winamax Poker - HOLD-UP "Colorado" - HandId: #19116069-444973-1701518762 - Holdem no limit (0.01€/0.02€) - 2023/12/02 12:06:02 UTC
Table: 'Colorado' 6-max (real money) Seat #6 is the button
Seat 1: FlyIndeSky (0.44€)
Seat 2: NyKOh11 (0.60€)
Seat 3: blie2006 (0.88€)
Seat 4: Eytrewq (3.04€)
Seat 5: Lunau (2.92€)
Seat 6: Fried Berg (0.96€)
*** ANTE/BLINDS ***
FlyIndeSky posts small blind 0.01€
NyKOh11 posts big blind 0.02€
Dealt to Fried Berg [7c Kd]
*** PRE-FLOP *** 
blie2006 raises 0.02€ to 0.04€
Eytrewq folds
Lunau folds
Fried Berg folds
FlyIndeSky folds
NyKOh11 folds
blie2006 collected 0.07€ from pot
*** SUMMARY ***
Total pot 0.07€ | No rake
Seat 3: blie2006 won 0.07€


Winamax Poker - HOLD-UP "Colorado" - HandId: #19116069-444982-1701518766 - Holdem no limit (0.01€/0.02€) - 2023/12/02 12:06:06 UTC
Table: 'Colorado' 6-max (real money) Seat #6 is the button
Seat 1: Lunau (2.92€)
Seat 2: Yann.63333 (0.41€)
Seat 3: Fried Berg (0.96€)
Seat 4: FlyIndeSky (0.43€)
Seat 5: NyKOh11 (0.50€)
Seat 6: TaBrEaMoI (8.75€)
Hold-up to Pot: total 0.20€
*** ANTE/BLINDS ***
Lunau posts small blind 0.01€
Yann.63333 posts big blind 0.02€
Dealt to Fried Berg [Js Jh]
*** PRE-FLOP *** 
Fried Berg raises 0.02€ to 0.04€
FlyIndeSky folds
NyKOh11 folds
TaBrEaMoI calls 0.04€
Lunau calls 0.03€
Yann.63333 folds
*** FLOP *** [2d Qc Kc]
Lunau checks
Fried Berg bets 0.16€
TaBrEaMoI calls 0.16€
Lunau calls 0.16€
*** TURN *** [2d Qc Kc][9s]
Lunau checks
Fried Berg checks
TaBrEaMoI checks
*** RIVER *** [2d Qc Kc 9s][7h]
Lunau checks
Fried Berg checks
TaBrEaMoI checks
*** SHOW DOWN ***
Lunau shows [Ac Jd] (High card : Ace)
Fried Berg shows [Js Jh] (One pair : Jacks)
TaBrEaMoI shows [Qd 3d] (One pair : Queens)
TaBrEaMoI collected 0.76€ from pot
*** SUMMARY ***
Total pot 0.76€ | Rake 0.06€
Board: [2d Qc Kc 9s 7h]
Seat 1: Lunau (small blind) showed [Ac Jd] and lost with High card : Ace
Seat 3: Fried Berg showed [Js Jh] and lost with One pair : Jacks
Seat 6: TaBrEaMoI (button) showed [Qd 3d] and won 0.76€ with One pair : Queens


Winamax Poker - HOLD-UP "Colorado" - HandId: #19116069-445077-1701518834 - Holdem no limit (0.01€/0.02€) - 2023/12/02 12:07:14 UTC
Table: 'Colorado' 6-max (real money) Seat #6 is the button
Seat 1: p4ppysl4m (4.37€)
Seat 2: Wolfert (3.01€)
Seat 3: TaBrEaMoI (9.31€)
Seat 4: l artiste ho (1.18€)
Seat 5: Fried Berg (0.76€)
Seat 6: lamuerta8300 (2.37€)
*** ANTE/BLINDS ***
p4ppysl4m posts small blind 0.01€
Wolfert posts big blind 0.02€
Dealt to Fried Berg [6s 3h]
*** PRE-FLOP *** 
TaBrEaMoI folds
l artiste ho folds
Fried Berg folds
lamuerta8300 raises 0.04€ to 0.06€
p4ppysl4m calls 0.05€
Wolfert raises 0.12€ to 0.18€
lamuerta8300 calls 0.12€
p4ppysl4m calls 0.12€
*** FLOP *** [5c Jh 9s]
p4ppysl4m checks
Wolfert bets 0.19€
lamuerta8300 folds
p4ppysl4m folds
Wolfert collected 0.68€ from pot
*** SUMMARY ***
Total pot 0.68€ | Rake 0.05€
Board: [5c Jh 9s]
Seat 2: Wolfert (big blind) won 0.68€


Winamax Poker - HOLD-UP "Colorado" - HandId: #19116069-445102-1701518856 - Holdem no limit (0.01€/0.02€) - 2023/12/02 12:07:36 UTC
Table: 'Colorado' 6-max (real money) Seat #6 is the button
Seat 1: Fried Berg (0.76€)
Seat 2: pedrohxx (1.70€)
Seat 3: metamex (1.79€)
Seat 4: Lunau (2.70€)
Seat 5: GokuClan (1.70€)
Seat 6: haouuum28 (3.02€)
*** ANTE/BLINDS ***
Fried Berg posts small blind 0.01€
pedrohxx posts big blind 0.02€
Dealt to Fried Berg [4d Tc]
*** PRE-FLOP *** 
metamex folds
Lunau folds
GokuClan folds
haouuum28 folds
Fried Berg folds
pedrohxx collected 0.03€ from pot
*** SUMMARY ***
Total pot 0.03€ | No rake
Seat 2: pedrohxx (big blind) won 0.03€


Winamax Poker - HOLD-UP "Colorado" - HandId: #19116069-445106-1701518858 - Holdem no limit (0.01€/0.02€) - 2023/12/02 12:07:38 UTC
Table: 'Colorado' 6-max (real money) Seat #6 is the button
Seat 1: metamex (1.79€)
Seat 2: Fried Berg (0.75€)
Seat 3: jdeepenslip (2.85€)
Seat 4: vuesurmer (2€)
Seat 5: sopra61 (1.97€)
Seat 6: magicfido (0.55€)
*** ANTE/BLINDS ***
metamex posts small blind 0.01€
Fried Berg posts big blind 0.02€
Dealt to Fried Berg [8d Ad]
*** PRE-FLOP *** 
jdeepenslip folds
vuesurmer folds
sopra61 folds
magicfido folds
metamex folds
Fried Berg collected 0.03€ from pot
*** SUMMARY ***
Total pot 0.03€ | No rake
Seat 2: Fried Berg (big blind) won 0.03€


Winamax Poker - HOLD-UP "Colorado" - HandId: #19116069-445115-1701518865 - Holdem no limit (0.01€/0.02€) - 2023/12/02 12:07:45 UTC
Table: 'Colorado' 6-max (real money) Seat #6 is the button
Seat 1: Abec16 (2.96€)
Seat 2: stotof (0.49€)
Seat 3: Fried Berg (0.76€)
Seat 4: Lunau (1.76€)
Seat 5: Amazigh 78 (2.06€)
Seat 6: Td08nomotto (2€)
*** ANTE/BLINDS ***
Abec16 posts small blind 0.01€
stotof posts big blind 0.02€
Dealt to Fried Berg [6d Ad]
*** PRE-FLOP *** 
Fried Berg raises 0.02€ to 0.04€
Lunau calls 0.04€
Amazigh 78 folds
Td08nomotto folds
Abec16 folds
stotof folds
*** FLOP *** [Qd 6c 7d]
Fried Berg checks
Lunau bets 0.04€
Fried Berg calls 0.04€
*** TURN *** [Qd 6c 7d][9d]
Fried Berg checks
Lunau checks
*** RIVER *** [Qd 6c 7d 9d][9c]
Fried Berg bets 0.12€
Lunau folds
Fried Berg collected 0.29€ from pot
*** SUMMARY ***
Total pot 0.29€ | Rake 0.02€
Board: [Qd 6c 7d 9d 9c]
Seat 3: Fried Berg won 0.29€


Winamax Poker - HOLD-UP "Colorado" - HandId: #19116069-445181-1701518913 - Holdem no limit (0.01€/0.02€) - 2023/12/02 12:08:33 UTC
Table: 'Colorado' 6-max (real money) Seat #6 is the button
Seat 1: Fried Berg (0.85€)
Seat 2: Holiap (2.07€)
Seat 3: Babi78_ (1.57€)
Seat 4: Eddy Agricol (2€)
Seat 5: Anubis1983 (0.97€)
Seat 6: Jaloux88737 (4.48€)
*** ANTE/BLINDS ***
Fried Berg posts small blind 0.01€
Holiap posts big blind 0.02€
Dealt to Fried Berg [9s 3d]
*** PRE-FLOP *** 
Babi78_ calls 0.02€
Eddy Agricol raises 0.07€ to 0.09€
Anubis1983 folds
Jaloux88737 folds
Fried Berg folds
Holiap folds
Babi78_ calls 0.07€
*** FLOP *** [Qh 2s As]
Babi78_ checks
Eddy Agricol bets 0.07€
Babi78_ calls 0.07€
*** TURN *** [Qh 2s As][9c]
Babi78_ checks
Eddy Agricol bets 0.12€
Babi78_ folds
Eddy Agricol collected 0.43€ from pot
*** SUMMARY ***
Total pot 0.43€ | Rake 0.04€
Board: [Qh 2s As 9c]
Seat 4: Eddy Agricol won 0.43€


Winamax Poker - HOLD-UP "Colorado" - HandId: #19116069-445188-1701518918 - Holdem no limit (0.01€/0.02€) - 2023/12/02 12:08:38 UTC
Table: 'Colorado' 6-max (real money) Seat #6 is the button
Seat 1: GokuClan (1.86€)
Seat 2: FH-LYON-OR (0.63€)
Seat 3: Deep Thought (2.01€)
Seat 4: Fried Berg (0.84€)
Seat 5: Jacop0113 (0.38€)
Seat 6: P.BaIkany (4.57€)
*** ANTE/BLINDS ***
GokuClan posts small blind 0.01€
FH-LYON-OR posts big blind 0.02€
Dealt to Fried Berg [Qc Kc]
*** PRE-FLOP *** 
Deep Thought raises 0.04€ to 0.06€
Fried Berg calls 0.06€
Jacop0113 folds
P.BaIkany folds
GokuClan folds
FH-LYON-OR calls 0.04€
*** FLOP *** [8d 7h Qd]
FH-LYON-OR checks
Deep Thought checks
Fried Berg bets 0.08€
FH-LYON-OR calls 0.08€
Deep Thought folds
*** TURN *** [8d 7h Qd][5d]
FH-LYON-OR checks
Fried Berg checks
*** RIVER *** [8d 7h Qd 5d][2s]
FH-LYON-OR checks
Fried Berg checks
*** SHOW DOWN ***
FH-LYON-OR shows [Ks As] (High card : Ace)
Fried Berg shows [Qc Kc] (One pair : Queens)
Fried Berg collected 0.31€ from pot
*** SUMMARY ***
Total pot 0.31€ | Rake 0.04€
Board: [8d 7h Qd 5d 2s]
Seat 2: FH-LYON-OR (big blind) showed [Ks As] and lost with High card : Ace
Seat 4: Fried Berg showed [Qc Kc] and won 0.31€ with One pair : Queens


Winamax Poker - HOLD-UP "Colorado" - HandId: #19116069-445256-1701518968 - Holdem no limit (0.01€/0.02€) - 2023/12/02 12:09:28 UTC
Table: 'Colorado' 6-max (real money) Seat #6 is the button
Seat 1: FH-LYON-OR (0.49€)
Seat 2: Lunau (1.74€)
Seat 3: El Paellas (0.76€)
Seat 4: Fried Berg (1.01€)
Seat 5: pedrohxx (1.74€)
Seat 6: TheNerd (2.40€)
*** ANTE/BLINDS ***
FH-LYON-OR posts small blind 0.01€
Lunau posts big blind 0.02€
Dealt to Fried Berg [Kh 6h]
*** PRE-FLOP *** 
El Paellas folds
Fried Berg folds
pedrohxx raises 0.04€ to 0.06€
TheNerd calls 0.06€
FH-LYON-OR folds
Lunau folds
*** FLOP *** [9s Kc 8h]
pedrohxx bets 0.03€
TheNerd calls 0.03€
*** TURN *** [9s Kc 8h][3h]
pedrohxx bets 0.04€
TheNerd raises 0.17€ to 0.21€
pedrohxx folds
TheNerd collected 0.43€ from pot
*** SUMMARY ***
Total pot 0.43€ | Rake 0.03€
Board: [9s Kc 8h 3h]
Seat 6: TheNerd (button) won 0.43€


Winamax Poker - HOLD-UP "Colorado" - HandId: #19116069-445265-1701518975 - Holdem no limit (0.01€/0.02€) - 2023/12/02 12:09:35 UTC
Table: 'Colorado' 6-max (real money) Seat #6 is the button
Seat 1: IRun4Good (2.02€)
Seat 2: Kipyomag (7.18€)
Seat 3: Deep Thought (2.52€)
Seat 4: lamuerta8300 (1.49€)
Seat 5: Fried Berg (1.01€)
Seat 6: El Paellas (0.55€)
*** ANTE/BLINDS ***
IRun4Good posts small blind 0.01€
Kipyomag posts big blind 0.02€
Dealt to Fried Berg [As 7d]
*** PRE-FLOP *** 
Deep Thought folds
lamuerta8300 raises 0.04€ to 0.06€
Fried Berg folds
El Paellas folds
IRun4Good folds
Kipyomag raises 0.12€ to 0.18€
lamuerta8300 calls 0.12€
*** FLOP *** [Tc 2d Ac]
Kipyomag bets 0.13€
lamuerta8300 folds
Kipyomag collected 0.46€ from pot
*** SUMMARY ***
Total pot 0.46€ | Rake 0.04€
Board: [Tc 2d Ac]
Seat 2: Kipyomag (big blind) won 0.46€


Winamax Poker - HOLD-UP "Colorado" - HandId: #19116069-445285-1701518988 - Holdem no limit (0.01€/0.02€) - 2023/12/02 12:09:48 UTC
Table: 'Colorado' 6-max (real money) Seat #6 is the button
Seat 1: NOT AT ALL (0.65€)
Seat 2: colgate12 (2.29€)
Seat 3: TqtPasLaMelo (2.03€)
Seat 4: TaBrEaMoI (3.79€)
Seat 5: haouuum28 (2.62€)
Seat 6: Fried Berg (1.01€)
*** ANTE/BLINDS ***
NOT AT ALL posts small blind 0.01€
colgate12 posts big blind 0.02€
Dealt to Fried Berg [5d 8c]
*** PRE-FLOP *** 
TqtPasLaMelo folds
TaBrEaMoI folds
haouuum28 raises 0.02€ to 0.04€
Fried Berg folds
NOT AT ALL calls 0.03€
colgate12 folds
*** FLOP *** [9h 7s 2h]
NOT AT ALL checks
haouuum28 checks
*** TURN *** [9h 7s 2h][Kc]
NOT AT ALL checks
haouuum28 checks
*** RIVER *** [9h 7s 2h Kc][Qd]
NOT AT ALL bets 0.10€
haouuum28 folds
NOT AT ALL collected 0.19€ from pot
*** SUMMARY ***
Total pot 0.19€ | Rake 0.01€
Board: [9h 7s 2h Kc Qd]
Seat 1: NOT AT ALL (small blind) won 0.19€


Winamax Poker - HOLD-UP "Colorado" - HandId: #19116069-445286-1701518989 - Holdem no limit (0.01€/0.02€) - 2023/12/02 12:09:49 UTC
Table: 'Colorado' 6-max (real money) Seat #6 is the button
Seat 1: 49_3 (1.48€)
Seat 2: chaketovibet (5.04€)
Seat 3: Fried Berg (1.01€)
Seat 4: ridiculuss (2.97€)
Seat 5: regisKing351 (0.51€)
Seat 6: Lunau (2.82€)
*** ANTE/BLINDS ***
49_3 posts small blind 0.01€
chaketovibet posts big blind 0.02€
Dealt to Fried Berg [7h 5h]
*** PRE-FLOP *** 
Fried Berg folds
ridiculuss folds
regisKing351 folds
Lunau folds
49_3 folds
chaketovibet collected 0.03€ from pot
*** SUMMARY ***
Total pot 0.03€ | No rake
Seat 2: chaketovibet (big blind) won 0.03€


Winamax Poker - HOLD-UP "Colorado" - HandId: #19116069-445289-1701518991 - Holdem no limit (0.01€/0.02€) - 2023/12/02 12:09:51 UTC
Table: 'Colorado' 6-max (real money) Seat #6 is the button
Seat 1: Holiap (2.96€)
Seat 2: regisKing351 (0.51€)
Seat 3: vuesurmer (3.74€)
Seat 4: Deep Thought (2.50€)
Seat 5: Zile741 (4.62€)
Seat 6: Fried Berg (1.01€)
Hold-up to Pot: total 0.10€
*** ANTE/BLINDS ***
Holiap posts small blind 0.01€
regisKing351 posts big blind 0.02€
Dealt to Fried Berg [Ad Qd]
*** PRE-FLOP *** 
vuesurmer folds
Deep Thought folds
Zile741 folds
Fried Berg raises 0.28€ to 0.30€
Holiap folds
regisKing351 calls 0.28€
*** FLOP *** [9d Td 7s]
regisKing351 checks
Fried Berg bets 0.10€
regisKing351 raises 0.11€ to 0.21€ and is all-in
Fried Berg calls 0.11€
*** TURN *** [9d Td 7s][9s]
*** RIVER *** [9d Td 7s 9s][Qc]
*** SHOW DOWN ***
Fried Berg shows [Ad Qd] (Two pairs : Queens and 9)
regisKing351 shows [7c 7h] (Full of 7 and 9)
regisKing351 collected 1.03€ from pot
*** SUMMARY ***
Total pot 1.03€ | Rake 0.10€
Board: [9d Td 7s 9s Qc]
Seat 2: regisKing351 (big blind) showed [7c 7h] and won 1.03€ with Full of 7 and 9
Seat 6: Fried Berg (button) showed [Ad Qd] and lost with Two pairs : Queens and 9


Winamax Poker - HOLD-UP "Colorado" - HandId: #19116069-445363-1701519045 - Holdem no limit (0.01€/0.02€) - 2023/12/02 12:10:45 UTC
Table: 'Colorado' 6-max (real money) Seat #6 is the button
Seat 1: regisKing351 (1.03€)
Seat 2: Kallonys (2€)
Seat 3: Upswing11 (2€)
Seat 4: Wiwidu78 (1.98€)
Seat 5: Fried Berg (0.50€)
Seat 6: Lunau (2.77€)
*** ANTE/BLINDS ***
regisKing351 posts small blind 0.01€
Kallonys posts big blind 0.02€
Dealt to Fried Berg [Ks 8s]
*** PRE-FLOP *** 
Upswing11 folds
Wiwidu78 folds
Fried Berg raises 0.02€ to 0.04€
Lunau folds
regisKing351 folds
Kallonys folds
Fried Berg collected 0.07€ from pot
*** SUMMARY ***
Total pot 0.07€ | No rake
Seat 5: Fried Berg won 0.07€


Winamax Poker - HOLD-UP "Colorado" - HandId: #19116069-445428-1701519089 - Holdem no limit (0.01€/0.02€) - 2023/12/02 12:11:29 UTC
Table: 'Colorado' 6-max (real money) Seat #6 is the button
Seat 1: H.K6788 (1.98€)
Seat 2: Durantula_6 (2€)
Seat 3: P.BaIkany (2.98€)
Seat 4: vuesurmer (2.43€)
Seat 5: KON-2-PEUTE (2.37€)
Seat 6: Fried Berg (0.53€)
Hold-up to Pot: total 0.20€
*** ANTE/BLINDS ***
H.K6788 posts small blind 0.01€
Durantula_6 posts big blind 0.02€
Dealt to Fried Berg [5h Jd]
*** PRE-FLOP *** 
P.BaIkany folds
vuesurmer raises 0.03€ to 0.05€
KON-2-PEUTE folds
Fried Berg calls 0.05€
H.K6788 calls 0.04€
Durantula_6 raises 0.18€ to 0.23€
vuesurmer folds
Fried Berg folds
H.K6788 calls 0.18€
*** FLOP *** [As 8c 5s]
H.K6788 checks
Durantula_6 bets 0.38€
H.K6788 folds
Durantula_6 collected 1.08€ from pot
*** SUMMARY ***
Total pot 1.08€ | Rake 0.06€
Board: [As 8c 5s]
Seat 2: Durantula_6 (big blind) won 1.08€


Winamax Poker - HOLD-UP "Colorado" - HandId: #19116069-445483-1701519122 - Holdem no limit (0.01€/0.02€) - 2023/12/02 12:12:02 UTC
Table: 'Colorado' 6-max (real money) Seat #6 is the button
Seat 1: Zile741 (2.31€)
Seat 2: Fried Berg (0.48€)
Seat 3: -Y4V- (3.63€)
Seat 4: pivert 83 (1.97€)
Seat 5: Caindymion99 (2.18€)
Seat 6: Baston57 (4.99€)
*** ANTE/BLINDS ***
Zile741 posts small blind 0.01€
Fried Berg posts big blind 0.02€
Dealt to Fried Berg [8c Td]
*** PRE-FLOP *** 
-Y4V- folds
pivert 83 folds
Caindymion99 folds
Baston57 folds
Zile741 folds
Fried Berg collected 0.03€ from pot
*** SUMMARY ***
Total pot 0.03€ | No rake
Seat 2: Fried Berg (big blind) won 0.03€


Winamax Poker - HOLD-UP "Colorado" - HandId: #19116069-445495-1701519133 - Holdem no limit (0.01€/0.02€) - 2023/12/02 12:12:13 UTC
Table: 'Colorado' 6-max (real money) Seat #6 is the button
Seat 1: Fried Berg (0.49€)
Seat 2: cybok20001 (0.80€)
Seat 3: oliveponcar (2.81€)
Seat 4: Zile741 (2.30€)
Seat 5: l artiste ho (1.10€)
Seat 6: El Paellas (0.50€)
*** ANTE/BLINDS ***
Fried Berg posts small blind 0.01€
cybok20001 posts big blind 0.02€
Dealt to Fried Berg [2d 5s]
*** PRE-FLOP *** 
oliveponcar raises 0.04€ to 0.06€
Zile741 folds
l artiste ho folds
El Paellas folds
Fried Berg folds
cybok20001 folds
oliveponcar collected 0.09€ from pot
*** SUMMARY ***
Total pot 0.09€ | No rake
Seat 3: oliveponcar won 0.09€


Winamax Poker - HOLD-UP "Colorado" - HandId: #19116069-445538-1701519165 - Holdem no limit (0.01€/0.02€) - 2023/12/02 12:12:45 UTC
Table: 'Colorado' 6-max (real money) Seat #6 is the button
Seat 1: Fried Berg (0.48€)
Seat 2: JFSredbaron (2.21€)
Seat 3: Zile741 (6.37€)
Seat 4: Itashi.95 (7.72€)
Seat 5: jritxal (2.31€)
Seat 6: Kallonys (1.97€)
*** ANTE/BLINDS ***
Fried Berg posts small blind 0.01€
JFSredbaron posts big blind 0.02€
Dealt to Fried Berg [Th 2s]
*** PRE-FLOP *** 
Zile741 folds
Itashi.95 folds
jritxal folds
Kallonys folds
Fried Berg folds
JFSredbaron collected 0.03€ from pot
*** SUMMARY ***
Total pot 0.03€ | No rake
Seat 2: JFSredbaron (big blind) won 0.03€


Winamax Poker - HOLD-UP "Colorado" - HandId: #19116069-445542-1701519167 - Holdem no limit (0.01€/0.02€) - 2023/12/02 12:12:47 UTC
Table: 'Colorado' 6-max (real money) Seat #6 is the button
Seat 1: Eytrewq (1.72€)
Seat 2: KB_Striker10 (1.40€)
Seat 3: Betiegarri (2.24€)
Seat 4: Fried Berg (0.47€)
Seat 5: Itashi.95 (7.72€)
Seat 6: Merlus83 (4.62€)
*** ANTE/BLINDS ***
Eytrewq posts small blind 0.01€
KB_Striker10 posts big blind 0.02€
Dealt to Fried Berg [2d Qc]
*** PRE-FLOP *** 
Betiegarri folds
Fried Berg folds
Itashi.95 folds
Merlus83 folds
Eytrewq raises 0.04€ to 0.06€
KB_Striker10 calls 0.04€
*** FLOP *** [5s 7s Kd]
Eytrewq checks
KB_Striker10 checks
*** TURN *** [5s 7s Kd][5c]
Eytrewq checks
KB_Striker10 checks
*** RIVER *** [5s 7s Kd 5c][7h]
Eytrewq checks
KB_Striker10 bets 1.34€ and is all-in
Eytrewq folds
KB_Striker10 collected 1.45€ from pot
*** SUMMARY ***
Total pot 1.45€ | Rake 0.01€
Board: [5s 7s Kd 5c 7h]
Seat 2: KB_Striker10 (big blind) won 1.45€


Winamax Poker - HOLD-UP "Colorado" - HandId: #19116069-445545-1701519168 - Holdem no limit (0.01€/0.02€) - 2023/12/02 12:12:48 UTC
Table: 'Colorado' 6-max (real money) Seat #6 is the button
Seat 1: Galeboetichr (2€)
Seat 2: Jean3776 (2€)
Seat 3: IRun4Good (1.97€)
Seat 4: dan.doc (1.88€)
Seat 5: haouuum28 (2.65€)
Seat 6: Fried Berg (0.47€)
*** ANTE/BLINDS ***
Galeboetichr posts small blind 0.01€
Jean3776 posts big blind 0.02€
Dealt to Fried Berg [4d 2c]
*** PRE-FLOP *** 
IRun4Good folds
dan.doc folds
haouuum28 folds
Fried Berg folds
Galeboetichr folds
Jean3776 collected 0.03€ from pot
*** SUMMARY ***
Total pot 0.03€ | No rake
Seat 2: Jean3776 (big blind) won 0.03€


Winamax Poker - HOLD-UP "Colorado" - HandId: #19116069-445547-1701519169 - Holdem no limit (0.01€/0.02€) - 2023/12/02 12:12:49 UTC
Table: 'Colorado' 6-max (real money) Seat #6 is the button
Seat 1: Fried Berg (0.47€)
Seat 2: Deep Thought (2.40€)
Seat 3: GokuClan (2.02€)
Seat 4: blie2006 (0.29€)
Seat 5: sopra61 (1.90€)
Seat 6: lA bAncAA (2.02€)
*** ANTE/BLINDS ***
Fried Berg posts small blind 0.01€
Deep Thought posts big blind 0.02€
Dealt to Fried Berg [3s 9d]
*** PRE-FLOP *** 
GokuClan folds
blie2006 folds
sopra61 folds
lA bAncAA raises 0.03€ to 0.05€
Fried Berg folds
Deep Thought folds
lA bAncAA collected 0.08€ from pot
*** SUMMARY ***
Total pot 0.08€ | No rake
Seat 6: lA bAncAA (button) won 0.08€


Winamax Poker - HOLD-UP "Colorado" - HandId: #19116069-445553-1701519172 - Holdem no limit (0.01€/0.02€) - 2023/12/02 12:12:52 UTC
Table: 'Colorado' 6-max (real money) Seat #6 is the button
Seat 1: Betiegarri (2.24€)
Seat 2: Fried Berg (0.46€)
Seat 3: El Paellas (0.50€)
Seat 4: Galeboetichr (2€)
Seat 5: sopra61 (1.90€)
Seat 6: Stream73 (0.74€)
*** ANTE/BLINDS ***
Betiegarri posts small blind 0.01€
Fried Berg posts big blind 0.02€
Dealt to Fried Berg [2h 6s]
*** PRE-FLOP *** 
El Paellas folds
Galeboetichr folds
sopra61 folds
Stream73 calls 0.02€
Betiegarri calls 0.01€
Fried Berg checks
*** FLOP *** [Ks 4s 3c]
Betiegarri checks
Fried Berg checks
Stream73 checks
*** TURN *** [Ks 4s 3c][Jh]
Betiegarri bets 0.05€
Fried Berg folds
Stream73 calls 0.05€
*** RIVER *** [Ks 4s 3c Jh][Ad]
Betiegarri bets 0.06€
Stream73 calls 0.06€
*** SHOW DOWN ***
Betiegarri shows [Tc Kh] (One pair : Kings)
Stream73 shows [Ac 2s] (One pair : Aces)
Stream73 collected 0.25€ from pot
*** SUMMARY ***
Total pot 0.25€ | Rake 0.03€
Board: [Ks 4s 3c Jh Ad]
Seat 1: Betiegarri (small blind) showed [Tc Kh] and lost with One pair : Kings
Seat 6: Stream73 (button) showed [Ac 2s] and won 0.25€ with One pair : Aces


Winamax Poker - HOLD-UP "Colorado" - HandId: #19116069-445583-1701519193 - Holdem no limit (0.01€/0.02€) - 2023/12/02 12:13:13 UTC
Table: 'Colorado' 6-max (real money) Seat #6 is the button
Seat 1: Lunau (3.10€)
Seat 2: Fried Berg (0.44€)
Seat 3: Galeboetichr (2€)
Seat 4: TaBrEaMoI (3.81€)
Seat 5: Icebound (1.82€)
Seat 6: l artiste ho (1.09€)
*** ANTE/BLINDS ***
Lunau posts small blind 0.01€
Fried Berg posts big blind 0.02€
Dealt to Fried Berg [Tc 6d]
*** PRE-FLOP *** 
Galeboetichr folds
TaBrEaMoI folds
Icebound folds
l artiste ho folds
Lunau raises 0.04€ to 0.06€
Fried Berg folds
Lunau collected 0.08€ from pot
*** SUMMARY ***
Total pot 0.08€ | No rake
Seat 1: Lunau (small blind) won 0.08€


Winamax Poker - HOLD-UP "Colorado" - HandId: #19116069-445599-1701519204 - Holdem no limit (0.01€/0.02€) - 2023/12/02 12:13:24 UTC
Table: 'Colorado' 6-max (real money) Seat #6 is the button
Seat 1: Nobru.7793 (2.61€)
Seat 2: Berig (2€)
Seat 3: Fried Berg (0.42€)
Seat 4: Deep Thought (2.47€)
Seat 5: TheNerd (2.70€)
Seat 6: El Paellas (2.01€)
*** ANTE/BLINDS ***
Nobru.7793 posts small blind 0.01€
Berig posts big blind 0.02€
Dealt to Fried Berg [Qc 4s]
*** PRE-FLOP *** 
Fried Berg folds
Deep Thought folds
TheNerd folds
El Paellas folds
Nobru.7793 calls 0.01€
Berig checks
*** FLOP *** [4d 2h 6s]
Nobru.7793 checks
Berig bets 0.04€
Nobru.7793 folds
Berig collected 0.08€ from pot
*** SUMMARY ***
Total pot 0.08€ | No rake
Board: [4d 2h 6s]
Seat 2: Berig (big blind) won 0.08€


Winamax Poker - HOLD-UP "Colorado" - HandId: #19116069-445600-1701519205 - Holdem no limit (0.01€/0.02€) - 2023/12/02 12:13:25 UTC
Table: 'Colorado' 6-max (real money) Seat #6 is the button
Seat 1: dan.doc (2.15€)
Seat 2: -Y4V- (3.94€)
Seat 3: oliveponcar (3.56€)
Seat 4: Fried Berg (0.42€)
Seat 5: TaBrEaMoI (3.81€)
Seat 6: JOK-R777 (4.52€)
*** ANTE/BLINDS ***
dan.doc posts small blind 0.01€
-Y4V- posts big blind 0.02€
Dealt to Fried Berg [8c 9c]
*** PRE-FLOP *** 
oliveponcar raises 0.04€ to 0.06€
Fried Berg calls 0.06€
TaBrEaMoI folds
JOK-R777 calls 0.06€
dan.doc folds
-Y4V- folds
*** FLOP *** [Qs Jd Qd]
oliveponcar checks
Fried Berg checks
JOK-R777 bets 0.07€
oliveponcar calls 0.07€
Fried Berg folds
*** TURN *** [Qs Jd Qd][5c]
oliveponcar checks
JOK-R777 bets 0.07€
oliveponcar calls 0.07€
*** RIVER *** [Qs Jd Qd 5c][2c]
oliveponcar checks
JOK-R777 checks
*** SHOW DOWN ***
JOK-R777 shows [3c Ac] (One pair : Queens)
oliveponcar shows [Kc Jc] (Two pairs : Queens and Jacks)
oliveponcar collected 0.44€ from pot
*** SUMMARY ***
Total pot 0.44€ | Rake 0.05€
Board: [Qs Jd Qd 5c 2c]
Seat 3: oliveponcar showed [Kc Jc] and won 0.44€ with Two pairs : Queens and Jacks
Seat 6: JOK-R777 (button) showed [3c Ac] and lost with One pair : Queens


Winamax Poker - HOLD-UP "Colorado" - HandId: #19116069-445633-1701519228 - Holdem no limit (0.01€/0.02€) - 2023/12/02 12:13:48 UTC
Table: 'Colorado' 6-max (real money) Seat #6 is the button
Seat 1: Icebound (1.92€)
Seat 2: Zile741 (6.34€)
Seat 3: Fried Berg (0.36€)
Seat 4: lamuerta8300 (3.67€)
Seat 5: Anubis1983 (1.26€)
Seat 6: Kipyomag (7.19€)
*** ANTE/BLINDS ***
Icebound posts small blind 0.01€
Zile741 posts big blind 0.02€
Dealt to Fried Berg [Ah 3s]
*** PRE-FLOP *** 
Fried Berg folds
lamuerta8300 folds
Anubis1983 raises 0.04€ to 0.06€
Kipyomag folds
Icebound folds
Zile741 calls 0.04€
*** FLOP *** [Jh 8d Qc]
Zile741 checks
Anubis1983 bets 0.08€
Zile741 calls 0.08€
*** TURN *** [Jh 8d Qc][8s]
Zile741 checks
Anubis1983 checks
*** RIVER *** [Jh 8d Qc 8s][3d]
Zile741 checks
Anubis1983 checks
*** SHOW DOWN ***
Anubis1983 shows [9d Ad] (One pair : 8)
Zile741 shows [Th Jd] (Two pairs : Jacks and 8)
Zile741 collected 0.26€ from pot
*** SUMMARY ***
Total pot 0.26€ | Rake 0.03€
Board: [Jh 8d Qc 8s 3d]
Seat 2: Zile741 (big blind) showed [Th Jd] and won 0.26€ with Two pairs : Jacks and 8
Seat 5: Anubis1983 showed [9d Ad] and lost with One pair : 8


Winamax Poker - HOLD-UP "Colorado" - HandId: #19116069-445636-1701519229 - Holdem no limit (0.01€/0.02€) - 2023/12/02 12:13:49 UTC
Table: 'Colorado' 6-max (real money) Seat #6 is the button
Seat 1: Betiegarri (2.08€)
Seat 2: H.K6788 (1.86€)
Seat 3: Upswing11 (2€)
Seat 4: Lunau (3.11€)
Seat 5: vuesurmer (3.19€)
Seat 6: Fried Berg (0.36€)
*** ANTE/BLINDS ***
Betiegarri posts small blind 0.01€
H.K6788 posts big blind 0.02€
Dealt to Fried Berg [8s 2h]
*** PRE-FLOP *** 
Upswing11 raises 0.04€ to 0.06€
Lunau folds
vuesurmer folds
Fried Berg folds
Betiegarri calls 0.05€
H.K6788 calls 0.04€
*** FLOP *** [3c Kh 6c]
Betiegarri checks
H.K6788 checks
Upswing11 bets 0.09€
Betiegarri folds
H.K6788 folds
Upswing11 collected 0.25€ from pot
*** SUMMARY ***
Total pot 0.25€ | Rake 0.02€
Board: [3c Kh 6c]
Seat 3: Upswing11 won 0.25€


Winamax Poker - HOLD-UP "Colorado" - HandId: #19116069-445638-1701519230 - Holdem no limit (0.01€/0.02€) - 2023/12/02 12:13:50 UTC
Table: 'Colorado' 6-max (real money) Seat #6 is the button
Seat 1: GokuClan (2.03€)
Seat 2: Lunau (2.32€)
Seat 3: muespachois1 (1.55€)
Seat 4: lA bAncAA (2€)
Seat 5: Fried Berg (0.36€)
Seat 6: TheNerd (2.64€)
*** ANTE/BLINDS ***
GokuClan posts small blind 0.01€
Lunau posts big blind 0.02€
Dealt to Fried Berg [Qs Ac]
*** PRE-FLOP *** 
muespachois1 folds
lA bAncAA folds
Fried Berg raises 0.04€ to 0.06€
TheNerd folds
GokuClan folds
Lunau folds
Fried Berg collected 0.09€ from pot
*** SUMMARY ***
Total pot 0.09€ | No rake
Seat 5: Fried Berg won 0.09€


Winamax Poker - HOLD-UP "Colorado" - HandId: #19116069-445670-1701519253 - Holdem no limit (0.01€/0.02€) - 2023/12/02 12:14:13 UTC
Table: 'Colorado' 6-max (real money) Seat #6 is the button
Seat 1: dan.doc (2.12€)
Seat 2: Fried Berg (0.39€)
Seat 3: JOK-R777 (4.32€)
Seat 4: mea botellas (2.16€)
Seat 5: oliveponcar (3.80€)
Seat 6: lamuerta8300 (3.64€)
*** ANTE/BLINDS ***
dan.doc posts small blind 0.01€
Fried Berg posts big blind 0.02€
Dealt to Fried Berg [Ad Qd]
*** PRE-FLOP *** 
JOK-R777 folds
mea botellas folds
oliveponcar folds
lamuerta8300 folds
dan.doc folds
Fried Berg collected 0.03€ from pot
*** SUMMARY ***
Total pot 0.03€ | No rake
Seat 2: Fried Berg (big blind) won 0.03€


Winamax Poker - HOLD-UP "Colorado" - HandId: #19116069-445678-1701519258 - Holdem no limit (0.01€/0.02€) - 2023/12/02 12:14:18 UTC
Table: 'Colorado' 6-max (real money) Seat #6 is the button
Seat 1: Fried Berg (0.40€)
Seat 2: Amendonnayyy (3.87€)
Seat 3: FDSpecimen27 (1.77€)
Seat 4: nuttflush (0.42€)
Seat 5: vuesurmer (3.52€)
Seat 6: haouuum28 (1.96€)
*** ANTE/BLINDS ***
Fried Berg posts small blind 0.01€
Amendonnayyy posts big blind 0.02€
Dealt to Fried Berg [Qd 9h]
*** PRE-FLOP *** 
FDSpecimen27 folds
nuttflush folds
vuesurmer folds
haouuum28 raises 0.05€ to 0.07€
Fried Berg folds
Amendonnayyy folds
haouuum28 collected 0.10€ from pot
*** SUMMARY ***
Total pot 0.10€ | No rake
Seat 6: haouuum28 (button) won 0.10€


Winamax Poker - HOLD-UP "Colorado" - HandId: #19116069-445682-1701519261 - Holdem no limit (0.01€/0.02€) - 2023/12/02 12:14:21 UTC
Table: 'Colorado' 6-max (real money) Seat #6 is the button
Seat 1: Wiwidu78 (3.84€)
Seat 2: mea botellas (2.16€)
Seat 3: Fried Berg (0.39€)
Seat 4: FDSpecimen27 (1.77€)
Seat 5: TheNerd (2.80€)
Seat 6: LEDesTAKeuR3 (1.91€)
Hold-up to Pot: total 0.20€
*** ANTE/BLINDS ***
Wiwidu78 posts small blind 0.01€
mea botellas posts big blind 0.02€
Dealt to Fried Berg [5d Ks]
*** PRE-FLOP *** 
Fried Berg folds
FDSpecimen27 calls 0.02€
TheNerd folds
LEDesTAKeuR3 calls 0.02€
Wiwidu78 calls 0.01€
mea botellas checks
*** FLOP *** [7h 3d Jc]
Wiwidu78 checks
mea botellas bets 0.03€
FDSpecimen27 folds
LEDesTAKeuR3 calls 0.03€
Wiwidu78 calls 0.03€
*** TURN *** [7h 3d Jc][2s]
Wiwidu78 checks
mea botellas bets 0.12€
LEDesTAKeuR3 folds
Wiwidu78 calls 0.12€
*** RIVER *** [7h 3d Jc 2s][As]
Wiwidu78 bets 0.42€
mea botellas folds
Wiwidu78 collected 0.99€ from pot
*** SUMMARY ***
Total pot 0.99€ | Rake 0.04€
Board: [7h 3d Jc 2s As]
Seat 1: Wiwidu78 (small blind) won 0.99€


Winamax Poker - HOLD-UP "Colorado" - HandId: #19116069-445691-1701519266 - Holdem no limit (0.01€/0.02€) - 2023/12/02 12:14:26 UTC
Table: 'Colorado' 6-max (real money) Seat #6 is the button
Seat 1: Lunau (3.29€)
Seat 2: Deep Thought (2.05€)
Seat 3: KON-2-PEUTE (5.11€)
Seat 4: Fried Berg (0.39€)
Seat 5: jdeepenslip (4.37€)
Seat 6: lA bAncAA (2€)
*** ANTE/BLINDS ***
Lunau posts small blind 0.01€
Deep Thought posts big blind 0.02€
Dealt to Fried Berg [Td 3h]
*** PRE-FLOP *** 
KON-2-PEUTE raises 0.03€ to 0.05€
Fried Berg folds
jdeepenslip folds
lA bAncAA folds
Lunau folds
Deep Thought calls 0.03€
*** FLOP *** [5c Jd 9d]
Deep Thought checks
KON-2-PEUTE bets 0.04€
Deep Thought raises 0.11€ to 0.15€
KON-2-PEUTE folds
Deep Thought collected 0.28€ from pot
*** SUMMARY ***
Total pot 0.28€ | Rake 0.02€
Board: [5c Jd 9d]
Seat 2: Deep Thought (big blind) won 0.28€


Winamax Poker - HOLD-UP "Colorado" - HandId: #19116069-445694-1701519267 - Holdem no limit (0.01€/0.02€) - 2023/12/02 12:14:27 UTC
Table: 'Colorado' 6-max (real money) Seat #6 is the button
Seat 1: Jean3776 (2.15€)
Seat 2: Lunau (3€)
Seat 3: El Paellas (0.50€)
Seat 4: liseau5312 (3.69€)
Seat 5: Fried Berg (0.39€)
Seat 6: Zile741 (2.25€)
Hold-up to Pot: total 0.10€
*** ANTE/BLINDS ***
Jean3776 posts small blind 0.01€
Lunau posts big blind 0.02€
Dealt to Fried Berg [9c 9s]
*** PRE-FLOP *** 
El Paellas folds
liseau5312 raises 0.15€ to 0.17€
Fried Berg raises 0.15€ to 0.32€
Zile741 folds
Jean3776 folds
Lunau folds
liseau5312 calls 0.15€
*** FLOP *** [3h 7s 2d]
liseau5312 bets 0.77€
Fried Berg calls 0.07€ and is all-in
*** TURN *** [3h 7s 2d][Ac]
*** RIVER *** [3h 7s 2d Ac][4c]
*** SHOW DOWN ***
liseau5312 shows [Ks Qs] (High card : Ace)
Fried Berg shows [9c 9s] (One pair : 9)
Fried Berg collected 0.83€ from main pot
liseau5312 collected 0.70€ from side pot 1
*** SUMMARY ***
Total pot 1.53€ | Rake 0.08€
Board: [3h 7s 2d Ac 4c]
Seat 4: liseau5312 showed [Ks Qs] and won 0.70€ with High card : Ace
Seat 5: Fried Berg showed [9c 9s] and won 0.83€ with One pair : 9


Winamax Poker - HOLD-UP "Colorado" - HandId: #19116069-445732-1701519292 - Holdem no limit (0.01€/0.02€) - 2023/12/02 12:14:52 UTC
Table: 'Colorado' 6-max (real money) Seat #6 is the button
Seat 1: Amendonnayyy (3.85€)
Seat 2: Lunau (2.97€)
Seat 3: vuesurmer (2.43€)
Seat 4: Jean3776 (2.14€)
Seat 5: Fried Berg (0.83€)
Seat 6: jdeepenslip (2.10€)
*** ANTE/BLINDS ***
Amendonnayyy posts small blind 0.01€
Lunau posts big blind 0.02€
Dealt to Fried Berg [Th 3c]
*** PRE-FLOP *** 
vuesurmer folds
Jean3776 folds
Fried Berg folds
jdeepenslip raises 0.02€ to 0.04€
Amendonnayyy folds
Lunau calls 0.02€
*** FLOP *** [Ac As Kc]
Lunau checks
jdeepenslip bets 0.03€
Lunau folds
jdeepenslip collected 0.11€ from pot
*** SUMMARY ***
Total pot 0.11€ | Rake 0.01€
Board: [Ac As Kc]
Seat 6: jdeepenslip (button) won 0.11€


Winamax Poker - HOLD-UP "Colorado" - HandId: #19116069-445740-1701519298 - Holdem no limit (0.01€/0.02€) - 2023/12/02 12:14:58 UTC
Table: 'Colorado' 6-max (real money) Seat #6 is the button
Seat 1: haouuum28 (1.97€)
Seat 2: Babi78_ (2.28€)
Seat 3: Fried Berg (0.83€)
Seat 4: Eytrewq (1.30€)
Seat 5: TaBrEaMoI (9€)
Seat 6: vuesurmer (2.43€)
*** ANTE/BLINDS ***
haouuum28 posts small blind 0.01€
Babi78_ posts big blind 0.02€
Dealt to Fried Berg [Tc 5d]
*** PRE-FLOP *** 
Fried Berg folds
Eytrewq raises 0.03€ to 0.05€
TaBrEaMoI folds
vuesurmer folds
haouuum28 calls 0.04€
Babi78_ folds
*** FLOP *** [8s 3h 7c]
haouuum28 checks
Eytrewq checks
*** TURN *** [8s 3h 7c][Js]
haouuum28 checks
Eytrewq bets 0.06€
haouuum28 folds
Eytrewq collected 0.17€ from pot
*** SUMMARY ***
Total pot 0.17€ | Rake 0.01€
Board: [8s 3h 7c Js]
Seat 4: Eytrewq won 0.17€


Winamax Poker - HOLD-UP "Colorado" - HandId: #19116069-445743-1701519300 - Holdem no limit (0.01€/0.02€) - 2023/12/02 12:15:00 UTC
Table: 'Colorado' 6-max (real money) Seat #6 is the button
Seat 1: Berig (2.01€)
Seat 2: oliveponcar (2.49€)
Seat 3: vuesurmer (2.43€)
Seat 4: Fried Berg (0.83€)
Seat 5: Catoche26 (1.28€)
Seat 6: P.BaIkany (2.99€)
*** ANTE/BLINDS ***
Berig posts small blind 0.01€
oliveponcar posts big blind 0.02€
Dealt to Fried Berg [Th 7d]
*** PRE-FLOP *** 
vuesurmer folds
Fried Berg folds
Catoche26 folds
P.BaIkany raises 0.04€ to 0.06€
Berig folds
oliveponcar folds
P.BaIkany collected 0.09€ from pot
*** SUMMARY ***
Total pot 0.09€ | No rake
Seat 6: P.BaIkany (button) won 0.09€


Winamax Poker - HOLD-UP "Colorado" - HandId: #19116069-445745-1701519301 - Holdem no limit (0.01€/0.02€) - 2023/12/02 12:15:01 UTC
Table: 'Colorado' 6-max (real money) Seat #6 is the button
Seat 1: metamex (2.28€)
Seat 2: Fried Berg (0.83€)
Seat 3: Jaloux88737 (4.52€)
Seat 4: Kallonys (1.91€)
Seat 5: Jean3776 (2.14€)
Seat 6: jritxal (2.43€)
*** ANTE/BLINDS ***
metamex posts small blind 0.01€
Fried Berg posts big blind 0.02€
Dealt to Fried Berg [Ts 5c]
*** PRE-FLOP *** 
Jaloux88737 folds
Kallonys folds
Jean3776 folds
jritxal raises 0.04€ to 0.06€
metamex folds
Fried Berg folds
jritxal collected 0.09€ from pot
*** SUMMARY ***
Total pot 0.09€ | No rake
Seat 6: jritxal (button) won 0.09€


Winamax Poker - HOLD-UP "Colorado" - HandId: #19116069-445758-1701519312 - Holdem no limit (0.01€/0.02€) - 2023/12/02 12:15:12 UTC
Table: 'Colorado' 6-max (real money) Seat #6 is the button
Seat 1: Rivermatuer (2.10€)
Seat 2: vuesurmer (5.96€)
Seat 3: TaBrEaMoI (9€)
Seat 4: dan.doc (1.99€)
Seat 5: Galeboetichr (2€)
Seat 6: Fried Berg (0.81€)
*** ANTE/BLINDS ***
Rivermatuer posts small blind 0.01€
vuesurmer posts big blind 0.02€
Dealt to Fried Berg [9d As]
*** PRE-FLOP *** 
TaBrEaMoI raises 0.04€ to 0.06€
dan.doc folds
Galeboetichr folds
Fried Berg calls 0.06€
Rivermatuer folds
vuesurmer calls 0.04€
*** FLOP *** [4s Qc 8d]
vuesurmer checks
TaBrEaMoI checks
Fried Berg checks
*** TURN *** [4s Qc 8d][Td]
vuesurmer checks
TaBrEaMoI checks
Fried Berg checks
*** RIVER *** [4s Qc 8d Td][5s]
vuesurmer checks
TaBrEaMoI checks
Fried Berg checks
*** SHOW DOWN ***
TaBrEaMoI shows [Kc Ad] (High card : Ace)
Fried Berg shows [9d As] (High card : Ace)
vuesurmer shows [5d 6h] (One pair : 5)
vuesurmer collected 0.17€ from pot
*** SUMMARY ***
Total pot 0.17€ | Rake 0.02€
Board: [4s Qc 8d Td 5s]
Seat 2: vuesurmer (big blind) showed [5d 6h] and won 0.17€ with One pair : 5
Seat 3: TaBrEaMoI showed [Kc Ad] and lost with High card : Ace
Seat 6: Fried Berg (button) showed [9d As] and lost with High card : Ace


Winamax Poker - HOLD-UP "Colorado" - HandId: #19116069-445801-1701519340 - Holdem no limit (0.01€/0.02€) - 2023/12/02 12:15:40 UTC
Table: 'Colorado' 6-max (real money) Seat #6 is the button
Seat 1: Kallonys (2.17€)
Seat 2: Galeboetichr (2.01€)
Seat 3: vuesurmer (6.07€)
Seat 4: Wiwidu78 (4.24€)
Seat 5: Fried Berg (0.75€)
Seat 6: TaBrEaMoI (8.94€)
*** ANTE/BLINDS ***
Kallonys posts small blind 0.01€
Galeboetichr posts big blind 0.02€
Dealt to Fried Berg [5d 6s]
*** PRE-FLOP *** 
vuesurmer folds
Wiwidu78 folds
Fried Berg folds
TaBrEaMoI folds
Kallonys folds
Galeboetichr collected 0.03€ from pot
*** SUMMARY ***
Total pot 0.03€ | No rake
Seat 2: Galeboetichr (big blind) won 0.03€


Winamax Poker - HOLD-UP "Colorado" - HandId: #19116069-445813-1701519348 - Holdem no limit (0.01€/0.02€) - 2023/12/02 12:15:48 UTC
Table: 'Colorado' 6-max (real money) Seat #6 is the button
Seat 1: vuesurmer (6.07€)
Seat 2: Fried Berg (0.75€)
Seat 3: DeX70 (2.32€)
Seat 4: BMWTPM (1.07€)
Seat 5: KON-2-PEUTE (2.41€)
Seat 6: CHANGAS (2.45€)
*** ANTE/BLINDS ***
vuesurmer posts small blind 0.01€
Fried Berg posts big blind 0.02€
Dealt to Fried Berg [9s 3s]
*** PRE-FLOP *** 
DeX70 folds
BMWTPM folds
KON-2-PEUTE folds
CHANGAS folds
vuesurmer folds
Fried Berg collected 0.03€ from pot
*** SUMMARY ***
Total pot 0.03€ | No rake
Seat 2: Fried Berg (big blind) won 0.03€


Winamax Poker - HOLD-UP "Colorado" - HandId: #19116069-445844-1701519368 - Holdem no limit (0.01€/0.02€) - 2023/12/02 12:16:08 UTC
Table: 'Colorado' 6-max (real money) Seat #6 is the button
Seat 1: Fried Berg (0.76€)
Seat 2: Berig (1.99€)
Seat 3: Durantula_6 (0.28€)
Seat 4: Betiegarri (1.99€)
Seat 5: Upswing11 (2.24€)
Seat 6: Dame de pik (0.79€)
*** ANTE/BLINDS ***
Fried Berg posts small blind 0.01€
Berig posts big blind 0.02€
Dealt to Fried Berg [Jh 6d]
*** PRE-FLOP *** 
Durantula_6 folds
Betiegarri folds
Upswing11 folds
Dame de pik calls 0.02€
Fried Berg folds
Berig checks
*** FLOP *** [3c Ac 6s]
Berig checks
Dame de pik bets 0.02€
Berig calls 0.02€
*** TURN *** [3c Ac 6s][5s]
Berig bets 0.06€
Dame de pik calls 0.06€
*** RIVER *** [3c Ac 6s 5s][7s]
Berig bets 0.14€
Dame de pik folds
Berig collected 0.33€ from pot
*** SUMMARY ***
Total pot 0.33€ | Rake 0.02€
Board: [3c Ac 6s 5s 7s]
Seat 2: Berig (big blind) won 0.33€


Winamax Poker - HOLD-UP "Colorado" - HandId: #19116069-445847-1701519370 - Holdem no limit (0.01€/0.02€) - 2023/12/02 12:16:10 UTC
Table: 'Colorado' 6-max (real money) Seat #6 is the button
Seat 1: Jean3776 (2.08€)
Seat 2: viins42 (2€)
Seat 3: Kallonys (1.92€)
Seat 4: Amazigh 78 (2.17€)
Seat 5: DeX70 (2.32€)
Seat 6: Fried Berg (0.75€)
Hold-up to Pot: total 0.10€
*** ANTE/BLINDS ***
Jean3776 posts small blind 0.01€
viins42 posts big blind 0.02€
Dealt to Fried Berg [6c Ad]
*** PRE-FLOP *** 
Kallonys folds
Amazigh 78 folds
DeX70 folds
Fried Berg raises 0.02€ to 0.04€
Jean3776 folds
viins42 calls 0.02€
*** FLOP *** [6d 5s Ac]
viins42 checks
Fried Berg bets 0.12€
viins42 folds
Fried Berg collected 0.30€ from pot
*** SUMMARY ***
Total pot 0.30€ | Rake 0.01€
Board: [6d 5s Ac]
Seat 6: Fried Berg (button) won 0.30€


Winamax Poker - HOLD-UP "Colorado" - HandId: #19116069-445899-1701519405 - Holdem no limit (0.01€/0.02€) - 2023/12/02 12:16:45 UTC
Table: 'Colorado' 6-max (real money) Seat #6 is the button
Seat 1: DanMD (0.55€)
Seat 2: Jaloux88737 (4.64€)
Seat 3: Amazigh 78 (2.28€)
Seat 4: Fried Berg (0.89€)
Seat 5: JFSredbaron (5.69€)
Seat 6: Galeboetichr (2.03€)
*** ANTE/BLINDS ***
DanMD posts small blind 0.01€
Jaloux88737 posts big blind 0.02€
Dealt to Fried Berg [3d Qc]
*** PRE-FLOP *** 
Amazigh 78 folds
Fried Berg folds
JFSredbaron folds
Galeboetichr folds
DanMD calls 0.01€
Jaloux88737 checks
*** FLOP *** [3s 5h 6h]
DanMD bets 0.02€
Jaloux88737 calls 0.02€
*** TURN *** [3s 5h 6h][Td]
DanMD bets 0.02€
Jaloux88737 calls 0.02€
*** RIVER *** [3s 5h 6h Td][Th]
DanMD bets 0.12€
Jaloux88737 folds
DanMD collected 0.23€ from pot
*** SUMMARY ***
Total pot 0.23€ | Rake 0.01€
Board: [3s 5h 6h Td Th]
Seat 1: DanMD (small blind) won 0.23€


Winamax Poker - HOLD-UP "Colorado" - HandId: #19116069-445905-1701519411 - Holdem no limit (0.01€/0.02€) - 2023/12/02 12:16:51 UTC
Table: 'Colorado' 6-max (real money) Seat #6 is the button
Seat 1: Fried Berg (0.89€)
Seat 2: YEUNS 24 (1.50€)
Seat 3: Jean3776 (2€)
Seat 4: Holiap (2.86€)
Seat 5: El Paellas (0.50€)
Seat 6: Kipyomag (7.09€)
*** ANTE/BLINDS ***
Fried Berg posts small blind 0.01€
YEUNS 24 posts big blind 0.02€
Dealt to Fried Berg [Js 3s]
*** PRE-FLOP *** 
Jean3776 folds
Holiap calls 0.02€
El Paellas calls 0.02€
Kipyomag folds
Fried Berg folds
YEUNS 24 checks
*** FLOP *** [Td 4d 4c]
YEUNS 24 checks
Holiap checks
El Paellas checks
*** TURN *** [Td 4d 4c][Ts]
YEUNS 24 checks
Holiap checks
El Paellas checks
*** RIVER *** [Td 4d 4c Ts][7h]
YEUNS 24 checks
Holiap checks
El Paellas checks
*** SHOW DOWN ***
YEUNS 24 shows [9d Kc] (Two pairs : Tens and 4)
Holiap shows [Qs 8c] (Two pairs : Tens and 4)
El Paellas shows [8h 8s] (Two pairs : Tens and 8)
El Paellas collected 0.06€ from pot
*** SUMMARY ***
Total pot 0.06€ | Rake 0.01€
Board: [Td 4d 4c Ts 7h]
Seat 2: YEUNS 24 (big blind) showed [9d Kc] and lost with Two pairs : Tens and 4
Seat 4: Holiap showed [Qs 8c] and lost with Two pairs : Tens and 4
Seat 5: El Paellas showed [8h 8s] and won 0.06€ with Two pairs : Tens and 8


Winamax Poker - HOLD-UP "Colorado" - HandId: #19116069-445911-1701519415 - Holdem no limit (0.01€/0.02€) - 2023/12/02 12:16:55 UTC
Table: 'Colorado' 6-max (real money) Seat #6 is the button
Seat 1: TqtPasLaMelo (2.42€)
Seat 2: Fried Berg (0.88€)
Seat 3: _Jacktakila_ (1.94€)
Seat 4: viins42 (1.95€)
Seat 5: CHANGAS (3.57€)
Seat 6: -Y4V- (4.05€)
*** ANTE/BLINDS ***
TqtPasLaMelo posts small blind 0.01€
Fried Berg posts big blind 0.02€
Dealt to Fried Berg [4c 9c]
*** PRE-FLOP *** 
_Jacktakila_ folds
viins42 folds
CHANGAS folds
-Y4V- folds
TqtPasLaMelo raises 0.06€ to 0.08€
Fried Berg folds
TqtPasLaMelo collected 0.10€ from pot
*** SUMMARY ***
Total pot 0.10€ | No rake
Seat 1: TqtPasLaMelo (small blind) won 0.10€


Winamax Poker - HOLD-UP "Colorado" - HandId: #19116069-445940-1701519433 - Holdem no limit (0.01€/0.02€) - 2023/12/02 12:17:13 UTC
Table: 'Colorado' 6-max (real money) Seat #6 is the button
Seat 1: Jean3776 (2€)
Seat 2: BMWTPM (1.70€)
Seat 3: Fried Berg (0.86€)
Seat 4: P.BaIkany (3.58€)
Seat 5: Deep Thought (2€)
Seat 6: TaBrEaMoI (9.29€)
*** ANTE/BLINDS ***
Jean3776 posts small blind 0.01€
BMWTPM posts big blind 0.02€
Dealt to Fried Berg [6c Qc]
*** PRE-FLOP *** 
Fried Berg folds
P.BaIkany raises 0.04€ to 0.06€
Deep Thought folds
TaBrEaMoI folds
Jean3776 folds
BMWTPM folds
P.BaIkany collected 0.09€ from pot
*** SUMMARY ***
Total pot 0.09€ | No rake
Seat 4: P.BaIkany won 0.09€


Winamax Poker - HOLD-UP "Colorado" - HandId: #19116069-445944-1701519435 - Holdem no limit (0.01€/0.02€) - 2023/12/02 12:17:15 UTC
Table: 'Colorado' 6-max (real money) Seat #6 is the button
Seat 1: Wood Copper (2€)
Seat 2: Baston57 (3.45€)
Seat 3: Berig (2.07€)
Seat 4: Fried Berg (0.86€)
Seat 5: JFSredbaron (2.13€)
Seat 6: Lunau (2.75€)
*** ANTE/BLINDS ***
Wood Copper posts small blind 0.01€
Baston57 posts big blind 0.02€
Dealt to Fried Berg [As Qh]
*** PRE-FLOP *** 
Berig folds
Fried Berg raises 0.02€ to 0.04€
JFSredbaron calls 0.04€
Lunau folds
Wood Copper folds
Baston57 folds
*** FLOP *** [7c 4s Jd]
Fried Berg checks
JFSredbaron checks
*** TURN *** [7c 4s Jd][8d]
Fried Berg checks
JFSredbaron checks
*** RIVER *** [7c 4s Jd 8d][6c]
Fried Berg checks
JFSredbaron checks
*** SHOW DOWN ***
JFSredbaron shows [Ks Td] (High card : King)
Fried Berg shows [As Qh] (High card : Ace)
Fried Berg collected 0.10€ from pot
*** SUMMARY ***
Total pot 0.10€ | Rake 0.01€
Board: [7c 4s Jd 8d 6c]
Seat 4: Fried Berg showed [As Qh] and won 0.10€ with High card : Ace
Seat 5: JFSredbaron showed [Ks Td] and lost with High card : King


Winamax Poker - HOLD-UP "Colorado" - HandId: #19116069-446020-1701519482 - Holdem no limit (0.01€/0.02€) - 2023/12/02 12:18:02 UTC
Table: 'Colorado' 6-max (real money) Seat #6 is the button
Seat 1: CHANGAS (4.38€)
Seat 2: Jean3776 (2€)
Seat 3: Fried Berg (0.92€)
Seat 4: TheNerd (2€)
Seat 5: JFSredbaron (2.09€)
Seat 6: Falckorn (0.79€)
*** ANTE/BLINDS ***
CHANGAS posts small blind 0.01€
Jean3776 posts big blind 0.02€
Dealt to Fried Berg [9d Js]
*** PRE-FLOP *** 
Fried Berg folds
TheNerd folds
JFSredbaron folds
Falckorn raises 0.04€ to 0.06€
CHANGAS folds
Jean3776 calls 0.04€
*** FLOP *** [6h As 6d]
Jean3776 checks
Falckorn checks
*** TURN *** [6h As 6d][Jc]
Jean3776 checks
Falckorn bets 0.13€
Jean3776 folds
Falckorn collected 0.25€ from pot
*** SUMMARY ***
Total pot 0.25€ | Rake 0.01€
Board: [6h As 6d Jc]
Seat 6: Falckorn (button) won 0.25€


Winamax Poker - HOLD-UP "Colorado" - HandId: #19116069-446023-1701519485 - Holdem no limit (0.01€/0.02€) - 2023/12/02 12:18:05 UTC
Table: 'Colorado' 6-max (real money) Seat #6 is the button
Seat 1: metamex (1.98€)
Seat 2: Anubis1983 (0.78€)
Seat 3: DeX70 (2.03€)
Seat 4: BMWTPM (1.84€)
Seat 5: Lunau (2.36€)
Seat 6: Fried Berg (0.92€)
*** ANTE/BLINDS ***
metamex posts small blind 0.01€
Anubis1983 posts big blind 0.02€
Dealt to Fried Berg [3c 5h]
*** PRE-FLOP *** 
DeX70 calls 0.02€
BMWTPM folds
Lunau folds
Fried Berg folds
metamex calls 0.01€
Anubis1983 checks
*** FLOP *** [6h 7c Qd]
metamex checks
Anubis1983 checks
DeX70 bets 0.02€
metamex folds
Anubis1983 calls 0.02€
*** TURN *** [6h 7c Qd][Qc]
Anubis1983 checks
DeX70 bets 0.03€
Anubis1983 calls 0.03€
*** RIVER *** [6h 7c Qd Qc][Kd]
Anubis1983 bets 0.10€
DeX70 calls 0.10€
*** SHOW DOWN ***
Anubis1983 shows [9s Kh] (Two pairs : Kings and Queens)
DeX70 shows [Jh Qh] (Trips of Queens)
DeX70 collected 0.32€ from pot
*** SUMMARY ***
Total pot 0.32€ | Rake 0.04€
Board: [6h 7c Qd Qc Kd]
Seat 2: Anubis1983 (big blind) showed [9s Kh] and lost with Two pairs : Kings and Queens
Seat 3: DeX70 showed [Jh Qh] and won 0.32€ with Trips of Queens


Winamax Poker - HOLD-UP "Colorado" - HandId: #19116069-446025-1701519486 - Holdem no limit (0.01€/0.02€) - 2023/12/02 12:18:06 UTC
Table: 'Colorado' 6-max (real money) Seat #6 is the button
Seat 1: Fried Berg (0.92€)
Seat 2: JFSredbaron (2.05€)
Seat 3: JOK-R777 (4.21€)
Seat 4: Amendonnayyy (3.72€)
Seat 5: Betiegarri (4.88€)
Seat 6: Froid_238737 (0.39€)
*** ANTE/BLINDS ***
Fried Berg posts small blind 0.01€
JFSredbaron posts big blind 0.02€
Dealt to Fried Berg [5h 2c]
*** PRE-FLOP *** 
JOK-R777 folds
Amendonnayyy raises 0.04€ to 0.06€
Betiegarri folds
Froid_238737 calls 0.06€
Fried Berg folds
JFSredbaron folds
*** FLOP *** [7s Ks Js]
Amendonnayyy checks
Froid_238737 checks
*** TURN *** [7s Ks Js][Kd]
Amendonnayyy bets 0.12€
Froid_238737 folds
Amendonnayyy collected 0.25€ from pot
*** SUMMARY ***
Total pot 0.25€ | Rake 0.02€
Board: [7s Ks Js Kd]
Seat 4: Amendonnayyy won 0.25€


Winamax Poker - HOLD-UP "Colorado" - HandId: #19116069-446026-1701519488 - Holdem no limit (0.01€/0.02€) - 2023/12/02 12:18:08 UTC
Table: 'Colorado' 6-max (real money) Seat #6 is the button
Seat 1: JOK-R777 (4.21€)
Seat 2: l artiste ho (0.71€)
Seat 3: Wolfert (2.93€)
Seat 4: -Y4V- (5.18€)
Seat 5: Fried Berg (0.91€)
Seat 6: oliveponcar (2.47€)
*** ANTE/BLINDS ***
JOK-R777 posts small blind 0.01€
l artiste ho posts big blind 0.02€
Dealt to Fried Berg [3s Kd]
*** PRE-FLOP *** 
Wolfert raises 0.03€ to 0.05€
-Y4V- folds
Fried Berg folds
oliveponcar folds
JOK-R777 calls 0.04€
l artiste ho folds
*** FLOP *** [Ah 4h Qs]
JOK-R777 checks
Wolfert checks
*** TURN *** [Ah 4h Qs][8d]
JOK-R777 bets 0.12€
Wolfert folds
JOK-R777 collected 0.23€ from pot
*** SUMMARY ***
Total pot 0.23€ | Rake 0.01€
Board: [Ah 4h Qs 8d]
Seat 1: JOK-R777 (small blind) won 0.23€


Winamax Poker - HOLD-UP "Colorado" - HandId: #19116069-446028-1701519489 - Holdem no limit (0.01€/0.02€) - 2023/12/02 12:18:09 UTC
Table: 'Colorado' 6-max (real money) Seat #6 is the button
Seat 1: lamuerta8300 (2.34€)
Seat 2: CHANGAS (4.37€)
Seat 3: Upswing11 (2.04€)
Seat 4: Fried Berg (0.91€)
Seat 5: -Y4V- (5.18€)
Seat 6: Betiegarri (4.88€)
*** ANTE/BLINDS ***
lamuerta8300 posts small blind 0.01€
CHANGAS posts big blind 0.02€
Dealt to Fried Berg [2s 9d]
*** PRE-FLOP *** 
Upswing11 raises 0.04€ to 0.06€
Fried Berg folds
-Y4V- folds
Betiegarri calls 0.06€
lamuerta8300 raises 0.14€ to 0.20€
CHANGAS folds
Upswing11 folds
Betiegarri calls 0.14€
*** FLOP *** [7d 7s Ts]
lamuerta8300 bets 0.34€
Betiegarri calls 0.34€
*** TURN *** [7d 7s Ts][2d]
lamuerta8300 bets 0.81€
Betiegarri folds
lamuerta8300 collected 1.85€ from pot
*** SUMMARY ***
Total pot 1.85€ | Rake 0.12€
Board: [7d 7s Ts 2d]
Seat 1: lamuerta8300 (small blind) won 1.85€


Winamax Poker - HOLD-UP "Colorado" - HandId: #19116069-446032-1701519492 - Holdem no limit (0.01€/0.02€) - 2023/12/02 12:18:12 UTC
Table: 'Colorado' 6-max (real money) Seat #6 is the button
Seat 1: KON-2-PEUTE (2.01€)
Seat 2: P.BaIkany (3.42€)
Seat 3: magicfido (1.04€)
Seat 4: haouuum28 (1.80€)
Seat 5: Fried Berg (0.91€)
Seat 6: BMWTPM (1.84€)
*** ANTE/BLINDS ***
KON-2-PEUTE posts small blind 0.01€
P.BaIkany posts big blind 0.02€
Dealt to Fried Berg [Ks Kh]
*** PRE-FLOP *** 
magicfido folds
haouuum28 folds
Fried Berg raises 0.02€ to 0.04€
BMWTPM folds
KON-2-PEUTE folds
P.BaIkany folds
Fried Berg collected 0.07€ from pot
*** SUMMARY ***
Total pot 0.07€ | No rake
Seat 5: Fried Berg won 0.07€


Winamax Poker - HOLD-UP "Colorado" - HandId: #19116069-446084-1701519529 - Holdem no limit (0.01€/0.02€) - 2023/12/02 12:18:49 UTC
Table: 'Colorado' 6-max (real money) Seat #6 is the button
Seat 1: Adame199623 (2€)
Seat 2: Wolfert (2.84€)
Seat 3: pivert 83 (2€)
Seat 4: Babi78_ (2.16€)
Seat 5: Fried Berg (0.94€)
Seat 6: Jean3776 (3.84€)
*** ANTE/BLINDS ***
Adame199623 posts small blind 0.01€
Wolfert posts big blind 0.02€
Dealt to Fried Berg [Ad 3d]
*** PRE-FLOP *** 
pivert 83 folds
Babi78_ folds
Fried Berg raises 0.02€ to 0.04€
Jean3776 folds
Adame199623 folds
Wolfert folds
Fried Berg collected 0.07€ from pot
*** SUMMARY ***
Total pot 0.07€ | No rake
Seat 5: Fried Berg won 0.07€


Winamax Poker - HOLD-UP "Colorado" - HandId: #19116069-446112-1701519548 - Holdem no limit (0.01€/0.02€) - 2023/12/02 12:19:08 UTC
Table: 'Colorado' 6-max (real money) Seat #6 is the button
Seat 1: Berig (1.63€)
Seat 2: Fried Berg (0.97€)
Seat 3: BMWTPM (1.15€)
Seat 4: Adame199623 (2€)
Seat 5: sopra61 (2.34€)
Seat 6: Baston57 (6.34€)
Hold-up to Pot: total 0.10€
*** ANTE/BLINDS ***
Berig posts small blind 0.01€
Fried Berg posts big blind 0.02€
Dealt to Fried Berg [As 3h]
*** PRE-FLOP *** 
BMWTPM folds
Adame199623 folds
sopra61 folds
Baston57 folds
Berig raises 0.04€ to 0.06€
Fried Berg calls 0.04€
*** FLOP *** [3c 9s 2d]
Berig checks
Fried Berg checks
*** TURN *** [3c 9s 2d][3s]
Berig checks
Fried Berg bets 0.06€
Berig folds
Fried Berg collected 0.27€ from pot
*** SUMMARY ***
Total pot 0.27€ | Rake 0.01€
Board: [3c 9s 2d 3s]
Seat 2: Fried Berg (big blind) won 0.27€


Winamax Poker - HOLD-UP "Colorado" - HandId: #19116069-446160-1701519581 - Holdem no limit (0.01€/0.02€) - 2023/12/02 12:19:41 UTC
Table: 'Colorado' 6-max (real money) Seat #6 is the button
Seat 1: chaketovibet (2.61€)
Seat 2: L INCONNU (1.83€)
Seat 3: pivert 83 (2€)
Seat 4: Lunau (2.93€)
Seat 5: Deep Thought (2.68€)
Seat 6: Fried Berg (1.12€)
*** ANTE/BLINDS ***
chaketovibet posts small blind 0.01€
L INCONNU posts big blind 0.02€
Dealt to Fried Berg [4s 5s]
*** PRE-FLOP *** 
pivert 83 calls 0.02€
Lunau folds
Deep Thought folds
Fried Berg calls 0.02€
chaketovibet folds
L INCONNU checks
*** FLOP *** [2s 8s Kh]
L INCONNU checks
pivert 83 checks
Fried Berg checks
*** TURN *** [2s 8s Kh][Jh]
L INCONNU checks
pivert 83 checks
Fried Berg checks
*** RIVER *** [2s 8s Kh Jh][2d]
L INCONNU checks
pivert 83 checks
Fried Berg checks
*** SHOW DOWN ***
L INCONNU shows [Qd 3s] (One pair : 2)
Fried Berg shows [4s 5s] (One pair : 2)
pivert 83 shows [4c Ad] (One pair : 2)
pivert 83 collected 0.06€ from pot
*** SUMMARY ***
Total pot 0.06€ | Rake 0.01€
Board: [2s 8s Kh Jh 2d]
Seat 2: L INCONNU (big blind) showed [Qd 3s] and lost with One pair : 2
Seat 3: pivert 83 showed [4c Ad] and won 0.06€ with One pair : 2
Seat 6: Fried Berg (button) showed [4s 5s] and lost with One pair : 2


Winamax Poker - HOLD-UP "Colorado" - HandId: #19116069-446216-1701519625 - Holdem no limit (0.01€/0.02€) - 2023/12/02 12:20:25 UTC
Table: 'Colorado' 6-max (real money) Seat #6 is the button
Seat 1: L INCONNU (1.81€)
Seat 2: AMBM2729 (1.20€)
Seat 3: viins42 (1.60€)
Seat 4: Kallonys (2.02€)
Seat 5: Galeboetichr (2.14€)
Seat 6: Fried Berg (1.10€)
*** ANTE/BLINDS ***
L INCONNU posts small blind 0.01€
AMBM2729 posts big blind 0.02€
Dealt to Fried Berg [Kh Tc]
*** PRE-FLOP *** 
viins42 folds
Kallonys folds
Galeboetichr raises 0.03€ to 0.05€
Fried Berg calls 0.05€
L INCONNU folds
AMBM2729 folds
*** FLOP *** [8c Ad 7c]
Galeboetichr checks
Fried Berg checks
*** TURN *** [8c Ad 7c][Ah]
Galeboetichr checks
Fried Berg checks
*** RIVER *** [8c Ad 7c Ah][9h]
Galeboetichr checks
Fried Berg checks
*** SHOW DOWN ***
Fried Berg shows [Kh Tc] (One pair : Aces)
Galeboetichr shows [3s 3h] (Two pairs : Aces and 3)
Galeboetichr collected 0.12€ from pot
*** SUMMARY ***
Total pot 0.12€ | Rake 0.01€
Board: [8c Ad 7c Ah 9h]
Seat 5: Galeboetichr showed [3s 3h] and won 0.12€ with Two pairs : Aces and 3
Seat 6: Fried Berg (button) showed [Kh Tc] and lost with One pair : Aces


Winamax Poker - HOLD-UP "Colorado" - HandId: #19116069-446295-1701519668 - Holdem no limit (0.01€/0.02€) - 2023/12/02 12:21:08 UTC
Table: 'Colorado' 6-max (real money) Seat #6 is the button
Seat 1: Caindymion99 (2€)
Seat 2: haouuum28 (2.34€)
Seat 3: Lunau (2.88€)
Seat 4: Fried Berg (1.05€)
Seat 5: P.BaIkany (3.77€)
Seat 6: Amendonnayyy (3.73€)
*** ANTE/BLINDS ***
Caindymion99 posts small blind 0.01€
haouuum28 posts big blind 0.02€
Dealt to Fried Berg [2h 3d]
*** PRE-FLOP *** 
Lunau folds
Fried Berg folds
P.BaIkany raises 0.04€ to 0.06€
Amendonnayyy folds
Caindymion99 folds
haouuum28 folds
P.BaIkany collected 0.09€ from pot
*** SUMMARY ***
Total pot 0.09€ | No rake
Seat 5: P.BaIkany won 0.09€


Winamax Poker - HOLD-UP "Colorado" - HandId: #19116069-446300-1701519671 - Holdem no limit (0.01€/0.02€) - 2023/12/02 12:21:11 UTC
Table: 'Colorado' 6-max (real money) Seat #6 is the button
Seat 1: Fried Berg (1.05€)
Seat 2: JOK-R777 (3.86€)
Seat 3: mhvargasc (2€)
Seat 4: Dame de pik (0.69€)
Seat 5: FH-LYON-OR (1.89€)
Seat 6: Lunau (2.88€)
*** ANTE/BLINDS ***
Fried Berg posts small blind 0.01€
JOK-R777 posts big blind 0.02€
Dealt to Fried Berg [4c 8c]
*** PRE-FLOP *** 
mhvargasc folds
Dame de pik folds
FH-LYON-OR calls 0.02€
Lunau folds
Fried Berg folds
JOK-R777 raises 0.04€ to 0.06€
FH-LYON-OR calls 0.04€
*** FLOP *** [Td Tc Ah]
JOK-R777 bets 0.05€
FH-LYON-OR calls 0.05€
*** TURN *** [Td Tc Ah][7d]
JOK-R777 bets 0.15€
FH-LYON-OR calls 0.15€
*** RIVER *** [Td Tc Ah 7d][8s]
JOK-R777 bets 0.19€
FH-LYON-OR calls 0.19€
*** SHOW DOWN ***
FH-LYON-OR shows [5s 5c] (Two pairs : Tens and 5)
JOK-R777 shows [9s As] (Two pairs : Aces and Tens)
JOK-R777 collected 0.82€ from pot
*** SUMMARY ***
Total pot 0.82€ | Rake 0.09€
Board: [Td Tc Ah 7d 8s]
Seat 2: JOK-R777 (big blind) showed [9s As] and won 0.82€ with Two pairs : Aces and Tens
Seat 5: FH-LYON-OR showed [5s 5c] and lost with Two pairs : Tens and 5


Winamax Poker - HOLD-UP "Colorado" - HandId: #19116069-446303-1701519673 - Holdem no limit (0.01€/0.02€) - 2023/12/02 12:21:13 UTC
Table: 'Colorado' 6-max (real money) Seat #6 is the button
Seat 1: Pwinpwin (2€)
Seat 2: Holiap (2.71€)
Seat 3: FDSpecimen27 (1.80€)
Seat 4: Zile741 (2.24€)
Seat 5: Fried Berg (1.04€)
Seat 6: viins42 (3.92€)
*** ANTE/BLINDS ***
Pwinpwin posts small blind 0.01€
Holiap posts big blind 0.02€
Dealt to Fried Berg [Qh Ts]
*** PRE-FLOP *** 
FDSpecimen27 folds
Zile741 folds
Fried Berg folds
viins42 raises 0.02€ to 0.04€
Pwinpwin folds
Holiap calls 0.02€
*** FLOP *** [3c Jd 6c]
Holiap checks
viins42 checks
*** TURN *** [3c Jd 6c][Ah]
Holiap checks
viins42 checks
*** RIVER *** [3c Jd 6c Ah][9d]
Holiap checks
viins42 checks
*** SHOW DOWN ***
Holiap shows [4s 5s] (High card : Ace)
viins42 shows [Th Ks] (High card : Ace)
viins42 collected 0.08€ from pot
*** SUMMARY ***
Total pot 0.08€ | Rake 0.01€
Board: [3c Jd 6c Ah 9d]
Seat 2: Holiap (big blind) showed [4s 5s] and lost with High card : Ace
Seat 6: viins42 (button) showed [Th Ks] and won 0.08€ with High card : Ace


Winamax Poker - HOLD-UP "Colorado" - HandId: #19116069-446307-1701519675 - Holdem no limit (0.01€/0.02€) - 2023/12/02 12:21:15 UTC
Table: 'Colorado' 6-max (real money) Seat #6 is the button
Seat 1: Fried Berg (1.04€)
Seat 2: Galeboetichr (2€)
Seat 3: Pwinpwin (2€)
Seat 4: IRun4Good (1.68€)
Seat 5: AMBM2729 (1.20€)
Seat 6: Jean3776 (2.26€)
*** ANTE/BLINDS ***
Fried Berg posts small blind 0.01€
Galeboetichr posts big blind 0.02€
Dealt to Fried Berg [3c 8h]
*** PRE-FLOP *** 
Pwinpwin folds
IRun4Good folds
AMBM2729 folds
Jean3776 folds
Fried Berg folds
Galeboetichr collected 0.03€ from pot
*** SUMMARY ***
Total pot 0.03€ | No rake
Seat 2: Galeboetichr (big blind) won 0.03€


Winamax Poker - HOLD-UP "Colorado" - HandId: #19116069-446310-1701519676 - Holdem no limit (0.01€/0.02€) - 2023/12/02 12:21:16 UTC
Table: 'Colorado' 6-max (real money) Seat #6 is the button
Seat 1: Kallonys (2.11€)
Seat 2: Fried Berg (1.03€)
Seat 3: Kipyomag (6.98€)
Seat 4: FDSpecimen27 (1.80€)
Seat 5: Dame de pik (0.69€)
Seat 6: Wolfert (4.37€)
Hold-up to Pot: total 0.10€
*** ANTE/BLINDS ***
Kallonys posts small blind 0.01€
Fried Berg posts big blind 0.02€
Dealt to Fried Berg [Kh 6h]
*** PRE-FLOP *** 
Kipyomag folds
FDSpecimen27 folds
Dame de pik calls 0.02€
Wolfert folds
Kallonys folds
Fried Berg checks
*** FLOP *** [3h Ac Tc]
Fried Berg checks
Dame de pik checks
*** TURN *** [3h Ac Tc][Th]
Fried Berg checks
Dame de pik checks
*** RIVER *** [3h Ac Tc Th][4c]
Fried Berg checks
Dame de pik checks
*** SHOW DOWN ***
Dame de pik shows [7s 8c] (One pair : Tens)
Fried Berg shows [Kh 6h] (One pair : Tens)
Fried Berg collected 0.14€ from pot
*** SUMMARY ***
Total pot 0.14€ | Rake 0.01€
Board: [3h Ac Tc Th 4c]
Seat 2: Fried Berg (big blind) showed [Kh 6h] and won 0.14€ with One pair : Tens
Seat 5: Dame de pik showed [7s 8c] and lost with One pair : Tens


Winamax Poker - HOLD-UP "Colorado" - HandId: #19116069-446369-1701519709 - Holdem no limit (0.01€/0.02€) - 2023/12/02 12:21:49 UTC
Table: 'Colorado' 6-max (real money) Seat #6 is the button
Seat 1: Fried Berg (1.15€)
Seat 2: Dame de pik (0.67€)
Seat 3: Coq82 (2.17€)
Seat 4: blie2006 (0.51€)
Seat 5: Wiwidu78 (4.28€)
Seat 6: AMBM2729 (1.37€)
*** ANTE/BLINDS ***
Fried Berg posts small blind 0.01€
Dame de pik posts big blind 0.02€
Dealt to Fried Berg [4c 9d]
*** PRE-FLOP *** 
Coq82 raises 0.03€ to 0.05€
blie2006 folds
Wiwidu78 calls 0.05€
AMBM2729 folds
Fried Berg folds
Dame de pik calls 0.03€
*** FLOP *** [9h Ks Kh]
Dame de pik checks
Coq82 checks
Wiwidu78 checks
*** TURN *** [9h Ks Kh][2h]
Dame de pik checks
Coq82 checks
Wiwidu78 bets 0.08€
Dame de pik calls 0.08€
Coq82 folds
*** RIVER *** [9h Ks Kh 2h][2c]
Dame de pik checks
Wiwidu78 bets 0.13€
Dame de pik folds
Wiwidu78 collected 0.42€ from pot
*** SUMMARY ***
Total pot 0.42€ | Rake 0.03€
Board: [9h Ks Kh 2h 2c]
Seat 5: Wiwidu78 won 0.42€


Winamax Poker - HOLD-UP "Colorado" - HandId: #19116069-446385-1701519719 - Holdem no limit (0.01€/0.02€) - 2023/12/02 12:21:59 UTC
Table: 'Colorado' 6-max (real money) Seat #6 is the button
Seat 1: Lunau (2.36€)
Seat 2: Fried Berg (1.14€)
Seat 3: Pwinpwin (2€)
Seat 4: blie2006 (0.55€)
Seat 5: Jean3776 (2€)
Seat 6: CHANGAS (3.79€)
*** ANTE/BLINDS ***
Lunau posts small blind 0.01€
Fried Berg posts big blind 0.02€
Dealt to Fried Berg [Kh Tc]
*** PRE-FLOP *** 
Pwinpwin folds
blie2006 raises 0.02€ to 0.04€
Jean3776 folds
CHANGAS folds
Lunau folds
Fried Berg calls 0.02€
*** FLOP *** [7d Qs 2d]
Fried Berg checks
blie2006 bets 0.05€
Fried Berg folds
blie2006 collected 0.13€ from pot
*** SUMMARY ***
Total pot 0.13€ | Rake 0.01€
Board: [7d Qs 2d]
Seat 4: blie2006 won 0.13€


Winamax Poker - HOLD-UP "Colorado" - HandId: #19116069-446413-1701519736 - Holdem no limit (0.01€/0.02€) - 2023/12/02 12:22:16 UTC
Table: 'Colorado' 6-max (real money) Seat #6 is the button
Seat 1: Nobru.7793 (3.13€)
Seat 2: Pwinpwin (2.01€)
Seat 3: Fried Berg (1.10€)
Seat 4: loreal78 (0.92€)
Seat 5: Adame199623 (2€)
Seat 6: oliveponcar (3.70€)
*** ANTE/BLINDS ***
Nobru.7793 posts small blind 0.01€
Pwinpwin posts big blind 0.02€
Dealt to Fried Berg [2c 5h]
*** PRE-FLOP *** 
Fried Berg folds
loreal78 calls 0.02€
Adame199623 folds
oliveponcar raises 0.06€ to 0.08€
Nobru.7793 folds
Pwinpwin folds
loreal78 calls 0.06€
*** FLOP *** [8c 2s 3c]
loreal78 checks
oliveponcar checks
*** TURN *** [8c 2s 3c][Ac]
loreal78 checks
oliveponcar bets 0.07€
loreal78 folds
oliveponcar collected 0.24€ from pot
*** SUMMARY ***
Total pot 0.24€ | Rake 0.02€
Board: [8c 2s 3c Ac]
Seat 6: oliveponcar (button) won 0.24€


Winamax Poker - HOLD-UP "Colorado" - HandId: #19116069-446416-1701519737 - Holdem no limit (0.01€/0.02€) - 2023/12/02 12:22:17 UTC
Table: 'Colorado' 6-max (real money) Seat #6 is the button
Seat 1: Rivermatuer (2.08€)
Seat 2: metamex (1.97€)
Seat 3: ases3bet (2.02€)
Seat 4: Fried Berg (1.10€)
Seat 5: lA bAncAA (2.14€)
Seat 6: Adame199623 (2€)
*** ANTE/BLINDS ***
Rivermatuer posts small blind 0.01€
metamex posts big blind 0.02€
Dealt to Fried Berg [8h Qs]
*** PRE-FLOP *** 
ases3bet folds
Fried Berg folds
lA bAncAA raises 0.04€ to 0.06€
Adame199623 raises 0.14€ to 0.20€
Rivermatuer folds
metamex folds
lA bAncAA folds
Adame199623 collected 0.29€ from pot
*** SUMMARY ***
Total pot 0.29€ | No rake
Seat 6: Adame199623 (button) won 0.29€


Winamax Poker - HOLD-UP "Colorado" - HandId: #19116069-446419-1701519738 - Holdem no limit (0.01€/0.02€) - 2023/12/02 12:22:18 UTC
Table: 'Colorado' 6-max (real money) Seat #6 is the button
Seat 1: DigBick99 (2€)
Seat 2: Nobru.7793 (3.12€)
Seat 3: CHANGAS (4.27€)
Seat 4: Holiap (2.67€)
Seat 5: blie2006 (0.59€)
Seat 6: Fried Berg (1.10€)
*** ANTE/BLINDS ***
DigBick99 posts small blind 0.01€
Nobru.7793 posts big blind 0.02€
Dealt to Fried Berg [Tc 7d]
*** PRE-FLOP *** 
CHANGAS folds
Holiap raises 0.05€ to 0.07€
blie2006 folds
Fried Berg folds
DigBick99 folds
Nobru.7793 folds
Holiap collected 0.10€ from pot
*** SUMMARY ***
Total pot 0.10€ | No rake
Seat 4: Holiap won 0.10€


Winamax Poker - HOLD-UP "Colorado" - HandId: #19116069-446422-1701519739 - Holdem no limit (0.01€/0.02€) - 2023/12/02 12:22:19 UTC
Table: 'Colorado' 6-max (real money) Seat #6 is the button
Seat 1: Baston57 (6.32€)
Seat 2: dan.doc (2.31€)
Seat 3: Deep Thought (2.62€)
Seat 4: jdeepenslip (4.46€)
Seat 5: pivert 83 (2.16€)
Seat 6: Fried Berg (1.10€)
*** ANTE/BLINDS ***
Baston57 posts small blind 0.01€
dan.doc posts big blind 0.02€
Dealt to Fried Berg [3c 5h]
*** PRE-FLOP *** 
Deep Thought folds
jdeepenslip folds
pivert 83 raises 0.05€ to 0.07€
Fried Berg folds
Baston57 folds
dan.doc calls 0.05€
*** FLOP *** [9d 8c Ks]
dan.doc checks
pivert 83 bets 0.15€
dan.doc calls 0.15€
*** TURN *** [9d 8c Ks][5d]
dan.doc checks
pivert 83 bets 0.45€
dan.doc raises 0.45€ to 0.90€
pivert 83 calls 0.45€
*** RIVER *** [9d 8c Ks 5d][Tc]
dan.doc bets 1.19€ and is all-in
pivert 83 folds
dan.doc collected 3.21€ from pot
*** SUMMARY ***
Total pot 3.21€ | Rake 0.23€
Board: [9d 8c Ks 5d Tc]
Seat 2: dan.doc (big blind) won 3.21€


Winamax Poker - HOLD-UP "Colorado" - HandId: #19116069-446426-1701519741 - Holdem no limit (0.01€/0.02€) - 2023/12/02 12:22:21 UTC
Table: 'Colorado' 6-max (real money) Seat #6 is the button
Seat 1: Upswing11 (2.15€)
Seat 2: IRun4Good (1.61€)
Seat 3: cybok20001 (0.73€)
Seat 4: Kallonys (1.95€)
Seat 5: mhvargasc (2€)
Seat 6: Fried Berg (1.10€)
*** ANTE/BLINDS ***
Upswing11 posts small blind 0.01€
IRun4Good posts big blind 0.02€
Dealt to Fried Berg [Kh 4s]
*** PRE-FLOP *** 
cybok20001 folds
Kallonys folds
mhvargasc folds
Fried Berg folds
Upswing11 raises 0.04€ to 0.06€
IRun4Good folds
Upswing11 collected 0.08€ from pot
*** SUMMARY ***
Total pot 0.08€ | No rake
Seat 1: Upswing11 (small blind) won 0.08€


Winamax Poker - HOLD-UP "Colorado" - HandId: #19116069-446430-1701519743 - Holdem no limit (0.01€/0.02€) - 2023/12/02 12:22:23 UTC
Table: 'Colorado' 6-max (real money) Seat #6 is the button
Seat 1: viins42 (3.97€)
Seat 2: p4ppysl4m (2.94€)
Seat 3: Fried Berg (1.10€)
Seat 4: Rivermatuer (2.07€)
Seat 5: Deep Thought (2.62€)
Seat 6: BMWTPM (1.78€)
Hold-up to Pot: total 0.10€
*** ANTE/BLINDS ***
viins42 posts small blind 0.01€
p4ppysl4m posts big blind 0.02€
Dealt to Fried Berg [2h 6c]
*** PRE-FLOP *** 
Fried Berg folds
Rivermatuer raises 0.15€ to 0.17€
Deep Thought folds
BMWTPM folds
viins42 folds
p4ppysl4m folds
Rivermatuer collected 0.30€ from pot
*** SUMMARY ***
Total pot 0.30€ | No rake
Seat 4: Rivermatuer won 0.30€


Winamax Poker - HOLD-UP "Colorado" - HandId: #19116069-446441-1701519748 - Holdem no limit (0.01€/0.02€) - 2023/12/02 12:22:28 UTC
Table: 'Colorado' 6-max (real money) Seat #6 is the button
Seat 1: -Y4V- (3.83€)
Seat 2: Eytrewq (2.68€)
Seat 3: Fried Berg (1.10€)
Seat 4: Zile741 (5.27€)
Seat 5: Sofi_27 (1.78€)
Seat 6: Falckorn (0.48€)
*** ANTE/BLINDS ***
-Y4V- posts small blind 0.01€
Eytrewq posts big blind 0.02€
Dealt to Fried Berg [9h 5d]
*** PRE-FLOP *** 
Fried Berg folds
Zile741 folds
Sofi_27 raises 0.23€ to 0.25€
Falckorn folds
-Y4V- folds
Eytrewq folds
Sofi_27 collected 0.28€ from pot
*** SUMMARY ***
Total pot 0.28€ | No rake
Seat 5: Sofi_27 won 0.28€


Winamax Poker - HOLD-UP "Colorado" - HandId: #19116069-446445-1701519751 - Holdem no limit (0.01€/0.02€) - 2023/12/02 12:22:31 UTC
Table: 'Colorado' 6-max (real money) Seat #6 is the button
Seat 1: metamex (1.95€)
Seat 2: Galeboetichr (2€)
Seat 3: DigBick99 (2€)
Seat 4: Nobru.7793 (3.10€)
Seat 5: Winnie-max (3.44€)
Seat 6: Fried Berg (1.10€)
*** ANTE/BLINDS ***
metamex posts small blind 0.01€
Galeboetichr posts big blind 0.02€
Dealt to Fried Berg [5c Ts]
*** PRE-FLOP *** 
DigBick99 folds
Nobru.7793 folds
Winnie-max folds
Fried Berg folds
metamex raises 0.02€ to 0.04€
Galeboetichr raises 0.12€ to 0.16€
metamex folds
Galeboetichr collected 0.20€ from pot
*** SUMMARY ***
Total pot 0.20€ | No rake
Seat 2: Galeboetichr (big blind) won 0.20€


Winamax Poker - HOLD-UP "Colorado" - HandId: #19116069-446451-1701519754 - Holdem no limit (0.01€/0.02€) - 2023/12/02 12:22:34 UTC
Table: 'Colorado' 6-max (real money) Seat #6 is the button
Seat 1: mea botellas (2€)
Seat 2: chaketovibet (3.05€)
Seat 3: Fried Berg (1.10€)
Seat 4: DigBick99 (2€)
Seat 5: Holiap (2.70€)
Seat 6: Winnie-max (3.44€)
*** ANTE/BLINDS ***
mea botellas posts small blind 0.01€
chaketovibet posts big blind 0.02€
Dealt to Fried Berg [Kh Ts]
*** PRE-FLOP *** 
Fried Berg folds
DigBick99 folds
Holiap folds
Winnie-max raises 0.03€ to 0.05€
mea botellas folds
chaketovibet folds
Winnie-max collected 0.08€ from pot
*** SUMMARY ***
Total pot 0.08€ | No rake
Seat 6: Winnie-max (button) won 0.08€


Winamax Poker - HOLD-UP "Colorado" - HandId: #19116069-446456-1701519756 - Holdem no limit (0.01€/0.02€) - 2023/12/02 12:22:36 UTC
Table: 'Colorado' 6-max (real money) Seat #6 is the button
Seat 1: Artorias (2.01€)
Seat 2: Deep Thought (2.65€)
Seat 3: Jaloux88737 (4.39€)
Seat 4: Fried Berg (1.10€)
Seat 5: LEDesTAKeuR3 (1.76€)
Seat 6: Pwinpwin (2.13€)
*** ANTE/BLINDS ***
Artorias posts small blind 0.01€
Deep Thought posts big blind 0.02€
Dealt to Fried Berg [Jh 8h]
*** PRE-FLOP *** 
Jaloux88737 folds
Fried Berg raises 0.02€ to 0.04€
LEDesTAKeuR3 folds
Pwinpwin folds
Artorias folds
Deep Thought folds
Fried Berg collected 0.07€ from pot
*** SUMMARY ***
Total pot 0.07€ | No rake
Seat 4: Fried Berg won 0.07€


Winamax Poker - HOLD-UP "Colorado" - HandId: #19116069-446480-1701519773 - Holdem no limit (0.01€/0.02€) - 2023/12/02 12:22:53 UTC
Table: 'Colorado' 6-max (real money) Seat #6 is the button
Seat 1: Jean3776 (2€)
Seat 2: Pwinpwin (2€)
Seat 3: _Jacktakila_ (2.10€)
Seat 4: DigBick99 (2.45€)
Seat 5: Fried Berg (1.13€)
Seat 6: l artiste ho (0.71€)
*** ANTE/BLINDS ***
Jean3776 posts small blind 0.01€
Pwinpwin posts big blind 0.02€
Dealt to Fried Berg [Jd 7s]
*** PRE-FLOP *** 
_Jacktakila_ folds
DigBick99 folds
Fried Berg folds
l artiste ho folds
Jean3776 raises 0.03€ to 0.05€
Pwinpwin folds
Jean3776 collected 0.07€ from pot
*** SUMMARY ***
Total pot 0.07€ | No rake
Seat 1: Jean3776 (small blind) won 0.07€


Winamax Poker - HOLD-UP "Colorado" - HandId: #19116069-446489-1701519777 - Holdem no limit (0.01€/0.02€) - 2023/12/02 12:22:57 UTC
Table: 'Colorado' 6-max (real money) Seat #6 is the button
Seat 1: Upswing11 (3.38€)
Seat 2: mhvargasc (2.07€)
Seat 3: Winnie-max (3.46€)
Seat 4: Fried Berg (1.13€)
Seat 5: blie2006 (0.48€)
Seat 6: -Y4V- (3.81€)
*** ANTE/BLINDS ***
Upswing11 posts small blind 0.01€
mhvargasc posts big blind 0.02€
Dealt to Fried Berg [4c 8s]
*** PRE-FLOP *** 
Winnie-max folds
Fried Berg folds
blie2006 folds
-Y4V- folds
Upswing11 raises 0.04€ to 0.06€
mhvargasc folds
Upswing11 collected 0.08€ from pot
*** SUMMARY ***
Total pot 0.08€ | No rake
Seat 1: Upswing11 (small blind) won 0.08€


Winamax Poker - HOLD-UP "Colorado" - HandId: #19116069-446492-1701519778 - Holdem no limit (0.01€/0.02€) - 2023/12/02 12:22:58 UTC
Table: 'Colorado' 6-max (real money) Seat #6 is the button
Seat 1: dan.doc (3.21€)
Seat 2: Fried Berg (1.13€)
Seat 3: -Y4V- (3.81€)
Seat 4: jdeepenslip (2.36€)
Seat 5: Zile741 (2.32€)
Seat 6: Beberb (2.02€)
*** ANTE/BLINDS ***
dan.doc posts small blind 0.01€
Fried Berg posts big blind 0.02€
Dealt to Fried Berg [Qh Kd]
*** PRE-FLOP *** 
-Y4V- folds
jdeepenslip folds
Zile741 folds
Beberb folds
dan.doc calls 0.01€
Fried Berg raises 0.08€ to 0.10€
dan.doc calls 0.08€
*** FLOP *** [Kh Ts Qc]
dan.doc checks
Fried Berg bets 0.12€
dan.doc folds
Fried Berg collected 0.30€ from pot
*** SUMMARY ***
Total pot 0.30€ | Rake 0.02€
Board: [Kh Ts Qc]
Seat 2: Fried Berg (big blind) won 0.30€


Winamax Poker - HOLD-UP "Colorado" - HandId: #19116069-446540-1701519805 - Holdem no limit (0.01€/0.02€) - 2023/12/02 12:23:25 UTC
Table: 'Colorado' 6-max (real money) Seat #6 is the button
Seat 1: viins42 (2.21€)
Seat 2: DosdeBras (2€)
Seat 3: Fried Berg (1.21€)
Seat 4: Wood Copper (2.18€)
Seat 5: P.BaIkany (3.29€)
Seat 6: Lunau (2.20€)
*** ANTE/BLINDS ***
viins42 posts small blind 0.01€
DosdeBras posts big blind 0.02€
Dealt to Fried Berg [5c Ks]
*** PRE-FLOP *** 
Fried Berg folds
Wood Copper folds
P.BaIkany raises 0.04€ to 0.06€
Lunau folds
viins42 folds
DosdeBras folds
P.BaIkany collected 0.09€ from pot
*** SUMMARY ***
Total pot 0.09€ | No rake
Seat 5: P.BaIkany won 0.09€


Winamax Poker - HOLD-UP "Colorado" - HandId: #19116069-446544-1701519808 - Holdem no limit (0.01€/0.02€) - 2023/12/02 12:23:28 UTC
Table: 'Colorado' 6-max (real money) Seat #6 is the button
Seat 1: Holiap (2.68€)
Seat 2: MadJackD (0.80€)
Seat 3: gamermax1 (2.31€)
Seat 4: AMBM2729 (1.29€)
Seat 5: Fried Berg (1.21€)
Seat 6: mea botellas (2.34€)
*** ANTE/BLINDS ***
Holiap posts small blind 0.01€
MadJackD posts big blind 0.02€
Dealt to Fried Berg [6d 2s]
*** PRE-FLOP *** 
gamermax1 folds
AMBM2729 folds
Fried Berg folds
mea botellas folds
Holiap folds
MadJackD collected 0.03€ from pot
*** SUMMARY ***
Total pot 0.03€ | No rake
Seat 2: MadJackD (big blind) won 0.03€


Winamax Poker - HOLD-UP "Colorado" - HandId: #19116069-446559-1701519817 - Holdem no limit (0.01€/0.02€) - 2023/12/02 12:23:37 UTC
Table: 'Colorado' 6-max (real money) Seat #6 is the button
Seat 1: KON-2-PEUTE (5.31€)
Seat 2: Fried Berg (1.21€)
Seat 3: Lunau (2.65€)
Seat 4: Beberb (1.91€)
Seat 5: Babi78_ (2.26€)
Seat 6: Zile741 (5.24€)
*** ANTE/BLINDS ***
KON-2-PEUTE posts small blind 0.01€
Fried Berg posts big blind 0.02€
Dealt to Fried Berg [Qc Ks]
*** PRE-FLOP *** 
Lunau folds
Beberb calls 0.02€
Babi78_ folds
Zile741 folds
KON-2-PEUTE folds
Fried Berg raises 0.08€ to 0.10€
Beberb calls 0.08€
*** FLOP *** [Ad Td 7c]
Fried Berg checks
Beberb bets 0.07€
Fried Berg folds
Beberb collected 0.26€ from pot
*** SUMMARY ***
Total pot 0.26€ | Rake 0.02€
Board: [Ad Td 7c]
Seat 4: Beberb won 0.26€


Winamax Poker - HOLD-UP "Colorado" - HandId: #19116069-446628-1701519857 - Holdem no limit (0.01€/0.02€) - 2023/12/02 12:24:17 UTC
Table: 'Colorado' 6-max (real money) Seat #6 is the button
Seat 1: mhvargasc (2€)
Seat 2: metamex (2€)
Seat 3: Lunau (2.72€)
Seat 4: Kallonys (1.98€)
Seat 5: jdeepenslip (2.33€)
Seat 6: Fried Berg (1.11€)
*** ANTE/BLINDS ***
mhvargasc posts small blind 0.01€
metamex posts big blind 0.02€
Dealt to Fried Berg [6s 8h]
*** PRE-FLOP *** 
Lunau folds
Kallonys folds
jdeepenslip raises 0.03€ to 0.05€
Fried Berg folds
mhvargasc folds
metamex folds
jdeepenslip collected 0.08€ from pot
*** SUMMARY ***
Total pot 0.08€ | No rake
Seat 5: jdeepenslip won 0.08€


Winamax Poker - HOLD-UP "Colorado" - HandId: #19116069-446636-1701519860 - Holdem no limit (0.01€/0.02€) - 2023/12/02 12:24:20 UTC
Table: 'Colorado' 6-max (real money) Seat #6 is the button
Seat 1: Fried Berg (1.11€)
Seat 2: missmadz (0.43€)
Seat 3: gagnejamais4 (6.49€)
Seat 4: DigBick99 (2.03€)
Seat 5: HenriGuyBet (2€)
Seat 6: Kallonys (1.98€)
*** ANTE/BLINDS ***
Fried Berg posts small blind 0.01€
missmadz posts big blind 0.02€
Dealt to Fried Berg [5h Qc]
*** PRE-FLOP *** 
gagnejamais4 folds
DigBick99 folds
HenriGuyBet folds
Kallonys folds
Fried Berg folds
missmadz collected 0.03€ from pot
*** SUMMARY ***
Total pot 0.03€ | No rake
Seat 2: missmadz (big blind) won 0.03€


Winamax Poker - HOLD-UP "Colorado" - HandId: #19116069-446644-1701519864 - Holdem no limit (0.01€/0.02€) - 2023/12/02 12:24:24 UTC
Table: 'Colorado' 6-max (real money) Seat #6 is the button
Seat 1: DanMD (2.02€)
Seat 2: Fried Berg (1.10€)
Seat 3: Durantula_6 (2.03€)
Seat 4: Babi78_ (2.29€)
Seat 5: HenriGuyBet (2€)
Seat 6: Galeboetichr (2€)
*** ANTE/BLINDS ***
DanMD posts small blind 0.01€
Fried Berg posts big blind 0.02€
Dealt to Fried Berg [9h As]
*** PRE-FLOP *** 
Durantula_6 folds
Babi78_ folds
HenriGuyBet folds
Galeboetichr folds
DanMD calls 0.01€
Fried Berg checks
*** FLOP *** [3h 7d Kc]
DanMD checks
Fried Berg checks
*** TURN *** [3h 7d Kc][8h]
DanMD bets 0.03€
Fried Berg folds
DanMD collected 0.07€ from pot
*** SUMMARY ***
Total pot 0.07€ | No rake
Board: [3h 7d Kc 8h]
Seat 1: DanMD (small blind) won 0.07€


Winamax Poker - HOLD-UP "Colorado" - HandId: #19116069-446686-1701519887 - Holdem no limit (0.01€/0.02€) - 2023/12/02 12:24:47 UTC
Table: 'Colorado' 6-max (real money) Seat #6 is the button
Seat 1: Fried Berg (1.08€)
Seat 2: metamex (1.97€)
Seat 3: AMBM2729 (1.21€)
Seat 4: Berig (2.15€)
Seat 5: _Jacktakila_ (1.88€)
Seat 6: Abec16 (2€)
*** ANTE/BLINDS ***
Fried Berg posts small blind 0.01€
metamex posts big blind 0.02€
Dealt to Fried Berg [2d 7d]
*** PRE-FLOP *** 
AMBM2729 raises 0.03€ to 0.05€
Berig folds
_Jacktakila_ folds
Abec16 calls 0.05€
Fried Berg folds
metamex calls 0.03€
*** FLOP *** [Kc 4s Js]
metamex checks
AMBM2729 bets 0.10€
Abec16 folds
metamex calls 0.10€
*** TURN *** [Kc 4s Js][4c]
metamex checks
AMBM2729 bets 0.29€
metamex folds
AMBM2729 collected 0.61€ from pot
*** SUMMARY ***
Total pot 0.61€ | Rake 0.04€
Board: [Kc 4s Js 4c]
Seat 3: AMBM2729 won 0.61€


Winamax Poker - HOLD-UP "Colorado" - HandId: #19116069-446693-1701519891 - Holdem no limit (0.01€/0.02€) - 2023/12/02 12:24:51 UTC
Table: 'Colorado' 6-max (real money) Seat #6 is the button
Seat 1: Fried Berg (1.07€)
Seat 2: blie2006 (0.36€)
Seat 3: lA bAncAA (2.03€)
Seat 4: oliveponcar (3.83€)
Seat 5: Wood Copper (2.08€)
Seat 6: DosdeBras (1.94€)
Hold-up to Pot: total 0.10€
*** ANTE/BLINDS ***
Fried Berg posts small blind 0.01€
blie2006 posts big blind 0.02€
Dealt to Fried Berg [Ks Qs]
*** PRE-FLOP *** 
lA bAncAA folds
oliveponcar raises 0.04€ to 0.06€
Wood Copper folds
DosdeBras calls 0.06€
Fried Berg raises 0.18€ to 0.24€
blie2006 calls 0.22€
oliveponcar folds
DosdeBras calls 0.18€
*** FLOP *** [6h 6c 8c]
Fried Berg checks
blie2006 bets 0.12€ and is all-in
DosdeBras raises 0.19€ to 0.31€
Fried Berg folds
*** TURN *** [6h 6c 8c][6d]
*** RIVER *** [6h 6c 8c 6d][Tc]
*** SHOW DOWN ***
blie2006 shows [Kh Th] (Full of 6 and Tens)
DosdeBras shows [Ac 2d] (Trips of 6)
DosdeBras collected 0.19€ from side pot 1
blie2006 collected 1.02€ from main pot
*** SUMMARY ***
Total pot 1.21€ | Rake 0.10€
Board: [6h 6c 8c 6d Tc]
Seat 2: blie2006 (big blind) showed [Kh Th] and won 1.02€ with Full of 6 and Tens
Seat 6: DosdeBras (button) showed [Ac 2d] and won 0.19€ with Trips of 6


Winamax Poker - HOLD-UP "Colorado" - HandId: #19116069-446762-1701519933 - Holdem no limit (0.01€/0.02€) - 2023/12/02 12:25:33 UTC
Table: 'Colorado' 6-max (real money) Seat #6 is the button
Seat 1: mhvargasc (2€)
Seat 2: Galeboetichr (2.19€)
Seat 3: viins42 (1.75€)
Seat 4: Pwinpwin (2€)
Seat 5: Fried Berg (0.83€)
Seat 6: Wiwidu78 (3.96€)
*** ANTE/BLINDS ***
mhvargasc posts small blind 0.01€
Galeboetichr posts big blind 0.02€
Dealt to Fried Berg [Ad 4c]
*** PRE-FLOP *** 
viins42 folds
Pwinpwin raises 0.03€ to 0.05€
Fried Berg folds
Wiwidu78 calls 0.05€
mhvargasc folds
Galeboetichr folds
*** FLOP *** [7s Js Qs]
Pwinpwin bets 0.05€
Wiwidu78 raises 0.09€ to 0.14€
Pwinpwin calls 0.09€
*** TURN *** [7s Js Qs][Kd]
Pwinpwin bets 0.29€
Wiwidu78 calls 0.29€
*** RIVER *** [7s Js Qs Kd][8d]
Pwinpwin bets 0.40€
Wiwidu78 folds
Pwinpwin collected 1.29€ from pot
*** SUMMARY ***
Total pot 1.29€ | Rake 0.10€
Board: [7s Js Qs Kd 8d]
Seat 4: Pwinpwin won 1.29€


Winamax Poker - HOLD-UP "Colorado" - HandId: #19116069-446776-1701519940 - Holdem no limit (0.01€/0.02€) - 2023/12/02 12:25:40 UTC
Table: 'Colorado' 6-max (real money) Seat #6 is the button
Seat 1: Babi78_ (2.25€)
Seat 2: Lunau (2.72€)
Seat 3: mea botellas (2.93€)
Seat 4: Fried Berg (0.83€)
Seat 5: BAVAROIS09 (0.47€)
Seat 6: AMBM2729 (1.20€)
*** ANTE/BLINDS ***
Babi78_ posts small blind 0.01€
Lunau posts big blind 0.02€
Dealt to Fried Berg [4h 5d]
*** PRE-FLOP *** 
mea botellas folds
Fried Berg folds
BAVAROIS09 calls 0.02€
AMBM2729 folds
Babi78_ folds
Lunau checks
*** FLOP *** [Kc Jd 7d]
Lunau checks
BAVAROIS09 checks
*** TURN *** [Kc Jd 7d][Tc]
Lunau bets 0.04€
BAVAROIS09 calls 0.04€
*** RIVER *** [Kc Jd 7d Tc][8h]
Lunau bets 0.13€
BAVAROIS09 raises 0.28€ to 0.41€ and is all-in
Lunau calls 0.28€
*** SHOW DOWN ***
BAVAROIS09 shows [2d 9d] (Straight Jack high)
Lunau shows [Qs 9c] (Straight King high)
Lunau collected 0.85€ from pot
*** SUMMARY ***
Total pot 0.85€ | Rake 0.10€
Board: [Kc Jd 7d Tc 8h]
Seat 2: Lunau (big blind) showed [Qs 9c] and won 0.85€ with Straight King high
Seat 5: BAVAROIS09 showed [2d 9d] and lost with Straight Jack high


Winamax Poker - HOLD-UP "Colorado" - HandId: #19116069-446778-1701519941 - Holdem no limit (0.01€/0.02€) - 2023/12/02 12:25:41 UTC
Table: 'Colorado' 6-max (real money) Seat #6 is the button
Seat 1: YEUNS 24 (0.59€)
Seat 2: Durantula_6 (2.67€)
Seat 3: CHANGAS (4.19€)
Seat 4: Fried Berg (0.83€)
Seat 5: KON-2-PEUTE (5.03€)
Seat 6: mea botellas (2.93€)
*** ANTE/BLINDS ***
YEUNS 24 posts small blind 0.01€
Durantula_6 posts big blind 0.02€
Dealt to Fried Berg [2s 2c]
*** PRE-FLOP *** 
CHANGAS folds
Fried Berg folds
KON-2-PEUTE folds
mea botellas raises 0.02€ to 0.04€
YEUNS 24 folds
Durantula_6 calls 0.02€
*** FLOP *** [4h Qd Ks]
Durantula_6 checks
mea botellas bets 0.03€
Durantula_6 folds
mea botellas collected 0.11€ from pot
*** SUMMARY ***
Total pot 0.11€ | Rake 0.01€
Board: [4h Qd Ks]
Seat 6: mea botellas (button) won 0.11€


Winamax Poker - HOLD-UP "Colorado" - HandId: #19116069-446784-1701519944 - Holdem no limit (0.01€/0.02€) - 2023/12/02 12:25:44 UTC
Table: 'Colorado' 6-max (real money) Seat #6 is the button
Seat 1: Berig (1.72€)
Seat 2: AMBM2729 (1.20€)
Seat 3: cdt 15 (0.49€)
Seat 4: jdeepenslip (4.39€)
Seat 5: Fried Berg (0.83€)
Seat 6: Adame199623 (2€)
*** ANTE/BLINDS ***
Berig posts small blind 0.01€
AMBM2729 posts big blind 0.02€
Dealt to Fried Berg [Jd Qs]
*** PRE-FLOP *** 
cdt 15 raises 0.02€ to 0.04€
jdeepenslip folds
Fried Berg calls 0.04€
Adame199623 folds
Berig folds
AMBM2729 raises 0.13€ to 0.17€
cdt 15 calls 0.13€
Fried Berg calls 0.13€
*** FLOP *** [5d 9d Tc]
AMBM2729 checks
cdt 15 checks
Fried Berg checks
*** TURN *** [5d 9d Tc][Js]
AMBM2729 checks
cdt 15 bets 0.13€
Fried Berg calls 0.13€
AMBM2729 calls 0.13€
*** RIVER *** [5d 9d Tc Js][Ad]
AMBM2729 checks
cdt 15 checks
Fried Berg checks
*** SHOW DOWN ***
cdt 15 shows [Kd Jh] (One pair : Jacks)
Fried Berg shows [Jd Qs] (One pair : Jacks)
AMBM2729 shows [As Qc] (One pair : Aces)
AMBM2729 collected 0.82€ from pot
*** SUMMARY ***
Total pot 0.82€ | Rake 0.09€
Board: [5d 9d Tc Js Ad]
Seat 2: AMBM2729 (big blind) showed [As Qc] and won 0.82€ with One pair : Aces
Seat 3: cdt 15 showed [Kd Jh] and lost with One pair : Jacks
Seat 5: Fried Berg showed [Jd Qs] and lost with One pair : Jacks


Winamax Poker - HOLD-UP "Colorado" - HandId: #19116069-446854-1701519988 - Holdem no limit (0.01€/0.02€) - 2023/12/02 12:26:28 UTC
Table: 'Colorado' 6-max (real money) Seat #6 is the button
Seat 1: fifi037 (1.88€)
Seat 2: Fried Berg (0.53€)
Seat 3: mhvargasc (2€)
Seat 4: metamex (2€)
Seat 5: cdt 15 (0.19€)
Seat 6: mea botellas (2.94€)
*** ANTE/BLINDS ***
fifi037 posts small blind 0.01€
Fried Berg posts big blind 0.02€
Dealt to Fried Berg [As 6s]
*** PRE-FLOP *** 
mhvargasc raises 0.02€ to 0.04€
metamex folds
cdt 15 folds
mea botellas folds
fifi037 folds
Fried Berg calls 0.02€
*** FLOP *** [7s 2s 5h]
Fried Berg checks
mhvargasc checks
*** TURN *** [7s 2s 5h][3s]
Fried Berg checks
mhvargasc checks
*** RIVER *** [7s 2s 5h 3s][Qs]
Fried Berg bets 0.08€
mhvargasc folds
Fried Berg collected 0.16€ from pot
*** SUMMARY ***
Total pot 0.16€ | Rake 0.01€
Board: [7s 2s 5h 3s Qs]
Seat 2: Fried Berg (big blind) won 0.16€


Winamax Poker - HOLD-UP "Colorado" - HandId: #19116069-446925-1701520026 - Holdem no limit (0.01€/0.02€) - 2023/12/02 12:27:06 UTC
Table: 'Colorado' 6-max (real money) Seat #6 is the button
Seat 1: orzanco (1.25€)
Seat 2: calijohn (0.32€)
Seat 3: Fried Berg (0.57€)
Seat 4: Zile741 (5.24€)
Seat 5: Coq82 (2.20€)
Seat 6: GokuClan (1.85€)
*** ANTE/BLINDS ***
orzanco posts small blind 0.01€
calijohn posts big blind 0.02€
Dealt to Fried Berg [Kh 9h]
*** PRE-FLOP *** 
Fried Berg folds
Zile741 folds
Coq82 raises 0.03€ to 0.05€
GokuClan folds
orzanco folds
calijohn calls 0.03€
*** FLOP *** [4s 5c 7s]
calijohn bets 0.11€
Coq82 raises 0.18€ to 0.29€
calijohn calls 0.16€ and is all-in
*** TURN *** [4s 5c 7s][8c]
*** RIVER *** [4s 5c 7s 8c][Qd]
*** SHOW DOWN ***
calijohn shows [Ad 7d] (One pair : 7)
Coq82 shows [Qs As] (One pair : Queens)
Coq82 collected 0.60€ from pot
*** SUMMARY ***
Total pot 0.60€ | Rake 0.07€
Board: [4s 5c 7s 8c Qd]
Seat 2: calijohn (big blind) showed [Ad 7d] and lost with One pair : 7
Seat 5: Coq82 showed [Qs As] and won 0.60€ with One pair : Queens


Winamax Poker - HOLD-UP "Colorado" - HandId: #19116069-446936-1701520032 - Holdem no limit (0.01€/0.02€) - 2023/12/02 12:27:12 UTC
Table: 'Colorado' 6-max (real money) Seat #6 is the button
Seat 1: LEDesTAKeuR3 (2.06€)
Seat 2: GokuClan (1.85€)
Seat 3: Beberb (1.95€)
Seat 4: DigBick99 (2.12€)
Seat 5: dan.doc (3.69€)
Seat 6: Fried Berg (0.57€)
*** ANTE/BLINDS ***
LEDesTAKeuR3 posts small blind 0.01€
GokuClan posts big blind 0.02€
Dealt to Fried Berg [2d Kh]
*** PRE-FLOP *** 
Beberb folds
DigBick99 folds
dan.doc calls 0.02€
Fried Berg folds
LEDesTAKeuR3 folds
GokuClan checks
*** FLOP *** [9c 5s 8s]
GokuClan checks
dan.doc bets 0.02€
GokuClan calls 0.02€
*** TURN *** [9c 5s 8s][6c]
GokuClan checks
dan.doc bets 0.02€
GokuClan raises 0.08€ to 0.10€
dan.doc calls 0.08€
*** RIVER *** [9c 5s 8s 6c][Js]
GokuClan checks
dan.doc checks
*** SHOW DOWN ***
GokuClan shows [Kd Tc] (High card : King)
dan.doc shows [Jd Ts] (One pair : Jacks)
dan.doc collected 0.26€ from pot
*** SUMMARY ***
Total pot 0.26€ | Rake 0.03€
Board: [9c 5s 8s 6c Js]
Seat 2: GokuClan (big blind) showed [Kd Tc] and lost with High card : King
Seat 5: dan.doc showed [Jd Ts] and won 0.26€ with One pair : Jacks


Winamax Poker - HOLD-UP "Colorado" - HandId: #19116069-446940-1701520034 - Holdem no limit (0.01€/0.02€) - 2023/12/02 12:27:14 UTC
Table: 'Colorado' 6-max (real money) Seat #6 is the button
Seat 1: sopra61 (2.68€)
Seat 2: AMBM2729 (1.20€)
Seat 3: Fried Berg (0.57€)
Seat 4: pivert 83 (1.82€)
Seat 5: 49_3 (2.89€)
Seat 6: Jaloux88737 (4.56€)
*** ANTE/BLINDS ***
sopra61 posts small blind 0.01€
AMBM2729 posts big blind 0.02€
Dealt to Fried Berg [9d As]
*** PRE-FLOP *** 
Fried Berg raises 0.02€ to 0.04€
pivert 83 folds
49_3 folds
Jaloux88737 folds
sopra61 folds
AMBM2729 folds
Fried Berg collected 0.07€ from pot
*** SUMMARY ***
Total pot 0.07€ | No rake
Seat 3: Fried Berg won 0.07€


Winamax Poker - HOLD-UP "Colorado" - HandId: #19116069-446970-1701520049 - Holdem no limit (0.01€/0.02€) - 2023/12/02 12:27:29 UTC
Table: 'Colorado' 6-max (real money) Seat #6 is the button
Seat 1: Lunau (2.88€)
Seat 2: Jean3776 (2.03€)
Seat 3: Fried Berg (0.60€)
Seat 4: viins42 (4.70€)
Seat 5: Le chameau w (2.27€)
Seat 6: BMWTPM (1.02€)
Hold-up to Pot: total 0.10€
*** ANTE/BLINDS ***
Lunau posts small blind 0.01€
Jean3776 posts big blind 0.02€
Dealt to Fried Berg [7h Ac]
*** PRE-FLOP *** 
Fried Berg raises 0.02€ to 0.04€
viins42 folds
Le chameau w calls 0.04€
BMWTPM folds
Lunau folds
Jean3776 calls 0.02€
*** FLOP *** [Ah 7d Jc]
Jean3776 checks
Fried Berg bets 0.12€
Le chameau w calls 0.12€
Jean3776 folds
*** TURN *** [Ah 7d Jc][4s]
Fried Berg bets 0.24€
Le chameau w calls 0.24€
*** RIVER *** [Ah 7d Jc 4s][Jh]
Fried Berg checks
Le chameau w bets 0.33€
Fried Berg calls 0.20€ and is all-in
*** SHOW DOWN ***
Fried Berg shows [7h Ac] (Two pairs : Aces and Jacks)
Le chameau w shows [Jd Js] (Quads of Jacks)
Le chameau w collected 1.35€ from pot
*** SUMMARY ***
Total pot 1.35€ | Rake 0.13€
Board: [Ah 7d Jc 4s Jh]
Seat 3: Fried Berg showed [7h Ac] and lost with Two pairs : Aces and Jacks
Seat 5: Le chameau w showed [Jd Js] and won 1.35€ with Quads of Jacks


