Winamax Poker - HOLD-UP "Colorado" - HandId: #19116069-199849-1701330480 - Holdem no limit (0.01€/0.02€) - 2023/11/30 07:48:00 UTC
Table: 'Colorado' 6-max (real money) Seat #6 is the button
Seat 1: Xeosfoot (2.01€)
Seat 2: Fried Berg (0.50€)
Seat 3: OnceUpoNaTym (1.78€)
Seat 4: Vinclesu2 (0.48€)
Seat 5: OuchSteve (2.43€)
Seat 6: Davidoo36 (1.12€)
*** ANTE/BLINDS ***
Xeosfoot posts small blind 0.01€
Fried Berg posts big blind 0.02€
Dealt to Fried Berg [9c 3d]
*** PRE-FLOP *** 
OnceUpoNaTym raises 0.03€ to 0.05€
Vinclesu2 folds
OuchSteve folds
Davidoo36 folds
Xeosfoot folds
Fried Berg folds
OnceUpoNaTym collected 0.08€ from pot
*** SUMMARY ***
Total pot 0.08€ | No rake
Seat 3: OnceUpoNaTym won 0.08€


Winamax Poker - HOLD-UP "Colorado" - HandId: #19116069-199866-1701330503 - Holdem no limit (0.01€/0.02€) - 2023/11/30 07:48:23 UTC
Table: 'Colorado' 6-max (real money) Seat #6 is the button
Seat 1: B&CLYDE (0.48€)
Seat 2: Fanfan21260 (1.88€)
Seat 3: Fried Berg (0.48€)
Seat 4: OuchSteve (2.42€)
Seat 5: Vinclesu2 (0.46€)
Seat 6: SUMO LARDON (4.53€)
*** ANTE/BLINDS ***
B&CLYDE posts small blind 0.01€
Fanfan21260 posts big blind 0.02€
Dealt to Fried Berg [6s 9s]
*** PRE-FLOP *** 
Fried Berg folds
OuchSteve folds
Vinclesu2 folds
SUMO LARDON folds
B&CLYDE calls 0.01€
Fanfan21260 checks
*** FLOP *** [Qc Th 2s]
B&CLYDE bets 0.02€
Fanfan21260 calls 0.02€
*** TURN *** [Qc Th 2s][7h]
B&CLYDE bets 0.04€
Fanfan21260 calls 0.04€
*** RIVER *** [Qc Th 2s 7h][Ah]
B&CLYDE checks
Fanfan21260 checks
*** SHOW DOWN ***
B&CLYDE shows [8s 9h] (High card : Ace)
Fanfan21260 shows [Tc 8h] (One pair : Tens)
Fanfan21260 collected 0.14€ from pot
*** SUMMARY ***
Total pot 0.14€ | Rake 0.02€
Board: [Qc Th 2s 7h Ah]
Seat 1: B&CLYDE (small blind) showed [8s 9h] and lost with High card : Ace
Seat 2: Fanfan21260 (big blind) showed [Tc 8h] and won 0.14€ with One pair : Tens


Winamax Poker - HOLD-UP "Colorado" - HandId: #19116069-199869-1701330507 - Holdem no limit (0.01€/0.02€) - 2023/11/30 07:48:27 UTC
Table: 'Colorado' 6-max (real money) Seat #6 is the button
Seat 1: Fried Berg (0.48€)
Seat 2: nico033 (2.09€)
Seat 3: OuchSteve (2.42€)
Seat 4: ForasteroTT (4.14€)
Seat 5: sopra61 (2.35€)
Seat 6: Vinclesu2 (0.46€)
*** ANTE/BLINDS ***
Fried Berg posts small blind 0.01€
nico033 posts big blind 0.02€
Dealt to Fried Berg [8s 8d]
*** PRE-FLOP *** 
OuchSteve folds
ForasteroTT raises 0.03€ to 0.05€
sopra61 folds
Vinclesu2 folds
Fried Berg calls 0.04€
nico033 calls 0.03€
*** FLOP *** [Kc Jd Ks]
Fried Berg bets 0.02€
nico033 folds
ForasteroTT calls 0.02€
*** TURN *** [Kc Jd Ks][Ah]
Fried Berg checks
ForasteroTT bets 0.07€
Fried Berg calls 0.07€
*** RIVER *** [Kc Jd Ks Ah][Th]
Fried Berg checks
ForasteroTT checks
*** SHOW DOWN ***
Fried Berg shows [8s 8d] (Two pairs : Kings and 8)
ForasteroTT shows [4s As] (Two pairs : Aces and Kings)
ForasteroTT collected 0.30€ from pot
*** SUMMARY ***
Total pot 0.30€ | Rake 0.03€
Board: [Kc Jd Ks Ah Th]
Seat 1: Fried Berg (small blind) showed [8s 8d] and lost with Two pairs : Kings and 8
Seat 4: ForasteroTT showed [4s As] and won 0.30€ with Two pairs : Aces and Kings


Winamax Poker - HOLD-UP "Colorado" - HandId: #19116069-199946-1701330615 - Holdem no limit (0.01€/0.02€) - 2023/11/30 07:50:15 UTC
Table: 'Colorado' 6-max (real money) Seat #6 is the button
Seat 1: l artiste ho (0.96€)
Seat 2: Dim city (1.35€)
Seat 3: Hagreed (1.02€)
Seat 4: Fried Berg (0.34€)
Seat 5: PolyMoz (1.98€)
Seat 6: PPV-Georges (0.21€)
*** ANTE/BLINDS ***
l artiste ho posts small blind 0.01€
Dim city posts big blind 0.02€
Dealt to Fried Berg [2h 6h]
*** PRE-FLOP *** 
Hagreed raises 0.04€ to 0.06€
Fried Berg folds
PolyMoz folds
PPV-Georges folds
l artiste ho folds
Dim city folds
Hagreed collected 0.09€ from pot
*** SUMMARY ***
Total pot 0.09€ | No rake
Seat 3: Hagreed won 0.09€


Winamax Poker - HOLD-UP "Colorado" - HandId: #19116069-199954-1701330627 - Holdem no limit (0.01€/0.02€) - 2023/11/30 07:50:27 UTC
Table: 'Colorado' 6-max (real money) Seat #6 is the button
Seat 1: OuchSteve (2.50€)
Seat 2: badou29 (2.32€)
Seat 3: Xeosfoot (2.31€)
Seat 4: nicky_poker (4.71€)
Seat 5: Fried Berg (0.34€)
Seat 6: Vinclesu2 (0.43€)
*** ANTE/BLINDS ***
OuchSteve posts small blind 0.01€
badou29 posts big blind 0.02€
Dealt to Fried Berg [Js As]
*** PRE-FLOP *** 
Xeosfoot calls 0.02€
nicky_poker folds
Fried Berg raises 0.03€ to 0.05€
Vinclesu2 folds
OuchSteve folds
badou29 folds
Xeosfoot calls 0.03€
*** FLOP *** [8s Th Kc]
Xeosfoot checks
Fried Berg checks
*** TURN *** [8s Th Kc][6s]
Xeosfoot checks
Fried Berg checks
*** RIVER *** [8s Th Kc 6s][Kh]
Xeosfoot checks
Fried Berg bets 0.02€
Xeosfoot folds
Fried Berg collected 0.14€ from pot
*** SUMMARY ***
Total pot 0.14€ | Rake 0.01€
Board: [8s Th Kc 6s Kh]
Seat 5: Fried Berg won 0.14€


Winamax Poker - HOLD-UP "Colorado" - HandId: #19116069-199997-1701330695 - Holdem no limit (0.01€/0.02€) - 2023/11/30 07:51:35 UTC
Table: 'Colorado' 6-max (real money) Seat #6 is the button
Seat 1: KassKhrane76 (2.82€)
Seat 2: wanttoberich (6.79€)
Seat 3: lamuerta8300 (1.97€)
Seat 4: l artiste ho (0.98€)
Seat 5: matmyl (7.22€)
Seat 6: Fried Berg (0.41€)
*** ANTE/BLINDS ***
KassKhrane76 posts small blind 0.01€
wanttoberich posts big blind 0.02€
Dealt to Fried Berg [6h 4c]
*** PRE-FLOP *** 
lamuerta8300 folds
l artiste ho folds
matmyl folds
Fried Berg folds
KassKhrane76 raises 0.04€ to 0.06€
wanttoberich folds
KassKhrane76 collected 0.08€ from pot
*** SUMMARY ***
Total pot 0.08€ | No rake
Seat 1: KassKhrane76 (small blind) won 0.08€


Winamax Poker - HOLD-UP "Colorado" - HandId: #19116069-200007-1701330708 - Holdem no limit (0.01€/0.02€) - 2023/11/30 07:51:48 UTC
Table: 'Colorado' 6-max (real money) Seat #6 is the button
Seat 1: DENZEL007 (1.99€)
Seat 2: l artiste ho (0.98€)
Seat 3: sopra61 (2.81€)
Seat 4: PIQSOU (2.96€)
Seat 5: MaXKataleya (1.87€)
Seat 6: Fried Berg (0.41€)
*** ANTE/BLINDS ***
DENZEL007 posts small blind 0.01€
l artiste ho posts big blind 0.02€
Dealt to Fried Berg [2c 6c]
*** PRE-FLOP *** 
sopra61 folds
PIQSOU raises 0.03€ to 0.05€
MaXKataleya calls 0.05€
Fried Berg folds
DENZEL007 folds
l artiste ho folds
*** FLOP *** [9c 4h Jh]
PIQSOU bets 0.04€
MaXKataleya folds
PIQSOU collected 0.16€ from pot
*** SUMMARY ***
Total pot 0.16€ | Rake 0.01€
Board: [9c 4h Jh]
Seat 4: PIQSOU won 0.16€


Winamax Poker - HOLD-UP "Colorado" - HandId: #19116069-200012-1701330714 - Holdem no limit (0.01€/0.02€) - 2023/11/30 07:51:54 UTC
Table: 'Colorado' 6-max (real money) Seat #6 is the button
Seat 1: nicky_poker (4.68€)
Seat 2: Fried Berg (0.41€)
Seat 3: SUMO LARDON (2.61€)
Seat 4: B&CLYDE (0.43€)
Seat 5: SashaTDouss (2.75€)
Seat 6: wanttoberich (4.97€)
*** ANTE/BLINDS ***
nicky_poker posts small blind 0.01€
Fried Berg posts big blind 0.02€
Dealt to Fried Berg [2h 7d]
*** PRE-FLOP *** 
SUMO LARDON folds
B&CLYDE folds
SashaTDouss calls 0.02€
wanttoberich folds
nicky_poker raises 0.06€ to 0.08€
Fried Berg folds
SashaTDouss calls 0.06€
*** FLOP *** [2c Js Qc]
nicky_poker bets 0.07€
SashaTDouss folds
nicky_poker collected 0.23€ from pot
*** SUMMARY ***
Total pot 0.23€ | Rake 0.02€
Board: [2c Js Qc]
Seat 1: nicky_poker (small blind) won 0.23€


Winamax Poker - HOLD-UP "Colorado" - HandId: #19116069-200026-1701330731 - Holdem no limit (0.01€/0.02€) - 2023/11/30 07:52:11 UTC
Table: 'Colorado' 6-max (real money) Seat #6 is the button
Seat 1: Fried Berg (0.39€)
Seat 2: Hydramist (2€)
Seat 3: Halmosthard (1.74€)
Seat 4: B&CLYDE (0.60€)
Seat 5: wanttoberich (4.96€)
Seat 6: matmyl (7.19€)
*** ANTE/BLINDS ***
Fried Berg posts small blind 0.01€
Hydramist posts big blind 0.02€
Dealt to Fried Berg [8c Kh]
*** PRE-FLOP *** 
Halmosthard raises 0.02€ to 0.04€
B&CLYDE folds
wanttoberich folds
matmyl calls 0.04€
Fried Berg calls 0.03€
Hydramist folds
*** FLOP *** [3d Qd 2h]
Fried Berg checks
Halmosthard checks
matmyl bets 0.09€
Fried Berg folds
Halmosthard folds
matmyl collected 0.22€ from pot
*** SUMMARY ***
Total pot 0.22€ | Rake 0.01€
Board: [3d Qd 2h]
Seat 6: matmyl (button) won 0.22€


Winamax Poker - HOLD-UP "Colorado" - HandId: #19116069-200088-1701330822 - Holdem no limit (0.01€/0.02€) - 2023/11/30 07:53:42 UTC
Table: 'Colorado' 6-max (real money) Seat #6 is the button
Seat 1: SUMO LARDON (2.86€)
Seat 2: OnceUpoNaTym (2.14€)
Seat 3: Fried Berg (0.35€)
Seat 4: Prayade (3.95€)
Seat 5: RatitaKK (2.58€)
Seat 6: PIQSOU (3.03€)
*** ANTE/BLINDS ***
SUMO LARDON posts small blind 0.01€
OnceUpoNaTym posts big blind 0.02€
Dealt to Fried Berg [Kh 7c]
*** PRE-FLOP *** 
Fried Berg folds
Prayade folds
RatitaKK folds
PIQSOU folds
SUMO LARDON raises 0.04€ to 0.06€
OnceUpoNaTym folds
SUMO LARDON collected 0.08€ from pot
*** SUMMARY ***
Total pot 0.08€ | No rake
Seat 1: SUMO LARDON (small blind) won 0.08€


Winamax Poker - HOLD-UP "Colorado" - HandId: #19116069-200090-1701330824 - Holdem no limit (0.01€/0.02€) - 2023/11/30 07:53:44 UTC
Table: 'Colorado' 6-max (real money) Seat #6 is the button
Seat 1: badou29 (2.25€)
Seat 2: matmyl (7.28€)
Seat 3: Xeosfoot (2€)
Seat 4: Fried Berg (0.35€)
Seat 5: ForasteroTT (4.18€)
Seat 6: RatitaKK (2.58€)
*** ANTE/BLINDS ***
badou29 posts small blind 0.01€
matmyl posts big blind 0.02€
Dealt to Fried Berg [8s As]
*** PRE-FLOP *** 
Xeosfoot calls 0.02€
Fried Berg raises 0.02€ to 0.04€
ForasteroTT raises 0.18€ to 0.22€
RatitaKK folds
badou29 folds
matmyl folds
Xeosfoot calls 0.20€
Fried Berg raises 0.13€ to 0.35€ and is all-in
ForasteroTT calls 0.13€
Xeosfoot calls 0.13€
*** FLOP *** [4h 4c Jd]
Xeosfoot bets 0.27€
ForasteroTT raises 0.96€ to 1.23€
Xeosfoot calls 0.96€
*** TURN *** [4h 4c Jd][9h]
Xeosfoot bets 0.42€ and is all-in
ForasteroTT calls 0.42€
*** RIVER *** [4h 4c Jd 9h][Jh]
*** SHOW DOWN ***
Xeosfoot shows [Tc Th] (Two pairs : Jacks and Tens)
Fried Berg shows [8s As] (Two pairs : Jacks and 4)
ForasteroTT shows [Ah Ac] (Two pairs : Aces and Jacks)
ForasteroTT collected 3.94€ from pot
*** SUMMARY ***
Total pot 3.94€ | Rake 0.44€
Board: [4h 4c Jd 9h Jh]
Seat 3: Xeosfoot showed [Tc Th] and lost with Two pairs : Jacks and Tens
Seat 4: Fried Berg showed [8s As] and lost with Two pairs : Jacks and 4
Seat 5: ForasteroTT showed [Ah Ac] and won 3.94€ with Two pairs : Aces and Jacks


Winamax Poker - HOLD-UP "Colorado" - HandId: #19116069-200125-1701330874 - Holdem no limit (0.01€/0.02€) - 2023/11/30 07:54:34 UTC
Table: 'Colorado' 6-max (real money) Seat #6 is the button
Seat 1: l artiste ho (0.89€)
Seat 2: Xeosfoot (3.03€)
Seat 3: MotherBrain (2.12€)
Seat 4: Jus2Cervelle (2€)
Seat 5: Fried Berg (0.50€)
Seat 6: SUMO LARDON (4.03€)
*** ANTE/BLINDS ***
l artiste ho posts small blind 0.01€
Xeosfoot posts big blind 0.02€
Dealt to Fried Berg [7s Jh]
*** PRE-FLOP *** 
MotherBrain folds
Jus2Cervelle folds
Fried Berg folds
SUMO LARDON folds
l artiste ho folds
Xeosfoot collected 0.03€ from pot
*** SUMMARY ***
Total pot 0.03€ | No rake
Seat 2: Xeosfoot (big blind) won 0.03€


Winamax Poker - HOLD-UP "Colorado" - HandId: #19116069-200130-1701330882 - Holdem no limit (0.01€/0.02€) - 2023/11/30 07:54:42 UTC
Table: 'Colorado' 6-max (real money) Seat #6 is the button
Seat 1: ForasteroTT (6.12€)
Seat 2: MotherBrain (2.12€)
Seat 3: Fried Berg (0.50€)
Seat 4: FC_Ghost1 (1.94€)
Seat 5: Jus2Cervelle (2€)
Seat 6: Hydramist (2€)
*** ANTE/BLINDS ***
ForasteroTT posts small blind 0.01€
MotherBrain posts big blind 0.02€
Dealt to Fried Berg [7h Qd]
*** PRE-FLOP *** 
Fried Berg folds
FC_Ghost1 folds
Jus2Cervelle folds
Hydramist folds
ForasteroTT folds
MotherBrain collected 0.03€ from pot
*** SUMMARY ***
Total pot 0.03€ | No rake
Seat 2: MotherBrain (big blind) won 0.03€


Winamax Poker - HOLD-UP "Colorado" - HandId: #19116069-200132-1701330886 - Holdem no limit (0.01€/0.02€) - 2023/11/30 07:54:46 UTC
Table: 'Colorado' 6-max (real money) Seat #6 is the button
Seat 1: Dim city (1.35€)
Seat 2: Fried Berg (0.50€)
Seat 3: Xeosfoot (2.29€)
Seat 4: Leane3010 (2€)
Seat 5: Prayade (3.94€)
Seat 6: H.D.LANDRU (0.97€)
Hold-up to Pot: total 0.10€
*** ANTE/BLINDS ***
Dim city posts small blind 0.01€
Fried Berg posts big blind 0.02€
Dealt to Fried Berg [3s 4s]
*** PRE-FLOP *** 
Xeosfoot folds
Leane3010 raises 0.04€ to 0.06€
Prayade folds
H.D.LANDRU folds
Dim city folds
Fried Berg calls 0.04€
*** FLOP *** [7c 9s 7d]
Fried Berg checks
Leane3010 bets 0.12€
Fried Berg folds
Leane3010 collected 0.34€ from pot
*** SUMMARY ***
Total pot 0.34€ | Rake 0.01€
Board: [7c 9s 7d]
Seat 4: Leane3010 won 0.34€


Winamax Poker - HOLD-UP "Colorado" - HandId: #19116069-200161-1701330930 - Holdem no limit (0.01€/0.02€) - 2023/11/30 07:55:30 UTC
Table: 'Colorado' 6-max (real money) Seat #6 is the button
Seat 1: Fried Berg (0.44€)
Seat 2: Prayade (2.70€)
Seat 3: Sucre10 (2.65€)
Seat 4: KingSoto (0.89€)
Seat 5: sopra61 (3.46€)
Seat 6: borodach1984 (2.56€)
*** ANTE/BLINDS ***
Fried Berg posts small blind 0.01€
Prayade posts big blind 0.02€
Dealt to Fried Berg [Jd Ts]
*** PRE-FLOP *** 
Sucre10 folds
KingSoto folds
sopra61 folds
borodach1984 raises 0.03€ to 0.05€
Fried Berg calls 0.04€
Prayade folds
*** FLOP *** [Kh 2c Jc]
Fried Berg checks
borodach1984 bets 0.09€
Fried Berg calls 0.09€
*** TURN *** [Kh 2c Jc][7c]
Fried Berg checks
borodach1984 checks
*** RIVER *** [Kh 2c Jc 7c][3c]
Fried Berg bets 0.08€
borodach1984 calls 0.08€
*** SHOW DOWN ***
Fried Berg shows [Jd Ts] (One pair : Jacks)
borodach1984 shows [Js 2s] (Two pairs : Jacks and 2)
borodach1984 collected 0.41€ from pot
*** SUMMARY ***
Total pot 0.41€ | Rake 0.05€
Board: [Kh 2c Jc 7c 3c]
Seat 1: Fried Berg (small blind) showed [Jd Ts] and lost with One pair : Jacks
Seat 6: borodach1984 (button) showed [Js 2s] and won 0.41€ with Two pairs : Jacks and 2


Winamax Poker - HOLD-UP "Colorado" - HandId: #19116069-200217-1701330993 - Holdem no limit (0.01€/0.02€) - 2023/11/30 07:56:33 UTC
Table: 'Colorado' 6-max (real money) Seat #6 is the button
Seat 1: borodach1984 (2.75€)
Seat 2: ForasteroTT (6.07€)
Seat 3: SUMO LARDON (2.78€)
Seat 4: Fried Berg (0.22€)
Seat 5: Jus2Cervelle (2€)
Seat 6: LimpDoud (2€)
*** ANTE/BLINDS ***
borodach1984 posts small blind 0.01€
ForasteroTT posts big blind 0.02€
Dealt to Fried Berg [Qs As]
*** PRE-FLOP *** 
SUMO LARDON folds
Fried Berg raises 0.03€ to 0.05€
Jus2Cervelle folds
LimpDoud folds
borodach1984 folds
ForasteroTT folds
Fried Berg collected 0.08€ from pot
*** SUMMARY ***
Total pot 0.08€ | No rake
Seat 4: Fried Berg won 0.08€


Winamax Poker - HOLD-UP "Colorado" - HandId: #19116069-200241-1701331021 - Holdem no limit (0.01€/0.02€) - 2023/11/30 07:57:01 UTC
Table: 'Colorado' 6-max (real money) Seat #6 is the button
Seat 1: kamclo (2.01€)
Seat 2: Hydramist (2.02€)
Seat 3: lamuerta8300 (6.42€)
Seat 4: Bulzer45 (0.54€)
Seat 5: Fried Berg (0.25€)
Seat 6: OnceUpoNaTym (1.12€)
*** ANTE/BLINDS ***
kamclo posts small blind 0.01€
Hydramist posts big blind 0.02€
Dealt to Fried Berg [7s 4d]
*** PRE-FLOP *** 
lamuerta8300 folds
Bulzer45 folds
Fried Berg folds
OnceUpoNaTym folds
kamclo folds
Hydramist collected 0.03€ from pot
*** SUMMARY ***
Total pot 0.03€ | No rake
Seat 2: Hydramist (big blind) won 0.03€


Winamax Poker - HOLD-UP "Colorado" - HandId: #19116069-200258-1701331044 - Holdem no limit (0.01€/0.02€) - 2023/11/30 07:57:24 UTC
Table: 'Colorado' 6-max (real money) Seat #6 is the button
Seat 1: KassKhrane76 (2.50€)
Seat 2: PolyMoz (1.91€)
Seat 3: Xeosfoot (2.12€)
Seat 4: kamclo (2€)
Seat 5: Fried Berg (0.25€)
Seat 6: FabWest (2€)
*** ANTE/BLINDS ***
KassKhrane76 posts small blind 0.01€
PolyMoz posts big blind 0.02€
Dealt to Fried Berg [Kd Qc]
*** PRE-FLOP *** 
Xeosfoot calls 0.02€
kamclo folds
Fried Berg raises 0.23€ to 0.25€ and is all-in
FabWest folds
KassKhrane76 folds
PolyMoz folds
Xeosfoot calls 0.23€
*** FLOP *** [6s 3c Qh]
*** TURN *** [6s 3c Qh][Qd]
*** RIVER *** [6s 3c Qh Qd][6c]
*** SHOW DOWN ***
Xeosfoot shows [7d 5d] (Two pairs : Queens and 6)
Fried Berg shows [Kd Qc] (Full of Queens and 6)
Fried Berg collected 0.48€ from pot
*** SUMMARY ***
Total pot 0.48€ | Rake 0.05€
Board: [6s 3c Qh Qd 6c]
Seat 3: Xeosfoot showed [7d 5d] and lost with Two pairs : Queens and 6
Seat 5: Fried Berg showed [Kd Qc] and won 0.48€ with Full of Queens and 6


Winamax Poker - HOLD-UP "Colorado" - HandId: #19116069-200285-1701331072 - Holdem no limit (0.01€/0.02€) - 2023/11/30 07:57:52 UTC
Table: 'Colorado' 6-max (real money) Seat #6 is the button
Seat 1: DENZEL007 (3.34€)
Seat 2: FabWest (2.03€)
Seat 3: Xeosfoot (1.97€)
Seat 4: Fried Berg (0.48€)
Seat 5: SUMO LARDON (2.78€)
Seat 6: SirX (2.60€)
*** ANTE/BLINDS ***
DENZEL007 posts small blind 0.01€
FabWest posts big blind 0.02€
Dealt to Fried Berg [Ks 4d]
*** PRE-FLOP *** 
Xeosfoot folds
Fried Berg folds
SUMO LARDON raises 0.04€ to 0.06€
SirX calls 0.06€
DENZEL007 folds
FabWest folds
*** FLOP *** [3c Tc Ah]
SUMO LARDON bets 0.08€
SirX folds
SUMO LARDON collected 0.21€ from pot
*** SUMMARY ***
Total pot 0.21€ | Rake 0.02€
Board: [3c Tc Ah]
Seat 5: SUMO LARDON won 0.21€


Winamax Poker - HOLD-UP "Colorado" - HandId: #19116069-200291-1701331078 - Holdem no limit (0.01€/0.02€) - 2023/11/30 07:57:58 UTC
Table: 'Colorado' 6-max (real money) Seat #6 is the button
Seat 1: Fried Berg (0.48€)
Seat 2: Halmosthard (2.88€)
Seat 3: B&CLYDE (0.72€)
Seat 4: DENZEL007 (3.33€)
Seat 5: Xeosfoot (1.97€)
Seat 6: kamclo (2€)
*** ANTE/BLINDS ***
Fried Berg posts small blind 0.01€
Halmosthard posts big blind 0.02€
Dealt to Fried Berg [Td 2c]
*** PRE-FLOP *** 
B&CLYDE folds
DENZEL007 folds
Xeosfoot folds
kamclo folds
Fried Berg folds
Halmosthard collected 0.03€ from pot
*** SUMMARY ***
Total pot 0.03€ | No rake
Seat 2: Halmosthard (big blind) won 0.03€


Winamax Poker - HOLD-UP "Colorado" - HandId: #19116069-200301-1701331091 - Holdem no limit (0.01€/0.02€) - 2023/11/30 07:58:11 UTC
Table: 'Colorado' 6-max (real money) Seat #6 is the button
Seat 1: Hydramist (2.01€)
Seat 2: Fried Berg (0.47€)
Seat 3: kamclo (2€)
Seat 4: Jus2Cervelle (2.24€)
Seat 5: rubenkano10 (2.50€)
Seat 6: Bulzer45 (0.50€)
*** ANTE/BLINDS ***
Hydramist posts small blind 0.01€
Fried Berg posts big blind 0.02€
Dealt to Fried Berg [8d 7s]
*** PRE-FLOP *** 
kamclo folds
Jus2Cervelle folds
rubenkano10 raises 0.04€ to 0.06€
Bulzer45 raises 0.44€ to 0.50€ and is all-in
Hydramist folds
Fried Berg folds
rubenkano10 raises 2€ to 2.50€ and is all-in
*** FLOP *** [9c 9h 9s]
*** TURN *** [9c 9h 9s][8h]
*** RIVER *** [9c 9h 9s 8h][2s]
*** SHOW DOWN ***
rubenkano10 shows [Ac Qd] (Trips of 9)
Bulzer45 shows [Ah Kc] (Trips of 9)
Bulzer45 collected 0.93€ from main pot
rubenkano10 collected 2€ from side pot 1
*** SUMMARY ***
Total pot 2.93€ | Rake 0.10€
Board: [9c 9h 9s 8h 2s]
Seat 5: rubenkano10 showed [Ac Qd] and won 2€ with Trips of 9
Seat 6: Bulzer45 (button) showed [Ah Kc] and won 0.93€ with Trips of 9


Winamax Poker - HOLD-UP "Colorado" - HandId: #19116069-200319-1701331112 - Holdem no limit (0.01€/0.02€) - 2023/11/30 07:58:32 UTC
Table: 'Colorado' 6-max (real money) Seat #6 is the button
Seat 1: LeDoc51 (3.28€)
Seat 2: Xeosfoot (1.99€)
Seat 3: Fried Berg (0.45€)
Seat 4: badou29 (2.18€)
Seat 5: kamclo (2.15€)
Seat 6: MotherBrain (2.09€)
*** ANTE/BLINDS ***
LeDoc51 posts small blind 0.01€
Xeosfoot posts big blind 0.02€
Dealt to Fried Berg [Qc 6c]
*** PRE-FLOP *** 
Fried Berg raises 0.02€ to 0.04€
badou29 folds
kamclo folds
MotherBrain folds
LeDoc51 folds
Xeosfoot calls 0.02€
*** FLOP *** [Tc 2s 7s]
Xeosfoot checks
Fried Berg checks
*** TURN *** [Tc 2s 7s][Kc]
Xeosfoot bets 0.06€
Fried Berg calls 0.06€
*** RIVER *** [Tc 2s 7s Kc][Ts]
Xeosfoot checks
Fried Berg checks
*** SHOW DOWN ***
Fried Berg shows [Qc 6c] (One pair : Tens)
Xeosfoot shows [Qd Kd] (Two pairs : Kings and Tens)
Xeosfoot collected 0.19€ from pot
*** SUMMARY ***
Total pot 0.19€ | Rake 0.02€
Board: [Tc 2s 7s Kc Ts]
Seat 2: Xeosfoot (big blind) showed [Qd Kd] and won 0.19€ with Two pairs : Kings and Tens
Seat 3: Fried Berg showed [Qc 6c] and lost with One pair : Tens


Winamax Poker - HOLD-UP "Colorado" - HandId: #19116069-200355-1701331147 - Holdem no limit (0.01€/0.02€) - 2023/11/30 07:59:07 UTC
Table: 'Colorado' 6-max (real money) Seat #6 is the button
Seat 1: Xeosfoot (2.89€)
Seat 2: FabWest (2€)
Seat 3: kamclo (2.12€)
Seat 4: Leane3010 (2.35€)
Seat 5: Fried Berg (0.35€)
Seat 6: GF Warrior82 (0.64€)
*** ANTE/BLINDS ***
Xeosfoot posts small blind 0.01€
FabWest posts big blind 0.02€
Dealt to Fried Berg [Js 3d]
*** PRE-FLOP *** 
kamclo folds
Leane3010 folds
Fried Berg folds
GF Warrior82 folds
Xeosfoot calls 0.01€
FabWest checks
*** FLOP *** [6c 4c Jc]
Xeosfoot checks
FabWest checks
*** TURN *** [6c 4c Jc][Ad]
Xeosfoot checks
FabWest checks
*** RIVER *** [6c 4c Jc Ad][Ac]
Xeosfoot checks
FabWest checks
*** SHOW DOWN ***
Xeosfoot shows [8s 8h] (Two pairs : Aces and 8)
FabWest shows [9s Jh] (Two pairs : Aces and Jacks)
FabWest collected 0.04€ from pot
*** SUMMARY ***
Total pot 0.04€ | No rake
Board: [6c 4c Jc Ad Ac]
Seat 1: Xeosfoot (small blind) showed [8s 8h] and lost with Two pairs : Aces and 8
Seat 2: FabWest (big blind) showed [9s Jh] and won 0.04€ with Two pairs : Aces and Jacks


Winamax Poker - HOLD-UP "Colorado" - HandId: #19116069-200360-1701331152 - Holdem no limit (0.01€/0.02€) - 2023/11/30 07:59:12 UTC
Table: 'Colorado' 6-max (real money) Seat #6 is the button
Seat 1: antien1963 (1.79€)
Seat 2: GF Warrior82 (0.64€)
Seat 3: LimpDoud (2.27€)
Seat 4: Leane3010 (2.03€)
Seat 5: SUMO LARDON (2.85€)
Seat 6: Fried Berg (0.35€)
*** ANTE/BLINDS ***
antien1963 posts small blind 0.01€
GF Warrior82 posts big blind 0.02€
Dealt to Fried Berg [Kd Ah]
*** PRE-FLOP *** 
LimpDoud raises 0.03€ to 0.05€
Leane3010 folds
SUMO LARDON folds
Fried Berg raises 0.30€ to 0.35€ and is all-in
antien1963 folds
GF Warrior82 calls 0.33€
LimpDoud raises 1.06€ to 1.41€
GF Warrior82 calls 0.29€ and is all-in
*** FLOP *** [8h 9c 3s]
*** TURN *** [8h 9c 3s][Qs]
*** RIVER *** [8h 9c 3s Qs][9d]
*** SHOW DOWN ***
GF Warrior82 shows [2c Qc] (Two pairs : Queens and 9)
Fried Berg shows [Kd Ah] (One pair : 9)
LimpDoud shows [Ks Kc] (Two pairs : Kings and 9)
LimpDoud collected 2.25€ from pot
*** SUMMARY ***
Total pot 2.25€ | Rake 0.16€
Board: [8h 9c 3s Qs 9d]
Seat 2: GF Warrior82 (big blind) showed [2c Qc] and lost with Two pairs : Queens and 9
Seat 3: LimpDoud showed [Ks Kc] and won 2.25€ with Two pairs : Kings and 9
Seat 6: Fried Berg (button) showed [Kd Ah] and lost with One pair : 9


Winamax Poker - HOLD-UP "Colorado" - HandId: #19116069-200396-1701331191 - Holdem no limit (0.01€/0.02€) - 2023/11/30 07:59:51 UTC
Table: 'Colorado' 6-max (real money) Seat #6 is the button
Seat 1: LeDoc51 (3.33€)
Seat 2: Jus2Cervelle (2.05€)
Seat 3: pamarmo79 (1.75€)
Seat 4: sopra61 (1.42€)
Seat 5: FC_Ghost1 (2€)
Seat 6: Fried Berg (0.50€)
*** ANTE/BLINDS ***
LeDoc51 posts small blind 0.01€
Jus2Cervelle posts big blind 0.02€
Dealt to Fried Berg [4h 6c]
*** PRE-FLOP *** 
pamarmo79 raises 0.04€ to 0.06€
sopra61 folds
FC_Ghost1 folds
Fried Berg folds
LeDoc51 folds
Jus2Cervelle folds
pamarmo79 collected 0.09€ from pot
*** SUMMARY ***
Total pot 0.09€ | No rake
Seat 3: pamarmo79 won 0.09€


Winamax Poker - HOLD-UP "Colorado" - HandId: #19116069-200404-1701331200 - Holdem no limit (0.01€/0.02€) - 2023/11/30 08:00:00 UTC
Table: 'Colorado' 6-max (real money) Seat #6 is the button
Seat 1: LimpDoud (2.05€)
Seat 2: Fried Berg (0.50€)
Seat 3: Xeosfoot (1.88€)
Seat 4: SUMO LARDON (2.83€)
Seat 5: PIQSOU (2.17€)
Seat 6: gueyf (1.97€)
*** ANTE/BLINDS ***
LimpDoud posts small blind 0.01€
Fried Berg posts big blind 0.02€
Dealt to Fried Berg [8c 6c]
*** PRE-FLOP *** 
Xeosfoot folds
SUMO LARDON folds
PIQSOU folds
gueyf folds
LimpDoud folds
Fried Berg collected 0.03€ from pot
*** SUMMARY ***
Total pot 0.03€ | No rake
Seat 2: Fried Berg (big blind) won 0.03€


Winamax Poker - HOLD-UP "Colorado" - HandId: #19116069-200413-1701331217 - Holdem no limit (0.01€/0.02€) - 2023/11/30 08:00:17 UTC
Table: 'Colorado' 6-max (real money) Seat #6 is the button
Seat 1: Hydramist (2€)
Seat 2: Xeosfoot (2.04€)
Seat 3: pamarmo79 (1.68€)
Seat 4: Fried Berg (0.51€)
Seat 5: B&CLYDE (0.64€)
Seat 6: SUMO LARDON (3.06€)
*** ANTE/BLINDS ***
Hydramist posts small blind 0.01€
Xeosfoot posts big blind 0.02€
Dealt to Fried Berg [2c Kc]
*** PRE-FLOP *** 
pamarmo79 folds
Fried Berg raises 0.02€ to 0.04€
B&CLYDE calls 0.04€
SUMO LARDON folds
Hydramist folds
Xeosfoot calls 0.02€
*** FLOP *** [8h 8c Qc]
Xeosfoot checks
Fried Berg checks
B&CLYDE checks
*** TURN *** [8h 8c Qc][3s]
Xeosfoot checks
Fried Berg checks
B&CLYDE bets 0.07€
Xeosfoot folds
Fried Berg raises 0.40€ to 0.47€ and is all-in
B&CLYDE raises 0.13€ to 0.60€ and is all-in
*** RIVER *** [8h 8c Qc 3s][7s]
*** SHOW DOWN ***
Fried Berg shows [2c Kc] (One pair : 8)
B&CLYDE shows [3c 3h] (Full of 3 and 8)
B&CLYDE collected 1.09€ from pot
*** SUMMARY ***
Total pot 1.09€ | Rake 0.11€
Board: [8h 8c Qc 3s 7s]
Seat 4: Fried Berg showed [2c Kc] and lost with One pair : 8
Seat 5: B&CLYDE showed [3c 3h] and won 1.09€ with Full of 3 and 8


Winamax Poker - HOLD-UP "Colorado" - HandId: #19116069-200500-1701331332 - Holdem no limit (0.01€/0.02€) - 2023/11/30 08:02:12 UTC
Table: 'Colorado' 6-max (real money) Seat #6 is the button
Seat 1: Fried Berg (0.50€)
Seat 2: Xeosfoot (1.25€)
Seat 3: gueyf (1.93€)
Seat 4: B&CLYDE (0.83€)
Seat 5: FabWest (2.29€)
Seat 6: vicieux59 (0.53€)
*** ANTE/BLINDS ***
Fried Berg posts small blind 0.01€
Xeosfoot posts big blind 0.02€
Dealt to Fried Berg [Td Jc]
*** PRE-FLOP *** 
gueyf folds
B&CLYDE folds
FabWest folds
vicieux59 folds
Fried Berg raises 0.02€ to 0.04€
Xeosfoot calls 0.02€
*** FLOP *** [Kd Ac 6d]
Fried Berg checks
Xeosfoot bets 0.03€
Fried Berg calls 0.03€
*** TURN *** [Kd Ac 6d][5c]
Fried Berg checks
Xeosfoot checks
*** RIVER *** [Kd Ac 6d 5c][3s]
Fried Berg checks
Xeosfoot checks
*** SHOW DOWN ***
Fried Berg shows [Td Jc] (High card : Ace)
Xeosfoot shows [8s 8d] (One pair : 8)
Xeosfoot collected 0.13€ from pot
*** SUMMARY ***
Total pot 0.13€ | Rake 0.01€
Board: [Kd Ac 6d 5c 3s]
Seat 1: Fried Berg (small blind) showed [Td Jc] and lost with High card : Ace
Seat 2: Xeosfoot (big blind) showed [8s 8d] and won 0.13€ with One pair : 8


Winamax Poker - HOLD-UP "Colorado" - HandId: #19116069-200553-1701331389 - Holdem no limit (0.01€/0.02€) - 2023/11/30 08:03:09 UTC
Table: 'Colorado' 6-max (real money) Seat #6 is the button
Seat 1: FC_Ghost1 (2.11€)
Seat 2: Prayade (3.83€)
Seat 3: Fried Berg (0.43€)
Seat 4: pamarmo79 (2.01€)
Seat 5: B&CLYDE (0.44€)
Seat 6: FabWest (3.76€)
*** ANTE/BLINDS ***
FC_Ghost1 posts small blind 0.01€
Prayade posts big blind 0.02€
Dealt to Fried Berg [8d 9c]
*** PRE-FLOP *** 
Fried Berg folds
pamarmo79 raises 0.04€ to 0.06€
B&CLYDE folds
FabWest folds
FC_Ghost1 folds
Prayade calls 0.04€
*** FLOP *** [4c 8h Jd]
Prayade checks
pamarmo79 bets 0.05€
Prayade folds
pamarmo79 collected 0.17€ from pot
*** SUMMARY ***
Total pot 0.17€ | Rake 0.01€
Board: [4c 8h Jd]
Seat 4: pamarmo79 won 0.17€


Winamax Poker - HOLD-UP "Colorado" - HandId: #19116069-200557-1701331394 - Holdem no limit (0.01€/0.02€) - 2023/11/30 08:03:14 UTC
Table: 'Colorado' 6-max (real money) Seat #6 is the button
Seat 1: ForasteroTT (6.37€)
Seat 2: Xeosfoot (2.40€)
Seat 3: OnceUpoNaTym (1.92€)
Seat 4: Fried Berg (0.43€)
Seat 5: vicieux59 (0.53€)
Seat 6: melijomia (2€)
Hold-up to Pot: total 0.10€
*** ANTE/BLINDS ***
ForasteroTT posts small blind 0.01€
Xeosfoot posts big blind 0.02€
Dealt to Fried Berg [5d Kd]
*** PRE-FLOP *** 
OnceUpoNaTym folds
Fried Berg raises 0.02€ to 0.04€
vicieux59 folds
melijomia raises 0.12€ to 0.16€
ForasteroTT folds
Xeosfoot folds
Fried Berg folds
melijomia collected 0.33€ from pot
*** SUMMARY ***
Total pot 0.33€ | No rake
Seat 6: melijomia (button) won 0.33€


Winamax Poker - HOLD-UP "Colorado" - HandId: #19116069-200594-1701331449 - Holdem no limit (0.01€/0.02€) - 2023/11/30 08:04:09 UTC
Table: 'Colorado' 6-max (real money) Seat #6 is the button
Seat 1: rubenkano10 (2.42€)
Seat 2: Fried Berg (0.39€)
Seat 3: PIQSOU (3.02€)
Seat 4: Bulzer45 (0.48€)
Seat 5: OnceUpoNaTym (1.45€)
Seat 6: _RaiseMint_ (1.08€)
*** ANTE/BLINDS ***
rubenkano10 posts small blind 0.01€
Fried Berg posts big blind 0.02€
Dealt to Fried Berg [Qh 3c]
*** PRE-FLOP *** 
PIQSOU folds
Bulzer45 calls 0.02€
OnceUpoNaTym folds
_RaiseMint_ folds
rubenkano10 raises 0.07€ to 0.09€
Fried Berg folds
Bulzer45 folds
rubenkano10 collected 0.13€ from pot
*** SUMMARY ***
Total pot 0.13€ | No rake
Seat 1: rubenkano10 (small blind) won 0.13€


Winamax Poker - HOLD-UP "Colorado" - HandId: #19116069-200601-1701331460 - Holdem no limit (0.01€/0.02€) - 2023/11/30 08:04:20 UTC
Table: 'Colorado' 6-max (real money) Seat #6 is the button
Seat 1: bimach444 (2.60€)
Seat 2: B&CLYDE (0.56€)
Seat 3: Fried Berg (0.37€)
Seat 4: SUMO LARDON (2€)
Seat 5: Bulzer45 (0.46€)
Seat 6: jerry1407 (2.01€)
*** ANTE/BLINDS ***
bimach444 posts small blind 0.01€
B&CLYDE posts big blind 0.02€
Dealt to Fried Berg [Jh As]
*** PRE-FLOP *** 
Fried Berg raises 0.04€ to 0.06€
SUMO LARDON folds
Bulzer45 folds
jerry1407 folds
bimach444 folds
B&CLYDE folds
Fried Berg collected 0.09€ from pot
*** SUMMARY ***
Total pot 0.09€ | No rake
Seat 3: Fried Berg won 0.09€


Winamax Poker - HOLD-UP "Colorado" - HandId: #19116069-200612-1701331473 - Holdem no limit (0.01€/0.02€) - 2023/11/30 08:04:33 UTC
Table: 'Colorado' 6-max (real money) Seat #6 is the button
Seat 1: Fried Berg (0.40€)
Seat 2: B&CLYDE (0.42€)
Seat 3: Roimish (1.92€)
Seat 4: Leane3010 (2.16€)
Seat 5: FabWest (3.76€)
Seat 6: ForasteroTT (6.42€)
*** ANTE/BLINDS ***
Fried Berg posts small blind 0.01€
B&CLYDE posts big blind 0.02€
Dealt to Fried Berg [2s 9d]
*** PRE-FLOP *** 
Roimish folds
Leane3010 raises 0.04€ to 0.06€
FabWest folds
ForasteroTT folds
Fried Berg folds
B&CLYDE folds
Leane3010 collected 0.09€ from pot
*** SUMMARY ***
Total pot 0.09€ | No rake
Seat 4: Leane3010 won 0.09€


Winamax Poker - HOLD-UP "Colorado" - HandId: #19116069-200618-1701331481 - Holdem no limit (0.01€/0.02€) - 2023/11/30 08:04:41 UTC
Table: 'Colorado' 6-max (real money) Seat #6 is the button
Seat 1: OnceUpoNaTym (1.45€)
Seat 2: FabWest (3.76€)
Seat 3: B&CLYDE (0.40€)
Seat 4: Vinclesu2 (0.76€)
Seat 5: Fried Berg (0.39€)
Seat 6: ForasteroTT (6.42€)
*** ANTE/BLINDS ***
OnceUpoNaTym posts small blind 0.01€
FabWest posts big blind 0.02€
Dealt to Fried Berg [5c Qd]
*** PRE-FLOP *** 
B&CLYDE calls 0.02€
Vinclesu2 folds
Fried Berg folds
ForasteroTT raises 0.07€ to 0.09€
OnceUpoNaTym folds
FabWest folds
B&CLYDE folds
ForasteroTT collected 0.14€ from pot
*** SUMMARY ***
Total pot 0.14€ | No rake
Seat 6: ForasteroTT (button) won 0.14€


Winamax Poker - HOLD-UP "Colorado" - HandId: #19116069-200626-1701331488 - Holdem no limit (0.01€/0.02€) - 2023/11/30 08:04:48 UTC
Table: 'Colorado' 6-max (real money) Seat #6 is the button
Seat 1: Xeosfoot (2€)
Seat 2: SUMO LARDON (2.40€)
Seat 3: Leane3010 (4.02€)
Seat 4: jerry1407 (2.01€)
Seat 5: FuckLaRiver. (0.50€)
Seat 6: Fried Berg (0.39€)
Hold-up to Pot: total 0.10€
*** ANTE/BLINDS ***
Xeosfoot posts small blind 0.01€
SUMO LARDON posts big blind 0.02€
Dealt to Fried Berg [Td 5c]
*** PRE-FLOP *** 
Leane3010 folds
jerry1407 folds
FuckLaRiver. folds
Fried Berg folds
Xeosfoot folds
SUMO LARDON collected 0.13€ from pot
*** SUMMARY ***
Total pot 0.13€ | No rake
Seat 2: SUMO LARDON (big blind) won 0.13€


Winamax Poker - HOLD-UP "Colorado" - HandId: #19116069-200630-1701331495 - Holdem no limit (0.01€/0.02€) - 2023/11/30 08:04:55 UTC
Table: 'Colorado' 6-max (real money) Seat #6 is the button
Seat 1: Bulzer45 (0.44€)
Seat 2: Jus2Cervelle (2.17€)
Seat 3: MotherBrain (2.85€)
Seat 4: PIQSOU (2€)
Seat 5: Fried Berg (0.39€)
Seat 6: pamarmo79 (2.10€)
*** ANTE/BLINDS ***
Bulzer45 posts small blind 0.01€
Jus2Cervelle posts big blind 0.02€
Dealt to Fried Berg [7s 4h]
*** PRE-FLOP *** 
MotherBrain folds
PIQSOU folds
Fried Berg folds
pamarmo79 folds
Bulzer45 calls 0.01€
Jus2Cervelle checks
*** FLOP *** [2s 3h 7d]
Bulzer45 bets 0.02€
Jus2Cervelle folds
Bulzer45 collected 0.06€ from pot
*** SUMMARY ***
Total pot 0.06€ | No rake
Board: [2s 3h 7d]
Seat 1: Bulzer45 (small blind) won 0.06€


Winamax Poker - HOLD-UP "Colorado" - HandId: #19116069-200633-1701331499 - Holdem no limit (0.01€/0.02€) - 2023/11/30 08:04:59 UTC
Table: 'Colorado' 6-max (real money) Seat #6 is the button
Seat 1: SashaTDouss (2.25€)
Seat 2: FuckLaRiver. (0.50€)
Seat 3: jerry1407 (2.01€)
Seat 4: Fried Berg (0.39€)
Seat 5: _RaiseMint_ (1.08€)
Seat 6: OnceUpoNaTym (1.69€)
*** ANTE/BLINDS ***
SashaTDouss posts small blind 0.01€
FuckLaRiver. posts big blind 0.02€
Dealt to Fried Berg [Qd 9h]
*** PRE-FLOP *** 
jerry1407 folds
Fried Berg folds
_RaiseMint_ folds
OnceUpoNaTym raises 0.06€ to 0.08€
SashaTDouss folds
FuckLaRiver. calls 0.06€
*** FLOP *** [6s Ac 4c]
FuckLaRiver. bets 0.11€
OnceUpoNaTym calls 0.11€
*** TURN *** [6s Ac 4c][6c]
FuckLaRiver. checks
OnceUpoNaTym checks
*** RIVER *** [6s Ac 4c 6c][2c]
FuckLaRiver. checks
OnceUpoNaTym checks
*** SHOW DOWN ***
FuckLaRiver. shows [9s 9d] (Two pairs : 9 and 6)
OnceUpoNaTym shows [Th Td] (Two pairs : Tens and 6)
OnceUpoNaTym collected 0.35€ from pot
*** SUMMARY ***
Total pot 0.35€ | Rake 0.04€
Board: [6s Ac 4c 6c 2c]
Seat 2: FuckLaRiver. (big blind) showed [9s 9d] and lost with Two pairs : 9 and 6
Seat 6: OnceUpoNaTym (button) showed [Th Td] and won 0.35€ with Two pairs : Tens and 6


Winamax Poker - HOLD-UP "Colorado" - HandId: #19116069-200637-1701331505 - Holdem no limit (0.01€/0.02€) - 2023/11/30 08:05:05 UTC
Table: 'Colorado' 6-max (real money) Seat #6 is the button
Seat 1: MotherBrain (2.85€)
Seat 2: jerry1407 (2.01€)
Seat 3: Leane3010 (2.16€)
Seat 4: DENZEL007 (1.97€)
Seat 5: SUMO LARDON (2.51€)
Seat 6: Fried Berg (0.39€)
*** ANTE/BLINDS ***
MotherBrain posts small blind 0.01€
jerry1407 posts big blind 0.02€
Dealt to Fried Berg [As 6d]
*** PRE-FLOP *** 
Leane3010 folds
DENZEL007 raises 0.04€ to 0.06€
SUMO LARDON folds
Fried Berg calls 0.06€
MotherBrain folds
jerry1407 folds
*** FLOP *** [8c 3c 4d]
DENZEL007 checks
Fried Berg checks
*** TURN *** [8c 3c 4d][3h]
DENZEL007 checks
Fried Berg checks
*** RIVER *** [8c 3c 4d 3h][Qd]
DENZEL007 checks
Fried Berg bets 0.02€
DENZEL007 calls 0.02€
*** SHOW DOWN ***
Fried Berg shows [As 6d] (One pair : 3)
DENZEL007 shows [Jd Ac] (One pair : 3)
DENZEL007 collected 0.17€ from pot
*** SUMMARY ***
Total pot 0.17€ | Rake 0.02€
Board: [8c 3c 4d 3h Qd]
Seat 4: DENZEL007 showed [Jd Ac] and won 0.17€ with One pair : 3
Seat 6: Fried Berg (button) showed [As 6d] and lost with One pair : 3


Winamax Poker - HOLD-UP "Colorado" - HandId: #19116069-200655-1701331535 - Holdem no limit (0.01€/0.02€) - 2023/11/30 08:05:35 UTC
Table: 'Colorado' 6-max (real money) Seat #6 is the button
Seat 1: Bulzer45 (0.46€)
Seat 2: Fried Berg (0.31€)
Seat 3: sopra61 (1.64€)
Seat 4: SUMO LARDON (3.56€)
Seat 5: MotherBrain (2.30€)
Seat 6: jerry1407 (2€)
*** ANTE/BLINDS ***
Bulzer45 posts small blind 0.01€
Fried Berg posts big blind 0.02€
Dealt to Fried Berg [5h 2h]
*** PRE-FLOP *** 
sopra61 folds
SUMO LARDON folds
MotherBrain folds
jerry1407 raises 0.03€ to 0.05€
Bulzer45 calls 0.04€
Fried Berg folds
*** FLOP *** [3s 9d 5c]
Bulzer45 checks
jerry1407 checks
*** TURN *** [3s 9d 5c][8s]
Bulzer45 bets 0.02€
jerry1407 calls 0.02€
*** RIVER *** [3s 9d 5c 8s][Ts]
Bulzer45 bets 0.06€
jerry1407 folds
Bulzer45 collected 0.20€ from pot
*** SUMMARY ***
Total pot 0.20€ | Rake 0.02€
Board: [3s 9d 5c 8s Ts]
Seat 1: Bulzer45 (small blind) won 0.20€


Winamax Poker - HOLD-UP "Colorado" - HandId: #19116069-200658-1701331540 - Holdem no limit (0.01€/0.02€) - 2023/11/30 08:05:40 UTC
Table: 'Colorado' 6-max (real money) Seat #6 is the button
Seat 1: B&CLYDE (0.38€)
Seat 2: SUMO LARDON (2.54€)
Seat 3: Fried Berg (0.29€)
Seat 4: sopra61 (1.64€)
Seat 5: PIQSOU (3.17€)
Seat 6: FabWest (2.49€)
Hold-up to Pot: total 0.10€
*** ANTE/BLINDS ***
B&CLYDE posts small blind 0.01€
SUMO LARDON posts big blind 0.02€
Dealt to Fried Berg [6d 6s]
*** PRE-FLOP *** 
Fried Berg raises 0.27€ to 0.29€ and is all-in
sopra61 calls 0.29€
PIQSOU folds
FabWest folds
B&CLYDE folds
SUMO LARDON folds
*** FLOP *** [4c 5h 3c]
*** TURN *** [4c 5h 3c][3s]
*** RIVER *** [4c 5h 3c 3s][3h]
*** SHOW DOWN ***
sopra61 shows [9d Qd] (Trips of 3)
Fried Berg shows [6d 6s] (Full of 3 and 6)
Fried Berg collected 0.65€ from pot
*** SUMMARY ***
Total pot 0.65€ | Rake 0.06€
Board: [4c 5h 3c 3s 3h]
Seat 3: Fried Berg showed [6d 6s] and won 0.65€ with Full of 3 and 6
Seat 4: sopra61 showed [9d Qd] and lost with Trips of 3


Winamax Poker - HOLD-UP "Colorado" - HandId: #19116069-200682-1701331582 - Holdem no limit (0.01€/0.02€) - 2023/11/30 08:06:22 UTC
Table: 'Colorado' 6-max (real money) Seat #6 is the button
Seat 1: Fried Berg (0.65€)
Seat 2: Vinclesu2 (0.70€)
Seat 3: OnceUpoNaTym (1.37€)
Seat 4: sopra61 (1.35€)
Seat 5: Jus2Cervelle (3.41€)
Seat 6: Manupoy (2.07€)
*** ANTE/BLINDS ***
Fried Berg posts small blind 0.01€
Vinclesu2 posts big blind 0.02€
Dealt to Fried Berg [5c Qd]
*** PRE-FLOP *** 
OnceUpoNaTym folds
sopra61 folds
Jus2Cervelle folds
Manupoy folds
Fried Berg folds
Vinclesu2 collected 0.03€ from pot
*** SUMMARY ***
Total pot 0.03€ | No rake
Seat 2: Vinclesu2 (big blind) won 0.03€


Winamax Poker - HOLD-UP "Colorado" - HandId: #19116069-200691-1701331594 - Holdem no limit (0.01€/0.02€) - 2023/11/30 08:06:34 UTC
Table: 'Colorado' 6-max (real money) Seat #6 is the button
Seat 1: Ziildjiin (5.51€)
Seat 2: bimach444 (3.23€)
Seat 3: FC_Ghost1 (1.53€)
Seat 4: _RaiseMint_ (1.05€)
Seat 5: FabWest (2.10€)
Seat 6: Fried Berg (0.64€)
*** ANTE/BLINDS ***
Ziildjiin posts small blind 0.01€
bimach444 posts big blind 0.02€
Dealt to Fried Berg [8s 3c]
*** PRE-FLOP *** 
FC_Ghost1 folds
_RaiseMint_ folds
FabWest folds
Fried Berg folds
Ziildjiin raises 0.02€ to 0.04€
bimach444 calls 0.02€
*** FLOP *** [Kh 9d 8h]
Ziildjiin bets 0.05€
bimach444 folds
Ziildjiin collected 0.12€ from pot
*** SUMMARY ***
Total pot 0.12€ | Rake 0.01€
Board: [Kh 9d 8h]
Seat 1: Ziildjiin (small blind) won 0.12€


Winamax Poker - HOLD-UP "Colorado" - HandId: #19116069-200697-1701331602 - Holdem no limit (0.01€/0.02€) - 2023/11/30 08:06:42 UTC
Table: 'Colorado' 6-max (real money) Seat #6 is the button
Seat 1: sopra61 (1.33€)
Seat 2: badou29 (2.11€)
Seat 3: nico033 (2.32€)
Seat 4: Fried Berg (0.64€)
Seat 5: _RaiseMint_ (1.05€)
Seat 6: FC_Ghost1 (1.53€)
*** ANTE/BLINDS ***
sopra61 posts small blind 0.01€
badou29 posts big blind 0.02€
Dealt to Fried Berg [Kc 5h]
*** PRE-FLOP *** 
nico033 folds
Fried Berg folds
_RaiseMint_ raises 0.04€ to 0.06€
FC_Ghost1 folds
sopra61 folds
badou29 folds
_RaiseMint_ collected 0.09€ from pot
*** SUMMARY ***
Total pot 0.09€ | No rake
Seat 5: _RaiseMint_ won 0.09€


Winamax Poker - HOLD-UP "Colorado" - HandId: #19116069-200706-1701331614 - Holdem no limit (0.01€/0.02€) - 2023/11/30 08:06:54 UTC
Table: 'Colorado' 6-max (real money) Seat #6 is the button
Seat 1: Halmosthard (1.45€)
Seat 2: FabWest (3.92€)
Seat 3: Fried Berg (0.64€)
Seat 4: gueyf (0.13€)
Seat 5: PIQSOU (2.68€)
Seat 6: pamarmo79 (1.64€)
*** ANTE/BLINDS ***
Halmosthard posts small blind 0.01€
FabWest posts big blind 0.02€
Dealt to Fried Berg [Kc As]
*** PRE-FLOP *** 
Fried Berg raises 0.02€ to 0.04€
gueyf folds
PIQSOU folds
pamarmo79 raises 0.11€ to 0.15€
Halmosthard folds
FabWest folds
Fried Berg raises 0.49€ to 0.64€ and is all-in
pamarmo79 calls 0.49€
*** FLOP *** [5d 8c Kh]
*** TURN *** [5d 8c Kh][Th]
*** RIVER *** [5d 8c Kh Th][8h]
*** SHOW DOWN ***
pamarmo79 shows [Js Jc] (Two pairs : Jacks and 8)
Fried Berg shows [Kc As] (Two pairs : Kings and 8)
Fried Berg collected 1.18€ from pot
*** SUMMARY ***
Total pot 1.18€ | Rake 0.13€
Board: [5d 8c Kh Th 8h]
Seat 3: Fried Berg showed [Kc As] and won 1.18€ with Two pairs : Kings and 8
Seat 6: pamarmo79 (button) showed [Js Jc] and lost with Two pairs : Jacks and 8


Winamax Poker - HOLD-UP "Colorado" - HandId: #19116069-200729-1701331642 - Holdem no limit (0.01€/0.02€) - 2023/11/30 08:07:22 UTC
Table: 'Colorado' 6-max (real money) Seat #6 is the button
Seat 1: LimpDoud (2€)
Seat 2: Fried Berg (1.18€)
Seat 3: B&CLYDE (1.13€)
Seat 4: Bulzer45 (0.53€)
Seat 5: Prayade (2.52€)
Seat 6: FabWest (2€)
*** ANTE/BLINDS ***
LimpDoud posts small blind 0.01€
Fried Berg posts big blind 0.02€
Dealt to Fried Berg [3h Jd]
*** PRE-FLOP *** 
B&CLYDE folds
Bulzer45 folds
Prayade folds
FabWest folds
LimpDoud calls 0.01€
Fried Berg checks
*** FLOP *** [Ah Th 8s]
LimpDoud bets 0.02€
Fried Berg folds
LimpDoud collected 0.06€ from pot
*** SUMMARY ***
Total pot 0.06€ | No rake
Board: [Ah Th 8s]
Seat 1: LimpDoud (small blind) won 0.06€


Winamax Poker - HOLD-UP "Colorado" - HandId: #19116069-200756-1701331682 - Holdem no limit (0.01€/0.02€) - 2023/11/30 08:08:02 UTC
Table: 'Colorado' 6-max (real money) Seat #6 is the button
Seat 1: _RaiseMint_ (1.19€)
Seat 2: SUMO LARDON (2.53€)
Seat 3: Xeosfoot (2.39€)
Seat 4: Kalendula (1.03€)
Seat 5: Fried Berg (1.16€)
Seat 6: PIQSOU (3.83€)
*** ANTE/BLINDS ***
_RaiseMint_ posts small blind 0.01€
SUMO LARDON posts big blind 0.02€
Dealt to Fried Berg [Td 5s]
*** PRE-FLOP *** 
Xeosfoot folds
Kalendula folds
Fried Berg folds
PIQSOU raises 0.03€ to 0.05€
_RaiseMint_ folds
SUMO LARDON folds
PIQSOU collected 0.08€ from pot
*** SUMMARY ***
Total pot 0.08€ | No rake
Seat 6: PIQSOU (button) won 0.08€


Winamax Poker - HOLD-UP "Colorado" - HandId: #19116069-200759-1701331686 - Holdem no limit (0.01€/0.02€) - 2023/11/30 08:08:06 UTC
Table: 'Colorado' 6-max (real money) Seat #6 is the button
Seat 1: Bulzer45 (0.84€)
Seat 2: MotherBrain (2.60€)
Seat 3: B&CLYDE (1.11€)
Seat 4: gueyf (0.10€)
Seat 5: Leane3010 (4.27€)
Seat 6: Fried Berg (1.16€)
*** ANTE/BLINDS ***
Bulzer45 posts small blind 0.01€
MotherBrain posts big blind 0.02€
Dealt to Fried Berg [9h 4c]
*** PRE-FLOP *** 
B&CLYDE folds
gueyf folds
Leane3010 folds
Fried Berg folds
Bulzer45 calls 0.01€
MotherBrain raises 0.06€ to 0.08€
Bulzer45 folds
MotherBrain collected 0.10€ from pot
*** SUMMARY ***
Total pot 0.10€ | No rake
Seat 2: MotherBrain (big blind) won 0.10€


Winamax Poker - HOLD-UP "Colorado" - HandId: #19116069-200762-1701331691 - Holdem no limit (0.01€/0.02€) - 2023/11/30 08:08:11 UTC
Table: 'Colorado' 6-max (real money) Seat #6 is the button
Seat 1: Fried Berg (1.16€)
Seat 2: pamarmo79 (2.32€)
Seat 3: SUMO LARDON (4.11€)
Seat 4: Leane3010 (4.27€)
Seat 5: Xeosfoot (2.04€)
Seat 6: nico033 (2.29€)
*** ANTE/BLINDS ***
Fried Berg posts small blind 0.01€
pamarmo79 posts big blind 0.02€
Dealt to Fried Berg [Qs Kc]
*** PRE-FLOP *** 
SUMO LARDON folds
Leane3010 folds
Xeosfoot calls 0.02€
nico033 raises 0.07€ to 0.09€
Fried Berg calls 0.08€
pamarmo79 folds
Xeosfoot folds
*** FLOP *** [9c 3d 3s]
Fried Berg checks
nico033 checks
*** TURN *** [9c 3d 3s][Qd]
Fried Berg checks
nico033 bets 0.08€
Fried Berg calls 0.08€
*** RIVER *** [9c 3d 3s Qd][5h]
Fried Berg checks
nico033 checks
*** SHOW DOWN ***
nico033 shows [Ah 6h] (One pair : 3)
Fried Berg shows [Qs Kc] (Two pairs : Queens and 3)
Fried Berg collected 0.34€ from pot
*** SUMMARY ***
Total pot 0.34€ | Rake 0.04€
Board: [9c 3d 3s Qd 5h]
Seat 1: Fried Berg (small blind) showed [Qs Kc] and won 0.34€ with Two pairs : Queens and 3
Seat 6: nico033 (button) showed [Ah 6h] and lost with One pair : 3


Winamax Poker - HOLD-UP "Colorado" - HandId: #19116069-200814-1701331765 - Holdem no limit (0.01€/0.02€) - 2023/11/30 08:09:25 UTC
Table: 'Colorado' 6-max (real money) Seat #6 is the button
Seat 1: Xeosfoot (2.36€)
Seat 2: PIQSOU (3.86€)
Seat 3: nico033 (2.12€)
Seat 4: OnceUpoNaTym (1.26€)
Seat 5: Fried Berg (1.33€)
Seat 6: pamarmo79 (2.49€)
*** ANTE/BLINDS ***
Xeosfoot posts small blind 0.01€
PIQSOU posts big blind 0.02€
Dealt to Fried Berg [7s Ks]
*** PRE-FLOP *** 
nico033 folds
OnceUpoNaTym folds
Fried Berg raises 0.02€ to 0.04€
pamarmo79 folds
Xeosfoot folds
PIQSOU folds
Fried Berg collected 0.07€ from pot
*** SUMMARY ***
Total pot 0.07€ | No rake
Seat 5: Fried Berg won 0.07€


Winamax Poker - HOLD-UP "Colorado" - HandId: #19116069-200829-1701331784 - Holdem no limit (0.01€/0.02€) - 2023/11/30 08:09:44 UTC
Table: 'Colorado' 6-max (real money) Seat #6 is the button
Seat 1: PIQSOU (3.84€)
Seat 2: MoutonFishu (1.17€)
Seat 3: Fried Berg (1.36€)
Seat 4: B&CLYDE (0.30€)
Seat 5: FC_Ghost1 (1.46€)
Seat 6: Cedlebon (2€)
*** ANTE/BLINDS ***
PIQSOU posts small blind 0.01€
MoutonFishu posts big blind 0.02€
Dealt to Fried Berg [7d 8c]
*** PRE-FLOP *** 
Fried Berg folds
B&CLYDE folds
FC_Ghost1 folds
Cedlebon folds
PIQSOU folds
MoutonFishu collected 0.03€ from pot
*** SUMMARY ***
Total pot 0.03€ | No rake
Seat 2: MoutonFishu (big blind) won 0.03€


Winamax Poker - HOLD-UP "Colorado" - HandId: #19116069-200833-1701331789 - Holdem no limit (0.01€/0.02€) - 2023/11/30 08:09:49 UTC
Table: 'Colorado' 6-max (real money) Seat #6 is the button
Seat 1: Bulzer45 (0.46€)
Seat 2: Fried Berg (1.36€)
Seat 3: FabWest (2.42€)
Seat 4: ludo989989 (2.09€)
Seat 5: Cedlebon (2€)
Seat 6: RatitaKK (2.19€)
*** ANTE/BLINDS ***
Bulzer45 posts small blind 0.01€
Fried Berg posts big blind 0.02€
Dealt to Fried Berg [4c 5s]
*** PRE-FLOP *** 
FabWest folds
ludo989989 folds
Cedlebon folds
RatitaKK folds
Bulzer45 folds
Fried Berg collected 0.03€ from pot
*** SUMMARY ***
Total pot 0.03€ | No rake
Seat 2: Fried Berg (big blind) won 0.03€


Winamax Poker - HOLD-UP "Colorado" - HandId: #19116069-200847-1701331807 - Holdem no limit (0.01€/0.02€) - 2023/11/30 08:10:07 UTC
Table: 'Colorado' 6-max (real money) Seat #6 is the button
Seat 1: Fried Berg (1.37€)
Seat 2: jerry1407 (2.08€)
Seat 3: Manupoy (1.29€)
Seat 4: Bulzer45 (0.45€)
Seat 5: FabWest (2.42€)
Seat 6: SUMO LARDON (3.37€)
*** ANTE/BLINDS ***
Fried Berg posts small blind 0.01€
jerry1407 posts big blind 0.02€
Dealt to Fried Berg [Kh 4h]
*** PRE-FLOP *** 
Manupoy folds
Bulzer45 calls 0.02€
FabWest folds
SUMO LARDON folds
Fried Berg calls 0.01€
jerry1407 checks
*** FLOP *** [5h Tc 4d]
Fried Berg checks
jerry1407 checks
Bulzer45 checks
*** TURN *** [5h Tc 4d][As]
Fried Berg checks
jerry1407 checks
Bulzer45 checks
*** RIVER *** [5h Tc 4d As][Ac]
Fried Berg bets 0.02€
jerry1407 folds
Bulzer45 folds
Fried Berg collected 0.07€ from pot
*** SUMMARY ***
Total pot 0.07€ | Rake 0.01€
Board: [5h Tc 4d As Ac]
Seat 1: Fried Berg (small blind) won 0.07€


Winamax Poker - HOLD-UP "Colorado" - HandId: #19116069-200894-1701331872 - Holdem no limit (0.01€/0.02€) - 2023/11/30 08:11:12 UTC
Table: 'Colorado' 6-max (real money) Seat #6 is the button
Seat 1: Xeosfoot (2€)
Seat 2: bimach444 (2.62€)
Seat 3: Jus2Cervelle (4.72€)
Seat 4: Fried Berg (1.40€)
Seat 5: LimpDoud (2€)
Seat 6: sopra61 (1€)
*** ANTE/BLINDS ***
Xeosfoot posts small blind 0.01€
bimach444 posts big blind 0.02€
Dealt to Fried Berg [Qh Tc]
*** PRE-FLOP *** 
Jus2Cervelle folds
Fried Berg folds
LimpDoud folds
sopra61 raises 0.04€ to 0.06€
Xeosfoot folds
bimach444 calls 0.04€
*** FLOP *** [6s 3h 5c]
bimach444 checks
sopra61 bets 0.08€
bimach444 calls 0.08€
*** TURN *** [6s 3h 5c][Js]
bimach444 checks
sopra61 bets 0.10€
bimach444 calls 0.10€
*** RIVER *** [6s 3h 5c Js][2d]
bimach444 checks
sopra61 bets 0.17€
bimach444 folds
sopra61 collected 0.61€ from pot
*** SUMMARY ***
Total pot 0.61€ | Rake 0.05€
Board: [6s 3h 5c Js 2d]
Seat 6: sopra61 (button) won 0.61€


Winamax Poker - HOLD-UP "Colorado" - HandId: #19116069-200904-1701331883 - Holdem no limit (0.01€/0.02€) - 2023/11/30 08:11:23 UTC
Table: 'Colorado' 6-max (real money) Seat #6 is the button
Seat 1: GGlaCh...... (1.98€)
Seat 2: FabWest (2.49€)
Seat 3: B&CLYDE (0.35€)
Seat 4: pamarmo79 (2.94€)
Seat 5: Leane3010 (4.37€)
Seat 6: Fried Berg (1.40€)
*** ANTE/BLINDS ***
GGlaCh...... posts small blind 0.01€
FabWest posts big blind 0.02€
Dealt to Fried Berg [4c 5s]
*** PRE-FLOP *** 
B&CLYDE raises 0.03€ to 0.05€
pamarmo79 folds
Leane3010 folds
Fried Berg folds
GGlaCh...... folds
FabWest folds
B&CLYDE collected 0.08€ from pot
*** SUMMARY ***
Total pot 0.08€ | No rake
Seat 3: B&CLYDE won 0.08€


Winamax Poker - HOLD-UP "Colorado" - HandId: #19116069-200912-1701331893 - Holdem no limit (0.01€/0.02€) - 2023/11/30 08:11:33 UTC
Table: 'Colorado' 6-max (real money) Seat #6 is the button
Seat 1: Prayade (2.58€)
Seat 2: LimpDoud (2€)
Seat 3: Leane3010 (4.36€)
Seat 4: Hydramist (2.15€)
Seat 5: Bulzer45 (0.72€)
Seat 6: Fried Berg (1.40€)
*** ANTE/BLINDS ***
Prayade posts small blind 0.01€
LimpDoud posts big blind 0.02€
Dealt to Fried Berg [5d 2d]
*** PRE-FLOP *** 
Leane3010 folds
Hydramist folds
Bulzer45 folds
Fried Berg folds
Prayade folds
LimpDoud collected 0.03€ from pot
*** SUMMARY ***
Total pot 0.03€ | No rake
Seat 2: LimpDoud (big blind) won 0.03€


Winamax Poker - HOLD-UP "Colorado" - HandId: #19116069-200920-1701331902 - Holdem no limit (0.01€/0.02€) - 2023/11/30 08:11:42 UTC
Table: 'Colorado' 6-max (real money) Seat #6 is the button
Seat 1: MotherBrain (2.06€)
Seat 2: Vitamines34 (1.01€)
Seat 3: Fried Berg (1.40€)
Seat 4: Bulzer45 (0.53€)
Seat 5: pamarmo79 (2.65€)
Seat 6: Xeosfoot (2.35€)
*** ANTE/BLINDS ***
MotherBrain posts small blind 0.01€
Vitamines34 posts big blind 0.02€
Dealt to Fried Berg [3s Td]
*** PRE-FLOP *** 
Fried Berg folds
Bulzer45 folds
pamarmo79 raises 0.04€ to 0.06€
Xeosfoot folds
MotherBrain raises 0.16€ to 0.22€
Vitamines34 calls 0.20€
pamarmo79 calls 0.16€
*** FLOP *** [5d 7c Ks]
MotherBrain checks
Vitamines34 checks
pamarmo79 bets 0.33€
MotherBrain folds
Vitamines34 calls 0.33€
*** TURN *** [5d 7c Ks][8h]
Vitamines34 checks
pamarmo79 checks
*** RIVER *** [5d 7c Ks 8h][8d]
Vitamines34 checks
pamarmo79 checks
*** SHOW DOWN ***
pamarmo79 shows [Qd Ah] (One pair : 8)
Vitamines34 shows [6c 4c] (Straight 8 high)
Vitamines34 collected 1.19€ from pot
*** SUMMARY ***
Total pot 1.19€ | Rake 0.13€
Board: [5d 7c Ks 8h 8d]
Seat 2: Vitamines34 (big blind) showed [6c 4c] and won 1.19€ with Straight 8 high
Seat 5: pamarmo79 showed [Qd Ah] and lost with One pair : 8


Winamax Poker - HOLD-UP "Colorado" - HandId: #19116069-200924-1701331906 - Holdem no limit (0.01€/0.02€) - 2023/11/30 08:11:46 UTC
Table: 'Colorado' 6-max (real money) Seat #6 is the button
Seat 1: OnceUpoNaTym (1.50€)
Seat 2: OscarJR (2.16€)
Seat 3: Bulzer45 (0.53€)
Seat 4: Fried Berg (1.40€)
Seat 5: Leane3010 (2.04€)
Seat 6: GGlaCh...... (1.97€)
*** ANTE/BLINDS ***
OnceUpoNaTym posts small blind 0.01€
OscarJR posts big blind 0.02€
Dealt to Fried Berg [Kh 6s]
*** PRE-FLOP *** 
Bulzer45 calls 0.02€
Fried Berg folds
Leane3010 folds
GGlaCh...... raises 0.04€ to 0.06€
OnceUpoNaTym folds
OscarJR calls 0.04€
Bulzer45 folds
*** FLOP *** [8d 7s 6c]
OscarJR checks
GGlaCh...... bets 0.09€
OscarJR folds
GGlaCh...... collected 0.22€ from pot
*** SUMMARY ***
Total pot 0.22€ | Rake 0.02€
Board: [8d 7s 6c]
Seat 6: GGlaCh...... (button) won 0.22€


Winamax Poker - HOLD-UP "Colorado" - HandId: #19116069-200927-1701331910 - Holdem no limit (0.01€/0.02€) - 2023/11/30 08:11:50 UTC
Table: 'Colorado' 6-max (real money) Seat #6 is the button
Seat 1: Leane3010 (2.04€)
Seat 2: Fried Berg (1.40€)
Seat 3: OnceUpoNaTym (1.49€)
Seat 4: PIQSOU (2.15€)
Seat 5: Manupoy (2.45€)
Seat 6: Bastalek83 (0.89€)
*** ANTE/BLINDS ***
Leane3010 posts small blind 0.01€
Fried Berg posts big blind 0.02€
Dealt to Fried Berg [3c 7c]
*** PRE-FLOP *** 
OnceUpoNaTym raises 0.02€ to 0.04€
PIQSOU folds
Manupoy folds
Bastalek83 folds
Leane3010 folds
Fried Berg folds
OnceUpoNaTym collected 0.07€ from pot
*** SUMMARY ***
Total pot 0.07€ | No rake
Seat 3: OnceUpoNaTym won 0.07€


Winamax Poker - HOLD-UP "Colorado" - HandId: #19116069-200934-1701331920 - Holdem no limit (0.01€/0.02€) - 2023/11/30 08:12:00 UTC
Table: 'Colorado' 6-max (real money) Seat #6 is the button
Seat 1: Fried Berg (1.38€)
Seat 2: ForasteroTT (6.13€)
Seat 3: Leane3010 (2.01€)
Seat 4: gueyf (2.09€)
Seat 5: jerry1407 (2.10€)
Seat 6: Jus2Cervelle (2.41€)
*** ANTE/BLINDS ***
Fried Berg posts small blind 0.01€
ForasteroTT posts big blind 0.02€
Dealt to Fried Berg [8c 5c]
*** PRE-FLOP *** 
Leane3010 folds
gueyf folds
jerry1407 folds
Jus2Cervelle folds
Fried Berg folds
ForasteroTT collected 0.03€ from pot
*** SUMMARY ***
Total pot 0.03€ | No rake
Seat 2: ForasteroTT (big blind) won 0.03€


Winamax Poker - HOLD-UP "Colorado" - HandId: #19116069-200943-1701331929 - Holdem no limit (0.01€/0.02€) - 2023/11/30 08:12:09 UTC
Table: 'Colorado' 6-max (real money) Seat #6 is the button
Seat 1: SUMO LARDON (4.02€)
Seat 2: Xeosfoot (3.24€)
Seat 3: DENZEL007 (3.64€)
Seat 4: Jatar Pr (0.95€)
Seat 5: Fried Berg (1.37€)
Seat 6: Prayade (2.56€)
*** ANTE/BLINDS ***
SUMO LARDON posts small blind 0.01€
Xeosfoot posts big blind 0.02€
Dealt to Fried Berg [4c 5c]
*** PRE-FLOP *** 
DENZEL007 folds
Jatar Pr folds
Fried Berg calls 0.02€
Prayade raises 0.08€ to 0.10€
SUMO LARDON folds
Xeosfoot raises 0.20€ to 0.30€
Fried Berg folds
Prayade folds
Xeosfoot collected 0.43€ from pot
*** SUMMARY ***
Total pot 0.43€ | No rake
Seat 2: Xeosfoot (big blind) won 0.43€


Winamax Poker - HOLD-UP "Colorado" - HandId: #19116069-200966-1701331960 - Holdem no limit (0.01€/0.02€) - 2023/11/30 08:12:40 UTC
Table: 'Colorado' 6-max (real money) Seat #6 is the button
Seat 1: OnceUpoNaTym (1.40€)
Seat 2: Leane3010 (2.01€)
Seat 3: Prayade (2.46€)
Seat 4: Fried Berg (1.35€)
Seat 5: GGlaCh...... (2.07€)
Seat 6: gueyf (1.96€)
*** ANTE/BLINDS ***
OnceUpoNaTym posts small blind 0.01€
Leane3010 posts big blind 0.02€
Dealt to Fried Berg [Qc Td]
*** PRE-FLOP *** 
Prayade folds
Fried Berg folds
GGlaCh...... folds
gueyf folds
OnceUpoNaTym raises 0.06€ to 0.08€
Leane3010 folds
OnceUpoNaTym collected 0.10€ from pot
*** SUMMARY ***
Total pot 0.10€ | No rake
Seat 1: OnceUpoNaTym (small blind) won 0.10€


Winamax Poker - HOLD-UP "Colorado" - HandId: #19116069-200976-1701331976 - Holdem no limit (0.01€/0.02€) - 2023/11/30 08:12:56 UTC
Table: 'Colorado' 6-max (real money) Seat #6 is the button
Seat 1: gueyf (1.94€)
Seat 2: Fried Berg (1.35€)
Seat 3: Hydramist (2€)
Seat 4: Cejargordas (2€)
Seat 5: Cedlebon (2€)
Seat 6: B&CLYDE (1.03€)
*** ANTE/BLINDS ***
gueyf posts small blind 0.01€
Fried Berg posts big blind 0.02€
Dealt to Fried Berg [Ts 4c]
*** PRE-FLOP *** 
Hydramist folds
Cejargordas folds
Cedlebon folds
B&CLYDE folds
gueyf calls 0.01€
Fried Berg checks
*** FLOP *** [2d 3c 7d]
gueyf checks
Fried Berg checks
*** TURN *** [2d 3c 7d][Ad]
gueyf checks
Fried Berg bets 0.04€
gueyf folds
Fried Berg collected 0.08€ from pot
*** SUMMARY ***
Total pot 0.08€ | No rake
Board: [2d 3c 7d Ad]
Seat 2: Fried Berg (big blind) won 0.08€


Winamax Poker - HOLD-UP "Colorado" - HandId: #19116069-201010-1701332011 - Holdem no limit (0.01€/0.02€) - 2023/11/30 08:13:31 UTC
Table: 'Colorado' 6-max (real money) Seat #6 is the button
Seat 1: DENZEL007 (1.40€)
Seat 2: sopra61 (1.20€)
Seat 3: Fried Berg (1.37€)
Seat 4: bimach444 (2.38€)
Seat 5: pamarmo79 (2.91€)
Seat 6: FabWest (3.80€)
*** ANTE/BLINDS ***
DENZEL007 posts small blind 0.01€
sopra61 posts big blind 0.02€
Dealt to Fried Berg [9h Qs]
*** PRE-FLOP *** 
Fried Berg folds
bimach444 raises 0.03€ to 0.05€
pamarmo79 raises 0.13€ to 0.18€
FabWest folds
DENZEL007 calls 0.17€
sopra61 folds
bimach444 calls 0.13€
*** FLOP *** [5s Js 3c]
DENZEL007 checks
bimach444 checks
pamarmo79 checks
*** TURN *** [5s Js 3c][3h]
DENZEL007 checks
bimach444 checks
pamarmo79 checks
*** RIVER *** [5s Js 3c 3h][2d]
DENZEL007 checks
bimach444 bets 0.20€
pamarmo79 folds
DENZEL007 calls 0.20€
*** SHOW DOWN ***
DENZEL007 shows [Tc Th] (Two pairs : Tens and 3)
bimach444 shows [Jc Jh] (Full of Jacks and 3)
bimach444 collected 0.86€ from pot
*** SUMMARY ***
Total pot 0.86€ | Rake 0.10€
Board: [5s Js 3c 3h 2d]
Seat 1: DENZEL007 (small blind) showed [Tc Th] and lost with Two pairs : Tens and 3
Seat 4: bimach444 showed [Jc Jh] and won 0.86€ with Full of Jacks and 3


Winamax Poker - HOLD-UP "Colorado" - HandId: #19116069-201018-1701332022 - Holdem no limit (0.01€/0.02€) - 2023/11/30 08:13:42 UTC
Table: 'Colorado' 6-max (real money) Seat #6 is the button
Seat 1: gueyf (2.04€)
Seat 2: Cejargordas (2€)
Seat 3: Ziildjiin (5.49€)
Seat 4: GGlaCh...... (1.98€)
Seat 5: Fried Berg (1.37€)
Seat 6: l artiste ho (1.85€)
*** ANTE/BLINDS ***
gueyf posts small blind 0.01€
Cejargordas posts big blind 0.02€
Dealt to Fried Berg [2c 4d]
*** PRE-FLOP *** 
Ziildjiin folds
GGlaCh...... folds
Fried Berg folds
l artiste ho folds
gueyf folds
Cejargordas collected 0.03€ from pot
*** SUMMARY ***
Total pot 0.03€ | No rake
Seat 2: Cejargordas (big blind) won 0.03€


Winamax Poker - HOLD-UP "Colorado" - HandId: #19116069-201021-1701332026 - Holdem no limit (0.01€/0.02€) - 2023/11/30 08:13:46 UTC
Table: 'Colorado' 6-max (real money) Seat #6 is the button
Seat 1: Fried Berg (1.37€)
Seat 2: Prayade (2.11€)
Seat 3: B&CLYDE (0.39€)
Seat 4: Xeosfoot (2.36€)
Seat 5: PIQSOU (3.13€)
Seat 6: Kalendula (1.16€)
Hold-up to Pot: total 0.20€
*** ANTE/BLINDS ***
Fried Berg posts small blind 0.01€
Prayade posts big blind 0.02€
Dealt to Fried Berg [Ah Ks]
*** PRE-FLOP *** 
B&CLYDE folds
Xeosfoot raises 0.04€ to 0.06€
PIQSOU folds
Kalendula calls 0.06€
Fried Berg calls 0.05€
Prayade folds
*** FLOP *** [7d 9s Ts]
Fried Berg checks
Xeosfoot bets 0.10€
Kalendula folds
Fried Berg calls 0.10€
*** TURN *** [7d 9s Ts][7h]
Fried Berg checks
Xeosfoot bets 0.21€
Fried Berg folds
Xeosfoot collected 0.77€ from pot
*** SUMMARY ***
Total pot 0.77€ | Rake 0.04€
Board: [7d 9s Ts 7h]
Seat 4: Xeosfoot won 0.77€


Winamax Poker - HOLD-UP "Colorado" - HandId: #19116069-201109-1701332121 - Holdem no limit (0.01€/0.02€) - 2023/11/30 08:15:21 UTC
Table: 'Colorado' 6-max (real money) Seat #6 is the button
Seat 1: jerry1407 (2.07€)
Seat 2: Hydramist (2€)
Seat 3: Leane3010 (2€)
Seat 4: Halmosthard (1.56€)
Seat 5: Fried Berg (1.21€)
Seat 6: DENZEL007 (0.95€)
*** ANTE/BLINDS ***
jerry1407 posts small blind 0.01€
Hydramist posts big blind 0.02€
Dealt to Fried Berg [9d 5s]
*** PRE-FLOP *** 
Leane3010 folds
Halmosthard folds
Fried Berg folds
DENZEL007 folds
jerry1407 raises 0.04€ to 0.06€
Hydramist folds
jerry1407 collected 0.08€ from pot
*** SUMMARY ***
Total pot 0.08€ | No rake
Seat 1: jerry1407 (small blind) won 0.08€


Winamax Poker - HOLD-UP "Colorado" - HandId: #19116069-201152-1701332159 - Holdem no limit (0.01€/0.02€) - 2023/11/30 08:15:59 UTC
Table: 'Colorado' 6-max (real money) Seat #6 is the button
Seat 1: Leane3010 (5.84€)
Seat 2: FabWest (2€)
Seat 3: pamarmo79 (2.38€)
Seat 4: SUMO LARDON (3.88€)
Seat 5: Xeosfoot (3.78€)
Seat 6: Fried Berg (1.21€)
*** ANTE/BLINDS ***
Leane3010 posts small blind 0.01€
FabWest posts big blind 0.02€
Dealt to Fried Berg [9c 6h]
*** PRE-FLOP *** 
pamarmo79 raises 0.04€ to 0.06€
SUMO LARDON folds
Xeosfoot folds
Fried Berg folds
Leane3010 folds
FabWest folds
pamarmo79 collected 0.09€ from pot
*** SUMMARY ***
Total pot 0.09€ | No rake
Seat 3: pamarmo79 won 0.09€


Winamax Poker - HOLD-UP "Colorado" - HandId: #19116069-201161-1701332170 - Holdem no limit (0.01€/0.02€) - 2023/11/30 08:16:10 UTC
Table: 'Colorado' 6-max (real money) Seat #6 is the button
Seat 1: gueyf (1.92€)
Seat 2: OscarJR (1.70€)
Seat 3: hello7585 (1.92€)
Seat 4: Leane3010 (5.83€)
Seat 5: bimach444 (2.34€)
Seat 6: Fried Berg (1.21€)
*** ANTE/BLINDS ***
gueyf posts small blind 0.01€
OscarJR posts big blind 0.02€
Dealt to Fried Berg [3h 4d]
*** PRE-FLOP *** 
hello7585 folds
Leane3010 raises 0.04€ to 0.06€
bimach444 folds
Fried Berg folds
gueyf folds
OscarJR calls 0.04€
*** FLOP *** [5s 2d Kc]
OscarJR checks
Leane3010 checks
*** TURN *** [5s 2d Kc][Qh]
OscarJR checks
Leane3010 checks
*** RIVER *** [5s 2d Kc Qh][Kh]
OscarJR checks
Leane3010 checks
*** SHOW DOWN ***
OscarJR shows [9c Ts] (One pair : Kings)
Leane3010 shows [4h 5h] (Two pairs : Kings and 5)
Leane3010 collected 0.12€ from pot
*** SUMMARY ***
Total pot 0.12€ | Rake 0.01€
Board: [5s 2d Kc Qh Kh]
Seat 2: OscarJR (big blind) showed [9c Ts] and lost with One pair : Kings
Seat 4: Leane3010 showed [4h 5h] and won 0.12€ with Two pairs : Kings and 5


Winamax Poker - HOLD-UP "Colorado" - HandId: #19116069-201177-1701332183 - Holdem no limit (0.01€/0.02€) - 2023/11/30 08:16:23 UTC
Table: 'Colorado' 6-max (real money) Seat #6 is the button
Seat 1: Kalendula (1.33€)
Seat 2: Fried Berg (1.21€)
Seat 3: nico033 (2.71€)
Seat 4: MotherBrain (2.16€)
Seat 5: l artiste ho (1.69€)
Seat 6: Cejargordas (2.26€)
*** ANTE/BLINDS ***
Kalendula posts small blind 0.01€
Fried Berg posts big blind 0.02€
Dealt to Fried Berg [8c 5c]
*** PRE-FLOP *** 
nico033 folds
MotherBrain folds
l artiste ho folds
Cejargordas folds
Kalendula folds
Fried Berg collected 0.03€ from pot
*** SUMMARY ***
Total pot 0.03€ | No rake
Seat 2: Fried Berg (big blind) won 0.03€


Winamax Poker - HOLD-UP "Colorado" - HandId: #19116069-201197-1701332206 - Holdem no limit (0.01€/0.02€) - 2023/11/30 08:16:46 UTC
Table: 'Colorado' 6-max (real money) Seat #6 is the button
Seat 1: Fried Berg (1.22€)
Seat 2: l artiste ho (1.69€)
Seat 3: Dim city (2.01€)
Seat 4: Xeosfoot (3.80€)
Seat 5: MaXKataleya (1.25€)
Seat 6: Jatar Pr (1.01€)
*** ANTE/BLINDS ***
Fried Berg posts small blind 0.01€
l artiste ho posts big blind 0.02€
Dealt to Fried Berg [8c Qd]
*** PRE-FLOP *** 
Dim city folds
Xeosfoot folds
MaXKataleya folds
Jatar Pr folds
Fried Berg folds
l artiste ho collected 0.03€ from pot
*** SUMMARY ***
Total pot 0.03€ | No rake
Seat 2: l artiste ho (big blind) won 0.03€


Winamax Poker - HOLD-UP "Colorado" - HandId: #19116069-201216-1701332228 - Holdem no limit (0.01€/0.02€) - 2023/11/30 08:17:08 UTC
Table: 'Colorado' 6-max (real money) Seat #6 is the button
Seat 1: Hydramist (2.03€)
Seat 2: slowreplay (2€)
Seat 3: Fried Berg (1.21€)
Seat 4: OnceUpoNaTym (4.10€)
Seat 5: SUMO LARDON (3.54€)
Seat 6: MotherBrain (4.22€)
*** ANTE/BLINDS ***
Hydramist posts small blind 0.01€
slowreplay posts big blind 0.02€
Dealt to Fried Berg [5h Kc]
*** PRE-FLOP *** 
Fried Berg folds
OnceUpoNaTym folds
SUMO LARDON raises 0.04€ to 0.06€
MotherBrain folds
Hydramist folds
slowreplay folds
SUMO LARDON collected 0.09€ from pot
*** SUMMARY ***
Total pot 0.09€ | No rake
Seat 5: SUMO LARDON won 0.09€


Winamax Poker - HOLD-UP "Colorado" - HandId: #19116069-201220-1701332232 - Holdem no limit (0.01€/0.02€) - 2023/11/30 08:17:12 UTC
Table: 'Colorado' 6-max (real money) Seat #6 is the button
Seat 1: hello7585 (2.30€)
Seat 2: Jatar Pr (1€)
Seat 3: Hydramist (2.02€)
Seat 4: Snakesolid56 (2€)
Seat 5: Ziildjiin (6.26€)
Seat 6: Fried Berg (1.21€)
*** ANTE/BLINDS ***
hello7585 posts small blind 0.01€
Jatar Pr posts big blind 0.02€
Dealt to Fried Berg [5c 5d]
*** PRE-FLOP *** 
Hydramist folds
Snakesolid56 folds
Ziildjiin raises 0.02€ to 0.04€
Fried Berg calls 0.04€
hello7585 folds
Jatar Pr folds
*** FLOP *** [As 2c Jc]
Ziildjiin checks
Fried Berg checks
*** TURN *** [As 2c Jc][4s]
Ziildjiin bets 0.07€
Fried Berg folds
Ziildjiin collected 0.17€ from pot
*** SUMMARY ***
Total pot 0.17€ | Rake 0.01€
Board: [As 2c Jc 4s]
Seat 5: Ziildjiin won 0.17€


Winamax Poker - HOLD-UP "Colorado" - HandId: #19116069-201254-1701332269 - Holdem no limit (0.01€/0.02€) - 2023/11/30 08:17:49 UTC
Table: 'Colorado' 6-max (real money) Seat #6 is the button
Seat 1: Manupoy (1.96€)
Seat 2: OnceUpoNaTym (4.16€)
Seat 3: Eisengrim (2€)
Seat 4: Fried Berg (1.17€)
Seat 5: Hydramist (2.18€)
Seat 6: SUMO LARDON (3.90€)
*** ANTE/BLINDS ***
Manupoy posts small blind 0.01€
OnceUpoNaTym posts big blind 0.02€
Dealt to Fried Berg [Jh Jc]
*** PRE-FLOP *** 
Eisengrim folds
Fried Berg raises 0.04€ to 0.06€
Hydramist folds
SUMO LARDON folds
Manupoy calls 0.05€
OnceUpoNaTym folds
*** FLOP *** [9h 5d 7h]
Manupoy bets 0.05€
Fried Berg raises 0.14€ to 0.19€
Manupoy calls 0.14€
*** TURN *** [9h 5d 7h][4h]
Manupoy checks
Fried Berg checks
*** RIVER *** [9h 5d 7h 4h][6c]
Manupoy checks
Fried Berg bets 0.13€
Manupoy calls 0.13€
*** SHOW DOWN ***
Manupoy shows [Ac 9c] (One pair : 9)
Fried Berg shows [Jh Jc] (One pair : Jacks)
Fried Berg collected 0.70€ from pot
*** SUMMARY ***
Total pot 0.70€ | Rake 0.08€
Board: [9h 5d 7h 4h 6c]
Seat 1: Manupoy (small blind) showed [Ac 9c] and lost with One pair : 9
Seat 4: Fried Berg showed [Jh Jc] and won 0.70€ with One pair : Jacks


Winamax Poker - HOLD-UP "Colorado" - HandId: #19116069-201336-1701332348 - Holdem no limit (0.01€/0.02€) - 2023/11/30 08:19:08 UTC
Table: 'Colorado' 6-max (real money) Seat #6 is the button
Seat 1: SirX (2.84€)
Seat 2: Snakesolid56 (2€)
Seat 3: slowreplay (2€)
Seat 4: DENZEL007 (4.06€)
Seat 5: Fried Berg (1.49€)
Seat 6: Manupoy (1.58€)
*** ANTE/BLINDS ***
SirX posts small blind 0.01€
Snakesolid56 posts big blind 0.02€
Dealt to Fried Berg [Kh Qs]
*** PRE-FLOP *** 
slowreplay folds
DENZEL007 raises 0.04€ to 0.06€
Fried Berg calls 0.06€
Manupoy calls 0.06€
SirX calls 0.05€
Snakesolid56 folds
*** FLOP *** [4d 8d Jh]
SirX checks
DENZEL007 checks
Fried Berg checks
Manupoy bets 0.09€
SirX folds
DENZEL007 folds
Fried Berg folds
Manupoy collected 0.32€ from pot
*** SUMMARY ***
Total pot 0.32€ | Rake 0.03€
Board: [4d 8d Jh]
Seat 6: Manupoy (button) won 0.32€


Winamax Poker - HOLD-UP "Colorado" - HandId: #19116069-201384-1701332399 - Holdem no limit (0.01€/0.02€) - 2023/11/30 08:19:59 UTC
Table: 'Colorado' 6-max (real money) Seat #6 is the button
Seat 1: LimpDoud (2.45€)
Seat 2: Snakesolid56 (2.03€)
Seat 3: slowreplay (2€)
Seat 4: DENZEL007 (1.01€)
Seat 5: PIQSOU (3.36€)
Seat 6: Fried Berg (1.43€)
*** ANTE/BLINDS ***
LimpDoud posts small blind 0.01€
Snakesolid56 posts big blind 0.02€
Dealt to Fried Berg [Kd 2c]
*** PRE-FLOP *** 
slowreplay folds
DENZEL007 folds
PIQSOU folds
Fried Berg folds
LimpDoud raises 0.04€ to 0.06€
Snakesolid56 folds
LimpDoud collected 0.08€ from pot
*** SUMMARY ***
Total pot 0.08€ | No rake
Seat 1: LimpDoud (small blind) won 0.08€


Winamax Poker - HOLD-UP "Colorado" - HandId: #19116069-201393-1701332408 - Holdem no limit (0.01€/0.02€) - 2023/11/30 08:20:08 UTC
Table: 'Colorado' 6-max (real money) Seat #6 is the button
Seat 1: Ziildjiin (6.26€)
Seat 2: Fried Berg (1.43€)
Seat 3: gueyf (1.38€)
Seat 4: OnceUpoNaTym (1.18€)
Seat 5: Charlise2 (2.57€)
Seat 6: slowreplay (2.07€)
*** ANTE/BLINDS ***
Ziildjiin posts small blind 0.01€
Fried Berg posts big blind 0.02€
Dealt to Fried Berg [Qd 4d]
*** PRE-FLOP *** 
gueyf folds
OnceUpoNaTym folds
Charlise2 calls 0.02€
slowreplay folds
Ziildjiin calls 0.01€
Fried Berg checks
*** FLOP *** [Tc 3d 8d]
Ziildjiin checks
Fried Berg checks
Charlise2 bets 0.06€
Ziildjiin folds
Fried Berg raises 0.10€ to 0.16€
Charlise2 calls 0.10€
*** TURN *** [Tc 3d 8d][7h]
Fried Berg checks
Charlise2 checks
*** RIVER *** [Tc 3d 8d 7h][Jd]
Fried Berg checks
Charlise2 checks
*** SHOW DOWN ***
Charlise2 shows [Kh Ac] (High card : Ace)
Fried Berg shows [Qd 4d] (Flush Queen high)
Fried Berg collected 0.34€ from pot
*** SUMMARY ***
Total pot 0.34€ | Rake 0.04€
Board: [Tc 3d 8d 7h Jd]
Seat 2: Fried Berg (big blind) showed [Qd 4d] and won 0.34€ with Flush Queen high
Seat 5: Charlise2 showed [Kh Ac] and lost with High card : Ace


Winamax Poker - HOLD-UP "Colorado" - HandId: #19116069-201473-1701332488 - Holdem no limit (0.01€/0.02€) - 2023/11/30 08:21:28 UTC
Table: 'Colorado' 6-max (real money) Seat #6 is the button
Seat 1: slowreplay (2€)
Seat 2: Charlise2 (2.39€)
Seat 3: Fried Berg (1.59€)
Seat 4: SUMO LARDON (4.16€)
Seat 5: LMG22_23 (1.96€)
Seat 6: jerry1407 (2.11€)
*** ANTE/BLINDS ***
slowreplay posts small blind 0.01€
Charlise2 posts big blind 0.02€
Dealt to Fried Berg [Kh Qc]
*** PRE-FLOP *** 
Fried Berg raises 0.04€ to 0.06€
SUMO LARDON folds
LMG22_23 folds
jerry1407 folds
slowreplay folds
Charlise2 folds
Fried Berg collected 0.09€ from pot
*** SUMMARY ***
Total pot 0.09€ | No rake
Seat 3: Fried Berg won 0.09€


Winamax Poker - HOLD-UP "Colorado" - HandId: #19116069-201505-1701332509 - Holdem no limit (0.01€/0.02€) - 2023/11/30 08:21:49 UTC
Table: 'Colorado' 6-max (real money) Seat #6 is the button
Seat 1: DENZEL007 (0.96€)
Seat 2: Ga31k (2€)
Seat 3: Hydramist (2.03€)
Seat 4: Fried Berg (1.62€)
Seat 5: GGlaCh...... (2.03€)
Seat 6: FabWest (2€)
*** ANTE/BLINDS ***
DENZEL007 posts small blind 0.01€
Ga31k posts big blind 0.02€
Dealt to Fried Berg [9h 2d]
*** PRE-FLOP *** 
Hydramist raises 0.03€ to 0.05€
Fried Berg folds
GGlaCh...... folds
FabWest folds
DENZEL007 folds
Ga31k folds
Hydramist collected 0.08€ from pot
*** SUMMARY ***
Total pot 0.08€ | No rake
Seat 3: Hydramist won 0.08€


Winamax Poker - HOLD-UP "Colorado" - HandId: #19116069-201516-1701332520 - Holdem no limit (0.01€/0.02€) - 2023/11/30 08:22:00 UTC
Table: 'Colorado' 6-max (real money) Seat #6 is the button
Seat 1: Leane3010 (2.07€)
Seat 2: slowreplay (2€)
Seat 3: Prayade (4.35€)
Seat 4: RatitaKK (1.62€)
Seat 5: Fried Berg (1.62€)
Seat 6: Bulzer45 (0.72€)
*** ANTE/BLINDS ***
Leane3010 posts small blind 0.01€
slowreplay posts big blind 0.02€
Dealt to Fried Berg [7s Kc]
*** PRE-FLOP *** 
Prayade folds
RatitaKK folds
Fried Berg folds
Bulzer45 calls 0.02€
Leane3010 folds
slowreplay checks
*** FLOP *** [2c Ah Th]
slowreplay checks
Bulzer45 bets 0.02€
slowreplay calls 0.02€
*** TURN *** [2c Ah Th][Qc]
slowreplay checks
Bulzer45 bets 0.02€
slowreplay calls 0.02€
*** RIVER *** [2c Ah Th Qc][8c]
slowreplay checks
Bulzer45 checks
*** SHOW DOWN ***
Bulzer45 shows [5h 5d] (One pair : 5)
slowreplay shows [As 3h] (One pair : Aces)
slowreplay collected 0.12€ from pot
*** SUMMARY ***
Total pot 0.12€ | Rake 0.01€
Board: [2c Ah Th Qc 8c]
Seat 2: slowreplay (big blind) showed [As 3h] and won 0.12€ with One pair : Aces
Seat 6: Bulzer45 (button) showed [5h 5d] and lost with One pair : 5


Winamax Poker - HOLD-UP "Colorado" - HandId: #19116069-201527-1701332533 - Holdem no limit (0.01€/0.02€) - 2023/11/30 08:22:13 UTC
Table: 'Colorado' 6-max (real money) Seat #6 is the button
Seat 1: Fried Berg (1.62€)
Seat 2: Xeosfoot (2€)
Seat 3: FabWest (2€)
Seat 4: OscarJR (1.55€)
Seat 5: Jus2Cervelle (4.74€)
Seat 6: DENZEL007 (0.89€)
*** ANTE/BLINDS ***
Fried Berg posts small blind 0.01€
Xeosfoot posts big blind 0.02€
Dealt to Fried Berg [3s Qd]
*** PRE-FLOP *** 
FabWest folds
OscarJR raises 0.04€ to 0.06€
Jus2Cervelle folds
DENZEL007 folds
Fried Berg folds
Xeosfoot folds
OscarJR collected 0.09€ from pot
*** SUMMARY ***
Total pot 0.09€ | No rake
Seat 4: OscarJR won 0.09€


Winamax Poker - HOLD-UP "Colorado" - HandId: #19116069-201539-1701332544 - Holdem no limit (0.01€/0.02€) - 2023/11/30 08:22:24 UTC
Table: 'Colorado' 6-max (real money) Seat #6 is the button
Seat 1: Fried Berg (1.61€)
Seat 2: FabWest (2€)
Seat 3: Cejargordas (4.22€)
Seat 4: OnceUpoNaTym (0.68€)
Seat 5: hello7585 (2.30€)
Seat 6: KingSoto (3.76€)
*** ANTE/BLINDS ***
Fried Berg posts small blind 0.01€
FabWest posts big blind 0.02€
Dealt to Fried Berg [9s 3s]
*** PRE-FLOP *** 
Cejargordas raises 0.03€ to 0.05€
OnceUpoNaTym folds
hello7585 folds
KingSoto folds
Fried Berg folds
FabWest folds
Cejargordas collected 0.08€ from pot
*** SUMMARY ***
Total pot 0.08€ | No rake
Seat 3: Cejargordas won 0.08€


Winamax Poker - HOLD-UP "Colorado" - HandId: #19116069-201547-1701332551 - Holdem no limit (0.01€/0.02€) - 2023/11/30 08:22:31 UTC
Table: 'Colorado' 6-max (real money) Seat #6 is the button
Seat 1: gueyf (2.01€)
Seat 2: LMG22_23 (2.06€)
Seat 3: Jatar Pr (0.76€)
Seat 4: Ga31k (2€)
Seat 5: Fried Berg (1.60€)
Seat 6: tanguy_cvl (1.97€)
*** ANTE/BLINDS ***
gueyf posts small blind 0.01€
LMG22_23 posts big blind 0.02€
Dealt to Fried Berg [Qh 9c]
*** PRE-FLOP *** 
Jatar Pr folds
Ga31k folds
Fried Berg folds
tanguy_cvl folds
gueyf calls 0.01€
LMG22_23 checks
*** FLOP *** [Qc Qd 5c]
gueyf checks
LMG22_23 checks
*** TURN *** [Qc Qd 5c][Ad]
gueyf checks
LMG22_23 checks
*** RIVER *** [Qc Qd 5c Ad][8s]
gueyf checks
LMG22_23 checks
*** SHOW DOWN ***
LMG22_23 shows [3d Kh] (One pair : Queens)
gueyf shows [6d 6c] (Two pairs : Queens and 6)
gueyf collected 0.04€ from pot
*** SUMMARY ***
Total pot 0.04€ | No rake
Board: [Qc Qd 5c Ad 8s]
Seat 1: gueyf (small blind) showed [6d 6c] and won 0.04€ with Two pairs : Queens and 6
Seat 2: LMG22_23 (big blind) showed [3d Kh] and lost with One pair : Queens


Winamax Poker - HOLD-UP "Colorado" - HandId: #19116069-201555-1701332558 - Holdem no limit (0.01€/0.02€) - 2023/11/30 08:22:38 UTC
Table: 'Colorado' 6-max (real money) Seat #6 is the button
Seat 1: DENZEL007 (0.91€)
Seat 2: Jatar Pr (0.76€)
Seat 3: Fried Berg (1.60€)
Seat 4: FabWest (2€)
Seat 5: MaXKataleya (0.98€)
Seat 6: g8o8k8u (2€)
*** ANTE/BLINDS ***
DENZEL007 posts small blind 0.01€
Jatar Pr posts big blind 0.02€
Dealt to Fried Berg [5c 3c]
*** PRE-FLOP *** 
Fried Berg folds
FabWest raises 0.03€ to 0.05€
MaXKataleya folds
g8o8k8u folds
DENZEL007 folds
Jatar Pr folds
FabWest collected 0.08€ from pot
*** SUMMARY ***
Total pot 0.08€ | No rake
Seat 4: FabWest won 0.08€


Winamax Poker - HOLD-UP "Colorado" - HandId: #19116069-201560-1701332563 - Holdem no limit (0.01€/0.02€) - 2023/11/30 08:22:43 UTC
Table: 'Colorado' 6-max (real money) Seat #6 is the button
Seat 1: KingSoto (3.74€)
Seat 2: Fried Berg (1.60€)
Seat 3: SUMO LARDON (3.63€)
Seat 4: Charlise2 (2.48€)
Seat 5: Xeosfoot (3.13€)
Seat 6: hello7585 (1.36€)
*** ANTE/BLINDS ***
KingSoto posts small blind 0.01€
Fried Berg posts big blind 0.02€
Dealt to Fried Berg [Kc Ac]
*** PRE-FLOP *** 
SUMO LARDON raises 0.04€ to 0.06€
Charlise2 calls 0.06€
Xeosfoot calls 0.06€
hello7585 folds
KingSoto folds
Fried Berg raises 0.12€ to 0.18€
SUMO LARDON calls 0.12€
Charlise2 calls 0.12€
Xeosfoot calls 0.12€
*** FLOP *** [7c 3c 4c]
Fried Berg bets 1.42€ and is all-in
SUMO LARDON folds
Charlise2 folds
Xeosfoot folds
Fried Berg collected 2.08€ from pot
*** SUMMARY ***
Total pot 2.08€ | Rake 0.07€
Board: [7c 3c 4c]
Seat 2: Fried Berg (big blind) won 2.08€


Winamax Poker - HOLD-UP "Colorado" - HandId: #19116069-201621-1701332623 - Holdem no limit (0.01€/0.02€) - 2023/11/30 08:23:43 UTC
Table: 'Colorado' 6-max (real money) Seat #6 is the button
Seat 1: Leane3010 (2.17€)
Seat 2: Fried Berg (2.08€)
Seat 3: 77boy77 (0.50€)
Seat 4: gueyf (2€)
Seat 5: LMG22_23 (1.96€)
Seat 6: Charlise2 (2.30€)
*** ANTE/BLINDS ***
Leane3010 posts small blind 0.01€
Fried Berg posts big blind 0.02€
Dealt to Fried Berg [6h 3d]
*** PRE-FLOP *** 
77boy77 folds
gueyf folds
LMG22_23 folds
Charlise2 folds
Leane3010 folds
Fried Berg collected 0.03€ from pot
*** SUMMARY ***
Total pot 0.03€ | No rake
Seat 2: Fried Berg (big blind) won 0.03€


Winamax Poker - HOLD-UP "Colorado" - HandId: #19116069-201634-1701332631 - Holdem no limit (0.01€/0.02€) - 2023/11/30 08:23:51 UTC
Table: 'Colorado' 6-max (real money) Seat #6 is the button
Seat 1: haamataraa (1.18€)
Seat 2: melijomia (2.10€)
Seat 3: Leane3010 (2.74€)
Seat 4: Fried Berg (2.09€)
Seat 5: GGlaCh...... (2.93€)
Seat 6: bimach444 (5.63€)
*** ANTE/BLINDS ***
haamataraa posts small blind 0.01€
melijomia posts big blind 0.02€
Dealt to Fried Berg [Qh 5c]
*** PRE-FLOP *** 
Leane3010 folds
Fried Berg folds
GGlaCh...... raises 0.04€ to 0.06€
bimach444 folds
haamataraa folds
melijomia raises 0.18€ to 0.24€
GGlaCh...... calls 0.18€
*** FLOP *** [Ad 5h 4h]
melijomia bets 0.17€
GGlaCh...... folds
melijomia collected 0.61€ from pot
*** SUMMARY ***
Total pot 0.61€ | Rake 0.05€
Board: [Ad 5h 4h]
Seat 2: melijomia (big blind) won 0.61€


Winamax Poker - HOLD-UP "Colorado" - HandId: #19116069-201640-1701332636 - Holdem no limit (0.01€/0.02€) - 2023/11/30 08:23:56 UTC
Table: 'Colorado' 6-max (real money) Seat #6 is the button
Seat 1: Vanight (2.12€)
Seat 2: SUMO LARDON (5.42€)
Seat 3: Fried Berg (2.09€)
Seat 4: Cedlebon (2€)
Seat 5: Leane3010 (2.13€)
Seat 6: Xeosfoot (3.98€)
*** ANTE/BLINDS ***
Vanight posts small blind 0.01€
SUMO LARDON posts big blind 0.02€
Dealt to Fried Berg [Jd 8s]
*** PRE-FLOP *** 
Fried Berg folds
Cedlebon folds
Leane3010 raises 0.04€ to 0.06€
Xeosfoot folds
Vanight raises 0.18€ to 0.24€
SUMO LARDON folds
Leane3010 folds
Vanight collected 0.32€ from pot
*** SUMMARY ***
Total pot 0.32€ | No rake
Seat 1: Vanight (small blind) won 0.32€


Winamax Poker - HOLD-UP "Colorado" - HandId: #19116069-201643-1701332638 - Holdem no limit (0.01€/0.02€) - 2023/11/30 08:23:58 UTC
Table: 'Colorado' 6-max (real money) Seat #6 is the button
Seat 1: Eisengrim (2.02€)
Seat 2: SashaTDouss (3.40€)
Seat 3: slowreplay (2.01€)
Seat 4: Cedlebon (2€)
Seat 5: OnceUpoNaTym (2€)
Seat 6: Fried Berg (2.09€)
*** ANTE/BLINDS ***
Eisengrim posts small blind 0.01€
SashaTDouss posts big blind 0.02€
Dealt to Fried Berg [4c 6h]
*** PRE-FLOP *** 
slowreplay folds
Cedlebon folds
OnceUpoNaTym folds
Fried Berg folds
Eisengrim raises 0.04€ to 0.06€
SashaTDouss raises 0.12€ to 0.18€
Eisengrim raises 0.36€ to 0.54€
SashaTDouss folds
Eisengrim collected 0.72€ from pot
*** SUMMARY ***
Total pot 0.72€ | No rake
Seat 1: Eisengrim (small blind) won 0.72€


Winamax Poker - HOLD-UP "Colorado" - HandId: #19116069-201649-1701332644 - Holdem no limit (0.01€/0.02€) - 2023/11/30 08:24:04 UTC
Table: 'Colorado' 6-max (real money) Seat #6 is the button
Seat 1: Fried Berg (2.09€)
Seat 2: Cedlebon (2€)
Seat 3: SirX (3.04€)
Seat 4: Cejargordas (2.28€)
Seat 5: OnceUpoNaTym (3.86€)
Seat 6: Prayade (2.89€)
*** ANTE/BLINDS ***
Fried Berg posts small blind 0.01€
Cedlebon posts big blind 0.02€
Dealt to Fried Berg [9c 7h]
*** PRE-FLOP *** 
SirX raises 0.04€ to 0.06€
Cejargordas folds
OnceUpoNaTym folds
Prayade raises 0.15€ to 0.21€
Fried Berg folds
Cedlebon folds
SirX calls 0.15€
*** FLOP *** [Th 6d 2c]
SirX bets 0.16€
Prayade folds
SirX collected 0.56€ from pot
*** SUMMARY ***
Total pot 0.56€ | Rake 0.05€
Board: [Th 6d 2c]
Seat 3: SirX won 0.56€


Winamax Poker - HOLD-UP "Colorado" - HandId: #19116069-201660-1701332656 - Holdem no limit (0.01€/0.02€) - 2023/11/30 08:24:16 UTC
Table: 'Colorado' 6-max (real money) Seat #6 is the button
Seat 1: Dim city (1.64€)
Seat 2: Hydramist (2€)
Seat 3: Xeosfoot (3.98€)
Seat 4: Fried Berg (2.08€)
Seat 5: SUMO LARDON (3.91€)
Seat 6: FabWest (2€)
Hold-up to Pot: total 0.20€
*** ANTE/BLINDS ***
Dim city posts small blind 0.01€
Hydramist posts big blind 0.02€
Dealt to Fried Berg [8d Jh]
*** PRE-FLOP *** 
Xeosfoot folds
Fried Berg calls 0.02€
SUMO LARDON folds
FabWest raises 0.08€ to 0.10€
Dim city folds
Hydramist folds
Fried Berg folds
FabWest collected 0.35€ from pot
*** SUMMARY ***
Total pot 0.35€ | No rake
Seat 6: FabWest (button) won 0.35€


Winamax Poker - HOLD-UP "Colorado" - HandId: #19116069-201677-1701332676 - Holdem no limit (0.01€/0.02€) - 2023/11/30 08:24:36 UTC
Table: 'Colorado' 6-max (real money) Seat #6 is the button
Seat 1: Fried Berg (2.06€)
Seat 2: Bulzer45 (1.15€)
Seat 3: Hydramist (2€)
Seat 4: slowreplay (2€)
Seat 5: LMG22_23 (1.42€)
Seat 6: Cejargordas (2.26€)
*** ANTE/BLINDS ***
Fried Berg posts small blind 0.01€
Bulzer45 posts big blind 0.02€
Dealt to Fried Berg [4c Kh]
*** PRE-FLOP *** 
Hydramist raises 0.03€ to 0.05€
slowreplay folds
LMG22_23 folds
Cejargordas folds
Fried Berg folds
Bulzer45 folds
Hydramist collected 0.08€ from pot
*** SUMMARY ***
Total pot 0.08€ | No rake
Seat 3: Hydramist won 0.08€


Winamax Poker - HOLD-UP "Colorado" - HandId: #19116069-201700-1701332697 - Holdem no limit (0.01€/0.02€) - 2023/11/30 08:24:57 UTC
Table: 'Colorado' 6-max (real money) Seat #6 is the button
Seat 1: GGlaCh...... (1.41€)
Seat 2: melijomia (2€)
Seat 3: Fried Berg (2.05€)
Seat 4: Vanight (2.46€)
Seat 5: Charlise2 (2.25€)
Seat 6: Bulzer45 (1.15€)
*** ANTE/BLINDS ***
GGlaCh...... posts small blind 0.01€
melijomia posts big blind 0.02€
Dealt to Fried Berg [2s Qs]
*** PRE-FLOP *** 
Fried Berg folds
Vanight folds
Charlise2 folds
Bulzer45 folds
GGlaCh...... raises 0.06€ to 0.08€
melijomia folds
GGlaCh...... collected 0.10€ from pot
*** SUMMARY ***
Total pot 0.10€ | No rake
Seat 1: GGlaCh...... (small blind) won 0.10€


Winamax Poker - HOLD-UP "Colorado" - HandId: #19116069-201706-1701332701 - Holdem no limit (0.01€/0.02€) - 2023/11/30 08:25:01 UTC
Table: 'Colorado' 6-max (real money) Seat #6 is the button
Seat 1: emerick83240 (2.57€)
Seat 2: LMG22_23 (2€)
Seat 3: moussaillax (1.86€)
Seat 4: FabWest (2€)
Seat 5: Fried Berg (2.05€)
Seat 6: Idf83 (2.09€)
*** ANTE/BLINDS ***
emerick83240 posts small blind 0.01€
LMG22_23 posts big blind 0.02€
Dealt to Fried Berg [Qh 4c]
*** PRE-FLOP *** 
moussaillax folds
FabWest folds
Fried Berg folds
Idf83 raises 0.03€ to 0.05€
emerick83240 calls 0.04€
LMG22_23 folds
*** FLOP *** [5h As Ks]
emerick83240 checks
Idf83 bets 0.04€
emerick83240 calls 0.04€
*** TURN *** [5h As Ks][7h]
emerick83240 bets 0.06€
Idf83 raises 0.19€ to 0.25€
emerick83240 calls 0.19€
*** RIVER *** [5h As Ks 7h][Jh]
emerick83240 bets 0.24€
Idf83 calls 0.24€
*** SHOW DOWN ***
emerick83240 shows [Qd Kc] (One pair : Kings)
Idf83 shows [7c Ac] (Two pairs : Aces and 7)
Idf83 collected 1.06€ from pot
*** SUMMARY ***
Total pot 1.06€ | Rake 0.12€
Board: [5h As Ks 7h Jh]
Seat 1: emerick83240 (small blind) showed [Qd Kc] and lost with One pair : Kings
Seat 6: Idf83 (button) showed [7c Ac] and won 1.06€ with Two pairs : Aces and 7


Winamax Poker - HOLD-UP "Colorado" - HandId: #19116069-201710-1701332706 - Holdem no limit (0.01€/0.02€) - 2023/11/30 08:25:06 UTC
Table: 'Colorado' 6-max (real money) Seat #6 is the button
Seat 1: sopra61 (2.41€)
Seat 2: Fried Berg (2.05€)
Seat 3: FabWest (2.31€)
Seat 4: slowreplay (2€)
Seat 5: Jatar Pr (0.51€)
Seat 6: Jus2Cervelle (0.55€)
*** ANTE/BLINDS ***
sopra61 posts small blind 0.01€
Fried Berg posts big blind 0.02€
Dealt to Fried Berg [8h 5d]
*** PRE-FLOP *** 
FabWest raises 0.03€ to 0.05€
slowreplay folds
Jatar Pr folds
Jus2Cervelle raises 0.50€ to 0.55€ and is all-in
sopra61 folds
Fried Berg folds
FabWest folds
Jus2Cervelle collected 0.63€ from pot
*** SUMMARY ***
Total pot 0.63€ | No rake
Seat 6: Jus2Cervelle (button) won 0.63€


Winamax Poker - HOLD-UP "Colorado" - HandId: #19116069-201715-1701332712 - Holdem no limit (0.01€/0.02€) - 2023/11/30 08:25:12 UTC
Table: 'Colorado' 6-max (real money) Seat #6 is the button
Seat 1: Leane3010 (2.71€)
Seat 2: Hydramist (3.62€)
Seat 3: sopra61 (2.40€)
Seat 4: Fried Berg (2.03€)
Seat 5: LMG22_23 (2.07€)
Seat 6: jerry1407 (2.05€)
*** ANTE/BLINDS ***
Leane3010 posts small blind 0.01€
Hydramist posts big blind 0.02€
Dealt to Fried Berg [7d 7s]
*** PRE-FLOP *** 
sopra61 folds
Fried Berg raises 0.04€ to 0.06€
LMG22_23 folds
jerry1407 folds
Leane3010 folds
Hydramist folds
Fried Berg collected 0.09€ from pot
*** SUMMARY ***
Total pot 0.09€ | No rake
Seat 4: Fried Berg won 0.09€


Winamax Poker - HOLD-UP "Colorado" - HandId: #19116069-201748-1701332747 - Holdem no limit (0.01€/0.02€) - 2023/11/30 08:25:47 UTC
Table: 'Colorado' 6-max (real money) Seat #6 is the button
Seat 1: Eisengrim (2.12€)
Seat 2: Cejargordas (2.24€)
Seat 3: sopra61 (2.37€)
Seat 4: moussaillax (1.81€)
Seat 5: FabWest (2€)
Seat 6: Fried Berg (2.06€)
*** ANTE/BLINDS ***
Eisengrim posts small blind 0.01€
Cejargordas posts big blind 0.02€
Dealt to Fried Berg [6s Qc]
*** PRE-FLOP *** 
sopra61 folds
moussaillax folds
FabWest folds
Fried Berg folds
Eisengrim folds
Cejargordas collected 0.03€ from pot
*** SUMMARY ***
Total pot 0.03€ | No rake
Seat 2: Cejargordas (big blind) won 0.03€


Winamax Poker - HOLD-UP "Colorado" - HandId: #19116069-201759-1701332755 - Holdem no limit (0.01€/0.02€) - 2023/11/30 08:25:55 UTC
Table: 'Colorado' 6-max (real money) Seat #6 is the button
Seat 1: FC_Ghost1 (0.87€)
Seat 2: RatitaKK (1.70€)
Seat 3: Xeosfoot (2.89€)
Seat 4: sopra61 (2.37€)
Seat 5: Manupoy (3.84€)
Seat 6: Fried Berg (2.06€)
*** ANTE/BLINDS ***
FC_Ghost1 posts small blind 0.01€
RatitaKK posts big blind 0.02€
Dealt to Fried Berg [Jh Qs]
*** PRE-FLOP *** 
Xeosfoot folds
sopra61 folds
Manupoy calls 0.02€
Fried Berg raises 0.04€ to 0.06€
FC_Ghost1 folds
RatitaKK folds
Manupoy calls 0.04€
*** FLOP *** [8d 3c Ac]
Manupoy checks
Fried Berg bets 0.02€
Manupoy calls 0.02€
*** TURN *** [8d 3c Ac][2s]
Manupoy checks
Fried Berg checks
*** RIVER *** [8d 3c Ac 2s][7d]
Manupoy bets 0.02€
Fried Berg calls 0.02€
*** SHOW DOWN ***
Fried Berg shows [Jh Qs] (High card : Ace)
Manupoy shows [Tc 7c] (One pair : 7)
Manupoy collected 0.21€ from pot
*** SUMMARY ***
Total pot 0.21€ | Rake 0.02€
Board: [8d 3c Ac 2s 7d]
Seat 5: Manupoy showed [Tc 7c] and won 0.21€ with One pair : 7
Seat 6: Fried Berg (button) showed [Jh Qs] and lost with High card : Ace


Winamax Poker - HOLD-UP "Colorado" - HandId: #19116069-201835-1701332816 - Holdem no limit (0.01€/0.02€) - 2023/11/30 08:26:56 UTC
Table: 'Colorado' 6-max (real money) Seat #6 is the button
Seat 1: Cejargordas (2.24€)
Seat 2: Vanight (2.32€)
Seat 3: Leane3010 (4.21€)
Seat 4: moussaillax (1.77€)
Seat 5: Manupoy (3.95€)
Seat 6: Fried Berg (1.96€)
*** ANTE/BLINDS ***
Cejargordas posts small blind 0.01€
Vanight posts big blind 0.02€
Dealt to Fried Berg [Ah 4c]
*** PRE-FLOP *** 
Leane3010 folds
moussaillax folds
Manupoy folds
Fried Berg raises 0.02€ to 0.04€
Cejargordas folds
Vanight folds
Fried Berg collected 0.07€ from pot
*** SUMMARY ***
Total pot 0.07€ | No rake
Seat 6: Fried Berg (button) won 0.07€


Winamax Poker - HOLD-UP "Colorado" - HandId: #19116069-201849-1701332829 - Holdem no limit (0.01€/0.02€) - 2023/11/30 08:27:09 UTC
Table: 'Colorado' 6-max (real money) Seat #6 is the button
Seat 1: Prayade (4.66€)
Seat 2: Vanight (2.17€)
Seat 3: Fried Berg (1.99€)
Seat 4: RatitaKK (1.66€)
Seat 5: OnceUpoNaTym (0.56€)
Seat 6: SashaTDouss (3.50€)
*** ANTE/BLINDS ***
Prayade posts small blind 0.01€
Vanight posts big blind 0.02€
Dealt to Fried Berg [Jh Ah]
*** PRE-FLOP *** 
Fried Berg raises 0.03€ to 0.05€
RatitaKK folds
OnceUpoNaTym folds
SashaTDouss folds
Prayade calls 0.04€
Vanight calls 0.03€
*** FLOP *** [Td Ad Kd]
Prayade checks
Vanight bets 0.12€
Fried Berg calls 0.12€
Prayade folds
*** TURN *** [Td Ad Kd][4s]
Vanight bets 0.25€
Fried Berg folds
Vanight collected 0.60€ from pot
*** SUMMARY ***
Total pot 0.60€ | Rake 0.04€
Board: [Td Ad Kd 4s]
Seat 2: Vanight (big blind) won 0.60€


Winamax Poker - HOLD-UP "Colorado" - HandId: #19116069-201965-1701332945 - Holdem no limit (0.01€/0.02€) - 2023/11/30 08:29:05 UTC
Table: 'Colorado' 6-max (real money) Seat #6 is the button
Seat 1: Fried Berg (1.82€)
Seat 2: g8o8k8u (2.06€)
Seat 3: FabWest (2.02€)
Seat 4: bimach444 (5.74€)
Seat 5: OnceUpoNaTym (0.63€)
Seat 6: Hydramist (2.60€)
*** ANTE/BLINDS ***
Fried Berg posts small blind 0.01€
g8o8k8u posts big blind 0.02€
Dealt to Fried Berg [4c Ah]
*** PRE-FLOP *** 
FabWest folds
bimach444 folds
OnceUpoNaTym folds
Hydramist folds
Fried Berg raises 0.02€ to 0.04€
g8o8k8u raises 0.08€ to 0.12€
Fried Berg folds
g8o8k8u collected 0.16€ from pot
*** SUMMARY ***
Total pot 0.16€ | No rake
Seat 2: g8o8k8u (big blind) won 0.16€


Winamax Poker - HOLD-UP "Colorado" - HandId: #19116069-201988-1701332969 - Holdem no limit (0.01€/0.02€) - 2023/11/30 08:29:29 UTC
Table: 'Colorado' 6-max (real money) Seat #6 is the button
Seat 1: OnceUpoNaTym (1.10€)
Seat 2: Fried Berg (1.78€)
Seat 3: FC_Ghost1 (2.39€)
Seat 4: Snakesolid56 (3.21€)
Seat 5: Halmosthard (2.80€)
Seat 6: slowreplay (2.06€)
*** ANTE/BLINDS ***
OnceUpoNaTym posts small blind 0.01€
Fried Berg posts big blind 0.02€
Dealt to Fried Berg [4d 5s]
*** PRE-FLOP *** 
FC_Ghost1 folds
Snakesolid56 folds
Halmosthard raises 0.04€ to 0.06€
slowreplay calls 0.06€
OnceUpoNaTym folds
Fried Berg folds
*** FLOP *** [As 2h Ad]
Halmosthard checks
slowreplay bets 0.05€
Halmosthard calls 0.05€
*** TURN *** [As 2h Ad][3h]
Halmosthard checks
slowreplay bets 0.32€
Halmosthard folds
slowreplay collected 0.54€ from pot
*** SUMMARY ***
Total pot 0.54€ | Rake 0.03€
Board: [As 2h Ad 3h]
Seat 6: slowreplay (button) won 0.54€


Winamax Poker - HOLD-UP "Colorado" - HandId: #19116069-202009-1701332998 - Holdem no limit (0.01€/0.02€) - 2023/11/30 08:29:58 UTC
Table: 'Colorado' 6-max (real money) Seat #6 is the button
Seat 1: Mc_CaIN (0.20€)
Seat 2: gueyf (1.46€)
Seat 3: Eisengrim (2.81€)
Seat 4: Fried Berg (1.76€)
Seat 5: Prayade (2.63€)
Seat 6: Leane3010 (2.20€)
*** ANTE/BLINDS ***
Mc_CaIN posts small blind 0.01€
gueyf posts big blind 0.02€
Dealt to Fried Berg [Ah 7s]
*** PRE-FLOP *** 
Eisengrim folds
Fried Berg folds
Prayade raises 0.04€ to 0.06€
Leane3010 folds
Mc_CaIN calls 0.05€
gueyf folds
*** FLOP *** [4d Td 5c]
Mc_CaIN bets 0.05€
Prayade folds
Mc_CaIN collected 0.18€ from pot
*** SUMMARY ***
Total pot 0.18€ | Rake 0.01€
Board: [4d Td 5c]
Seat 1: Mc_CaIN (small blind) won 0.18€


Winamax Poker - HOLD-UP "Colorado" - HandId: #19116069-202020-1701333014 - Holdem no limit (0.01€/0.02€) - 2023/11/30 08:30:14 UTC
Table: 'Colorado' 6-max (real money) Seat #6 is the button
Seat 1: RatitaKK (1.85€)
Seat 2: ForasteroTT (4.28€)
Seat 3: FabWest (2.83€)
Seat 4: Fried Berg (1.76€)
Seat 5: Cejargordas (2.25€)
Seat 6: FC_Ghost1 (2.39€)
*** ANTE/BLINDS ***
RatitaKK posts small blind 0.01€
ForasteroTT posts big blind 0.02€
Dealt to Fried Berg [5d 2h]
*** PRE-FLOP *** 
FabWest folds
Fried Berg folds
Cejargordas folds
FC_Ghost1 folds
RatitaKK calls 0.01€
ForasteroTT checks
*** FLOP *** [9s 8d 8s]
RatitaKK bets 0.02€
ForasteroTT folds
RatitaKK collected 0.06€ from pot
*** SUMMARY ***
Total pot 0.06€ | No rake
Board: [9s 8d 8s]
Seat 1: RatitaKK (small blind) won 0.06€


Winamax Poker - HOLD-UP "Colorado" - HandId: #19116069-202022-1701333017 - Holdem no limit (0.01€/0.02€) - 2023/11/30 08:30:17 UTC
Table: 'Colorado' 6-max (real money) Seat #6 is the button
Seat 1: OnceUpoNaTym (1.91€)
Seat 2: Leane3010 (2.19€)
Seat 3: DENZEL007 (2.56€)
Seat 4: Cejargordas (2.38€)
Seat 5: Fried Berg (1.76€)
Seat 6: 18GranDDuC18 (2.04€)
*** ANTE/BLINDS ***
OnceUpoNaTym posts small blind 0.01€
Leane3010 posts big blind 0.02€
Dealt to Fried Berg [Ks 8d]
*** PRE-FLOP *** 
DENZEL007 folds
Cejargordas folds
Fried Berg raises 0.02€ to 0.04€
18GranDDuC18 folds
OnceUpoNaTym folds
Leane3010 folds
Fried Berg collected 0.07€ from pot
*** SUMMARY ***
Total pot 0.07€ | No rake
Seat 5: Fried Berg won 0.07€


Winamax Poker - HOLD-UP "Colorado" - HandId: #19116069-202034-1701333033 - Holdem no limit (0.01€/0.02€) - 2023/11/30 08:30:33 UTC
Table: 'Colorado' 6-max (real money) Seat #6 is the button
Seat 1: Leane3010 (2.26€)
Seat 2: Fried Berg (1.79€)
Seat 3: FabWest (2.10€)
Seat 4: slowreplay (2.17€)
Seat 5: gueyf (1.43€)
Seat 6: OscarJR (0.90€)
*** ANTE/BLINDS ***
Leane3010 posts small blind 0.01€
Fried Berg posts big blind 0.02€
Dealt to Fried Berg [Jh Tc]
*** PRE-FLOP *** 
FabWest raises 0.03€ to 0.05€
slowreplay folds
gueyf folds
OscarJR calls 0.05€
Leane3010 folds
Fried Berg folds
*** FLOP *** [8h 7d As]
FabWest checks
OscarJR checks
*** TURN *** [8h 7d As][Ks]
FabWest checks
OscarJR checks
*** RIVER *** [8h 7d As Ks][4s]
FabWest checks
OscarJR bets 0.20€
FabWest folds
OscarJR collected 0.32€ from pot
*** SUMMARY ***
Total pot 0.32€ | Rake 0.01€
Board: [8h 7d As Ks 4s]
Seat 6: OscarJR (button) won 0.32€


Winamax Poker - HOLD-UP "Colorado" - HandId: #19116069-202052-1701333053 - Holdem no limit (0.01€/0.02€) - 2023/11/30 08:30:53 UTC
Table: 'Colorado' 6-max (real money) Seat #6 is the button
Seat 1: Fried Berg (1.77€)
Seat 2: Eisengrim (2.78€)
Seat 3: LimpDoud (3.04€)
Seat 4: LaFobie31 (2.06€)
Seat 5: Prayade (2.05€)
Seat 6: OnceUpoNaTym (0.62€)
*** ANTE/BLINDS ***
Fried Berg posts small blind 0.01€
Eisengrim posts big blind 0.02€
Dealt to Fried Berg [6c 3d]
*** PRE-FLOP *** 
LimpDoud folds
LaFobie31 folds
Prayade raises 0.04€ to 0.06€
OnceUpoNaTym folds
Fried Berg folds
Eisengrim folds
Prayade collected 0.09€ from pot
*** SUMMARY ***
Total pot 0.09€ | No rake
Seat 5: Prayade won 0.09€


Winamax Poker - HOLD-UP "Colorado" - HandId: #19116069-202058-1701333060 - Holdem no limit (0.01€/0.02€) - 2023/11/30 08:31:00 UTC
Table: 'Colorado' 6-max (real money) Seat #6 is the button
Seat 1: Manupoy (3.96€)
Seat 2: LaPitchoune (0.84€)
Seat 3: LMG22_23 (2.59€)
Seat 4: FC_Ghost1 (0.47€)
Seat 5: Fried Berg (1.76€)
Seat 6: Dim city (1.51€)
*** ANTE/BLINDS ***
Manupoy posts small blind 0.01€
LaPitchoune posts big blind 0.02€
Dealt to Fried Berg [9s 7s]
*** PRE-FLOP *** 
LMG22_23 folds
FC_Ghost1 folds
Fried Berg calls 0.02€
Dim city folds
Manupoy calls 0.01€
LaPitchoune checks
*** FLOP *** [Jd 4c 7h]
Manupoy bets 0.02€
LaPitchoune folds
Fried Berg calls 0.02€
*** TURN *** [Jd 4c 7h][5s]
Manupoy bets 0.02€
Fried Berg calls 0.02€
*** RIVER *** [Jd 4c 7h 5s][7d]
Manupoy bets 0.09€
Fried Berg raises 0.09€ to 0.18€
Manupoy folds
Fried Berg collected 0.38€ from pot
*** SUMMARY ***
Total pot 0.38€ | Rake 0.03€
Board: [Jd 4c 7h 5s 7d]
Seat 5: Fried Berg won 0.38€


Winamax Poker - HOLD-UP "Colorado" - HandId: #19116069-202102-1701333105 - Holdem no limit (0.01€/0.02€) - 2023/11/30 08:31:45 UTC
Table: 'Colorado' 6-max (real money) Seat #6 is the button
Seat 1: FabWest (2.02€)
Seat 2: gueyf (2.82€)
Seat 3: Fried Berg (1.90€)
Seat 4: 18GranDDuC18 (1.73€)
Seat 5: Leane3010 (4.33€)
Seat 6: OnceUpoNaTym (0.61€)
*** ANTE/BLINDS ***
FabWest posts small blind 0.01€
gueyf posts big blind 0.02€
Dealt to Fried Berg [8c 6h]
*** PRE-FLOP *** 
Fried Berg folds
18GranDDuC18 folds
Leane3010 folds
OnceUpoNaTym raises 0.59€ to 0.61€ and is all-in
FabWest folds
gueyf folds
OnceUpoNaTym collected 0.64€ from pot
*** SUMMARY ***
Total pot 0.64€ | No rake
Seat 6: OnceUpoNaTym (button) won 0.64€


Winamax Poker - HOLD-UP "Colorado" - HandId: #19116069-202109-1701333114 - Holdem no limit (0.01€/0.02€) - 2023/11/30 08:31:54 UTC
Table: 'Colorado' 6-max (real money) Seat #6 is the button
Seat 1: Jatar Pr (0.30€)
Seat 2: JirAiyAwAwA (2.45€)
Seat 3: Leane3010 (4.32€)
Seat 4: Snakesolid56 (3.34€)
Seat 5: Fried Berg (1.90€)
Seat 6: 18GranDDuC18 (1.73€)
*** ANTE/BLINDS ***
Jatar Pr posts small blind 0.01€
JirAiyAwAwA posts big blind 0.02€
Dealt to Fried Berg [2s 2d]
*** PRE-FLOP *** 
Leane3010 folds
Snakesolid56 folds
Fried Berg raises 0.02€ to 0.04€
18GranDDuC18 folds
Jatar Pr calls 0.03€
JirAiyAwAwA calls 0.02€
*** FLOP *** [6h Ad 2h]
Jatar Pr checks
JirAiyAwAwA checks
Fried Berg bets 0.04€
Jatar Pr calls 0.04€
JirAiyAwAwA folds
*** TURN *** [6h Ad 2h][6c]
Jatar Pr checks
Fried Berg bets 0.02€
Jatar Pr calls 0.02€
*** RIVER *** [6h Ad 2h 6c][Jh]
Jatar Pr bets 0.16€
Fried Berg calls 0.16€
*** SHOW DOWN ***
Jatar Pr shows [3h Th] (Flush Jack high)
Fried Berg shows [2s 2d] (Full of 2 and 6)
Fried Berg collected 0.50€ from pot
*** SUMMARY ***
Total pot 0.50€ | Rake 0.06€
Board: [6h Ad 2h 6c Jh]
Seat 1: Jatar Pr (small blind) showed [3h Th] and lost with Flush Jack high
Seat 5: Fried Berg showed [2s 2d] and won 0.50€ with Full of 2 and 6


Winamax Poker - HOLD-UP "Colorado" - HandId: #19116069-202162-1701333177 - Holdem no limit (0.01€/0.02€) - 2023/11/30 08:32:57 UTC
Table: 'Colorado' 6-max (real money) Seat #6 is the button
Seat 1: Cejargordas (2.12€)
Seat 2: Jatar Pr (0.04€)
Seat 3: Fried Berg (2.14€)
Seat 4: Prayade (4.51€)
Seat 5: LimpDoud (2.07€)
Seat 6: Jus2Cervelle (1.92€)
*** ANTE/BLINDS ***
Cejargordas posts small blind 0.01€
Jatar Pr posts big blind 0.02€
Dealt to Fried Berg [Kc Kh]
*** PRE-FLOP *** 
Fried Berg raises 0.04€ to 0.06€
Prayade folds
LimpDoud folds
Jus2Cervelle folds
Cejargordas folds
Jatar Pr folds
Fried Berg collected 0.09€ from pot
*** SUMMARY ***
Total pot 0.09€ | No rake
Seat 3: Fried Berg won 0.09€


Winamax Poker - HOLD-UP "Colorado" - HandId: #19116069-202185-1701333205 - Holdem no limit (0.01€/0.02€) - 2023/11/30 08:33:25 UTC
Table: 'Colorado' 6-max (real money) Seat #6 is the button
Seat 1: badou29 (2.10€)
Seat 2: g8o8k8u (2.32€)
Seat 3: Cejargordas (2.11€)
Seat 4: Jatar Pr (0.02€)
Seat 5: Fried Berg (2.17€)
Seat 6: Bulzer45 (0.97€)
*** ANTE/BLINDS ***
badou29 posts small blind 0.01€
g8o8k8u posts big blind 0.02€
Dealt to Fried Berg [Ks 5h]
*** PRE-FLOP *** 
Cejargordas folds
Jatar Pr calls 0.02€ and is all-in
Fried Berg folds
Bulzer45 folds
badou29 folds
*** FLOP *** [6s Qh Ad]
*** TURN *** [6s Qh Ad][4c]
*** RIVER *** [6s Qh Ad 4c][5s]
*** SHOW DOWN ***
Jatar Pr shows [Qc Td] (One pair : Queens)
g8o8k8u shows [2h 3s] (Straight 6 high)
g8o8k8u collected 0.04€ from pot
*** SUMMARY ***
Total pot 0.04€ | Rake 0.01€
Board: [6s Qh Ad 4c 5s]
Seat 2: g8o8k8u (big blind) showed [2h 3s] and won 0.04€ with Straight 6 high
Seat 4: Jatar Pr showed [Qc Td] and lost with One pair : Queens


Winamax Poker - HOLD-UP "Colorado" - HandId: #19116069-202190-1701333210 - Holdem no limit (0.01€/0.02€) - 2023/11/30 08:33:30 UTC
Table: 'Colorado' 6-max (real money) Seat #6 is the button
Seat 1: Leane3010 (2.22€)
Seat 2: Fried Berg (2.17€)
Seat 3: Cedlebon (2.38€)
Seat 4: OnceUpoNaTym (2.07€)
Seat 5: gueyf (2.82€)
Seat 6: LMG22_23 (2.69€)
*** ANTE/BLINDS ***
Leane3010 posts small blind 0.01€
Fried Berg posts big blind 0.02€
Dealt to Fried Berg [5s 7h]
*** PRE-FLOP *** 
Cedlebon folds
OnceUpoNaTym raises 0.02€ to 0.04€
gueyf folds
LMG22_23 calls 0.04€
Leane3010 folds
Fried Berg folds
*** FLOP *** [Ts 3h 2s]
OnceUpoNaTym checks
LMG22_23 checks
*** TURN *** [Ts 3h 2s][4s]
OnceUpoNaTym checks
LMG22_23 bets 0.06€
OnceUpoNaTym folds
LMG22_23 collected 0.16€ from pot
*** SUMMARY ***
Total pot 0.16€ | Rake 0.01€
Board: [Ts 3h 2s 4s]
Seat 6: LMG22_23 (button) won 0.16€


Winamax Poker - HOLD-UP "Colorado" - HandId: #19116069-202193-1701333213 - Holdem no limit (0.01€/0.02€) - 2023/11/30 08:33:33 UTC
Table: 'Colorado' 6-max (real money) Seat #6 is the button
Seat 1: Le Chiffre - (1.95€)
Seat 2: LaPitchoune (0.56€)
Seat 3: Kalendula (1.84€)
Seat 4: Fried Berg (2.15€)
Seat 5: Leane3010 (4.24€)
Seat 6: Dim city (1.98€)
Hold-up to Pot: total 0.10€
*** ANTE/BLINDS ***
Le Chiffre - posts small blind 0.01€
LaPitchoune posts big blind 0.02€
Dealt to Fried Berg [7h Kd]
*** PRE-FLOP *** 
Kalendula folds
Fried Berg folds
Leane3010 raises 0.04€ to 0.06€
Dim city folds
Le Chiffre - folds
LaPitchoune calls 0.04€
*** FLOP *** [3c 7s 8c]
LaPitchoune checks
Leane3010 bets 0.08€
LaPitchoune folds
Leane3010 collected 0.30€ from pot
*** SUMMARY ***
Total pot 0.30€ | Rake 0.01€
Board: [3c 7s 8c]
Seat 5: Leane3010 won 0.30€


Winamax Poker - HOLD-UP "Colorado" - HandId: #19116069-202207-1701333233 - Holdem no limit (0.01€/0.02€) - 2023/11/30 08:33:53 UTC
Table: 'Colorado' 6-max (real money) Seat #6 is the button
Seat 1: Fried Berg (2.15€)
Seat 2: gueyf (2.82€)
Seat 3: Manupoy (2.89€)
Seat 4: Prayade (2.08€)
Seat 5: SirX (4€)
Seat 6: Bulzer45 (0.77€)
*** ANTE/BLINDS ***
Fried Berg posts small blind 0.01€
gueyf posts big blind 0.02€
Dealt to Fried Berg [Qc 2d]
*** PRE-FLOP *** 
Manupoy folds
Prayade folds
SirX folds
Bulzer45 folds
Fried Berg folds
gueyf collected 0.03€ from pot
*** SUMMARY ***
Total pot 0.03€ | No rake
Seat 2: gueyf (big blind) won 0.03€


Winamax Poker - HOLD-UP "Colorado" - HandId: #19116069-202221-1701333244 - Holdem no limit (0.01€/0.02€) - 2023/11/30 08:34:04 UTC
Table: 'Colorado' 6-max (real money) Seat #6 is the button
Seat 1: Idf83 (2.44€)
Seat 2: OnceUpoNaTym (1.22€)
Seat 3: Val_Hawkins (2.47€)
Seat 4: Cedlebon (2.35€)
Seat 5: slowreplay (2.37€)
Seat 6: Fried Berg (2.14€)
*** ANTE/BLINDS ***
Idf83 posts small blind 0.01€
OnceUpoNaTym posts big blind 0.02€
Dealt to Fried Berg [7h Qd]
*** PRE-FLOP *** 
Val_Hawkins folds
Cedlebon folds
slowreplay folds
Fried Berg raises 0.02€ to 0.04€
Idf83 folds
OnceUpoNaTym folds
Fried Berg collected 0.07€ from pot
*** SUMMARY ***
Total pot 0.07€ | No rake
Seat 6: Fried Berg (button) won 0.07€


Winamax Poker - HOLD-UP "Colorado" - HandId: #19116069-202244-1701333271 - Holdem no limit (0.01€/0.02€) - 2023/11/30 08:34:31 UTC
Table: 'Colorado' 6-max (real money) Seat #6 is the button
Seat 1: jerry1407 (2.12€)
Seat 2: LMG22_23 (2.61€)
Seat 3: Leane3010 (2.22€)
Seat 4: l artiste ho (3.37€)
Seat 5: Prayade (2.43€)
Seat 6: Fried Berg (2.17€)
*** ANTE/BLINDS ***
jerry1407 posts small blind 0.01€
LMG22_23 posts big blind 0.02€
Dealt to Fried Berg [7s 6h]
*** PRE-FLOP *** 
Leane3010 folds
l artiste ho folds
Prayade folds
Fried Berg raises 0.02€ to 0.04€
jerry1407 folds
LMG22_23 calls 0.02€
*** FLOP *** [As 3d Th]
LMG22_23 checks
Fried Berg checks
*** TURN *** [As 3d Th][Qh]
LMG22_23 bets 0.03€
Fried Berg folds
LMG22_23 collected 0.11€ from pot
*** SUMMARY ***
Total pot 0.11€ | Rake 0.01€
Board: [As 3d Th Qh]
Seat 2: LMG22_23 (big blind) won 0.11€


Winamax Poker - HOLD-UP "Colorado" - HandId: #19116069-202270-1701333301 - Holdem no limit (0.01€/0.02€) - 2023/11/30 08:35:01 UTC
Table: 'Colorado' 6-max (real money) Seat #6 is the button
Seat 1: gueyf (1.29€)
Seat 2: Fried Berg (2.13€)
Seat 3: Eisengrim (4.61€)
Seat 4: Manupoy (4.05€)
Seat 5: Bulzer45 (0.88€)
Seat 6: Jatar Pr (2.46€)
*** ANTE/BLINDS ***
gueyf posts small blind 0.01€
Fried Berg posts big blind 0.02€
Dealt to Fried Berg [9s Qc]
*** PRE-FLOP *** 
Eisengrim folds
Manupoy folds
Bulzer45 folds
Jatar Pr folds
gueyf folds
Fried Berg collected 0.03€ from pot
*** SUMMARY ***
Total pot 0.03€ | No rake
Seat 2: Fried Berg (big blind) won 0.03€


Winamax Poker - HOLD-UP "Colorado" - HandId: #19116069-202285-1701333314 - Holdem no limit (0.01€/0.02€) - 2023/11/30 08:35:14 UTC
Table: 'Colorado' 6-max (real money) Seat #6 is the button
Seat 1: l artiste ho (3.38€)
Seat 2: gueyf (2.83€)
Seat 3: Leane3010 (2.20€)
Seat 4: LMG22_23 (2.64€)
Seat 5: OscarJR (0.62€)
Seat 6: Fried Berg (2.14€)
*** ANTE/BLINDS ***
l artiste ho posts small blind 0.01€
gueyf posts big blind 0.02€
Dealt to Fried Berg [Qs Ks]
*** PRE-FLOP *** 
Leane3010 folds
LMG22_23 folds
OscarJR folds
Fried Berg raises 0.04€ to 0.06€
l artiste ho folds
gueyf calls 0.04€
*** FLOP *** [Jc 5s 4c]
gueyf checks
Fried Berg bets 0.03€
gueyf raises 0.11€ to 0.14€
Fried Berg folds
gueyf collected 0.28€ from pot
*** SUMMARY ***
Total pot 0.28€ | Rake 0.02€
Board: [Jc 5s 4c]
Seat 2: gueyf (big blind) won 0.28€


Winamax Poker - HOLD-UP "Colorado" - HandId: #19116069-202341-1701333382 - Holdem no limit (0.01€/0.02€) - 2023/11/30 08:36:22 UTC
Table: 'Colorado' 6-max (real money) Seat #6 is the button
Seat 1: Vanight (2.16€)
Seat 2: slowreplay (2.40€)
Seat 3: Fried Berg (2.05€)
Seat 4: Scr.squirrel (2.02€)
Seat 5: Eisengrim (2€)
Seat 6: Bulzer45 (0.69€)
*** ANTE/BLINDS ***
Vanight posts small blind 0.01€
slowreplay posts big blind 0.02€
Dealt to Fried Berg [Ks Jh]
*** PRE-FLOP *** 
Fried Berg raises 0.02€ to 0.04€
Scr.squirrel folds
Eisengrim folds
Bulzer45 calls 0.04€
Vanight folds
slowreplay calls 0.02€
*** FLOP *** [9d 3d Ac]
slowreplay checks
Fried Berg checks
Bulzer45 bets 0.02€
slowreplay calls 0.02€
Fried Berg calls 0.02€
*** TURN *** [9d 3d Ac][2d]
slowreplay checks
Fried Berg checks
Bulzer45 bets 0.02€
slowreplay folds
Fried Berg folds
Bulzer45 collected 0.19€ from pot
*** SUMMARY ***
Total pot 0.19€ | Rake 0.02€
Board: [9d 3d Ac 2d]
Seat 6: Bulzer45 (button) won 0.19€


Winamax Poker - HOLD-UP "Colorado" - HandId: #19116069-202426-1701333474 - Holdem no limit (0.01€/0.02€) - 2023/11/30 08:37:54 UTC
Table: 'Colorado' 6-max (real money) Seat #6 is the button
Seat 1: Fried Berg (1.99€)
Seat 2: Jus2Cervelle (1.93€)
Seat 3: gueyf (2.54€)
Seat 4: Dim city (1.95€)
Seat 5: pamarmo79 (2.42€)
Seat 6: Halmosthard (3.41€)
*** ANTE/BLINDS ***
Fried Berg posts small blind 0.01€
Jus2Cervelle posts big blind 0.02€
Dealt to Fried Berg [Qh 5c]
*** PRE-FLOP *** 
gueyf folds
Dim city folds
pamarmo79 folds
Halmosthard raises 0.04€ to 0.06€
Fried Berg folds
Jus2Cervelle calls 0.04€
*** FLOP *** [4h Kc Qd]
Jus2Cervelle checks
Halmosthard bets 0.08€
Jus2Cervelle folds
Halmosthard collected 0.20€ from pot
*** SUMMARY ***
Total pot 0.20€ | Rake 0.01€
Board: [4h Kc Qd]
Seat 6: Halmosthard (button) won 0.20€


Winamax Poker - HOLD-UP "Colorado" - HandId: #19116069-202435-1701333487 - Holdem no limit (0.01€/0.02€) - 2023/11/30 08:38:07 UTC
Table: 'Colorado' 6-max (real money) Seat #6 is the button
Seat 1: Idf83 (2.82€)
Seat 2: Annieduck (2€)
Seat 3: Vanight (2.32€)
Seat 4: Fried Berg (1.98€)
Seat 5: gueyf (1.32€)
Seat 6: slowreplay (2.33€)
*** ANTE/BLINDS ***
Idf83 posts small blind 0.01€
Annieduck posts big blind 0.02€
Dealt to Fried Berg [Jc Qd]
*** PRE-FLOP *** 
Vanight raises 0.06€ to 0.08€
Fried Berg calls 0.08€
gueyf folds
slowreplay folds
Idf83 folds
Annieduck folds
*** FLOP *** [4c 7h Jd]
Vanight checks
Fried Berg bets 0.10€
Vanight folds
Fried Berg collected 0.27€ from pot
*** SUMMARY ***
Total pot 0.27€ | Rake 0.02€
Board: [4c 7h Jd]
Seat 4: Fried Berg won 0.27€


Winamax Poker - HOLD-UP "Colorado" - HandId: #19116069-202510-1701333582 - Holdem no limit (0.01€/0.02€) - 2023/11/30 08:39:42 UTC
Table: 'Colorado' 6-max (real money) Seat #6 is the button
Seat 1: pamarmo79 (3.99€)
Seat 2: Prayade (2.48€)
Seat 3: Coolax3019 (3.32€)
Seat 4: Fried Berg (2.07€)
Seat 5: Cejargordas (3.38€)
Seat 6: Leane3010 (4.68€)
Hold-up to Pot: total 0.10€
*** ANTE/BLINDS ***
pamarmo79 posts small blind 0.01€
Prayade posts big blind 0.02€
Dealt to Fried Berg [9h 3s]
*** PRE-FLOP *** 
Coolax3019 calls 0.02€
Fried Berg folds
Cejargordas folds
Leane3010 calls 0.02€
pamarmo79 folds
Prayade raises 0.10€ to 0.12€
Coolax3019 calls 0.10€
Leane3010 folds
*** FLOP *** [7c Kd 5d]
Prayade checks
Coolax3019 checks
*** TURN *** [7c Kd 5d][2s]
Prayade checks
Coolax3019 checks
*** RIVER *** [7c Kd 5d 2s][4d]
Prayade checks
Coolax3019 bets 3.20€ and is all-in
Prayade folds
Coolax3019 collected 3.54€ from pot
*** SUMMARY ***
Total pot 3.54€ | Rake 0.03€
Board: [7c Kd 5d 2s 4d]
Seat 3: Coolax3019 won 3.54€


Winamax Poker - HOLD-UP "Colorado" - HandId: #19116069-202517-1701333589 - Holdem no limit (0.01€/0.02€) - 2023/11/30 08:39:49 UTC
Table: 'Colorado' 6-max (real money) Seat #6 is the button
Seat 1: Fried Berg (2.07€)
Seat 2: gueyf (2.14€)
Seat 3: JirAiyAwAwA (2.08€)
Seat 4: pamarmo79 (3.98€)
Seat 5: moussaillax (1.27€)
Seat 6: Ga31k (2€)
*** ANTE/BLINDS ***
Fried Berg posts small blind 0.01€
gueyf posts big blind 0.02€
Dealt to Fried Berg [3s Js]
*** PRE-FLOP *** 
JirAiyAwAwA folds
pamarmo79 folds
moussaillax folds
Ga31k raises 0.04€ to 0.06€
Fried Berg calls 0.05€
gueyf folds
*** FLOP *** [5h 2d 9h]
Fried Berg checks
Ga31k checks
*** TURN *** [5h 2d 9h][7s]
Fried Berg checks
Ga31k bets 0.07€
Fried Berg folds
Ga31k collected 0.20€ from pot
*** SUMMARY ***
Total pot 0.20€ | Rake 0.01€
Board: [5h 2d 9h 7s]
Seat 6: Ga31k (button) won 0.20€


Winamax Poker - HOLD-UP "Colorado" - HandId: #19116069-202556-1701333632 - Holdem no limit (0.01€/0.02€) - 2023/11/30 08:40:32 UTC
Table: 'Colorado' 6-max (real money) Seat #6 is the button
Seat 1: Leane3010 (4.67€)
Seat 2: Cejargordas (2.47€)
Seat 3: Lunau (2.06€)
Seat 4: morganeswolf (2.02€)
Seat 5: Fried Berg (2.01€)
Seat 6: Valetissimo (1.88€)
*** ANTE/BLINDS ***
Leane3010 posts small blind 0.01€
Cejargordas posts big blind 0.02€
Dealt to Fried Berg [Ts 6d]
*** PRE-FLOP *** 
Lunau folds
morganeswolf folds
Fried Berg folds
Valetissimo folds
Leane3010 raises 0.04€ to 0.06€
Cejargordas calls 0.04€
*** FLOP *** [9d 6h 5s]
Leane3010 checks
Cejargordas bets 0.06€
Leane3010 folds
Cejargordas collected 0.17€ from pot
*** SUMMARY ***
Total pot 0.17€ | Rake 0.01€
Board: [9d 6h 5s]
Seat 2: Cejargordas (big blind) won 0.17€


Winamax Poker - HOLD-UP "Colorado" - HandId: #19116069-202563-1701333639 - Holdem no limit (0.01€/0.02€) - 2023/11/30 08:40:39 UTC
Table: 'Colorado' 6-max (real money) Seat #6 is the button
Seat 1: moussaillax (1.23€)
Seat 2: Valetissimo (1.88€)
Seat 3: KON-2-PEUTE (2€)
Seat 4: VashtaNerada (2.17€)
Seat 5: Ziildjiin (9.71€)
Seat 6: Fried Berg (2.01€)
*** ANTE/BLINDS ***
moussaillax posts small blind 0.01€
Valetissimo posts big blind 0.02€
Dealt to Fried Berg [4h 4d]
*** PRE-FLOP *** 
KON-2-PEUTE folds
VashtaNerada folds
Ziildjiin raises 0.02€ to 0.04€
Fried Berg raises 0.08€ to 0.12€
moussaillax folds
Valetissimo calls 0.10€
Ziildjiin calls 0.08€
*** FLOP *** [2s 7c 9c]
Valetissimo checks
Ziildjiin bets 0.08€
Fried Berg folds
Valetissimo calls 0.08€
*** TURN *** [2s 7c 9c][Ah]
Valetissimo checks
Ziildjiin bets 0.34€
Valetissimo calls 0.34€
*** RIVER *** [2s 7c 9c Ah][Qs]
Valetissimo bets 1.34€ and is all-in
Ziildjiin calls 1.34€
*** SHOW DOWN ***
Ziildjiin shows [9h Ad] (Two pairs : Aces and 9)
Valetissimo shows [Ac Qd] (Two pairs : Aces and Queens)
Valetissimo collected 3.50€ from pot
*** SUMMARY ***
Total pot 3.50€ | Rake 0.39€
Board: [2s 7c 9c Ah Qs]
Seat 2: Valetissimo (big blind) showed [Ac Qd] and won 3.50€ with Two pairs : Aces and Queens
Seat 5: Ziildjiin showed [9h Ad] and lost with Two pairs : Aces and 9


Winamax Poker - HOLD-UP "Colorado" - HandId: #19116069-202607-1701333699 - Holdem no limit (0.01€/0.02€) - 2023/11/30 08:41:39 UTC
Table: 'Colorado' 6-max (real money) Seat #6 is the button
Seat 1: OnceUpoNaTym (2.05€)
Seat 2: KON-2-PEUTE (2.03€)
Seat 3: Lunau (1.97€)
Seat 4: LaFobie31 (2.04€)
Seat 5: Fried Berg (1.89€)
Seat 6: Eisengrim (2€)
*** ANTE/BLINDS ***
OnceUpoNaTym posts small blind 0.01€
KON-2-PEUTE posts big blind 0.02€
Dealt to Fried Berg [5d Qd]
*** PRE-FLOP *** 
Lunau folds
LaFobie31 raises 0.04€ to 0.06€
Fried Berg folds
Eisengrim folds
OnceUpoNaTym calls 0.05€
KON-2-PEUTE folds
*** FLOP *** [8c 7d Ad]
OnceUpoNaTym checks
LaFobie31 bets 0.07€
OnceUpoNaTym calls 0.07€
*** TURN *** [8c 7d Ad][6h]
OnceUpoNaTym checks
LaFobie31 bets 0.14€
OnceUpoNaTym calls 0.14€
*** RIVER *** [8c 7d Ad 6h][8h]
OnceUpoNaTym checks
LaFobie31 checks
*** SHOW DOWN ***
OnceUpoNaTym shows [9s Ac] (Two pairs : Aces and 8)
LaFobie31 shows [Ah Jd] (Two pairs : Aces and 8)
LaFobie31 collected 0.50€ from pot
*** SUMMARY ***
Total pot 0.50€ | Rake 0.06€
Board: [8c 7d Ad 6h 8h]
Seat 1: OnceUpoNaTym (small blind) showed [9s Ac] and lost with Two pairs : Aces and 8
Seat 4: LaFobie31 showed [Ah Jd] and won 0.50€ with Two pairs : Aces and 8


Winamax Poker - HOLD-UP "Colorado" - HandId: #19116069-202616-1701333708 - Holdem no limit (0.01€/0.02€) - 2023/11/30 08:41:48 UTC
Table: 'Colorado' 6-max (real money) Seat #6 is the button
Seat 1: melijomia (2€)
Seat 2: Annieduck (1.93€)
Seat 3: morganeswolf (2.02€)
Seat 4: gueyf (2.94€)
Seat 5: slowreplay (2.66€)
Seat 6: Fried Berg (1.89€)
*** ANTE/BLINDS ***
melijomia posts small blind 0.01€
Annieduck posts big blind 0.02€
Dealt to Fried Berg [8s 3d]
*** PRE-FLOP *** 
morganeswolf folds
gueyf folds
slowreplay folds
Fried Berg folds
melijomia raises 0.04€ to 0.06€
Annieduck calls 0.04€
*** FLOP *** [Th 5h Qc]
melijomia checks
Annieduck checks
*** TURN *** [Th 5h Qc][2c]
melijomia checks
Annieduck checks
*** RIVER *** [Th 5h Qc 2c][5d]
melijomia checks
Annieduck bets 0.08€
melijomia folds
Annieduck collected 0.19€ from pot
*** SUMMARY ***
Total pot 0.19€ | Rake 0.01€
Board: [Th 5h Qc 2c 5d]
Seat 2: Annieduck (big blind) won 0.19€


Winamax Poker - HOLD-UP "Colorado" - HandId: #19116069-202620-1701333711 - Holdem no limit (0.01€/0.02€) - 2023/11/30 08:41:51 UTC
Table: 'Colorado' 6-max (real money) Seat #6 is the button
Seat 1: Ga31k (2.10€)
Seat 2: Bulzer45 (0.50€)
Seat 3: pamarmo79 (3.98€)
Seat 4: Fried Berg (1.89€)
Seat 5: morganeswolf (2.02€)
Seat 6: DENZEL007 (2.16€)
*** ANTE/BLINDS ***
Ga31k posts small blind 0.01€
Bulzer45 posts big blind 0.02€
Dealt to Fried Berg [4d 7h]
*** PRE-FLOP *** 
pamarmo79 folds
Fried Berg folds
morganeswolf folds
DENZEL007 raises 0.04€ to 0.06€
Ga31k folds
Bulzer45 folds
DENZEL007 collected 0.09€ from pot
*** SUMMARY ***
Total pot 0.09€ | No rake
Seat 6: DENZEL007 (button) won 0.09€


Winamax Poker - HOLD-UP "Colorado" - HandId: #19116069-202626-1701333717 - Holdem no limit (0.01€/0.02€) - 2023/11/30 08:41:57 UTC
Table: 'Colorado' 6-max (real money) Seat #6 is the button
Seat 1: KON-2-PEUTE (2.15€)
Seat 2: Fried Berg (1.89€)
Seat 3: Valetissimo (3.50€)
Seat 4: gueyf (1.89€)
Seat 5: slowreplay (2.66€)
Seat 6: Ziildjiin (7.83€)
*** ANTE/BLINDS ***
KON-2-PEUTE posts small blind 0.01€
Fried Berg posts big blind 0.02€
Dealt to Fried Berg [5s 8s]
*** PRE-FLOP *** 
Valetissimo raises 0.03€ to 0.05€
gueyf folds
slowreplay folds
Ziildjiin folds
KON-2-PEUTE folds
Fried Berg folds
Valetissimo collected 0.08€ from pot
*** SUMMARY ***
Total pot 0.08€ | No rake
Seat 3: Valetissimo won 0.08€


Winamax Poker - HOLD-UP "Colorado" - HandId: #19116069-202637-1701333732 - Holdem no limit (0.01€/0.02€) - 2023/11/30 08:42:12 UTC
Table: 'Colorado' 6-max (real money) Seat #6 is the button
Seat 1: Halmosthard (3.45€)
Seat 2: JirAiyAwAwA (1.43€)
Seat 3: Fried Berg (1.87€)
Seat 4: Ga31k (2.06€)
Seat 5: gueyf (2.94€)
Seat 6: slowreplay (2€)
*** ANTE/BLINDS ***
Halmosthard posts small blind 0.01€
JirAiyAwAwA posts big blind 0.02€
Dealt to Fried Berg [4d 7d]
*** PRE-FLOP *** 
Fried Berg folds
Ga31k folds
gueyf folds
slowreplay folds
Halmosthard folds
JirAiyAwAwA collected 0.03€ from pot
*** SUMMARY ***
Total pot 0.03€ | No rake
Seat 2: JirAiyAwAwA (big blind) won 0.03€


Winamax Poker - HOLD-UP "Colorado" - HandId: #19116069-202639-1701333734 - Holdem no limit (0.01€/0.02€) - 2023/11/30 08:42:14 UTC
Table: 'Colorado' 6-max (real money) Seat #6 is the button
Seat 1: Jus2Cervelle (2.03€)
Seat 2: Fried Berg (1.87€)
Seat 3: badou29 (2.03€)
Seat 4: g8o8k8u (2€)
Seat 5: 18GranDDuC18 (2.02€)
Seat 6: Manupoy (2.91€)
*** ANTE/BLINDS ***
Jus2Cervelle posts small blind 0.01€
Fried Berg posts big blind 0.02€
Dealt to Fried Berg [4c Th]
*** PRE-FLOP *** 
badou29 folds
g8o8k8u folds
18GranDDuC18 raises 0.03€ to 0.05€
Manupoy folds
Jus2Cervelle folds
Fried Berg folds
18GranDDuC18 collected 0.08€ from pot
*** SUMMARY ***
Total pot 0.08€ | No rake
Seat 5: 18GranDDuC18 won 0.08€


Winamax Poker - HOLD-UP "Colorado" - HandId: #19116069-202659-1701333756 - Holdem no limit (0.01€/0.02€) - 2023/11/30 08:42:36 UTC
Table: 'Colorado' 6-max (real money) Seat #6 is the button
Seat 1: slowreplay (2.67€)
Seat 2: gueyf (2.93€)
Seat 3: melijomia (2€)
Seat 4: Fried Berg (1.85€)
Seat 5: JirAiyAwAwA (1.46€)
Seat 6: FabWest (2€)
*** ANTE/BLINDS ***
slowreplay posts small blind 0.01€
gueyf posts big blind 0.02€
Dealt to Fried Berg [Th Kc]
*** PRE-FLOP *** 
melijomia folds
Fried Berg raises 0.02€ to 0.04€
JirAiyAwAwA folds
FabWest folds
slowreplay folds
gueyf calls 0.02€
*** FLOP *** [As 4d 5d]
gueyf checks
Fried Berg checks
*** TURN *** [As 4d 5d][9s]
gueyf checks
Fried Berg checks
*** RIVER *** [As 4d 5d 9s][3s]
gueyf checks
Fried Berg checks
*** SHOW DOWN ***
Fried Berg shows [Th Kc] (High card : Ace)
gueyf shows [Qc Kd] (High card : Ace)
gueyf collected 0.08€ from pot
*** SUMMARY ***
Total pot 0.08€ | Rake 0.01€
Board: [As 4d 5d 9s 3s]
Seat 2: gueyf (big blind) showed [Qc Kd] and won 0.08€ with High card : Ace
Seat 4: Fried Berg showed [Th Kc] and lost with High card : Ace


Winamax Poker - HOLD-UP "Colorado" - HandId: #19116069-202694-1701333797 - Holdem no limit (0.01€/0.02€) - 2023/11/30 08:43:17 UTC
Table: 'Colorado' 6-max (real money) Seat #6 is the button
Seat 1: Fried Berg (1.81€)
Seat 2: gueyf (2.97€)
Seat 3: Sucre10 (2.06€)
Seat 4: Annieduck (1.81€)
Seat 5: OnceUpoNaTym (1.66€)
Seat 6: 18GranDDuC18 (2.05€)
*** ANTE/BLINDS ***
Fried Berg posts small blind 0.01€
gueyf posts big blind 0.02€
Dealt to Fried Berg [2c 4c]
*** PRE-FLOP *** 
Sucre10 folds
Annieduck raises 0.04€ to 0.06€
OnceUpoNaTym calls 0.06€
18GranDDuC18 folds
Fried Berg folds
gueyf folds
*** FLOP *** [9s Jc 6h]
Annieduck bets 0.05€
OnceUpoNaTym folds
Annieduck collected 0.18€ from pot
*** SUMMARY ***
Total pot 0.18€ | Rake 0.02€
Board: [9s Jc 6h]
Seat 4: Annieduck won 0.18€


Winamax Poker - HOLD-UP "Colorado" - HandId: #19116069-202705-1701333813 - Holdem no limit (0.01€/0.02€) - 2023/11/30 08:43:33 UTC
Table: 'Colorado' 6-max (real money) Seat #6 is the button
Seat 1: melijomia (2€)
Seat 2: Cejargordas (2.50€)
Seat 3: Fried Berg (1.80€)
Seat 4: OscarJR (0.66€)
Seat 5: Halmosthard (3.46€)
Seat 6: Leane3010 (2.08€)
*** ANTE/BLINDS ***
melijomia posts small blind 0.01€
Cejargordas posts big blind 0.02€
Dealt to Fried Berg [Tc 4d]
*** PRE-FLOP *** 
Fried Berg folds
OscarJR folds
Halmosthard folds
Leane3010 raises 0.04€ to 0.06€
melijomia folds
Cejargordas calls 0.04€
*** FLOP *** [2s 6h 8d]
Cejargordas checks
Leane3010 bets 0.05€
Cejargordas folds
Leane3010 collected 0.17€ from pot
*** SUMMARY ***
Total pot 0.17€ | Rake 0.01€
Board: [2s 6h 8d]
Seat 6: Leane3010 (button) won 0.17€


Winamax Poker - HOLD-UP "Colorado" - HandId: #19116069-202707-1701333816 - Holdem no limit (0.01€/0.02€) - 2023/11/30 08:43:36 UTC
Table: 'Colorado' 6-max (real money) Seat #6 is the button
Seat 1: LMG22_23 (3.16€)
Seat 2: -Mindfull- (1.99€)
Seat 3: Fried Berg (1.80€)
Seat 4: KON-2-PEUTE (2.11€)
Seat 5: OscarJR (0.66€)
Seat 6: Bulzer45 (0.41€)
*** ANTE/BLINDS ***
LMG22_23 posts small blind 0.01€
-Mindfull- posts big blind 0.02€
Dealt to Fried Berg [9h Jh]
*** PRE-FLOP *** 
Fried Berg folds
KON-2-PEUTE folds
OscarJR folds
Bulzer45 folds
LMG22_23 raises 0.03€ to 0.05€
-Mindfull- calls 0.03€
*** FLOP *** [9d 7d Qd]
LMG22_23 checks
-Mindfull- bets 0.03€
LMG22_23 calls 0.03€
*** TURN *** [9d 7d Qd][6h]
LMG22_23 checks
-Mindfull- bets 0.06€
LMG22_23 raises 0.16€ to 0.22€
-Mindfull- folds
LMG22_23 collected 0.41€ from pot
*** SUMMARY ***
Total pot 0.41€ | Rake 0.03€
Board: [9d 7d Qd 6h]
Seat 1: LMG22_23 (small blind) won 0.41€


Winamax Poker - HOLD-UP "Colorado" - HandId: #19116069-202718-1701333828 - Holdem no limit (0.01€/0.02€) - 2023/11/30 08:43:48 UTC
Table: 'Colorado' 6-max (real money) Seat #6 is the button
Seat 1: TimToBey (2.01€)
Seat 2: Fried Berg (1.80€)
Seat 3: melijomia (2€)
Seat 4: Prayade (7.19€)
Seat 5: Kalendula (2.06€)
Seat 6: Val_Hawkins (3.04€)
*** ANTE/BLINDS ***
TimToBey posts small blind 0.01€
Fried Berg posts big blind 0.02€
Dealt to Fried Berg [Jh 8h]
*** PRE-FLOP *** 
melijomia folds
Prayade folds
Kalendula raises 0.02€ to 0.04€
Val_Hawkins folds
TimToBey folds
Fried Berg calls 0.02€
*** FLOP *** [3d 4c 2h]
Fried Berg checks
Kalendula bets 0.05€
Fried Berg calls 0.05€
*** TURN *** [3d 4c 2h][Ts]
Fried Berg checks
Kalendula checks
*** RIVER *** [3d 4c 2h Ts][3s]
Fried Berg bets 0.10€
Kalendula calls 0.10€
*** SHOW DOWN ***
Fried Berg shows [Jh 8h] (One pair : 3)
Kalendula shows [9s Ah] (One pair : 3)
Kalendula collected 0.35€ from pot
*** SUMMARY ***
Total pot 0.35€ | Rake 0.04€
Board: [3d 4c 2h Ts 3s]
Seat 2: Fried Berg (big blind) showed [Jh 8h] and lost with One pair : 3
Seat 5: Kalendula showed [9s Ah] and won 0.35€ with One pair : 3


Winamax Poker - HOLD-UP "Colorado" - HandId: #19116069-202763-1701333882 - Holdem no limit (0.01€/0.02€) - 2023/11/30 08:44:42 UTC
Table: 'Colorado' 6-max (real money) Seat #6 is the button
Seat 1: Kalendula (2.22€)
Seat 2: melijomia (2€)
Seat 3: LMG22_23 (3.27€)
Seat 4: slowreplay (2€)
Seat 5: Prayade (2.06€)
Seat 6: Fried Berg (1.61€)
*** ANTE/BLINDS ***
Kalendula posts small blind 0.01€
melijomia posts big blind 0.02€
Dealt to Fried Berg [7c 8s]
*** PRE-FLOP *** 
LMG22_23 folds
slowreplay folds
Prayade folds
Fried Berg folds
Kalendula folds
melijomia collected 0.03€ from pot
*** SUMMARY ***
Total pot 0.03€ | No rake
Seat 2: melijomia (big blind) won 0.03€


Winamax Poker - HOLD-UP "Colorado" - HandId: #19116069-202777-1701333908 - Holdem no limit (0.01€/0.02€) - 2023/11/30 08:45:08 UTC
Table: 'Colorado' 6-max (real money) Seat #6 is the button
Seat 1: LaFobie31 (2€)
Seat 2: Le Chiffre - (1.75€)
Seat 3: LMG22_23 (4.74€)
Seat 4: slowreplay (2.64€)
Seat 5: Fried Berg (1.61€)
Seat 6: gueyf (2.90€)
*** ANTE/BLINDS ***
LaFobie31 posts small blind 0.01€
Le Chiffre - posts big blind 0.02€
Dealt to Fried Berg [2c As]
*** PRE-FLOP *** 
LMG22_23 folds
slowreplay raises 0.03€ to 0.05€
Fried Berg folds
gueyf folds
LaFobie31 folds
Le Chiffre - folds
slowreplay collected 0.08€ from pot
*** SUMMARY ***
Total pot 0.08€ | No rake
Seat 4: slowreplay won 0.08€


Winamax Poker - HOLD-UP "Colorado" - HandId: #19116069-202785-1701333918 - Holdem no limit (0.01€/0.02€) - 2023/11/30 08:45:18 UTC
Table: 'Colorado' 6-max (real money) Seat #6 is the button
Seat 1: Fried Berg (1.61€)
Seat 2: melijomia (4.06€)
Seat 3: OscarJR (0.46€)
Seat 4: KON-2-PEUTE (2.01€)
Seat 5: 18GranDDuC18 (2.14€)
Seat 6: LaFobie31 (2€)
Hold-up to Pot: total 0.10€
*** ANTE/BLINDS ***
Fried Berg posts small blind 0.01€
melijomia posts big blind 0.02€
Dealt to Fried Berg [4s 8d]
*** PRE-FLOP *** 
OscarJR raises 0.04€ to 0.06€
KON-2-PEUTE calls 0.06€
18GranDDuC18 folds
LaFobie31 folds
Fried Berg folds
melijomia folds
*** FLOP *** [3c 3s 6c]
OscarJR bets 0.09€
KON-2-PEUTE folds
OscarJR collected 0.32€ from pot
*** SUMMARY ***
Total pot 0.32€ | Rake 0.02€
Board: [3c 3s 6c]
Seat 3: OscarJR won 0.32€


Winamax Poker - HOLD-UP "Colorado" - HandId: #19116069-202790-1701333924 - Holdem no limit (0.01€/0.02€) - 2023/11/30 08:45:24 UTC
Table: 'Colorado' 6-max (real money) Seat #6 is the button
Seat 1: LaFobie31 (2€)
Seat 2: Ga31k (2.06€)
Seat 3: Scr.squirrel (2€)
Seat 4: gueyf (2.06€)
Seat 5: Fried Berg (1.60€)
Seat 6: Rahl6 (2€)
*** ANTE/BLINDS ***
LaFobie31 posts small blind 0.01€
Ga31k posts big blind 0.02€
Dealt to Fried Berg [Kd Qs]
*** PRE-FLOP *** 
Scr.squirrel folds
gueyf folds
Fried Berg raises 0.04€ to 0.06€
Rahl6 folds
LaFobie31 folds
Ga31k calls 0.04€
*** FLOP *** [5d As 7d]
Ga31k checks
Fried Berg checks
*** TURN *** [5d As 7d][3h]
Ga31k checks
Fried Berg checks
*** RIVER *** [5d As 7d 3h][Jc]
Ga31k checks
Fried Berg checks
*** SHOW DOWN ***
Fried Berg shows [Kd Qs] (High card : Ace)
Ga31k shows [Qc Js] (One pair : Jacks)
Ga31k collected 0.12€ from pot
*** SUMMARY ***
Total pot 0.12€ | Rake 0.01€
Board: [5d As 7d 3h Jc]
Seat 2: Ga31k (big blind) showed [Qc Js] and won 0.12€ with One pair : Jacks
Seat 5: Fried Berg showed [Kd Qs] and lost with High card : Ace


Winamax Poker - HOLD-UP "Colorado" - HandId: #19116069-202820-1701333959 - Holdem no limit (0.01€/0.02€) - 2023/11/30 08:45:59 UTC
Table: 'Colorado' 6-max (real money) Seat #6 is the button
Seat 1: Ga31k (2.12€)
Seat 2: Fried Berg (1.54€)
Seat 3: melijomia (2.01€)
Seat 4: Rahl6 (2€)
Seat 5: Scr.squirrel (1.66€)
Seat 6: LMG22_23 (4.79€)
*** ANTE/BLINDS ***
Ga31k posts small blind 0.01€
Fried Berg posts big blind 0.02€
Dealt to Fried Berg [8s 5s]
*** PRE-FLOP *** 
melijomia folds
Rahl6 raises 0.03€ to 0.05€
Scr.squirrel folds
LMG22_23 folds
Ga31k folds
Fried Berg folds
Rahl6 collected 0.08€ from pot
*** SUMMARY ***
Total pot 0.08€ | No rake
Seat 4: Rahl6 won 0.08€


Winamax Poker - HOLD-UP "Colorado" - HandId: #19116069-202828-1701333970 - Holdem no limit (0.01€/0.02€) - 2023/11/30 08:46:10 UTC
Table: 'Colorado' 6-max (real money) Seat #6 is the button
Seat 1: Fried Berg (1.52€)
Seat 2: badou29 (2€)
Seat 3: Ga31k (2.11€)
Seat 4: Ju89400 (1.14€)
Seat 5: LMG22_23 (4.79€)
Seat 6: melijomia (2€)
*** ANTE/BLINDS ***
Fried Berg posts small blind 0.01€
badou29 posts big blind 0.02€
Dealt to Fried Berg [7h 9d]
*** PRE-FLOP *** 
Ga31k folds
Ju89400 folds
LMG22_23 raises 0.03€ to 0.05€
melijomia folds
Fried Berg folds
badou29 folds
LMG22_23 collected 0.08€ from pot
*** SUMMARY ***
Total pot 0.08€ | No rake
Seat 5: LMG22_23 won 0.08€


Winamax Poker - HOLD-UP "Colorado" - HandId: #19116069-202830-1701333973 - Holdem no limit (0.01€/0.02€) - 2023/11/30 08:46:13 UTC
Table: 'Colorado' 6-max (real money) Seat #6 is the button
Seat 1: SirX (5.83€)
Seat 2: Cejargordas (4.81€)
Seat 3: Fried Berg (1.51€)
Seat 4: Val_Hawkins (3.21€)
Seat 5: LaFobie31 (2€)
Seat 6: Le Chiffre - (1.67€)
*** ANTE/BLINDS ***
SirX posts small blind 0.01€
Cejargordas posts big blind 0.02€
Dealt to Fried Berg [8s 6h]
*** PRE-FLOP *** 
Fried Berg folds
Val_Hawkins folds
LaFobie31 folds
Le Chiffre - folds
SirX raises 0.04€ to 0.06€
Cejargordas folds
SirX collected 0.08€ from pot
*** SUMMARY ***
Total pot 0.08€ | No rake
Seat 1: SirX (small blind) won 0.08€


Winamax Poker - HOLD-UP "Colorado" - HandId: #19116069-202831-1701333976 - Holdem no limit (0.01€/0.02€) - 2023/11/30 08:46:16 UTC
Table: 'Colorado' 6-max (real money) Seat #6 is the button
Seat 1: Val_Hawkins (3.21€)
Seat 2: Ju89400 (1.14€)
Seat 3: Fried Berg (1.51€)
Seat 4: antien1963 (2.02€)
Seat 5: Ga31k (2.02€)
Seat 6: Scr.squirrel (0.55€)
*** ANTE/BLINDS ***
Val_Hawkins posts small blind 0.01€
Ju89400 posts big blind 0.02€
Dealt to Fried Berg [8c 6c]
*** PRE-FLOP *** 
Fried Berg folds
antien1963 folds
Ga31k folds
Scr.squirrel folds
Val_Hawkins folds
Ju89400 collected 0.03€ from pot
*** SUMMARY ***
Total pot 0.03€ | No rake
Seat 2: Ju89400 (big blind) won 0.03€


Winamax Poker - HOLD-UP "Colorado" - HandId: #19116069-202835-1701333978 - Holdem no limit (0.01€/0.02€) - 2023/11/30 08:46:18 UTC
Table: 'Colorado' 6-max (real money) Seat #6 is the button
Seat 1: Fried Berg (1.51€)
Seat 2: slowreplay (2.02€)
Seat 3: LaFobie31 (2.93€)
Seat 4: 18GranDDuC18 (2.01€)
Seat 5: antien1963 (2.02€)
Seat 6: OnceUpoNaTym (1.48€)
*** ANTE/BLINDS ***
Fried Berg posts small blind 0.01€
slowreplay posts big blind 0.02€
Dealt to Fried Berg [As Td]
*** PRE-FLOP *** 
LaFobie31 folds
18GranDDuC18 folds
antien1963 folds
OnceUpoNaTym raises 0.02€ to 0.04€
Fried Berg calls 0.03€
slowreplay folds
*** FLOP *** [9h Kh Kc]
Fried Berg checks
OnceUpoNaTym checks
*** TURN *** [9h Kh Kc][Tc]
Fried Berg checks
OnceUpoNaTym checks
*** RIVER *** [9h Kh Kc Tc][2h]
Fried Berg bets 0.04€
OnceUpoNaTym calls 0.04€
*** SHOW DOWN ***
OnceUpoNaTym shows [Th 9c] (Two pairs : Kings and Tens)
Fried Berg shows [As Td] (Two pairs : Kings and Tens)
Fried Berg collected 0.16€ from pot
*** SUMMARY ***
Total pot 0.16€ | Rake 0.02€
Board: [9h Kh Kc Tc 2h]
Seat 1: Fried Berg (small blind) showed [As Td] and won 0.16€ with Two pairs : Kings and Tens
Seat 6: OnceUpoNaTym (button) showed [Th 9c] and lost with Two pairs : Kings and Tens


Winamax Poker - HOLD-UP "Colorado" - HandId: #19116069-202869-1701334017 - Holdem no limit (0.01€/0.02€) - 2023/11/30 08:46:57 UTC
Table: 'Colorado' 6-max (real money) Seat #6 is the button
Seat 1: LMG22_23 (2.19€)
Seat 2: slowreplay (2.25€)
Seat 3: -Mindfull- (1.76€)
Seat 4: Fried Berg (1.59€)
Seat 5: OnceUpoNaTym (1.40€)
Seat 6: Leane3010 (2€)
*** ANTE/BLINDS ***
LMG22_23 posts small blind 0.01€
slowreplay posts big blind 0.02€
Dealt to Fried Berg [2d 9s]
*** PRE-FLOP *** 
-Mindfull- folds
Fried Berg folds
OnceUpoNaTym folds
Leane3010 folds
LMG22_23 raises 0.03€ to 0.05€
slowreplay calls 0.03€
*** FLOP *** [4c 5c 3s]
LMG22_23 checks
slowreplay checks
*** TURN *** [4c 5c 3s][Qs]
LMG22_23 bets 0.04€
slowreplay calls 0.04€
*** RIVER *** [4c 5c 3s Qs][Tc]
LMG22_23 checks
slowreplay bets 0.09€
LMG22_23 folds
slowreplay collected 0.25€ from pot
*** SUMMARY ***
Total pot 0.25€ | Rake 0.02€
Board: [4c 5c 3s Qs Tc]
Seat 2: slowreplay (big blind) won 0.25€


Winamax Poker - HOLD-UP "Colorado" - HandId: #19116069-202877-1701334022 - Holdem no limit (0.01€/0.02€) - 2023/11/30 08:47:02 UTC
Table: 'Colorado' 6-max (real money) Seat #6 is the button
Seat 1: Cedlebon (2.54€)
Seat 2: La-Jonquera (1€)
Seat 3: lestat6993 (2.08€)
Seat 4: Fried Berg (1.59€)
Seat 5: -Mindfull- (1.76€)
Seat 6: gueyf (0.48€)
*** ANTE/BLINDS ***
Cedlebon posts small blind 0.01€
La-Jonquera posts big blind 0.02€
Dealt to Fried Berg [Js Th]
*** PRE-FLOP *** 
lestat6993 raises 0.03€ to 0.05€
Fried Berg folds
-Mindfull- folds
gueyf folds
Cedlebon folds
La-Jonquera folds
lestat6993 collected 0.08€ from pot
*** SUMMARY ***
Total pot 0.08€ | No rake
Seat 3: lestat6993 won 0.08€


Winamax Poker - HOLD-UP "Colorado" - HandId: #19116069-202882-1701334031 - Holdem no limit (0.01€/0.02€) - 2023/11/30 08:47:11 UTC
Table: 'Colorado' 6-max (real money) Seat #6 is the button
Seat 1: Bulzer45 (0.46€)
Seat 2: JirAiyAwAwA (2.07€)
Seat 3: La-Jonquera (0.97€)
Seat 4: morganeswolf (2.51€)
Seat 5: Fried Berg (1.59€)
Seat 6: melijomia (2€)
*** ANTE/BLINDS ***
Bulzer45 posts small blind 0.01€
JirAiyAwAwA posts big blind 0.02€
Dealt to Fried Berg [6s 2h]
*** PRE-FLOP *** 
La-Jonquera folds
morganeswolf folds
Fried Berg folds
melijomia folds
Bulzer45 folds
JirAiyAwAwA collected 0.03€ from pot
*** SUMMARY ***
Total pot 0.03€ | No rake
Seat 2: JirAiyAwAwA (big blind) won 0.03€


Winamax Poker - HOLD-UP "Colorado" - HandId: #19116069-202884-1701334033 - Holdem no limit (0.01€/0.02€) - 2023/11/30 08:47:13 UTC
Table: 'Colorado' 6-max (real money) Seat #6 is the button
Seat 1: Cejargordas (3.11€)
Seat 2: morganeswolf (2.51€)
Seat 3: LaFobie31 (2€)
Seat 4: Fried Berg (1.59€)
Seat 5: Leane3010 (4.22€)
Seat 6: Halmosthard (2.02€)
*** ANTE/BLINDS ***
Cejargordas posts small blind 0.01€
morganeswolf posts big blind 0.02€
Dealt to Fried Berg [Jc 2d]
*** PRE-FLOP *** 
LaFobie31 folds
Fried Berg folds
Leane3010 folds
Halmosthard folds
Cejargordas raises 0.04€ to 0.06€
morganeswolf calls 0.04€
*** FLOP *** [3d Ad 7c]
Cejargordas checks
morganeswolf bets 0.02€
Cejargordas folds
morganeswolf collected 0.13€ from pot
*** SUMMARY ***
Total pot 0.13€ | Rake 0.01€
Board: [3d Ad 7c]
Seat 2: morganeswolf (big blind) won 0.13€


Winamax Poker - HOLD-UP "Colorado" - HandId: #19116069-202885-1701334035 - Holdem no limit (0.01€/0.02€) - 2023/11/30 08:47:15 UTC
Table: 'Colorado' 6-max (real money) Seat #6 is the button
Seat 1: Sucre10 (1.98€)
Seat 2: Bulzer45 (0.45€)
Seat 3: Fried Berg (1.59€)
Seat 4: antien1963 (2.71€)
Seat 5: La-Jonquera (0.97€)
Seat 6: Rahl6 (2€)
*** ANTE/BLINDS ***
Sucre10 posts small blind 0.01€
Bulzer45 posts big blind 0.02€
Dealt to Fried Berg [Qc 3h]
*** PRE-FLOP *** 
Fried Berg folds
antien1963 folds
La-Jonquera calls 0.02€
Rahl6 calls 0.02€
Sucre10 raises 0.08€ to 0.10€
Bulzer45 folds
La-Jonquera calls 0.08€
Rahl6 calls 0.08€
*** FLOP *** [Ad 3c Js]
Sucre10 checks
La-Jonquera bets 0.32€
Rahl6 folds
Sucre10 folds
La-Jonquera collected 0.61€ from pot
*** SUMMARY ***
Total pot 0.61€ | Rake 0.03€
Board: [Ad 3c Js]
Seat 5: La-Jonquera won 0.61€


Winamax Poker - HOLD-UP "Colorado" - HandId: #19116069-202887-1701334037 - Holdem no limit (0.01€/0.02€) - 2023/11/30 08:47:17 UTC
Table: 'Colorado' 6-max (real money) Seat #6 is the button
Seat 1: Coolax3019 (4.53€)
Seat 2: -Mindfull- (1.76€)
Seat 3: LaFobie31 (2.88€)
Seat 4: OnceUpoNaTym (1.97€)
Seat 5: Fried Berg (1.59€)
Seat 6: Eisengrim (2.48€)
*** ANTE/BLINDS ***
Coolax3019 posts small blind 0.01€
-Mindfull- posts big blind 0.02€
Dealt to Fried Berg [Jd 4h]
*** PRE-FLOP *** 
LaFobie31 folds
OnceUpoNaTym folds
Fried Berg folds
Eisengrim folds
Coolax3019 calls 0.01€
-Mindfull- checks
*** FLOP *** [Qh 6s 2c]
Coolax3019 checks
-Mindfull- bets 0.02€
Coolax3019 calls 0.02€
*** TURN *** [Qh 6s 2c][9c]
Coolax3019 checks
-Mindfull- bets 0.03€
Coolax3019 folds
-Mindfull- collected 0.10€ from pot
*** SUMMARY ***
Total pot 0.10€ | Rake 0.01€
Board: [Qh 6s 2c 9c]
Seat 2: -Mindfull- (big blind) won 0.10€


Winamax Poker - HOLD-UP "Colorado" - HandId: #19116069-202889-1701334040 - Holdem no limit (0.01€/0.02€) - 2023/11/30 08:47:20 UTC
Table: 'Colorado' 6-max (real money) Seat #6 is the button
Seat 1: TimToBey (2.34€)
Seat 2: Fried Berg (1.59€)
Seat 3: Ga31k (2.47€)
Seat 4: fivyna14FF (1.47€)
Seat 5: antien1963 (2.71€)
Seat 6: OnceUpoNaTym (1.97€)
*** ANTE/BLINDS ***
TimToBey posts small blind 0.01€
Fried Berg posts big blind 0.02€
Dealt to Fried Berg [6c Qs]
*** PRE-FLOP *** 
Ga31k folds
fivyna14FF raises 0.02€ to 0.04€
antien1963 folds
OnceUpoNaTym calls 0.04€
TimToBey folds
Fried Berg folds
*** FLOP *** [2c 5s 9d]
fivyna14FF bets 0.02€
OnceUpoNaTym calls 0.02€
*** TURN *** [2c 5s 9d][Jc]
fivyna14FF bets 0.02€
OnceUpoNaTym calls 0.02€
*** RIVER *** [2c 5s 9d Jc][3s]
fivyna14FF bets 0.19€
OnceUpoNaTym folds
fivyna14FF collected 0.36€ from pot
*** SUMMARY ***
Total pot 0.36€ | Rake 0.02€
Board: [2c 5s 9d Jc 3s]
Seat 4: fivyna14FF won 0.36€


Winamax Poker - HOLD-UP "Colorado" - HandId: #19116069-202897-1701334054 - Holdem no limit (0.01€/0.02€) - 2023/11/30 08:47:34 UTC
Table: 'Colorado' 6-max (real money) Seat #6 is the button
Seat 1: melijomia (2.04€)
Seat 2: Fried Berg (1.57€)
Seat 3: JirAiyAwAwA (2.07€)
Seat 4: VashtaNerada (2.07€)
Seat 5: pamarmo79 (4.12€)
Seat 6: Eisengrim (2.48€)
*** ANTE/BLINDS ***
melijomia posts small blind 0.01€
Fried Berg posts big blind 0.02€
Dealt to Fried Berg [9d 4c]
*** PRE-FLOP *** 
JirAiyAwAwA folds
VashtaNerada raises 0.04€ to 0.06€
pamarmo79 folds
Eisengrim raises 0.12€ to 0.18€
melijomia folds
Fried Berg folds
VashtaNerada calls 0.12€
*** FLOP *** [6h 7d 7h]
VashtaNerada checks
Eisengrim bets 0.20€
VashtaNerada folds
Eisengrim collected 0.55€ from pot
*** SUMMARY ***
Total pot 0.55€ | Rake 0.04€
Board: [6h 7d 7h]
Seat 6: Eisengrim (button) won 0.55€


Winamax Poker - HOLD-UP "Colorado" - HandId: #19116069-202908-1701334068 - Holdem no limit (0.01€/0.02€) - 2023/11/30 08:47:48 UTC
Table: 'Colorado' 6-max (real money) Seat #6 is the button
Seat 1: Leane3010 (4.20€)
Seat 2: Le Chiffre - (1.73€)
Seat 3: Bulzer45 (0.50€)
Seat 4: g8o8k8u (2.12€)
Seat 5: SashaTDouss (4.94€)
Seat 6: Fried Berg (1.55€)
*** ANTE/BLINDS ***
Leane3010 posts small blind 0.01€
Le Chiffre - posts big blind 0.02€
Dealt to Fried Berg [6c 6h]
*** PRE-FLOP *** 
Bulzer45 calls 0.02€
g8o8k8u folds
SashaTDouss calls 0.02€
Fried Berg raises 0.10€ to 0.12€
Leane3010 folds
Le Chiffre - folds
Bulzer45 raises 0.38€ to 0.50€ and is all-in
SashaTDouss folds
Fried Berg calls 0.38€
*** FLOP *** [8c 3c 3s]
*** TURN *** [8c 3c 3s][Ac]
*** RIVER *** [8c 3c 3s Ac][Ts]
*** SHOW DOWN ***
Fried Berg shows [6c 6h] (Two pairs : 6 and 3)
Bulzer45 shows [Qc Qs] (Two pairs : Queens and 3)
Bulzer45 collected 0.94€ from pot
*** SUMMARY ***
Total pot 0.94€ | Rake 0.11€
Board: [8c 3c 3s Ac Ts]
Seat 3: Bulzer45 showed [Qc Qs] and won 0.94€ with Two pairs : Queens and 3
Seat 6: Fried Berg (button) showed [6c 6h] and lost with Two pairs : 6 and 3


Winamax Poker - HOLD-UP "Colorado" - HandId: #19116069-202997-1701334202 - Holdem no limit (0.01€/0.02€) - 2023/11/30 08:50:02 UTC
Table: 'Colorado' 6-max (real money) Seat #6 is the button
Seat 1: fivyna14FF (1.56€)
Seat 2: Idf83 (3.72€)
Seat 3: Fried Berg (1.05€)
Seat 4: Bulzer45 (0.94€)
Seat 5: Le Chiffre - (1.62€)
Seat 6: SashaTDouss (4.92€)
*** ANTE/BLINDS ***
fivyna14FF posts small blind 0.01€
Idf83 posts big blind 0.02€
Dealt to Fried Berg [Tc 7h]
*** PRE-FLOP *** 
Fried Berg folds
Bulzer45 calls 0.02€
Le Chiffre - folds
SashaTDouss calls 0.02€
fivyna14FF raises 0.02€ to 0.04€
Idf83 raises 0.12€ to 0.16€
Bulzer45 calls 0.14€
SashaTDouss folds
fivyna14FF calls 0.12€
*** FLOP *** [6c Jh 6s]
fivyna14FF bets 0.02€
Idf83 raises 0.18€ to 0.20€
Bulzer45 folds
fivyna14FF calls 0.18€
*** TURN *** [6c Jh 6s][2c]
fivyna14FF checks
Idf83 bets 0.32€
fivyna14FF calls 0.32€
*** RIVER *** [6c Jh 6s 2c][Kc]
fivyna14FF checks
Idf83 checks
*** SHOW DOWN ***
fivyna14FF shows [4h 4s] (Two pairs : 6 and 4)
Idf83 shows [As Jd] (Two pairs : Jacks and 6)
Idf83 collected 1.39€ from pot
*** SUMMARY ***
Total pot 1.39€ | Rake 0.15€
Board: [6c Jh 6s 2c Kc]
Seat 1: fivyna14FF (small blind) showed [4h 4s] and lost with Two pairs : 6 and 4
Seat 2: Idf83 (big blind) showed [As Jd] and won 1.39€ with Two pairs : Jacks and 6


Winamax Poker - HOLD-UP "Colorado" - HandId: #19116069-203001-1701334210 - Holdem no limit (0.01€/0.02€) - 2023/11/30 08:50:10 UTC
Table: 'Colorado' 6-max (real money) Seat #6 is the button
Seat 1: La-Jonquera (1.19€)
Seat 2: Cejargordas (2€)
Seat 3: lefraisier (2.36€)
Seat 4: Fried Berg (1.05€)
Seat 5: LaFobie31 (2.96€)
Seat 6: LMG22_23 (2.12€)
Hold-up to Pot: total 0.20€
*** ANTE/BLINDS ***
La-Jonquera posts small blind 0.01€
Cejargordas posts big blind 0.02€
Dealt to Fried Berg [9s 4c]
*** PRE-FLOP *** 
lefraisier calls 0.02€
Fried Berg folds
LaFobie31 calls 0.02€
LMG22_23 folds
La-Jonquera calls 0.01€
Cejargordas checks
*** FLOP *** [Jh Ks 8h]
La-Jonquera checks
Cejargordas checks
lefraisier checks
LaFobie31 checks
*** TURN *** [Jh Ks 8h][Kh]
La-Jonquera checks
Cejargordas checks
lefraisier checks
LaFobie31 checks
*** RIVER *** [Jh Ks 8h Kh][4h]
La-Jonquera checks
Cejargordas checks
lefraisier checks
LaFobie31 bets 0.28€
La-Jonquera folds
Cejargordas calls 0.28€
lefraisier folds
*** SHOW DOWN ***
Cejargordas shows [7h 5d] (Flush King high)
LaFobie31 shows [2d Ah] (Flush Ace high)
LaFobie31 collected 0.78€ from pot
*** SUMMARY ***
Total pot 0.78€ | Rake 0.06€
Board: [Jh Ks 8h Kh 4h]
Seat 2: Cejargordas (big blind) showed [7h 5d] and lost with Flush King high
Seat 5: LaFobie31 showed [2d Ah] and won 0.78€ with Flush Ace high


Winamax Poker - HOLD-UP "Colorado" - HandId: #19116069-203006-1701334219 - Holdem no limit (0.01€/0.02€) - 2023/11/30 08:50:19 UTC
Table: 'Colorado' 6-max (real money) Seat #6 is the button
Seat 1: Fried Berg (1.05€)
Seat 2: Ga31k (2€)
Seat 3: KON-2-PEUTE (2.08€)
Seat 4: 18GranDDuC18 (0.80€)
Seat 5: Eisengrim (2.61€)
Seat 6: Pierrof24 (1.81€)
*** ANTE/BLINDS ***
Fried Berg posts small blind 0.01€
Ga31k posts big blind 0.02€
Dealt to Fried Berg [Kc 3s]
*** PRE-FLOP *** 
KON-2-PEUTE raises 0.03€ to 0.05€
18GranDDuC18 folds
Eisengrim folds
Pierrof24 calls 0.05€
Fried Berg folds
Ga31k folds
*** FLOP *** [9d Js 7c]
KON-2-PEUTE bets 0.05€
Pierrof24 calls 0.05€
*** TURN *** [9d Js 7c][Ac]
KON-2-PEUTE checks
Pierrof24 bets 0.12€
KON-2-PEUTE folds
Pierrof24 collected 0.33€ from pot
*** SUMMARY ***
Total pot 0.33€ | Rake 0.02€
Board: [9d Js 7c Ac]
Seat 6: Pierrof24 (button) won 0.33€


Winamax Poker - HOLD-UP "Colorado" - HandId: #19116069-203018-1701334244 - Holdem no limit (0.01€/0.02€) - 2023/11/30 08:50:44 UTC
Table: 'Colorado' 6-max (real money) Seat #6 is the button
Seat 1: PIQSOU (2€)
Seat 2: LMG22_23 (4.18€)
Seat 3: slowreplay (2.24€)
Seat 4: Le Chiffre - (1.85€)
Seat 5: Fried Berg (1.04€)
Seat 6: Sucre10 (2€)
*** ANTE/BLINDS ***
PIQSOU posts small blind 0.01€
LMG22_23 posts big blind 0.02€
Dealt to Fried Berg [Js Qh]
*** PRE-FLOP *** 
slowreplay folds
Le Chiffre - folds
Fried Berg raises 0.02€ to 0.04€
Sucre10 raises 0.08€ to 0.12€
PIQSOU folds
LMG22_23 folds
Fried Berg calls 0.08€
*** FLOP *** [Kh Qc Kc]
Fried Berg checks
Sucre10 bets 0.09€
Fried Berg calls 0.09€
*** TURN *** [Kh Qc Kc][5h]
Fried Berg checks
Sucre10 checks
*** RIVER *** [Kh Qc Kc 5h][Kd]
Fried Berg checks
Sucre10 checks
*** SHOW DOWN ***
Sucre10 shows [4d Ad] (Trips of Kings)
Fried Berg shows [Js Qh] (Full of Kings and Queens)
Fried Berg collected 0.40€ from pot
*** SUMMARY ***
Total pot 0.40€ | Rake 0.05€
Board: [Kh Qc Kc 5h Kd]
Seat 5: Fried Berg showed [Js Qh] and won 0.40€ with Full of Kings and Queens
Seat 6: Sucre10 (button) showed [4d Ad] and lost with Trips of Kings


Winamax Poker - HOLD-UP "Colorado" - HandId: #19116069-203047-1701334291 - Holdem no limit (0.01€/0.02€) - 2023/11/30 08:51:31 UTC
Table: 'Colorado' 6-max (real money) Seat #6 is the button
Seat 1: Ga31k (2.13€)
Seat 2: Sucre10 (2€)
Seat 3: Cejargordas (2€)
Seat 4: slowreplay (2.24€)
Seat 5: LaFobie31 (3.44€)
Seat 6: Fried Berg (1.23€)
*** ANTE/BLINDS ***
Ga31k posts small blind 0.01€
Sucre10 posts big blind 0.02€
Dealt to Fried Berg [8d 9c]
*** PRE-FLOP *** 
Cejargordas raises 0.04€ to 0.06€
slowreplay folds
LaFobie31 folds
Fried Berg folds
Ga31k folds
Sucre10 folds
Cejargordas collected 0.09€ from pot
*** SUMMARY ***
Total pot 0.09€ | No rake
Seat 3: Cejargordas won 0.09€


Winamax Poker - HOLD-UP "Colorado" - HandId: #19116069-203053-1701334303 - Holdem no limit (0.01€/0.02€) - 2023/11/30 08:51:43 UTC
Table: 'Colorado' 6-max (real money) Seat #6 is the button
Seat 1: LaFobie31 (3.44€)
Seat 2: Fried Berg (1.23€)
Seat 3: 6...sco49 (1.97€)
Seat 4: Eisengrim (2€)
Seat 5: slowreplay (2.44€)
Seat 6: Rahl6 (4.76€)
*** ANTE/BLINDS ***
LaFobie31 posts small blind 0.01€
Fried Berg posts big blind 0.02€
Dealt to Fried Berg [2d 8s]
*** PRE-FLOP *** 
6...sco49 calls 0.02€
Eisengrim raises 0.07€ to 0.09€
slowreplay folds
Rahl6 folds
LaFobie31 calls 0.08€
Fried Berg folds
6...sco49 calls 0.07€
*** FLOP *** [Tc Js 3d]
LaFobie31 checks
6...sco49 checks
Eisengrim bets 0.10€
LaFobie31 calls 0.10€
6...sco49 folds
*** TURN *** [Tc Js 3d][Jd]
LaFobie31 checks
Eisengrim checks
*** RIVER *** [Tc Js 3d Jd][7s]
LaFobie31 bets 0.17€
Eisengrim folds
LaFobie31 collected 0.61€ from pot
*** SUMMARY ***
Total pot 0.61€ | Rake 0.05€
Board: [Tc Js 3d Jd 7s]
Seat 1: LaFobie31 (small blind) won 0.61€


Winamax Poker - HOLD-UP "Colorado" - HandId: #19116069-203056-1701334310 - Holdem no limit (0.01€/0.02€) - 2023/11/30 08:51:50 UTC
Table: 'Colorado' 6-max (real money) Seat #6 is the button
Seat 1: Fried Berg (1.21€)
Seat 2: Valetissimo (4.14€)
Seat 3: PIQSOU (2€)
Seat 4: OscarJR (0.46€)
Seat 5: Ga31k (2.12€)
Seat 6: morganeswolf (2.27€)
Hold-up to Pot: total 0.10€
*** ANTE/BLINDS ***
Fried Berg posts small blind 0.01€
Valetissimo posts big blind 0.02€
Dealt to Fried Berg [Qd Kd]
*** PRE-FLOP *** 
PIQSOU folds
OscarJR calls 0.02€
Ga31k folds
morganeswolf calls 0.02€
Fried Berg raises 1.19€ to 1.21€ and is all-in
Valetissimo folds
OscarJR folds
morganeswolf calls 1.19€
*** FLOP *** [5s 3h 2s]
*** TURN *** [5s 3h 2s][4s]
*** RIVER *** [5s 3h 2s 4s][9s]
*** SHOW DOWN ***
Fried Berg shows [Qd Kd] (High card : King)
morganeswolf shows [Qs 8s] (Flush Queen high)
morganeswolf collected 2.31€ from pot
*** SUMMARY ***
Total pot 2.31€ | Rake 0.25€
Board: [5s 3h 2s 4s 9s]
Seat 1: Fried Berg (small blind) showed [Qd Kd] and lost with High card : King
Seat 6: morganeswolf (button) showed [Qs 8s] and won 2.31€ with Flush Queen high


Winamax Poker - HOLD-UP "Colorado" - HandId: #19116069-203087-1701334370 - Holdem no limit (0.01€/0.02€) - 2023/11/30 08:52:50 UTC
Table: 'Colorado' 6-max (real money) Seat #6 is the button
Seat 1: PIQSOU (2€)
Seat 2: Fried Berg (0.50€)
Seat 3: Mc_CaIN (0.55€)
Seat 4: Bulzer45 (0.27€)
Seat 5: LMG22_23 (6.81€)
Seat 6: lefraisier (2.26€)
*** ANTE/BLINDS ***
PIQSOU posts small blind 0.01€
Fried Berg posts big blind 0.02€
Dealt to Fried Berg [3s 9c]
*** PRE-FLOP *** 
Mc_CaIN folds
Bulzer45 folds
LMG22_23 folds
lefraisier folds
PIQSOU folds
Fried Berg collected 0.03€ from pot
*** SUMMARY ***
Total pot 0.03€ | No rake
Seat 2: Fried Berg (big blind) won 0.03€


Winamax Poker - HOLD-UP "Colorado" - HandId: #19116069-203100-1701334389 - Holdem no limit (0.01€/0.02€) - 2023/11/30 08:53:09 UTC
Table: 'Colorado' 6-max (real money) Seat #6 is the button
Seat 1: La-Jonquera (1.12€)
Seat 2: OnceUpoNaTym (1.80€)
Seat 3: Prayade (7.26€)
Seat 4: 18GranDDuC18 (0.36€)
Seat 5: LMG22_23 (2.71€)
Seat 6: Fried Berg (0.51€)
Hold-up to Pot: total 0.10€
*** ANTE/BLINDS ***
La-Jonquera posts small blind 0.01€
OnceUpoNaTym posts big blind 0.02€
Dealt to Fried Berg [9c 4s]
*** PRE-FLOP *** 
Prayade folds
18GranDDuC18 raises 0.34€ to 0.36€ and is all-in
LMG22_23 folds
Fried Berg folds
La-Jonquera calls 0.35€
OnceUpoNaTym folds
*** FLOP *** [5c 6s Qc]
*** TURN *** [5c 6s Qc][7s]
*** RIVER *** [5c 6s Qc 7s][3s]
*** SHOW DOWN ***
La-Jonquera shows [Kh Kc] (One pair : Kings)
18GranDDuC18 shows [Ac Ah] (One pair : Aces)
18GranDDuC18 collected 0.77€ from pot
*** SUMMARY ***
Total pot 0.77€ | Rake 0.07€
Board: [5c 6s Qc 7s 3s]
Seat 1: La-Jonquera (small blind) showed [Kh Kc] and lost with One pair : Kings
Seat 4: 18GranDDuC18 showed [Ac Ah] and won 0.77€ with One pair : Aces


Winamax Poker - HOLD-UP "Colorado" - HandId: #19116069-203108-1701334408 - Holdem no limit (0.01€/0.02€) - 2023/11/30 08:53:28 UTC
Table: 'Colorado' 6-max (real money) Seat #6 is the button
Seat 1: LMG22_23 (6.81€)
Seat 2: slowreplay (2.53€)
Seat 3: Rahl6 (2.03€)
Seat 4: Fried Berg (0.51€)
Seat 5: Pierrof24 (2.14€)
Seat 6: Coolax3019 (2.97€)
Hold-up to Pot: total 0.10€
*** ANTE/BLINDS ***
LMG22_23 posts small blind 0.01€
slowreplay posts big blind 0.02€
Dealt to Fried Berg [Kd 6h]
*** PRE-FLOP *** 
Rahl6 folds
Fried Berg folds
Pierrof24 folds
Coolax3019 calls 0.02€
LMG22_23 raises 0.04€ to 0.06€
slowreplay folds
Coolax3019 calls 0.04€
*** FLOP *** [5s 5c 9c]
LMG22_23 checks
Coolax3019 checks
*** TURN *** [5s 5c 9c][Ah]
LMG22_23 bets 0.08€
Coolax3019 calls 0.08€
*** RIVER *** [5s 5c 9c Ah][3s]
LMG22_23 checks
Coolax3019 checks
*** SHOW DOWN ***
LMG22_23 shows [Jh Qh] (One pair : 5)
Coolax3019 shows [3h 2h] (Two pairs : 5 and 3)
Coolax3019 collected 0.37€ from pot
*** SUMMARY ***
Total pot 0.37€ | Rake 0.03€
Board: [5s 5c 9c Ah 3s]
Seat 1: LMG22_23 (small blind) showed [Jh Qh] and lost with One pair : 5
Seat 6: Coolax3019 (button) showed [3h 2h] and won 0.37€ with Two pairs : 5 and 3


Winamax Poker - HOLD-UP "Colorado" - HandId: #19116069-203112-1701334417 - Holdem no limit (0.01€/0.02€) - 2023/11/30 08:53:37 UTC
Table: 'Colorado' 6-max (real money) Seat #6 is the button
Seat 1: OnceUpoNaTym (1.80€)
Seat 2: Rahl6 (2.18€)
Seat 3: Fried Berg (0.51€)
Seat 4: Prayade (7.26€)
Seat 5: Ga31k (2.17€)
Seat 6: Pierrof24 (2.14€)
*** ANTE/BLINDS ***
OnceUpoNaTym posts small blind 0.01€
Rahl6 posts big blind 0.02€
Dealt to Fried Berg [7s Qc]
*** PRE-FLOP *** 
Fried Berg folds
Prayade folds
Ga31k folds
Pierrof24 raises 0.02€ to 0.04€
OnceUpoNaTym folds
Rahl6 calls 0.02€
*** FLOP *** [3h 9s 2c]
Rahl6 checks
Pierrof24 checks
*** TURN *** [3h 9s 2c][Jh]
Rahl6 bets 0.05€
Pierrof24 calls 0.05€
*** RIVER *** [3h 9s 2c Jh][3c]
Rahl6 checks
Pierrof24 checks
*** SHOW DOWN ***
Pierrof24 shows [5h 6h] (One pair : 3)
Rahl6 shows [Jd 6c] (Two pairs : Jacks and 3)
Rahl6 collected 0.17€ from pot
*** SUMMARY ***
Total pot 0.17€ | Rake 0.02€
Board: [3h 9s 2c Jh 3c]
Seat 2: Rahl6 (big blind) showed [Jd 6c] and won 0.17€ with Two pairs : Jacks and 3
Seat 6: Pierrof24 (button) showed [5h 6h] and lost with One pair : 3


Winamax Poker - HOLD-UP "Colorado" - HandId: #19116069-203118-1701334426 - Holdem no limit (0.01€/0.02€) - 2023/11/30 08:53:46 UTC
Table: 'Colorado' 6-max (real money) Seat #6 is the button
Seat 1: TimToBey (4.29€)
Seat 2: OnceUpoNaTym (1.43€)
Seat 3: PIQSOU (2€)
Seat 4: Bulzer45 (1.07€)
Seat 5: Fried Berg (0.51€)
Seat 6: La-Jonquera (0.76€)
*** ANTE/BLINDS ***
TimToBey posts small blind 0.01€
OnceUpoNaTym posts big blind 0.02€
Dealt to Fried Berg [2c 7h]
*** PRE-FLOP *** 
PIQSOU folds
Bulzer45 folds
Fried Berg folds
La-Jonquera folds
TimToBey folds
OnceUpoNaTym collected 0.03€ from pot
*** SUMMARY ***
Total pot 0.03€ | No rake
Seat 2: OnceUpoNaTym (big blind) won 0.03€


Winamax Poker - HOLD-UP "Colorado" - HandId: #19116069-203121-1701334430 - Holdem no limit (0.01€/0.02€) - 2023/11/30 08:53:50 UTC
Table: 'Colorado' 6-max (real money) Seat #6 is the button
Seat 1: LA TOUR FL (3.41€)
Seat 2: SirX (4.03€)
Seat 3: Ga31k (2.17€)
Seat 4: Fried Berg (0.51€)
Seat 5: Bulzer45 (1.07€)
Seat 6: 18GranDDuC18 (0.75€)
*** ANTE/BLINDS ***
LA TOUR FL posts small blind 0.01€
SirX posts big blind 0.02€
Dealt to Fried Berg [5h Qc]
*** PRE-FLOP *** 
Ga31k folds
Fried Berg folds
Bulzer45 calls 0.02€
18GranDDuC18 folds
LA TOUR FL folds
SirX raises 0.04€ to 0.06€
Bulzer45 calls 0.04€
*** FLOP *** [7h Kc 9d]
SirX bets 0.08€
Bulzer45 calls 0.08€
*** TURN *** [7h Kc 9d][Td]
SirX bets 0.29€
Bulzer45 calls 0.29€
*** RIVER *** [7h Kc 9d Td][5d]
SirX bets 0.87€
Bulzer45 calls 0.64€ and is all-in
*** SHOW DOWN ***
SirX shows [6s 3h] (High card : King)
Bulzer45 shows [Js Ks] (One pair : Kings)
Bulzer45 collected 1.93€ from main pot
SirX collected 0.23€ from side pot 1
*** SUMMARY ***
Total pot 2.16€ | Rake 0.22€
Board: [7h Kc 9d Td 5d]
Seat 2: SirX (big blind) showed [6s 3h] and won 0.23€ with High card : King
Seat 5: Bulzer45 showed [Js Ks] and won 1.93€ with One pair : Kings


Winamax Poker - HOLD-UP "Colorado" - HandId: #19116069-203125-1701334435 - Holdem no limit (0.01€/0.02€) - 2023/11/30 08:53:55 UTC
Table: 'Colorado' 6-max (real money) Seat #6 is the button
Seat 1: Effray (2€)
Seat 2: lestat6993 (2.58€)
Seat 3: VashtaNerada (3.61€)
Seat 4: 18GranDDuC18 (0.75€)
Seat 5: Fried Berg (0.51€)
Seat 6: Ga31k (2€)
Hold-up to Pot: total 0.10€
*** ANTE/BLINDS ***
Effray posts small blind 0.01€
lestat6993 posts big blind 0.02€
Dealt to Fried Berg [5h Js]
*** PRE-FLOP *** 
VashtaNerada calls 0.02€
18GranDDuC18 folds
Fried Berg folds
Ga31k folds
Effray folds
lestat6993 checks
*** FLOP *** [Jd Kd 4c]
lestat6993 checks
VashtaNerada bets 0.15€
lestat6993 folds
VashtaNerada collected 0.29€ from pot
*** SUMMARY ***
Total pot 0.29€ | Rake 0.01€
Board: [Jd Kd 4c]
Seat 3: VashtaNerada won 0.29€


Winamax Poker - HOLD-UP "Colorado" - HandId: #19116069-203132-1701334442 - Holdem no limit (0.01€/0.02€) - 2023/11/30 08:54:02 UTC
Table: 'Colorado' 6-max (real money) Seat #6 is the button
Seat 1: 18GranDDuC18 (0.75€)
Seat 2: Sucre10 (2.08€)
Seat 3: LA TOUR FL (3.40€)
Seat 4: KON-2-PEUTE (3.76€)
Seat 5: PIQSOU (2.24€)
Seat 6: Fried Berg (0.51€)
*** ANTE/BLINDS ***
18GranDDuC18 posts small blind 0.01€
Sucre10 posts big blind 0.02€
Dealt to Fried Berg [Ts 3h]
*** PRE-FLOP *** 
LA TOUR FL folds
KON-2-PEUTE raises 3.74€ to 3.76€ and is all-in
PIQSOU folds
Fried Berg folds
18GranDDuC18 folds
Sucre10 folds
KON-2-PEUTE collected 3.79€ from pot
*** SUMMARY ***
Total pot 3.79€ | No rake
Seat 4: KON-2-PEUTE won 3.79€


Winamax Poker - HOLD-UP "Colorado" - HandId: #19116069-203135-1701334446 - Holdem no limit (0.01€/0.02€) - 2023/11/30 08:54:06 UTC
Table: 'Colorado' 6-max (real money) Seat #6 is the button
Seat 1: Fried Berg (0.51€)
Seat 2: Cejargordas (2.23€)
Seat 3: Effray (2€)
Seat 4: OnceUpoNaTym (1.44€)
Seat 5: Idf83 (4.42€)
Seat 6: 6...sco49 (1.89€)
*** ANTE/BLINDS ***
Fried Berg posts small blind 0.01€
Cejargordas posts big blind 0.02€
Dealt to Fried Berg [6c 7c]
*** PRE-FLOP *** 
Effray folds
OnceUpoNaTym folds
Idf83 folds
6...sco49 folds
Fried Berg raises 0.02€ to 0.04€
Cejargordas folds
Fried Berg collected 0.06€ from pot
*** SUMMARY ***
Total pot 0.06€ | No rake
Seat 1: Fried Berg (small blind) won 0.06€


Winamax Poker - HOLD-UP "Colorado" - HandId: #19116069-203144-1701334460 - Holdem no limit (0.01€/0.02€) - 2023/11/30 08:54:20 UTC
Table: 'Colorado' 6-max (real money) Seat #6 is the button
Seat 1: slowreplay (2.51€)
Seat 2: 18GranDDuC18 (0.74€)
Seat 3: Vingt Milles (0.50€)
Seat 4: Eisengrim (3.97€)
Seat 5: Fried Berg (0.53€)
Seat 6: Cejargordas (3.13€)
*** ANTE/BLINDS ***
slowreplay posts small blind 0.01€
18GranDDuC18 posts big blind 0.02€
Dealt to Fried Berg [Jd Ks]
*** PRE-FLOP *** 
Vingt Milles folds
Eisengrim raises 0.03€ to 0.05€
Fried Berg calls 0.05€
Cejargordas folds
slowreplay folds
18GranDDuC18 folds
*** FLOP *** [4s 7c 9c]
Eisengrim bets 0.05€
Fried Berg calls 0.05€
*** TURN *** [4s 7c 9c][5h]
Eisengrim checks
Fried Berg checks
*** RIVER *** [4s 7c 9c 5h][Kh]
Eisengrim bets 0.15€
Fried Berg calls 0.15€
*** SHOW DOWN ***
Eisengrim shows [Ah Jc] (High card : Ace)
Fried Berg shows [Jd Ks] (One pair : Kings)
Fried Berg collected 0.48€ from pot
*** SUMMARY ***
Total pot 0.48€ | Rake 0.05€
Board: [4s 7c 9c 5h Kh]
Seat 4: Eisengrim showed [Ah Jc] and lost with High card : Ace
Seat 5: Fried Berg showed [Jd Ks] and won 0.48€ with One pair : Kings


Winamax Poker - HOLD-UP "Colorado" - HandId: #19116069-203172-1701334505 - Holdem no limit (0.01€/0.02€) - 2023/11/30 08:55:05 UTC
Table: 'Colorado' 6-max (real money) Seat #6 is the button
Seat 1: Fried Berg (0.76€)
Seat 2: TimToBey (2.12€)
Seat 3: affable 5102 (0.20€)
Seat 4: Prayade (2.32€)
Seat 5: LMG22_23 (6.65€)
Seat 6: slowreplay (2.04€)
*** ANTE/BLINDS ***
Fried Berg posts small blind 0.01€
TimToBey posts big blind 0.02€
Dealt to Fried Berg [Qd 3c]
*** PRE-FLOP *** 
affable 5102 folds
Prayade folds
LMG22_23 folds
slowreplay folds
Fried Berg folds
TimToBey collected 0.03€ from pot
*** SUMMARY ***
Total pot 0.03€ | No rake
Seat 2: TimToBey (big blind) won 0.03€


Winamax Poker - HOLD-UP "Colorado" - HandId: #19116069-203185-1701334525 - Holdem no limit (0.01€/0.02€) - 2023/11/30 08:55:25 UTC
Table: 'Colorado' 6-max (real money) Seat #6 is the button
Seat 1: Rahl6 (4.66€)
Seat 2: Cedlebon (2€)
Seat 3: Fried Berg (0.75€)
Seat 4: slowreplay (3.04€)
Seat 5: LaFobie31 (2.81€)
Seat 6: OnceUpoNaTym (1.74€)
Hold-up to Pot: total 0.20€
*** ANTE/BLINDS ***
Rahl6 posts small blind 0.01€
Cedlebon posts big blind 0.02€
Dealt to Fried Berg [7c Qh]
*** PRE-FLOP *** 
Fried Berg folds
slowreplay folds
LaFobie31 folds
OnceUpoNaTym folds
Rahl6 raises 4.64€ to 4.66€ and is all-in
Cedlebon calls 1.98€ and is all-in
*** FLOP *** [8d 8s Ks]
*** TURN *** [8d 8s Ks][Kh]
*** RIVER *** [8d 8s Ks Kh][Jd]
*** SHOW DOWN ***
Rahl6 shows [Ad Tc] (Two pairs : Kings and 8)
Cedlebon shows [As Kd] (Full of Kings and 8)
Cedlebon collected 3.80€ from main pot
Rahl6 collected 2.66€ from side pot 1
*** SUMMARY ***
Total pot 6.46€ | Rake 0.40€
Board: [8d 8s Ks Kh Jd]
Seat 1: Rahl6 (small blind) showed [Ad Tc] and won 2.66€ with Two pairs : Kings and 8
Seat 2: Cedlebon (big blind) showed [As Kd] and won 3.80€ with Full of Kings and 8


Winamax Poker - HOLD-UP "Colorado" - HandId: #19116069-203191-1701334531 - Holdem no limit (0.01€/0.02€) - 2023/11/30 08:55:31 UTC
Table: 'Colorado' 6-max (real money) Seat #6 is the button
Seat 1: Prayade (2.02€)
Seat 2: Fried Berg (0.75€)
Seat 3: slowreplay (3.04€)
Seat 4: Le Chiffre - (1.76€)
Seat 5: Raging.Full (1.96€)
Seat 6: LaFobie31 (2.81€)
*** ANTE/BLINDS ***
Prayade posts small blind 0.01€
Fried Berg posts big blind 0.02€
Dealt to Fried Berg [Jc 7c]
*** PRE-FLOP *** 
slowreplay folds
Le Chiffre - raises 0.04€ to 0.06€
Raging.Full folds
LaFobie31 folds
Prayade folds
Fried Berg folds
Le Chiffre - collected 0.09€ from pot
*** SUMMARY ***
Total pot 0.09€ | No rake
Seat 4: Le Chiffre - won 0.09€


Winamax Poker - HOLD-UP "Colorado" - HandId: #19116069-203207-1701334557 - Holdem no limit (0.01€/0.02€) - 2023/11/30 08:55:57 UTC
Table: 'Colorado' 6-max (real money) Seat #6 is the button
Seat 1: Ga31k (2€)
Seat 2: BaSt0sBzH (2€)
Seat 3: LMG22_23 (6.65€)
Seat 4: Pierrof24 (1.61€)
Seat 5: SashaTDouss (4.85€)
Seat 6: Fried Berg (0.73€)
*** ANTE/BLINDS ***
Ga31k posts small blind 0.01€
BaSt0sBzH posts big blind 0.02€
Dealt to Fried Berg [Th Tc]
*** PRE-FLOP *** 
LMG22_23 folds
Pierrof24 folds
SashaTDouss raises 0.03€ to 0.05€
Fried Berg raises 0.10€ to 0.15€
Ga31k folds
BaSt0sBzH calls 0.13€
SashaTDouss calls 0.10€
*** FLOP *** [8h Kd 3h]
BaSt0sBzH checks
SashaTDouss checks
Fried Berg bets 0.10€
BaSt0sBzH raises 0.39€ to 0.49€
SashaTDouss folds
Fried Berg folds
BaSt0sBzH collected 0.98€ from pot
*** SUMMARY ***
Total pot 0.98€ | Rake 0.07€
Board: [8h Kd 3h]
Seat 2: BaSt0sBzH (big blind) won 0.98€


Winamax Poker - HOLD-UP "Colorado" - HandId: #19116069-203245-1701334630 - Holdem no limit (0.01€/0.02€) - 2023/11/30 08:57:10 UTC
Table: 'Colorado' 6-max (real money) Seat #6 is the button
Seat 1: SheeDou2150 (1.89€)
Seat 2: slowreplay (2.96€)
Seat 3: Effray (2€)
Seat 4: Fried Berg (0.48€)
Seat 5: La-Jonquera (1.02€)
Seat 6: KON-2-PEUTE (3.93€)
*** ANTE/BLINDS ***
SheeDou2150 posts small blind 0.01€
slowreplay posts big blind 0.02€
Dealt to Fried Berg [Ac Kh]
*** PRE-FLOP *** 
Effray folds
Fried Berg raises 0.03€ to 0.05€
La-Jonquera folds
KON-2-PEUTE calls 0.05€
SheeDou2150 folds
slowreplay folds
*** FLOP *** [2h 5h 8s]
Fried Berg bets 0.03€
KON-2-PEUTE raises 3.85€ to 3.88€ and is all-in
Fried Berg calls 0.40€ and is all-in
*** TURN *** [2h 5h 8s][4s]
*** RIVER *** [2h 5h 8s 4s][4h]
*** SHOW DOWN ***
Fried Berg shows [Ac Kh] (One pair : 4)
KON-2-PEUTE shows [Js Jc] (Two pairs : Jacks and 4)
KON-2-PEUTE collected 4.34€ from pot
*** SUMMARY ***
Total pot 4.34€ | Rake 0.10€
Board: [2h 5h 8s 4s 4h]
Seat 4: Fried Berg showed [Ac Kh] and lost with One pair : 4
Seat 6: KON-2-PEUTE (button) showed [Js Jc] and won 4.34€ with Two pairs : Jacks and 4


Winamax Poker - HOLD-UP "Colorado" - HandId: #19116069-203284-1701334697 - Holdem no limit (0.01€/0.02€) - 2023/11/30 08:58:17 UTC
Table: 'Colorado' 6-max (real money) Seat #6 is the button
Seat 1: Fried Berg (0.50€)
Seat 2: OnceUpoNaTym (1.48€)
Seat 3: Idf83 (4.39€)
Seat 4: Eisengrim (4.42€)
Seat 5: KON-2-PEUTE (4.34€)
Seat 6: OMMANIPADME (2.31€)
*** ANTE/BLINDS ***
Fried Berg posts small blind 0.01€
OnceUpoNaTym posts big blind 0.02€
Dealt to Fried Berg [3s Kd]
*** PRE-FLOP *** 
Idf83 folds
Eisengrim raises 0.03€ to 0.05€
KON-2-PEUTE folds
OMMANIPADME folds
Fried Berg folds
OnceUpoNaTym folds
Eisengrim collected 0.08€ from pot
*** SUMMARY ***
Total pot 0.08€ | No rake
Seat 4: Eisengrim won 0.08€


Winamax Poker - HOLD-UP "Colorado" - HandId: #19116069-203298-1701334710 - Holdem no limit (0.01€/0.02€) - 2023/11/30 08:58:30 UTC
Table: 'Colorado' 6-max (real money) Seat #6 is the button
Seat 1: 800KtasVu (2€)
Seat 2: Fried Berg (0.49€)
Seat 3: LMG22_23 (2.47€)
Seat 4: Bulzer45 (2.19€)
Seat 5: PIQSOU (2€)
Seat 6: OnceUpoNaTym (3.31€)
*** ANTE/BLINDS ***
800KtasVu posts small blind 0.01€
Fried Berg posts big blind 0.02€
Dealt to Fried Berg [Qh As]
*** PRE-FLOP *** 
LMG22_23 folds
Bulzer45 folds
PIQSOU raises 0.03€ to 0.05€
OnceUpoNaTym folds
800KtasVu folds
Fried Berg raises 0.10€ to 0.15€
PIQSOU folds
Fried Berg collected 0.21€ from pot
*** SUMMARY ***
Total pot 0.21€ | No rake
Seat 2: Fried Berg (big blind) won 0.21€


Winamax Poker - HOLD-UP "Colorado" - HandId: #19116069-203311-1701334733 - Holdem no limit (0.01€/0.02€) - 2023/11/30 08:58:53 UTC
Table: 'Colorado' 6-max (real money) Seat #6 is the button
Seat 1: Rahl6 (2€)
Seat 2: Fried Berg (0.55€)
Seat 3: Coolax3019 (2.75€)
Seat 4: RatitaKK (2.89€)
Seat 5: LA TOUR FL (2€)
Seat 6: PIQSOU (2€)
*** ANTE/BLINDS ***
Rahl6 posts small blind 0.01€
Fried Berg posts big blind 0.02€
Dealt to Fried Berg [Qs 6d]
*** PRE-FLOP *** 
Coolax3019 calls 0.02€
RatitaKK folds
LA TOUR FL calls 0.02€
PIQSOU calls 0.02€
Rahl6 raises 0.10€ to 0.12€
Fried Berg folds
Coolax3019 calls 0.10€
LA TOUR FL calls 0.10€
PIQSOU calls 0.10€
*** FLOP *** [Ad 3d 8s]
Rahl6 bets 0.33€
Coolax3019 calls 0.33€
LA TOUR FL folds
PIQSOU folds
*** TURN *** [Ad 3d 8s][Tc]
Rahl6 bets 1.55€ and is all-in
Coolax3019 calls 1.55€
*** RIVER *** [Ad 3d 8s Tc][9h]
*** SHOW DOWN ***
Coolax3019 shows [4d 8d] (One pair : 8)
Rahl6 shows [Kd As] (One pair : Aces)
Rahl6 collected 3.83€ from pot
*** SUMMARY ***
Total pot 3.83€ | Rake 0.43€
Board: [Ad 3d 8s Tc 9h]
Seat 1: Rahl6 (small blind) showed [Kd As] and won 3.83€ with One pair : Aces
Seat 3: Coolax3019 showed [4d 8d] and lost with One pair : 8


Winamax Poker - HOLD-UP "Colorado" - HandId: #19116069-203329-1701334759 - Holdem no limit (0.01€/0.02€) - 2023/11/30 08:59:19 UTC
Table: 'Colorado' 6-max (real money) Seat #6 is the button
Seat 1: avatar00 (0.58€)
Seat 2: Cejargordas (2.34€)
Seat 3: LMG22_23 (8.28€)
Seat 4: Fried Berg (0.53€)
Seat 5: Idf83 (4.05€)
Seat 6: LaFobie31 (2.12€)
Hold-up to Pot: total 0.10€
*** ANTE/BLINDS ***
avatar00 posts small blind 0.01€
Cejargordas posts big blind 0.02€
Dealt to Fried Berg [Ks 7c]
*** PRE-FLOP *** 
LMG22_23 folds
Fried Berg folds
Idf83 raises 0.03€ to 0.05€
LaFobie31 calls 0.05€
avatar00 folds
Cejargordas folds
*** FLOP *** [Jc Qd 4c]
Idf83 bets 0.08€
LaFobie31 calls 0.08€
*** TURN *** [Jc Qd 4c][9c]
Idf83 bets 0.20€
LaFobie31 calls 0.20€
*** RIVER *** [Jc Qd 4c 9c][3h]
Idf83 checks
LaFobie31 checks
*** SHOW DOWN ***
LaFobie31 shows [Ah Td] (High card : Ace)
Idf83 shows [Ad 9s] (One pair : 9)
Idf83 collected 0.72€ from pot
*** SUMMARY ***
Total pot 0.72€ | Rake 0.07€
Board: [Jc Qd 4c 9c 3h]
Seat 5: Idf83 showed [Ad 9s] and won 0.72€ with One pair : 9
Seat 6: LaFobie31 (button) showed [Ah Td] and lost with High card : Ace


Winamax Poker - HOLD-UP "Colorado" - HandId: #19116069-203337-1701334768 - Holdem no limit (0.01€/0.02€) - 2023/11/30 08:59:28 UTC
Table: 'Colorado' 6-max (real money) Seat #6 is the button
Seat 1: Prayade (2€)
Seat 2: S-aaron24 (2€)
Seat 3: Fried Berg (0.53€)
Seat 4: Bulzer45 (0.47€)
Seat 5: OMMANIPADME (2.44€)
Seat 6: badou29 (2€)
*** ANTE/BLINDS ***
Prayade posts small blind 0.01€
S-aaron24 posts big blind 0.02€
Dealt to Fried Berg [7s 2c]
*** PRE-FLOP *** 
Fried Berg folds
Bulzer45 folds
OMMANIPADME folds
badou29 folds
Prayade raises 0.05€ to 0.07€
S-aaron24 calls 0.05€
*** FLOP *** [Th 7h 4d]
Prayade checks
S-aaron24 checks
*** TURN *** [Th 7h 4d][Ad]
Prayade bets 0.04€
S-aaron24 calls 0.04€
*** RIVER *** [Th 7h 4d Ad][5c]
Prayade checks
S-aaron24 bets 0.17€
Prayade folds
S-aaron24 collected 0.37€ from pot
*** SUMMARY ***
Total pot 0.37€ | Rake 0.02€
Board: [Th 7h 4d Ad 5c]
Seat 2: S-aaron24 (big blind) won 0.37€


Winamax Poker - HOLD-UP "Colorado" - HandId: #19116069-203344-1701334779 - Holdem no limit (0.01€/0.02€) - 2023/11/30 08:59:39 UTC
Table: 'Colorado' 6-max (real money) Seat #6 is the button
Seat 1: Goldinher (0.45€)
Seat 2: OnceUpoNaTym (1.79€)
Seat 3: Cejargordas (2.32€)
Seat 4: Sucre10 (2€)
Seat 5: Fried Berg (0.53€)
Seat 6: slowreplay (2.13€)
*** ANTE/BLINDS ***
Goldinher posts small blind 0.01€
OnceUpoNaTym posts big blind 0.02€
Dealt to Fried Berg [Ah 3d]
*** PRE-FLOP *** 
Cejargordas folds
Sucre10 raises 0.03€ to 0.05€
Fried Berg folds
slowreplay folds
Goldinher calls 0.04€
OnceUpoNaTym calls 0.03€
*** FLOP *** [3s 8d As]
Goldinher bets 0.02€
OnceUpoNaTym calls 0.02€
Sucre10 raises 0.09€ to 0.11€
Goldinher folds
OnceUpoNaTym folds
Sucre10 collected 0.28€ from pot
*** SUMMARY ***
Total pot 0.28€ | Rake 0.02€
Board: [3s 8d As]
Seat 4: Sucre10 won 0.28€


Winamax Poker - HOLD-UP "Colorado" - HandId: #19116069-203347-1701334787 - Holdem no limit (0.01€/0.02€) - 2023/11/30 08:59:47 UTC
Table: 'Colorado' 6-max (real money) Seat #6 is the button
Seat 1: La-Jonquera (0.55€)
Seat 2: Cejargordas (2.32€)
Seat 3: Fried Berg (0.53€)
Seat 4: 18GranDDuC18 (1.46€)
Seat 5: Bulzer45 (2.40€)
Seat 6: 800KtasVu (2.05€)
*** ANTE/BLINDS ***
La-Jonquera posts small blind 0.01€
Cejargordas posts big blind 0.02€
Dealt to Fried Berg [2s 9c]
*** PRE-FLOP *** 
Fried Berg folds
18GranDDuC18 raises 0.03€ to 0.05€
Bulzer45 folds
800KtasVu folds
La-Jonquera folds
Cejargordas folds
18GranDDuC18 collected 0.08€ from pot
*** SUMMARY ***
Total pot 0.08€ | No rake
Seat 4: 18GranDDuC18 won 0.08€


Winamax Poker - HOLD-UP "Colorado" - HandId: #19116069-203350-1701334790 - Holdem no limit (0.01€/0.02€) - 2023/11/30 08:59:50 UTC
Table: 'Colorado' 6-max (real money) Seat #6 is the button
Seat 1: Coolax3019 (0.75€)
Seat 2: 800KtasVu (2.05€)
Seat 3: La-Jonquera (0.54€)
Seat 4: sopra61 (2.16€)
Seat 5: KON-2-PEUTE (4.33€)
Seat 6: Fried Berg (0.53€)
Hold-up to Pot: total 0.10€
*** ANTE/BLINDS ***
Coolax3019 posts small blind 0.01€
800KtasVu posts big blind 0.02€
Dealt to Fried Berg [Td 2s]
*** PRE-FLOP *** 
La-Jonquera calls 0.02€
sopra61 calls 0.02€
KON-2-PEUTE folds
Fried Berg folds
Coolax3019 calls 0.01€
800KtasVu checks
*** FLOP *** [9c 8s 2c]
Coolax3019 checks
800KtasVu checks
La-Jonquera checks
sopra61 checks
*** TURN *** [9c 8s 2c][6d]
Coolax3019 bets 0.18€
800KtasVu folds
La-Jonquera folds
sopra61 calls 0.18€
*** RIVER *** [9c 8s 2c 6d][7c]
Coolax3019 bets 0.55€ and is all-in
sopra61 folds
Coolax3019 collected 1.05€ from pot
*** SUMMARY ***
Total pot 1.05€ | Rake 0.04€
Board: [9c 8s 2c 6d 7c]
Seat 1: Coolax3019 (small blind) won 1.05€


Winamax Poker - HOLD-UP "Colorado" - HandId: #19116069-203355-1701334797 - Holdem no limit (0.01€/0.02€) - 2023/11/30 08:59:57 UTC
Table: 'Colorado' 6-max (real money) Seat #6 is the button
Seat 1: PIQSOU (2.31€)
Seat 2: KON-2-PEUTE (4.33€)
Seat 3: Bulzer45 (2.40€)
Seat 4: slowreplay (2.13€)
Seat 5: Fried Berg (0.53€)
Seat 6: BeOldEagle (3.64€)
*** ANTE/BLINDS ***
PIQSOU posts small blind 0.01€
KON-2-PEUTE posts big blind 0.02€
Dealt to Fried Berg [6h Ts]
*** PRE-FLOP *** 
Bulzer45 folds
slowreplay folds
Fried Berg folds
BeOldEagle raises 0.03€ to 0.05€
PIQSOU folds
KON-2-PEUTE folds
BeOldEagle collected 0.08€ from pot
*** SUMMARY ***
Total pot 0.08€ | No rake
Seat 6: BeOldEagle (button) won 0.08€


Winamax Poker - HOLD-UP "Colorado" - HandId: #19116069-203357-1701334801 - Holdem no limit (0.01€/0.02€) - 2023/11/30 09:00:01 UTC
Table: 'Colorado' 6-max (real money) Seat #6 is the button
Seat 1: Bulzer45 (0.47€)
Seat 2: badou29 (2€)
Seat 3: Fried Berg (0.53€)
Seat 4: NoNo-MaHa2.0 (2.20€)
Seat 5: lefraisier (1.84€)
Seat 6: lestat6993 (2.94€)
*** ANTE/BLINDS ***
Bulzer45 posts small blind 0.01€
badou29 posts big blind 0.02€
Dealt to Fried Berg [Ac Jd]
*** PRE-FLOP *** 
Fried Berg raises 0.03€ to 0.05€
NoNo-MaHa2.0 folds
lefraisier folds
lestat6993 folds
Bulzer45 folds
badou29 folds
Fried Berg collected 0.08€ from pot
*** SUMMARY ***
Total pot 0.08€ | No rake
Seat 3: Fried Berg won 0.08€


Winamax Poker - HOLD-UP "Colorado" - HandId: #19116069-203365-1701334810 - Holdem no limit (0.01€/0.02€) - 2023/11/30 09:00:10 UTC
Table: 'Colorado' 6-max (real money) Seat #6 is the button
Seat 1: LA TOUR FL (2.01€)
Seat 2: Fried Berg (0.56€)
Seat 3: slowreplay (2.47€)
Seat 4: OnceUpoNaTym (2.52€)
Seat 5: gagnejamais4 (3.89€)
Seat 6: RatitaKK (2.64€)
*** ANTE/BLINDS ***
LA TOUR FL posts small blind 0.01€
Fried Berg posts big blind 0.02€
Dealt to Fried Berg [6d 5s]
*** PRE-FLOP *** 
slowreplay raises 0.03€ to 0.05€
OnceUpoNaTym folds
gagnejamais4 folds
RatitaKK folds
LA TOUR FL folds
Fried Berg folds
slowreplay collected 0.08€ from pot
*** SUMMARY ***
Total pot 0.08€ | No rake
Seat 3: slowreplay won 0.08€


Winamax Poker - HOLD-UP "Colorado" - HandId: #19116069-203372-1701334817 - Holdem no limit (0.01€/0.02€) - 2023/11/30 09:00:17 UTC
Table: 'Colorado' 6-max (real money) Seat #6 is the button
Seat 1: Fried Berg (0.54€)
Seat 2: 18GranDDuC18 (2.01€)
Seat 3: PIQSOU (2.30€)
Seat 4: Cedlebon (6.07€)
Seat 5: OnceUpoNaTym (2.52€)
Seat 6: BeOldEagle (3.67€)
*** ANTE/BLINDS ***
Fried Berg posts small blind 0.01€
18GranDDuC18 posts big blind 0.02€
Dealt to Fried Berg [9h 5h]
*** PRE-FLOP *** 
PIQSOU raises 0.03€ to 0.05€
Cedlebon folds
OnceUpoNaTym folds
BeOldEagle folds
Fried Berg folds
18GranDDuC18 raises 0.11€ to 0.16€
PIQSOU folds
18GranDDuC18 collected 0.22€ from pot
*** SUMMARY ***
Total pot 0.22€ | No rake
Seat 2: 18GranDDuC18 (big blind) won 0.22€


Winamax Poker - HOLD-UP "Colorado" - HandId: #19116069-203382-1701334832 - Holdem no limit (0.01€/0.02€) - 2023/11/30 09:00:32 UTC
Table: 'Colorado' 6-max (real money) Seat #6 is the button
Seat 1: Fried Berg (0.53€)
Seat 2: Bulzer45 (1.23€)
Seat 3: slowreplay (2.80€)
Seat 4: OnceUpoNaTym (1.70€)
Seat 5: LMG22_23 (2.48€)
Seat 6: Rahl6 (3.81€)
*** ANTE/BLINDS ***
Fried Berg posts small blind 0.01€
Bulzer45 posts big blind 0.02€
Dealt to Fried Berg [Qs 5s]
*** PRE-FLOP *** 
slowreplay folds
OnceUpoNaTym folds
LMG22_23 folds
Rahl6 folds
Fried Berg raises 0.02€ to 0.04€
Bulzer45 folds
Fried Berg collected 0.06€ from pot
*** SUMMARY ***
Total pot 0.06€ | No rake
Seat 1: Fried Berg (small blind) won 0.06€


Winamax Poker - HOLD-UP "Colorado" - HandId: #19116069-203408-1701334861 - Holdem no limit (0.01€/0.02€) - 2023/11/30 09:01:01 UTC
Table: 'Colorado' 6-max (real money) Seat #6 is the button
Seat 1: BaSt0sBzH (2.73€)
Seat 2: LA TOUR FL (2.30€)
Seat 3: ZenoidZ (1.77€)
Seat 4: Fried Berg (0.55€)
Seat 5: Eisengrim (2€)
Seat 6: NoNo-MaHa2.0 (2.15€)
*** ANTE/BLINDS ***
BaSt0sBzH posts small blind 0.01€
LA TOUR FL posts big blind 0.02€
Dealt to Fried Berg [Qs 6d]
*** PRE-FLOP *** 
ZenoidZ calls 0.02€
Fried Berg folds
Eisengrim folds
NoNo-MaHa2.0 folds
BaSt0sBzH calls 0.01€
LA TOUR FL checks
*** FLOP *** [Th 4c Js]
BaSt0sBzH checks
LA TOUR FL checks
ZenoidZ checks
*** TURN *** [Th 4c Js][2c]
BaSt0sBzH checks
LA TOUR FL bets 0.03€
ZenoidZ calls 0.03€
BaSt0sBzH folds
*** RIVER *** [Th 4c Js 2c][Kd]
LA TOUR FL bets 0.09€
ZenoidZ folds
LA TOUR FL collected 0.20€ from pot
*** SUMMARY ***
Total pot 0.20€ | Rake 0.01€
Board: [Th 4c Js 2c Kd]
Seat 2: LA TOUR FL (big blind) won 0.20€


Winamax Poker - HOLD-UP "Colorado" - HandId: #19116069-203415-1701334870 - Holdem no limit (0.01€/0.02€) - 2023/11/30 09:01:10 UTC
Table: 'Colorado' 6-max (real money) Seat #6 is the button
Seat 1: KON-2-PEUTE (2€)
Seat 2: Prayade (2€)
Seat 3: Bulzer45 (2.38€)
Seat 4: LMG22_23 (6.56€)
Seat 5: lestat6993 (2.93€)
Seat 6: Fried Berg (0.55€)
*** ANTE/BLINDS ***
KON-2-PEUTE posts small blind 0.01€
Prayade posts big blind 0.02€
Dealt to Fried Berg [As Qs]
*** PRE-FLOP *** 
Bulzer45 folds
LMG22_23 folds
lestat6993 raises 0.03€ to 0.05€
Fried Berg raises 0.10€ to 0.15€
KON-2-PEUTE folds
Prayade folds
lestat6993 folds
Fried Berg collected 0.23€ from pot
*** SUMMARY ***
Total pot 0.23€ | No rake
Seat 6: Fried Berg (button) won 0.23€


Winamax Poker - HOLD-UP "Colorado" - HandId: #19116069-203438-1701334897 - Holdem no limit (0.01€/0.02€) - 2023/11/30 09:01:37 UTC
Table: 'Colorado' 6-max (real money) Seat #6 is the button
Seat 1: Bulzer45 (2.36€)
Seat 2: Eisengrim (2.25€)
Seat 3: Tatodu64 (2.43€)
Seat 4: badou29 (2€)
Seat 5: Dim city (3.05€)
Seat 6: Fried Berg (0.63€)
*** ANTE/BLINDS ***
Bulzer45 posts small blind 0.01€
Eisengrim posts big blind 0.02€
Dealt to Fried Berg [Kh 4c]
*** PRE-FLOP *** 
Tatodu64 folds
badou29 folds
Dim city folds
Fried Berg folds
Bulzer45 folds
Eisengrim collected 0.03€ from pot
*** SUMMARY ***
Total pot 0.03€ | No rake
Seat 2: Eisengrim (big blind) won 0.03€


Winamax Poker - HOLD-UP "Colorado" - HandId: #19116069-203451-1701334918 - Holdem no limit (0.01€/0.02€) - 2023/11/30 09:01:58 UTC
Table: 'Colorado' 6-max (real money) Seat #6 is the button
Seat 1: Prayade (3.16€)
Seat 2: LMG22_23 (8.12€)
Seat 3: Fried Berg (0.63€)
Seat 4: S-aaron24 (2.08€)
Seat 5: Berig (1.95€)
Seat 6: Bulzer45 (1.18€)
*** ANTE/BLINDS ***
Prayade posts small blind 0.01€
LMG22_23 posts big blind 0.02€
Dealt to Fried Berg [Kd 8s]
*** PRE-FLOP *** 
Fried Berg folds
S-aaron24 folds
Berig folds
Bulzer45 folds
Prayade folds
LMG22_23 collected 0.03€ from pot
*** SUMMARY ***
Total pot 0.03€ | No rake
Seat 2: LMG22_23 (big blind) won 0.03€


Winamax Poker - HOLD-UP "Colorado" - HandId: #19116069-203453-1701334923 - Holdem no limit (0.01€/0.02€) - 2023/11/30 09:02:03 UTC
Table: 'Colorado' 6-max (real money) Seat #6 is the button
Seat 1: Eisengrim (2.26€)
Seat 2: TimToBey (2.69€)
Seat 3: Dim city (3.04€)
Seat 4: Fried Berg (0.63€)
Seat 5: Effray (3.63€)
Seat 6: Bulzer45 (1.18€)
*** ANTE/BLINDS ***
Eisengrim posts small blind 0.01€
TimToBey posts big blind 0.02€
Dealt to Fried Berg [Kh Qh]
*** PRE-FLOP *** 
Dim city folds
Fried Berg raises 0.04€ to 0.06€
Effray folds
Bulzer45 folds
Eisengrim folds
TimToBey folds
Fried Berg collected 0.09€ from pot
*** SUMMARY ***
Total pot 0.09€ | No rake
Seat 4: Fried Berg won 0.09€


Winamax Poker - HOLD-UP "Colorado" - HandId: #19116069-203468-1701334939 - Holdem no limit (0.01€/0.02€) - 2023/11/30 09:02:19 UTC
Table: 'Colorado' 6-max (real money) Seat #6 is the button
Seat 1: KON-2-PEUTE (4.25€)
Seat 2: avatar00 (0.65€)
Seat 3: lestat6993 (3.02€)
Seat 4: Berig (1.92€)
Seat 5: Fried Berg (0.66€)
Seat 6: Vingt Milles (1.10€)
*** ANTE/BLINDS ***
KON-2-PEUTE posts small blind 0.01€
avatar00 posts big blind 0.02€
Dealt to Fried Berg [8h 7c]
*** PRE-FLOP *** 
lestat6993 folds
Berig folds
Fried Berg folds
Vingt Milles folds
KON-2-PEUTE folds
avatar00 collected 0.03€ from pot
*** SUMMARY ***
Total pot 0.03€ | No rake
Seat 2: avatar00 (big blind) won 0.03€


Winamax Poker - HOLD-UP "Colorado" - HandId: #19116069-203475-1701334947 - Holdem no limit (0.01€/0.02€) - 2023/11/30 09:02:27 UTC
Table: 'Colorado' 6-max (real money) Seat #6 is the button
Seat 1: PIQSOU (2.02€)
Seat 2: OnceUpoNaTym (1.68€)
Seat 3: sopra61 (2€)
Seat 4: lestat6993 (3€)
Seat 5: Fried Berg (0.66€)
Seat 6: Rahl6 (3.77€)
*** ANTE/BLINDS ***
PIQSOU posts small blind 0.01€
OnceUpoNaTym posts big blind 0.02€
Dealt to Fried Berg [Jh 5c]
*** PRE-FLOP *** 
sopra61 raises 0.02€ to 0.04€
lestat6993 folds
Fried Berg folds
Rahl6 calls 0.04€
PIQSOU folds
OnceUpoNaTym folds
*** FLOP *** [8s 5s Jd]
sopra61 bets 0.04€
Rahl6 calls 0.04€
*** TURN *** [8s 5s Jd][Jc]
sopra61 bets 0.07€
Rahl6 calls 0.07€
*** RIVER *** [8s 5s Jd Jc][6c]
sopra61 bets 0.12€
Rahl6 raises 0.12€ to 0.24€
sopra61 folds
Rahl6 collected 0.63€ from pot
*** SUMMARY ***
Total pot 0.63€ | Rake 0.06€
Board: [8s 5s Jd Jc 6c]
Seat 6: Rahl6 (button) won 0.63€


Winamax Poker - HOLD-UP "Colorado" - HandId: #19116069-203479-1701334953 - Holdem no limit (0.01€/0.02€) - 2023/11/30 09:02:33 UTC
Table: 'Colorado' 6-max (real money) Seat #6 is the button
Seat 1: S-aaron24 (2.06€)
Seat 2: 800KtasVu (2.13€)
Seat 3: lestat6993 (3€)
Seat 4: Kalendula (1.44€)
Seat 5: SashaTDouss (4.75€)
Seat 6: Fried Berg (0.66€)
*** ANTE/BLINDS ***
S-aaron24 posts small blind 0.01€
800KtasVu posts big blind 0.02€
Dealt to Fried Berg [Ts 9h]
*** PRE-FLOP *** 
lestat6993 folds
Kalendula folds
SashaTDouss raises 0.03€ to 0.05€
Fried Berg calls 0.05€
S-aaron24 folds
800KtasVu calls 0.03€
*** FLOP *** [4s 3c Jc]
800KtasVu checks
SashaTDouss checks
Fried Berg checks
*** TURN *** [4s 3c Jc][9c]
800KtasVu checks
SashaTDouss checks
Fried Berg checks
*** RIVER *** [4s 3c Jc 9c][6c]
800KtasVu checks
SashaTDouss bets 0.06€
Fried Berg calls 0.06€
800KtasVu calls 0.06€
*** SHOW DOWN ***
800KtasVu shows [4h Jd] (Two pairs : Jacks and 4)
Fried Berg shows [Ts 9h] (One pair : 9)
SashaTDouss shows [Ah Tc] (Flush Jack high)
SashaTDouss collected 0.31€ from pot
*** SUMMARY ***
Total pot 0.31€ | Rake 0.03€
Board: [4s 3c Jc 9c 6c]
Seat 2: 800KtasVu (big blind) showed [4h Jd] and lost with Two pairs : Jacks and 4
Seat 5: SashaTDouss showed [Ah Tc] and won 0.31€ with Flush Jack high
Seat 6: Fried Berg (button) showed [Ts 9h] and lost with One pair : 9


Winamax Poker - HOLD-UP "Colorado" - HandId: #19116069-203519-1701335214 - Holdem no limit (0.01€/0.02€) - 2023/11/30 09:06:54 UTC
Table: 'Colorado' 6-max (real money) Seat #6 is the button
Seat 1: Fried Berg (0.50€)
Seat 2: La-Jonquera (0.50€)
Seat 3: Hypra-taz (2.04€)
Seat 4: Pierrof24 (1.94€)
Seat 5: KON-2-PEUTE (3.67€)
Seat 6: badou29 (2€)
*** ANTE/BLINDS ***
Fried Berg posts small blind 0.01€
La-Jonquera posts big blind 0.02€
Dealt to Fried Berg [6d Ks]
*** PRE-FLOP *** 
Hypra-taz calls 0.02€
Pierrof24 folds
KON-2-PEUTE folds
badou29 folds
Fried Berg folds
La-Jonquera checks
*** FLOP *** [5c 9h Ac]
La-Jonquera checks
Hypra-taz bets 0.02€
La-Jonquera folds
Hypra-taz collected 0.06€ from pot
*** SUMMARY ***
Total pot 0.06€ | Rake 0.01€
Board: [5c 9h Ac]
Seat 3: Hypra-taz won 0.06€


Winamax Poker - HOLD-UP "Colorado" - HandId: #19116069-203521-1701335234 - Holdem no limit (0.01€/0.02€) - 2023/11/30 09:07:14 UTC
Table: 'Colorado' 6-max (real money) Seat #6 is the button
Seat 1: gagnejamais4 (3.92€)
Seat 2: Fried Berg (0.49€)
Seat 3: affable 5102 (0.69€)
Seat 4: Gildus44 (1.97€)
Seat 5: NoNo-MaHa2.0 (1.89€)
Seat 6: LeR6907 (1.99€)
*** ANTE/BLINDS ***
gagnejamais4 posts small blind 0.01€
Fried Berg posts big blind 0.02€
Dealt to Fried Berg [6h 7s]
*** PRE-FLOP *** 
affable 5102 folds
Gildus44 folds
NoNo-MaHa2.0 raises 0.04€ to 0.06€
LeR6907 calls 0.06€
gagnejamais4 folds
Fried Berg folds
*** FLOP *** [9c Jc Tc]
NoNo-MaHa2.0 bets 0.08€
LeR6907 calls 0.08€
*** TURN *** [9c Jc Tc][Qc]
NoNo-MaHa2.0 checks
LeR6907 bets 0.31€
NoNo-MaHa2.0 folds
LeR6907 collected 0.59€ from pot
*** SUMMARY ***
Total pot 0.59€ | Rake 0.03€
Board: [9c Jc Tc Qc]
Seat 6: LeR6907 (button) won 0.59€


Winamax Poker - HOLD-UP "Colorado" - HandId: #19116069-203522-1701335244 - Holdem no limit (0.01€/0.02€) - 2023/11/30 09:07:24 UTC
Table: 'Colorado' 6-max (real money) Seat #6 is the button
Seat 1: I-rhum-man28 (1.54€)
Seat 2: Vingt Milles (0.48€)
Seat 3: Fried Berg (0.47€)
Seat 4: affable 5102 (0.69€)
Seat 5: Gildus44 (1.97€)
Seat 6: l artiste ho (1.98€)
*** ANTE/BLINDS ***
I-rhum-man28 posts small blind 0.01€
Vingt Milles posts big blind 0.02€
Dealt to Fried Berg [3d 3h]
*** PRE-FLOP *** 
Fried Berg raises 0.02€ to 0.04€
affable 5102 folds
Gildus44 raises 0.11€ to 0.15€
l artiste ho folds
I-rhum-man28 folds
Vingt Milles folds
Fried Berg folds
Gildus44 collected 0.22€ from pot
*** SUMMARY ***
Total pot 0.22€ | No rake
Seat 5: Gildus44 won 0.22€


Winamax Poker - HOLD-UP "Colorado" - HandId: #19116069-203524-1701335258 - Holdem no limit (0.01€/0.02€) - 2023/11/30 09:07:38 UTC
Table: 'Colorado' 6-max (real money) Seat #6 is the button
Seat 1: Alexisdpp (0.81€)
Seat 2: KON-2-PEUTE (2€)
Seat 3: l artiste ho (1.98€)
Seat 4: Fried Berg (0.43€)
Seat 5: affable 5102 (0.69€)
Seat 6: gagnejamais4 (3.91€)
*** ANTE/BLINDS ***
Alexisdpp posts small blind 0.01€
KON-2-PEUTE posts big blind 0.02€
Dealt to Fried Berg [2h Ac]
*** PRE-FLOP *** 
l artiste ho folds
Fried Berg folds
affable 5102 folds
gagnejamais4 raises 0.04€ to 0.06€
Alexisdpp folds
KON-2-PEUTE folds
gagnejamais4 collected 0.09€ from pot
*** SUMMARY ***
Total pot 0.09€ | No rake
Seat 6: gagnejamais4 (button) won 0.09€


Winamax Poker - HOLD-UP "Colorado" - HandId: #19116069-203526-1701335263 - Holdem no limit (0.01€/0.02€) - 2023/11/30 09:07:43 UTC
Table: 'Colorado' 6-max (real money) Seat #6 is the button
Seat 1: OnceUpoNaTym (2€)
Seat 2: LeR6907 (2.13€)
Seat 3: I-rhum-man28 (1.53€)
Seat 4: Gildus44 (2.04€)
Seat 5: Fried Berg (0.43€)
Seat 6: affable 5102 (0.69€)
*** ANTE/BLINDS ***
OnceUpoNaTym posts small blind 0.01€
LeR6907 posts big blind 0.02€
Dealt to Fried Berg [6h 6c]
*** PRE-FLOP *** 
I-rhum-man28 folds
Gildus44 folds
Fried Berg raises 0.02€ to 0.04€
affable 5102 calls 0.04€
OnceUpoNaTym folds
LeR6907 calls 0.02€
*** FLOP *** [Td 5h Th]
LeR6907 checks
Fried Berg bets 0.07€
affable 5102 calls 0.07€
LeR6907 folds
*** TURN *** [Td 5h Th][As]
Fried Berg checks
affable 5102 checks
*** RIVER *** [Td 5h Th As][7s]
Fried Berg checks
affable 5102 checks
*** SHOW DOWN ***
affable 5102 shows [Jc Kd] (One pair : Tens)
Fried Berg shows [6h 6c] (Two pairs : Tens and 6)
Fried Berg collected 0.24€ from pot
*** SUMMARY ***
Total pot 0.24€ | Rake 0.03€
Board: [Td 5h Th As 7s]
Seat 5: Fried Berg showed [6h 6c] and won 0.24€ with Two pairs : Tens and 6
Seat 6: affable 5102 (button) showed [Jc Kd] and lost with One pair : Tens


Winamax Poker - HOLD-UP "Colorado" - HandId: #19116069-203536-1701335294 - Holdem no limit (0.01€/0.02€) - 2023/11/30 09:08:14 UTC
Table: 'Colorado' 6-max (real money) Seat #6 is the button
Seat 1: SirX (1.94€)
Seat 2: GriGri24 (1.99€)
Seat 3: FabWest (2€)
Seat 4: gagnejamais4 (3.94€)
Seat 5: affable 5102 (0.58€)
Seat 6: Fried Berg (0.56€)
*** ANTE/BLINDS ***
SirX posts small blind 0.01€
GriGri24 posts big blind 0.02€
Dealt to Fried Berg [Kc 4c]
*** PRE-FLOP *** 
FabWest folds
gagnejamais4 folds
affable 5102 calls 0.02€
Fried Berg raises 0.02€ to 0.04€
SirX calls 0.03€
GriGri24 folds
affable 5102 calls 0.02€
*** FLOP *** [Tc 8d 5d]
SirX checks
affable 5102 checks
Fried Berg checks
*** TURN *** [Tc 8d 5d][2d]
SirX bets 0.09€
affable 5102 calls 0.09€
Fried Berg folds
*** RIVER *** [Tc 8d 5d 2d][Qc]
SirX bets 0.21€
affable 5102 calls 0.21€
*** SHOW DOWN ***
SirX shows [Qh 7d] (One pair : Queens)
affable 5102 shows [Qs Kd] (One pair : Queens)
affable 5102 collected 0.67€ from pot
*** SUMMARY ***
Total pot 0.67€ | Rake 0.07€
Board: [Tc 8d 5d 2d Qc]
Seat 1: SirX (small blind) showed [Qh 7d] and lost with One pair : Queens
Seat 5: affable 5102 showed [Qs Kd] and won 0.67€ with One pair : Queens


Winamax Poker - HOLD-UP "Colorado" - HandId: #19116069-203543-1701335322 - Holdem no limit (0.01€/0.02€) - 2023/11/30 09:08:42 UTC
Table: 'Colorado' 6-max (real money) Seat #6 is the button
Seat 1: gagnejamais4 (3.92€)
Seat 2: badou29 (2€)
Seat 3: FabWest (2.07€)
Seat 4: Fried Berg (0.52€)
Seat 5: GriGri24 (1.97€)
Seat 6: Adrianohhhh (2€)
*** ANTE/BLINDS ***
gagnejamais4 posts small blind 0.01€
badou29 posts big blind 0.02€
Dealt to Fried Berg [Th 6c]
*** PRE-FLOP *** 
FabWest folds
Fried Berg folds
GriGri24 raises 0.03€ to 0.05€
Adrianohhhh folds
gagnejamais4 raises 0.10€ to 0.15€
badou29 folds
GriGri24 folds
gagnejamais4 collected 0.22€ from pot
*** SUMMARY ***
Total pot 0.22€ | No rake
Seat 1: gagnejamais4 (small blind) won 0.22€


Winamax Poker - HOLD-UP "Colorado" - HandId: #19116069-203548-1701335332 - Holdem no limit (0.01€/0.02€) - 2023/11/30 09:08:52 UTC
Table: 'Colorado' 6-max (real money) Seat #6 is the button
Seat 1: gitPush (2.08€)
Seat 2: FabWest (2€)
Seat 3: affable 5102 (0.90€)
Seat 4: Gildus44 (2.01€)
Seat 5: Fried Berg (0.52€)
Seat 6: La-Jonquera (0.40€)
*** ANTE/BLINDS ***
gitPush posts small blind 0.01€
FabWest posts big blind 0.02€
Dealt to Fried Berg [Td Ks]
*** PRE-FLOP *** 
affable 5102 folds
Gildus44 folds
Fried Berg raises 0.02€ to 0.04€
La-Jonquera calls 0.04€
gitPush folds
FabWest calls 0.02€
*** FLOP *** [8h 9d 4c]
FabWest checks
Fried Berg checks
La-Jonquera checks
*** TURN *** [8h 9d 4c][Ad]
FabWest checks
Fried Berg checks
La-Jonquera checks
*** RIVER *** [8h 9d 4c Ad][3c]
FabWest checks
Fried Berg checks
La-Jonquera checks
*** SHOW DOWN ***
FabWest shows [Qc Jd] (High card : Ace)
Fried Berg shows [Td Ks] (High card : Ace)
La-Jonquera shows [5c Ah] (One pair : Aces)
La-Jonquera collected 0.12€ from pot
*** SUMMARY ***
Total pot 0.12€ | Rake 0.01€
Board: [8h 9d 4c Ad 3c]
Seat 2: FabWest (big blind) showed [Qc Jd] and lost with High card : Ace
Seat 5: Fried Berg showed [Td Ks] and lost with High card : Ace
Seat 6: La-Jonquera (button) showed [5c Ah] and won 0.12€ with One pair : Aces


Winamax Poker - HOLD-UP "Colorado" - HandId: #19116069-203562-1701335363 - Holdem no limit (0.01€/0.02€) - 2023/11/30 09:09:23 UTC
Table: 'Colorado' 6-max (real money) Seat #6 is the button
Seat 1: Fried Berg (0.48€)
Seat 2: LMG22_23 (1.99€)
Seat 3: Berig (2.05€)
Seat 4: NoNo-MaHa2.0 (1.73€)
Seat 5: FabWest (2€)
Seat 6: TimToBey (4.11€)
*** ANTE/BLINDS ***
Fried Berg posts small blind 0.01€
LMG22_23 posts big blind 0.02€
Dealt to Fried Berg [4d Ac]
*** PRE-FLOP *** 
Berig raises 0.04€ to 0.06€
NoNo-MaHa2.0 folds
FabWest folds
TimToBey folds
Fried Berg calls 0.05€
LMG22_23 folds
*** FLOP *** [As 6h Jd]
Fried Berg checks
Berig bets 0.09€
Fried Berg calls 0.09€
*** TURN *** [As 6h Jd][Tc]
Fried Berg checks
Berig bets 0.11€
Fried Berg calls 0.11€
*** RIVER *** [As 6h Jd Tc][4c]
Fried Berg checks
Berig bets 0.35€
Fried Berg calls 0.22€ and is all-in
*** SHOW DOWN ***
Fried Berg shows [4d Ac] (Two pairs : Aces and 4)
Berig shows [Ah Kc] (One pair : Aces)
Berig collected 0.13€ from side pot 1
Fried Berg collected 0.88€ from main pot
*** SUMMARY ***
Total pot 1.01€ | Rake 0.10€
Board: [As 6h Jd Tc 4c]
Seat 1: Fried Berg (small blind) showed [4d Ac] and won 0.88€ with Two pairs : Aces and 4
Seat 3: Berig showed [Ah Kc] and won 0.13€ with One pair : Aces


Winamax Poker - HOLD-UP "Colorado" - HandId: #19116069-203586-1701335422 - Holdem no limit (0.01€/0.02€) - 2023/11/30 09:10:22 UTC
Table: 'Colorado' 6-max (real money) Seat #6 is the button
Seat 1: Adrianohhhh (2€)
Seat 2: Fried Berg (0.88€)
Seat 3: GriGri24 (1.88€)
Seat 4: Berig (1.96€)
Seat 5: LMG22_23 (2€)
Seat 6: VashtaNerada (2€)
*** ANTE/BLINDS ***
Adrianohhhh posts small blind 0.01€
Fried Berg posts big blind 0.02€
Dealt to Fried Berg [5h 2c]
*** PRE-FLOP *** 
GriGri24 folds
Berig folds
LMG22_23 folds
VashtaNerada folds
Adrianohhhh folds
Fried Berg collected 0.03€ from pot
*** SUMMARY ***
Total pot 0.03€ | No rake
Seat 2: Fried Berg (big blind) won 0.03€


Winamax Poker - HOLD-UP "Colorado" - HandId: #19116069-203599-1701335446 - Holdem no limit (0.01€/0.02€) - 2023/11/30 09:10:46 UTC
Table: 'Colorado' 6-max (real money) Seat #6 is the button
Seat 1: KON-2-PEUTE (4.14€)
Seat 2: OnceUpoNaTym (1.27€)
Seat 3: Fried Berg (0.89€)
Seat 4: Adrianohhhh (2€)
Seat 5: FabWest (2€)
Seat 6: avatar00 (0.74€)
*** ANTE/BLINDS ***
KON-2-PEUTE posts small blind 0.01€
OnceUpoNaTym posts big blind 0.02€
Dealt to Fried Berg [7d 7s]
*** PRE-FLOP *** 
Fried Berg raises 0.04€ to 0.06€
Adrianohhhh folds
FabWest folds
avatar00 folds
KON-2-PEUTE calls 0.05€
OnceUpoNaTym folds
*** FLOP *** [6d 8s Ts]
KON-2-PEUTE checks
Fried Berg bets 0.05€
KON-2-PEUTE folds
Fried Berg collected 0.18€ from pot
*** SUMMARY ***
Total pot 0.18€ | Rake 0.01€
Board: [6d 8s Ts]
Seat 3: Fried Berg won 0.18€


Winamax Poker - HOLD-UP "Colorado" - HandId: #19116069-203608-1701335466 - Holdem no limit (0.01€/0.02€) - 2023/11/30 09:11:06 UTC
Table: 'Colorado' 6-max (real money) Seat #6 is the button
Seat 1: KON-2-PEUTE (4.08€)
Seat 2: Naga Viper (2€)
Seat 3: FabWest (2€)
Seat 4: Berig (2.67€)
Seat 5: Gildus44 (1.46€)
Seat 6: Fried Berg (0.96€)
*** ANTE/BLINDS ***
KON-2-PEUTE posts small blind 0.01€
Naga Viper posts big blind 0.02€
Dealt to Fried Berg [3c 8h]
*** PRE-FLOP *** 
FabWest folds
Berig folds
Gildus44 calls 0.02€
Fried Berg folds
KON-2-PEUTE folds
Naga Viper checks
*** FLOP *** [4d 5c 2d]
Naga Viper checks
Gildus44 bets 0.02€
Naga Viper calls 0.02€
*** TURN *** [4d 5c 2d][Kh]
Naga Viper checks
Gildus44 bets 0.02€
Naga Viper calls 0.02€
*** RIVER *** [4d 5c 2d Kh][7h]
Naga Viper checks
Gildus44 bets 0.02€
Naga Viper folds
Gildus44 collected 0.14€ from pot
*** SUMMARY ***
Total pot 0.14€ | Rake 0.01€
Board: [4d 5c 2d Kh 7h]
Seat 5: Gildus44 won 0.14€


Winamax Poker - HOLD-UP "Colorado" - HandId: #19116069-203610-1701335475 - Holdem no limit (0.01€/0.02€) - 2023/11/30 09:11:15 UTC
Table: 'Colorado' 6-max (real money) Seat #6 is the button
Seat 1: antien1963 (1.90€)
Seat 2: David Boring (2€)
Seat 3: Fried Berg (0.96€)
Seat 4: FabWest (2€)
Seat 5: KON-2-PEUTE (4.07€)
Seat 6: Berig (2.67€)
*** ANTE/BLINDS ***
antien1963 posts small blind 0.01€
David Boring posts big blind 0.02€
Dealt to Fried Berg [7s Kd]
*** PRE-FLOP *** 
Fried Berg folds
FabWest folds
KON-2-PEUTE folds
Berig folds
antien1963 folds
David Boring collected 0.03€ from pot
*** SUMMARY ***
Total pot 0.03€ | No rake
Seat 2: David Boring (big blind) won 0.03€


Winamax Poker - HOLD-UP "Colorado" - HandId: #19116069-203614-1701335485 - Holdem no limit (0.01€/0.02€) - 2023/11/30 09:11:25 UTC
Table: 'Colorado' 6-max (real money) Seat #6 is the button
Seat 1: H4bet (2€)
Seat 2: FabWest (2€)
Seat 3: Petit-g (0.99€)
Seat 4: Fried Berg (0.96€)
Seat 5: antien1963 (1.89€)
Seat 6: wAAlterrr (1.74€)
*** ANTE/BLINDS ***
H4bet posts small blind 0.01€
FabWest posts big blind 0.02€
Dealt to Fried Berg [6s Td]
*** PRE-FLOP *** 
Petit-g raises 0.73€ to 0.75€
Fried Berg folds
antien1963 folds
wAAlterrr folds
H4bet folds
FabWest folds
Petit-g collected 0.78€ from pot
*** SUMMARY ***
Total pot 0.78€ | No rake
Seat 3: Petit-g won 0.78€


Winamax Poker - HOLD-UP "Colorado" - HandId: #19116069-203617-1701335494 - Holdem no limit (0.01€/0.02€) - 2023/11/30 09:11:34 UTC
Table: 'Colorado' 6-max (real money) Seat #6 is the button
Seat 1: OnceUpoNaTym (1.17€)
Seat 2: antien1963 (1.89€)
Seat 3: TimToBey (2.13€)
Seat 4: H4bet (2€)
Seat 5: Fried Berg (0.96€)
Seat 6: Salvidm (2.22€)
*** ANTE/BLINDS ***
OnceUpoNaTym posts small blind 0.01€
antien1963 posts big blind 0.02€
Dealt to Fried Berg [8c 7d]
*** PRE-FLOP *** 
TimToBey raises 0.03€ to 0.05€
H4bet folds
Fried Berg folds
Salvidm folds
OnceUpoNaTym folds
antien1963 folds
TimToBey collected 0.08€ from pot
*** SUMMARY ***
Total pot 0.08€ | No rake
Seat 3: TimToBey won 0.08€


Winamax Poker - HOLD-UP "Colorado" - HandId: #19116069-203623-1701335501 - Holdem no limit (0.01€/0.02€) - 2023/11/30 09:11:41 UTC
Table: 'Colorado' 6-max (real money) Seat #6 is the button
Seat 1: LMG22_23 (2.46€)
Seat 2: Fried Berg (0.96€)
Seat 3: gitPush (2.46€)
Seat 4: Naga Viper (1.97€)
Seat 5: antien1963 (1.87€)
Seat 6: FabWest (2€)
*** ANTE/BLINDS ***
LMG22_23 posts small blind 0.01€
Fried Berg posts big blind 0.02€
Dealt to Fried Berg [6h Ts]
*** PRE-FLOP *** 
gitPush folds
Naga Viper folds
antien1963 folds
FabWest folds
LMG22_23 folds
Fried Berg collected 0.03€ from pot
*** SUMMARY ***
Total pot 0.03€ | No rake
Seat 2: Fried Berg (big blind) won 0.03€


Winamax Poker - HOLD-UP "Colorado" - HandId: #19116069-203627-1701335509 - Holdem no limit (0.01€/0.02€) - 2023/11/30 09:11:49 UTC
Table: 'Colorado' 6-max (real money) Seat #6 is the button
Seat 1: basenites31 (0.48€)
Seat 2: LMG22_23 (2.45€)
Seat 3: l artiste ho (1.85€)
Seat 4: TimToBey (4.16€)
Seat 5: Naga Viper (1.97€)
Seat 6: Fried Berg (0.97€)
*** ANTE/BLINDS ***
basenites31 posts small blind 0.01€
LMG22_23 posts big blind 0.02€
Dealt to Fried Berg [6h Th]
*** PRE-FLOP *** 
l artiste ho folds
TimToBey folds
Naga Viper folds
Fried Berg folds
basenites31 raises 0.03€ to 0.05€
LMG22_23 calls 0.03€
*** FLOP *** [2c Qd Kc]
basenites31 bets 0.03€
LMG22_23 calls 0.03€
*** TURN *** [2c Qd Kc][Qs]
basenites31 checks
LMG22_23 bets 0.06€
basenites31 calls 0.06€
*** RIVER *** [2c Qd Kc Qs][Ac]
basenites31 bets 0.10€
LMG22_23 folds
basenites31 collected 0.35€ from pot
*** SUMMARY ***
Total pot 0.35€ | Rake 0.03€
Board: [2c Qd Kc Qs Ac]
Seat 1: basenites31 (small blind) won 0.35€


Winamax Poker - HOLD-UP "Colorado" - HandId: #19116069-203634-1701335525 - Holdem no limit (0.01€/0.02€) - 2023/11/30 09:12:05 UTC
Table: 'Colorado' 6-max (real money) Seat #6 is the button
Seat 1: Fried Berg (0.97€)
Seat 2: H4bet (2.03€)
Seat 3: Pierrof24 (2.50€)
Seat 4: NoNo-MaHa2.0 (1.87€)
Seat 5: Berig (2.15€)
Seat 6: Naga Viper (1.97€)
*** ANTE/BLINDS ***
Fried Berg posts small blind 0.01€
H4bet posts big blind 0.02€
Dealt to Fried Berg [2h 2c]
*** PRE-FLOP *** 
Pierrof24 folds
NoNo-MaHa2.0 raises 0.02€ to 0.04€
Berig folds
Naga Viper folds
Fried Berg calls 0.03€
H4bet calls 0.02€
*** FLOP *** [9s 5h Tc]
Fried Berg checks
H4bet checks
NoNo-MaHa2.0 bets 0.04€
Fried Berg calls 0.04€
H4bet folds
*** TURN *** [9s 5h Tc][Qc]
Fried Berg checks
NoNo-MaHa2.0 checks
*** RIVER *** [9s 5h Tc Qc][Jc]
Fried Berg checks
NoNo-MaHa2.0 bets 0.07€
Fried Berg folds
NoNo-MaHa2.0 collected 0.25€ from pot
*** SUMMARY ***
Total pot 0.25€ | Rake 0.02€
Board: [9s 5h Tc Qc Jc]
Seat 4: NoNo-MaHa2.0 won 0.25€


Winamax Poker - HOLD-UP "Colorado" - HandId: #19116069-203674-1701335598 - Holdem no limit (0.01€/0.02€) - 2023/11/30 09:13:18 UTC
Table: 'Colorado' 6-max (real money) Seat #6 is the button
Seat 1: H4bet (2€)
Seat 2: FabWest (2€)
Seat 3: PIQSOU (2€)
Seat 4: Fried Berg (0.89€)
Seat 5: Vingt Milles (1.32€)
Seat 6: TimToBey (2.13€)
*** ANTE/BLINDS ***
H4bet posts small blind 0.01€
FabWest posts big blind 0.02€
Dealt to Fried Berg [Th Ks]
*** PRE-FLOP *** 
PIQSOU folds
Fried Berg folds
Vingt Milles calls 0.02€
TimToBey folds
H4bet folds
FabWest checks
*** FLOP *** [Tc Kc 9h]
FabWest checks
Vingt Milles checks
*** TURN *** [Tc Kc 9h][Qc]
FabWest checks
Vingt Milles bets 0.03€
FabWest folds
Vingt Milles collected 0.07€ from pot
*** SUMMARY ***
Total pot 0.07€ | Rake 0.01€
Board: [Tc Kc 9h Qc]
Seat 5: Vingt Milles won 0.07€


Winamax Poker - HOLD-UP "Colorado" - HandId: #19116069-203676-1701335605 - Holdem no limit (0.01€/0.02€) - 2023/11/30 09:13:25 UTC
Table: 'Colorado' 6-max (real money) Seat #6 is the button
Seat 1: I-rhum-man28 (1.21€)
Seat 2: bandarra8520 (2€)
Seat 3: Fried Berg (0.89€)
Seat 4: H4bet (2€)
Seat 5: Berig (1.70€)
Seat 6: OnceUpoNaTym (1.20€)
*** ANTE/BLINDS ***
I-rhum-man28 posts small blind 0.01€
bandarra8520 posts big blind 0.02€
Dealt to Fried Berg [Jd 9h]
*** PRE-FLOP *** 
Fried Berg folds
H4bet folds
Berig folds
OnceUpoNaTym folds
I-rhum-man28 folds
bandarra8520 collected 0.03€ from pot
*** SUMMARY ***
Total pot 0.03€ | No rake
Seat 2: bandarra8520 (big blind) won 0.03€


Winamax Poker - HOLD-UP "Colorado" - HandId: #19116069-203678-1701335608 - Holdem no limit (0.01€/0.02€) - 2023/11/30 09:13:28 UTC
Table: 'Colorado' 6-max (real money) Seat #6 is the button
Seat 1: Adrianohhhh (2.08€)
Seat 2: OnceUpoNaTym (1.20€)
Seat 3: gitPush (2.94€)
Seat 4: TimToBey (2.13€)
Seat 5: loreal78 (0.87€)
Seat 6: Fried Berg (0.89€)
*** ANTE/BLINDS ***
Adrianohhhh posts small blind 0.01€
OnceUpoNaTym posts big blind 0.02€
Dealt to Fried Berg [4s 7s]
*** PRE-FLOP *** 
gitPush raises 0.06€ to 0.08€
TimToBey raises 0.16€ to 0.24€
loreal78 raises 0.36€ to 0.60€
Fried Berg folds
Adrianohhhh folds
OnceUpoNaTym folds
gitPush folds
TimToBey raises 1.53€ to 2.13€ and is all-in
loreal78 calls 0.27€ and is all-in
*** FLOP *** [9h 4c 3h]
*** TURN *** [9h 4c 3h][Js]
*** RIVER *** [9h 4c 3h Js][9d]
*** SHOW DOWN ***
loreal78 shows [Kh 2s] (One pair : 9)
TimToBey shows [Qh As] (One pair : 9)
TimToBey collected 2.92€ from pot
*** SUMMARY ***
Total pot 2.92€ | Rake 0.19€
Board: [9h 4c 3h Js 9d]
Seat 4: TimToBey showed [Qh As] and won 2.92€ with One pair : 9
Seat 5: loreal78 showed [Kh 2s] and lost with One pair : 9


Winamax Poker - HOLD-UP "Colorado" - HandId: #19116069-203698-1701335657 - Holdem no limit (0.01€/0.02€) - 2023/11/30 09:14:17 UTC
Table: 'Colorado' 6-max (real money) Seat #6 is the button
Seat 1: gitPush (2.86€)
Seat 2: SirX (2.76€)
Seat 3: Pierrof24 (1.52€)
Seat 4: OnceUpoNaTym (1.41€)
Seat 5: Fried Berg (0.89€)
Seat 6: PIQSOU (2.05€)
*** ANTE/BLINDS ***
gitPush posts small blind 0.01€
SirX posts big blind 0.02€
Dealt to Fried Berg [Ah Qh]
*** PRE-FLOP *** 
Pierrof24 folds
OnceUpoNaTym folds
Fried Berg raises 0.04€ to 0.06€
PIQSOU folds
gitPush folds
SirX raises 2.70€ to 2.76€ and is all-in
Fried Berg calls 0.83€ and is all-in
*** FLOP *** [Kh 6d Qs]
*** TURN *** [Kh 6d Qs][2d]
*** RIVER *** [Kh 6d Qs 2d][Js]
*** SHOW DOWN ***
SirX shows [Qc As] (One pair : Queens)
Fried Berg shows [Ah Qh] (One pair : Queens)
Fried Berg collected 0.81€ from main pot
SirX collected 2.67€ from side pot 1
*** SUMMARY ***
Total pot 3.48€ | Rake 0.18€
Board: [Kh 6d Qs 2d Js]
Seat 2: SirX (big blind) showed [Qc As] and won 2.67€ with One pair : Queens
Seat 5: Fried Berg showed [Ah Qh] and won 0.81€ with One pair : Queens


Winamax Poker - HOLD-UP "Colorado" - HandId: #19116069-203726-1701335711 - Holdem no limit (0.01€/0.02€) - 2023/11/30 09:15:11 UTC
Table: 'Colorado' 6-max (real money) Seat #6 is the button
Seat 1: l artiste ho (1.94€)
Seat 2: Fried Berg (0.81€)
Seat 3: B&CLYDE (0.40€)
Seat 4: SirX (2.67€)
Seat 5: H4bet (2€)
Seat 6: FabWest (3.56€)
*** ANTE/BLINDS ***
l artiste ho posts small blind 0.01€
Fried Berg posts big blind 0.02€
Dealt to Fried Berg [As Kd]
*** PRE-FLOP *** 
B&CLYDE folds
SirX folds
H4bet folds
FabWest folds
l artiste ho calls 0.01€
Fried Berg checks
*** FLOP *** [Ks 2h Th]
l artiste ho checks
Fried Berg checks
*** TURN *** [Ks 2h Th][6s]
l artiste ho checks
Fried Berg checks
*** RIVER *** [Ks 2h Th 6s][Td]
l artiste ho checks
Fried Berg bets 0.02€
l artiste ho folds
Fried Berg collected 0.06€ from pot
*** SUMMARY ***
Total pot 0.06€ | No rake
Board: [Ks 2h Th 6s Td]
Seat 2: Fried Berg (big blind) won 0.06€


Winamax Poker - HOLD-UP "Colorado" - HandId: #19116069-203756-1701335770 - Holdem no limit (0.01€/0.02€) - 2023/11/30 09:16:10 UTC
Table: 'Colorado' 6-max (real money) Seat #6 is the button
Seat 1: Fried Berg (0.83€)
Seat 2: LA TOUR FL (2€)
Seat 3: Adrianohhhh (2.22€)
Seat 4: FabWest (4.04€)
Seat 5: noodles577 (1.94€)
Seat 6: PIQSOU (2.03€)
*** ANTE/BLINDS ***
Fried Berg posts small blind 0.01€
LA TOUR FL posts big blind 0.02€
Dealt to Fried Berg [2h 2c]
*** PRE-FLOP *** 
Adrianohhhh folds
FabWest folds
noodles577 folds
PIQSOU raises 0.03€ to 0.05€
Fried Berg folds
LA TOUR FL folds
PIQSOU collected 0.08€ from pot
*** SUMMARY ***
Total pot 0.08€ | No rake
Seat 6: PIQSOU (button) won 0.08€


Winamax Poker - HOLD-UP "Colorado" - HandId: #19116069-203768-1701335787 - Holdem no limit (0.01€/0.02€) - 2023/11/30 09:16:27 UTC
Table: 'Colorado' 6-max (real money) Seat #6 is the button
Seat 1: Fried Berg (0.82€)
Seat 2: FabWest (4.04€)
Seat 3: affable 5102 (0.59€)
Seat 4: noodles577 (1.91€)
Seat 5: Pierrof24 (1.43€)
Seat 6: TimToBey (2.96€)
*** ANTE/BLINDS ***
Fried Berg posts small blind 0.01€
FabWest posts big blind 0.02€
Dealt to Fried Berg [9c Td]
*** PRE-FLOP *** 
affable 5102 calls 0.02€
noodles577 folds
Pierrof24 folds
TimToBey folds
Fried Berg folds
FabWest checks
*** FLOP *** [9d 7s 4d]
FabWest checks
affable 5102 checks
*** TURN *** [9d 7s 4d][Ah]
FabWest checks
affable 5102 checks
*** RIVER *** [9d 7s 4d Ah][3s]
FabWest checks
affable 5102 checks
*** SHOW DOWN ***
affable 5102 shows [Th Kc] (High card : Ace)
FabWest shows [Kd 3c] (One pair : 3)
FabWest collected 0.04€ from pot
*** SUMMARY ***
Total pot 0.04€ | Rake 0.01€
Board: [9d 7s 4d Ah 3s]
Seat 2: FabWest (big blind) showed [Kd 3c] and won 0.04€ with One pair : 3
Seat 3: affable 5102 showed [Th Kc] and lost with High card : Ace


Winamax Poker - HOLD-UP "Colorado" - HandId: #19116069-203778-1701335798 - Holdem no limit (0.01€/0.02€) - 2023/11/30 09:16:38 UTC
Table: 'Colorado' 6-max (real money) Seat #6 is the button
Seat 1: ZJER10 (1.08€)
Seat 2: LMG22_23 (2.35€)
Seat 3: Fried Berg (0.81€)
Seat 4: PIQSOU (2.30€)
Seat 5: Pierrof24 (2.35€)
Seat 6: OscarJR (0.70€)
*** ANTE/BLINDS ***
ZJER10 posts small blind 0.01€
LMG22_23 posts big blind 0.02€
Dealt to Fried Berg [Jd Ah]
*** PRE-FLOP *** 
Fried Berg raises 0.02€ to 0.04€
PIQSOU folds
Pierrof24 calls 0.04€
OscarJR folds
ZJER10 folds
LMG22_23 folds
*** FLOP *** [8h 4d 5s]
Fried Berg bets 0.03€
Pierrof24 calls 0.03€
*** TURN *** [8h 4d 5s][6h]
Fried Berg checks
Pierrof24 checks
*** RIVER *** [8h 4d 5s 6h][Jh]
Fried Berg bets 0.04€
Pierrof24 folds
Fried Berg collected 0.19€ from pot
*** SUMMARY ***
Total pot 0.19€ | Rake 0.02€
Board: [8h 4d 5s 6h Jh]
Seat 3: Fried Berg won 0.19€


Winamax Poker - HOLD-UP "Colorado" - HandId: #19116069-203820-1701335856 - Holdem no limit (0.01€/0.02€) - 2023/11/30 09:17:36 UTC
Table: 'Colorado' 6-max (real money) Seat #6 is the button
Seat 1: Salvidm (2.33€)
Seat 2: Fried Berg (0.89€)
Seat 3: GriGri24 (1.79€)
Seat 4: Clemence75 (2€)
Seat 5: noodles577 (1.93€)
Seat 6: Berig (1.65€)
*** ANTE/BLINDS ***
Salvidm posts small blind 0.01€
Fried Berg posts big blind 0.02€
Dealt to Fried Berg [9c Jh]
*** PRE-FLOP *** 
GriGri24 folds
Clemence75 folds
noodles577 folds
Berig folds
Salvidm folds
Fried Berg collected 0.03€ from pot
*** SUMMARY ***
Total pot 0.03€ | No rake
Seat 2: Fried Berg (big blind) won 0.03€


Winamax Poker - HOLD-UP "Colorado" - HandId: #19116069-203827-1701335867 - Holdem no limit (0.01€/0.02€) - 2023/11/30 09:17:47 UTC
Table: 'Colorado' 6-max (real money) Seat #6 is the button
Seat 1: Berig (1.88€)
Seat 2: LMG22_23 (2.20€)
Seat 3: Bulzer45 (0.46€)
Seat 4: Fried Berg (0.90€)
Seat 5: ZJER10 (0.98€)
Seat 6: LA TOUR FL (2.02€)
*** ANTE/BLINDS ***
Berig posts small blind 0.01€
LMG22_23 posts big blind 0.02€
Dealt to Fried Berg [4s Ts]
*** PRE-FLOP *** 
Bulzer45 folds
Fried Berg folds
ZJER10 folds
LA TOUR FL raises 0.04€ to 0.06€
Berig folds
LMG22_23 folds
LA TOUR FL collected 0.09€ from pot
*** SUMMARY ***
Total pot 0.09€ | No rake
Seat 6: LA TOUR FL (button) won 0.09€


Winamax Poker - HOLD-UP "Colorado" - HandId: #19116069-203834-1701335872 - Holdem no limit (0.01€/0.02€) - 2023/11/30 09:17:52 UTC
Table: 'Colorado' 6-max (real money) Seat #6 is the button
Seat 1: KassKhrane76 (1.80€)
Seat 2: FabWest (2€)
Seat 3: Un_brochet (2.23€)
Seat 4: GriGri24 (1.78€)
Seat 5: Fried Berg (0.90€)
Seat 6: VashtaNerada (2.56€)
*** ANTE/BLINDS ***
KassKhrane76 posts small blind 0.01€
FabWest posts big blind 0.02€
Dealt to Fried Berg [Kd Qs]
*** PRE-FLOP *** 
Un_brochet raises 0.03€ to 0.05€
GriGri24 folds
Fried Berg calls 0.05€
VashtaNerada calls 0.05€
KassKhrane76 folds
FabWest folds
*** FLOP *** [5d 7c 5c]
Un_brochet checks
Fried Berg bets 0.05€
VashtaNerada calls 0.05€
Un_brochet folds
*** TURN *** [5d 7c 5c][6h]
Fried Berg bets 0.02€
VashtaNerada raises 0.07€ to 0.09€
Fried Berg calls 0.07€
*** RIVER *** [5d 7c 5c 6h][7d]
Fried Berg checks
VashtaNerada bets 2.37€ and is all-in
Fried Berg folds
VashtaNerada collected 2.78€ from pot
*** SUMMARY ***
Total pot 2.78€ | Rake 0.05€
Board: [5d 7c 5c 6h 7d]
Seat 6: VashtaNerada (button) won 2.78€


Winamax Poker - HOLD-UP "Colorado" - HandId: #19116069-203896-1701335979 - Holdem no limit (0.01€/0.02€) - 2023/11/30 09:19:39 UTC
Table: 'Colorado' 6-max (real money) Seat #6 is the button
Seat 1: GriGri24 (1.76€)
Seat 2: Pierrof24 (1.59€)
Seat 3: LA TOUR FL (2.02€)
Seat 4: JaviJavi (1.69€)
Seat 5: LeR6907 (2.17€)
Seat 6: Fried Berg (0.71€)
*** ANTE/BLINDS ***
GriGri24 posts small blind 0.01€
Pierrof24 posts big blind 0.02€
Dealt to Fried Berg [Qh Ah]
*** PRE-FLOP *** 
LA TOUR FL folds
JaviJavi raises 0.04€ to 0.06€
LeR6907 folds
Fried Berg raises 0.12€ to 0.18€
GriGri24 folds
Pierrof24 folds
JaviJavi calls 0.12€
*** FLOP *** [4h 5s 4d]
JaviJavi checks
Fried Berg checks
*** TURN *** [4h 5s 4d][Jc]
JaviJavi bets 0.39€
Fried Berg folds
JaviJavi collected 0.74€ from pot
*** SUMMARY ***
Total pot 0.74€ | Rake 0.04€
Board: [4h 5s 4d Jc]
Seat 4: JaviJavi won 0.74€


Winamax Poker - HOLD-UP "Colorado" - HandId: #19116069-203927-1701336017 - Holdem no limit (0.01€/0.02€) - 2023/11/30 09:20:17 UTC
Table: 'Colorado' 6-max (real money) Seat #6 is the button
Seat 1: avatar00 (1.65€)
Seat 2: FabWest (3.74€)
Seat 3: noodles577 (1.64€)
Seat 4: Fried Berg (0.53€)
Seat 5: Clemence75 (2.02€)
Seat 6: chut je dodo (1.64€)
*** ANTE/BLINDS ***
avatar00 posts small blind 0.01€
FabWest posts big blind 0.02€
Dealt to Fried Berg [5d 4c]
*** PRE-FLOP *** 
noodles577 folds
Fried Berg folds
Clemence75 folds
chut je dodo folds
avatar00 folds
FabWest collected 0.03€ from pot
*** SUMMARY ***
Total pot 0.03€ | No rake
Seat 2: FabWest (big blind) won 0.03€


Winamax Poker - HOLD-UP "Colorado" - HandId: #19116069-203935-1701336025 - Holdem no limit (0.01€/0.02€) - 2023/11/30 09:20:25 UTC
Table: 'Colorado' 6-max (real money) Seat #6 is the button
Seat 1: Fried Berg (0.53€)
Seat 2: avatar00 (1.64€)
Seat 3: gitPush (2€)
Seat 4: LeR6907 (2.30€)
Seat 5: VashtaNerada (2.79€)
Seat 6: David Boring (2.41€)
*** ANTE/BLINDS ***
Fried Berg posts small blind 0.01€
avatar00 posts big blind 0.02€
Dealt to Fried Berg [4d Jh]
*** PRE-FLOP *** 
gitPush raises 0.06€ to 0.08€
LeR6907 folds
VashtaNerada folds
David Boring folds
Fried Berg folds
avatar00 folds
gitPush collected 0.11€ from pot
*** SUMMARY ***
Total pot 0.11€ | No rake
Seat 3: gitPush won 0.11€


Winamax Poker - HOLD-UP "Colorado" - HandId: #19116069-203945-1701336032 - Holdem no limit (0.01€/0.02€) - 2023/11/30 09:20:32 UTC
Table: 'Colorado' 6-max (real money) Seat #6 is the button
Seat 1: SirX (3.01€)
Seat 2: l artiste ho (1.95€)
Seat 3: Fried Berg (0.52€)
Seat 4: David Boring (3.40€)
Seat 5: JaviJavi (1.86€)
Seat 6: Un_brochet (2.23€)
*** ANTE/BLINDS ***
SirX posts small blind 0.01€
l artiste ho posts big blind 0.02€
Dealt to Fried Berg [Jd As]
*** PRE-FLOP *** 
Fried Berg raises 0.03€ to 0.05€
David Boring folds
JaviJavi folds
Un_brochet folds
SirX calls 0.04€
l artiste ho calls 0.03€
*** FLOP *** [4h Qd 6h]
SirX checks
l artiste ho bets 0.02€
Fried Berg calls 0.02€
SirX calls 0.02€
*** TURN *** [4h Qd 6h][5s]
SirX checks
l artiste ho checks
Fried Berg checks
*** RIVER *** [4h Qd 6h 5s][Js]
SirX bets 0.14€
l artiste ho folds
Fried Berg calls 0.14€
*** SHOW DOWN ***
SirX shows [Kh Td] (High card : King)
Fried Berg shows [Jd As] (One pair : Jacks)
Fried Berg collected 0.44€ from pot
*** SUMMARY ***
Total pot 0.44€ | Rake 0.05€
Board: [4h Qd 6h 5s Js]
Seat 1: SirX (small blind) showed [Kh Td] and lost with High card : King
Seat 3: Fried Berg showed [Jd As] and won 0.44€ with One pair : Jacks


Winamax Poker - HOLD-UP "Colorado" - HandId: #19116069-203994-1701336087 - Holdem no limit (0.01€/0.02€) - 2023/11/30 09:21:27 UTC
Table: 'Colorado' 6-max (real money) Seat #6 is the button
Seat 1: hello7585 (2.20€)
Seat 2: FabWest (2.03€)
Seat 3: Pierrof24 (1.57€)
Seat 4: Solda14 (0.96€)
Seat 5: Direct Oli (1.67€)
Seat 6: Fried Berg (0.75€)
*** ANTE/BLINDS ***
hello7585 posts small blind 0.01€
FabWest posts big blind 0.02€
Dealt to Fried Berg [8c 7c]
*** PRE-FLOP *** 
Pierrof24 folds
Solda14 calls 0.02€
Direct Oli folds
Fried Berg raises 0.02€ to 0.04€
hello7585 calls 0.03€
FabWest folds
Solda14 calls 0.02€
*** FLOP *** [Ad 4d Jc]
hello7585 checks
Solda14 checks
Fried Berg checks
*** TURN *** [Ad 4d Jc][Td]
hello7585 bets 0.05€
Solda14 folds
Fried Berg folds
hello7585 collected 0.18€ from pot
*** SUMMARY ***
Total pot 0.18€ | Rake 0.01€
Board: [Ad 4d Jc Td]
Seat 1: hello7585 (small blind) won 0.18€


Winamax Poker - HOLD-UP "Colorado" - HandId: #19116069-204029-1701336141 - Holdem no limit (0.01€/0.02€) - 2023/11/30 09:22:21 UTC
Table: 'Colorado' 6-max (real money) Seat #6 is the button
Seat 1: B&CLYDE (1.63€)
Seat 2: Brut2pok (2€)
Seat 3: bandarra8520 (2.25€)
Seat 4: kyce974 (1.42€)
Seat 5: Fried Berg (0.71€)
Seat 6: LMG22_23 (2.09€)
*** ANTE/BLINDS ***
B&CLYDE posts small blind 0.01€
Brut2pok posts big blind 0.02€
Dealt to Fried Berg [Ac Ad]
*** PRE-FLOP *** 
bandarra8520 folds
kyce974 folds
Fried Berg raises 0.04€ to 0.06€
LMG22_23 folds
B&CLYDE folds
Brut2pok calls 0.04€
*** FLOP *** [8h 6d 5c]
Brut2pok checks
Fried Berg bets 0.05€
Brut2pok calls 0.05€
*** TURN *** [8h 6d 5c][Jh]
Brut2pok checks
Fried Berg bets 0.08€
Brut2pok calls 0.08€
*** RIVER *** [8h 6d 5c Jh][Qh]
Brut2pok bets 0.25€
Fried Berg calls 0.25€
*** SHOW DOWN ***
Fried Berg shows [Ac Ad] (One pair : Aces)
Brut2pok shows [7h Ah] (Flush Ace high)
Brut2pok collected 0.80€ from pot
*** SUMMARY ***
Total pot 0.80€ | Rake 0.09€
Board: [8h 6d 5c Jh Qh]
Seat 2: Brut2pok (big blind) showed [7h Ah] and won 0.80€ with Flush Ace high
Seat 5: Fried Berg showed [Ac Ad] and lost with One pair : Aces


Winamax Poker - HOLD-UP "Colorado" - HandId: #19116069-204086-1701336205 - Holdem no limit (0.01€/0.02€) - 2023/11/30 09:23:25 UTC
Table: 'Colorado' 6-max (real money) Seat #6 is the button
Seat 1: Brut2pok (2.36€)
Seat 2: Fried Berg (0.27€)
Seat 3: LMG22_23 (1.82€)
Seat 4: Pierrof24 (2€)
Seat 5: Salvidm (2.36€)
Seat 6: crabaudeur (1.65€)
*** ANTE/BLINDS ***
Brut2pok posts small blind 0.01€
Fried Berg posts big blind 0.02€
Dealt to Fried Berg [6h Td]
*** PRE-FLOP *** 
LMG22_23 folds
Pierrof24 folds
Salvidm folds
crabaudeur raises 0.04€ to 0.06€
Brut2pok folds
Fried Berg folds
crabaudeur collected 0.09€ from pot
*** SUMMARY ***
Total pot 0.09€ | No rake
Seat 6: crabaudeur (button) won 0.09€


Winamax Poker - HOLD-UP "Colorado" - HandId: #19116069-204109-1701336228 - Holdem no limit (0.01€/0.02€) - 2023/11/30 09:23:48 UTC
Table: 'Colorado' 6-max (real money) Seat #6 is the button
Seat 1: l artiste ho (1.82€)
Seat 2: hello7585 (1.73€)
Seat 3: Berig (1.91€)
Seat 4: LMG22_23 (3.31€)
Seat 5: Fried Berg (0.25€)
Seat 6: FabWest (4.46€)
*** ANTE/BLINDS ***
l artiste ho posts small blind 0.01€
hello7585 posts big blind 0.02€
Dealt to Fried Berg [Js Jh]
*** PRE-FLOP *** 
Berig folds
LMG22_23 folds
Fried Berg raises 0.04€ to 0.06€
FabWest folds
l artiste ho folds
hello7585 folds
Fried Berg collected 0.09€ from pot
*** SUMMARY ***
Total pot 0.09€ | No rake
Seat 5: Fried Berg won 0.09€


Winamax Poker - HOLD-UP "Colorado" - HandId: #19116069-204140-1701336255 - Holdem no limit (0.01€/0.02€) - 2023/11/30 09:24:15 UTC
Table: 'Colorado' 6-max (real money) Seat #6 is the button
Seat 1: Fried Berg (0.28€)
Seat 2: gitPush (5.60€)
Seat 3: Effray (2.17€)
Seat 4: hello7585 (2.22€)
Seat 5: Un_brochet (2.13€)
Seat 6: Ga31k (2.10€)
Hold-up to Pot: total 0.10€
*** ANTE/BLINDS ***
Fried Berg posts small blind 0.01€
gitPush posts big blind 0.02€
Dealt to Fried Berg [5h Kh]
*** PRE-FLOP *** 
Effray folds
hello7585 folds
Un_brochet calls 0.02€
Ga31k folds
Fried Berg calls 0.01€
gitPush checks
*** FLOP *** [3h 4d 8c]
Fried Berg checks
gitPush checks
Un_brochet checks
*** TURN *** [3h 4d 8c][2c]
Fried Berg checks
gitPush bets 0.07€
Un_brochet calls 0.07€
Fried Berg calls 0.07€
*** RIVER *** [3h 4d 8c 2c][2d]
Fried Berg checks
gitPush bets 0.46€
Un_brochet folds
Fried Berg calls 0.19€ and is all-in
*** SHOW DOWN ***
Fried Berg shows [5h Kh] (One pair : 2)
gitPush shows [9s 6d] (One pair : 2)
gitPush collected 0.27€ from side pot 1
Fried Berg collected 0.68€ from main pot
*** SUMMARY ***
Total pot 0.95€ | Rake 0.07€
Board: [3h 4d 8c 2c 2d]
Seat 1: Fried Berg (small blind) showed [5h Kh] and won 0.68€ with One pair : 2
Seat 2: gitPush (big blind) showed [9s 6d] and won 0.27€ with One pair : 2


Winamax Poker - HOLD-UP "Colorado" - HandId: #19116069-204211-1701336325 - Holdem no limit (0.01€/0.02€) - 2023/11/30 09:25:25 UTC
Table: 'Colorado' 6-max (real money) Seat #6 is the button
Seat 1: BTCHodler (0.96€)
Seat 2: hello7585 (1.84€)
Seat 3: curiouz dje (2€)
Seat 4: Clemence75 (2.22€)
Seat 5: Un_brochet (2.04€)
Seat 6: Fried Berg (0.68€)
*** ANTE/BLINDS ***
BTCHodler posts small blind 0.01€
hello7585 posts big blind 0.02€
Dealt to Fried Berg [9d Td]
*** PRE-FLOP *** 
curiouz dje raises 0.03€ to 0.05€
Clemence75 folds
Un_brochet folds
Fried Berg calls 0.05€
BTCHodler raises 0.10€ to 0.15€
hello7585 folds
curiouz dje folds
Fried Berg calls 0.10€
*** FLOP *** [7h 8h Jd]
BTCHodler bets 0.24€
Fried Berg calls 0.24€
*** TURN *** [7h 8h Jd][4c]
BTCHodler bets 0.57€ and is all-in
Fried Berg calls 0.29€ and is all-in
*** RIVER *** [7h 8h Jd 4c][5s]
*** SHOW DOWN ***
BTCHodler shows [Jh Qs] (One pair : Jacks)
Fried Berg shows [9d Td] (Straight Jack high)
Fried Berg collected 1.29€ from main pot
BTCHodler collected 0.28€ from side pot 1
*** SUMMARY ***
Total pot 1.57€ | Rake 0.14€
Board: [7h 8h Jd 4c 5s]
Seat 1: BTCHodler (small blind) showed [Jh Qs] and won 0.28€ with One pair : Jacks
Seat 6: Fried Berg (button) showed [9d Td] and won 1.29€ with Straight Jack high


Winamax Poker - HOLD-UP "Colorado" - HandId: #19116069-204261-1701336383 - Holdem no limit (0.01€/0.02€) - 2023/11/30 09:26:23 UTC
Table: 'Colorado' 6-max (real money) Seat #6 is the button
Seat 1: curiouz dje (2€)
Seat 2: Fried Berg (1.29€)
Seat 3: BTCHodler (0.28€)
Seat 4: David Boring (2.90€)
Seat 5: cygoud (2€)
Seat 6: LMG22_23 (2.20€)
*** ANTE/BLINDS ***
curiouz dje posts small blind 0.01€
Fried Berg posts big blind 0.02€
Dealt to Fried Berg [2d Qh]
*** PRE-FLOP *** 
BTCHodler calls 0.02€
David Boring folds
cygoud folds
LMG22_23 folds
curiouz dje folds
Fried Berg checks
*** FLOP *** [7c 6c Th]
Fried Berg checks
BTCHodler checks
*** TURN *** [7c 6c Th][Jc]
Fried Berg checks
BTCHodler bets 0.03€
Fried Berg folds
BTCHodler collected 0.07€ from pot
*** SUMMARY ***
Total pot 0.07€ | Rake 0.01€
Board: [7c 6c Th Jc]
Seat 3: BTCHodler won 0.07€


Winamax Poker - HOLD-UP "Colorado" - HandId: #19116069-204296-1701336417 - Holdem no limit (0.01€/0.02€) - 2023/11/30 09:26:57 UTC
Table: 'Colorado' 6-max (real money) Seat #6 is the button
Seat 1: OnceUpoNaTym (1.99€)
Seat 2: Effray (2.11€)
Seat 3: Fried Berg (1.27€)
Seat 4: FabWest (5.05€)
Seat 5: Clemence75 (2.87€)
Seat 6: hello7585 (2.65€)
*** ANTE/BLINDS ***
OnceUpoNaTym posts small blind 0.01€
Effray posts big blind 0.02€
Dealt to Fried Berg [Qc 2h]
*** PRE-FLOP *** 
Fried Berg folds
FabWest folds
Clemence75 raises 0.04€ to 0.06€
hello7585 folds
OnceUpoNaTym folds
Effray folds
Clemence75 collected 0.09€ from pot
*** SUMMARY ***
Total pot 0.09€ | No rake
Seat 5: Clemence75 won 0.09€


Winamax Poker - HOLD-UP "Colorado" - HandId: #19116069-204301-1701336421 - Holdem no limit (0.01€/0.02€) - 2023/11/30 09:27:01 UTC
Table: 'Colorado' 6-max (real money) Seat #6 is the button
Seat 1: LMG22_23 (3.06€)
Seat 2: Cejargordas (2€)
Seat 3: Berig (3.13€)
Seat 4: Fried Berg (1.27€)
Seat 5: TimToBey (4.02€)
Seat 6: FabWest (2.08€)
*** ANTE/BLINDS ***
LMG22_23 posts small blind 0.01€
Cejargordas posts big blind 0.02€
Dealt to Fried Berg [2h 2d]
*** PRE-FLOP *** 
Berig folds
Fried Berg raises 0.02€ to 0.04€
TimToBey folds
FabWest folds
LMG22_23 calls 0.03€
Cejargordas calls 0.02€
*** FLOP *** [7c 3d Qh]
LMG22_23 checks
Cejargordas checks
Fried Berg bets 0.08€
LMG22_23 calls 0.08€
Cejargordas folds
*** TURN *** [7c 3d Qh][3h]
LMG22_23 bets 0.10€
Fried Berg folds
LMG22_23 collected 0.35€ from pot
*** SUMMARY ***
Total pot 0.35€ | Rake 0.03€
Board: [7c 3d Qh 3h]
Seat 1: LMG22_23 (small blind) won 0.35€


Winamax Poker - HOLD-UP "Colorado" - HandId: #19116069-204448-1701336564 - Holdem no limit (0.01€/0.02€) - 2023/11/30 09:29:24 UTC
Table: 'Colorado' 6-max (real money) Seat #6 is the button
Seat 1: Cedlebon (2.01€)
Seat 2: gagnejamais4 (1.99€)
Seat 3: David Boring (4.15€)
Seat 4: Fried Berg (1.15€)
Seat 5: BTCHodler (2.23€)
Seat 6: Pierrof24 (2.69€)
*** ANTE/BLINDS ***
Cedlebon posts small blind 0.01€
gagnejamais4 posts big blind 0.02€
Dealt to Fried Berg [Ac 4s]
*** PRE-FLOP *** 
David Boring folds
Fried Berg raises 0.02€ to 0.04€
BTCHodler calls 0.04€
Pierrof24 calls 0.04€
Cedlebon calls 0.03€
gagnejamais4 folds
*** FLOP *** [Js 8d Kh]
Cedlebon checks
Fried Berg checks
BTCHodler bets 0.06€
Pierrof24 folds
Cedlebon folds
Fried Berg folds
BTCHodler collected 0.22€ from pot
*** SUMMARY ***
Total pot 0.22€ | Rake 0.02€
Board: [Js 8d Kh]
Seat 5: BTCHodler won 0.22€


Winamax Poker - HOLD-UP "Colorado" - HandId: #19116069-204525-1701336642 - Holdem no limit (0.01€/0.02€) - 2023/11/30 09:30:42 UTC
Table: 'Colorado' 6-max (real money) Seat #6 is the button
Seat 1: Fcgb_2907 (1.02€)
Seat 2: Fried Berg (1.11€)
Seat 3: LMG22_23 (2€)
Seat 4: Porthos (0.94€)
Seat 5: cygoud (2€)
Seat 6: Snakesolid56 (3.75€)
Hold-up to Pot: total 0.10€
*** ANTE/BLINDS ***
Fcgb_2907 posts small blind 0.01€
Fried Berg posts big blind 0.02€
Dealt to Fried Berg [6c 6s]
*** PRE-FLOP *** 
LMG22_23 raises 0.02€ to 0.04€
Porthos folds
cygoud folds
Snakesolid56 calls 0.04€
Fcgb_2907 calls 0.03€
Fried Berg calls 0.02€
*** FLOP *** [Qc 7s Ad]
Fcgb_2907 bets 0.09€
Fried Berg folds
LMG22_23 calls 0.09€
Snakesolid56 folds
*** TURN *** [Qc 7s Ad][Jh]
Fcgb_2907 bets 0.89€ and is all-in
LMG22_23 calls 0.89€
*** RIVER *** [Qc 7s Ad Jh][8c]
*** SHOW DOWN ***
LMG22_23 shows [Th Ac] (One pair : Aces)
Fcgb_2907 shows [7c As] (Two pairs : Aces and 7)
Fcgb_2907 collected 2.01€ from pot
*** SUMMARY ***
Total pot 2.01€ | Rake 0.21€
Board: [Qc 7s Ad Jh 8c]
Seat 1: Fcgb_2907 (small blind) showed [7c As] and won 2.01€ with Two pairs : Aces and 7
Seat 3: LMG22_23 showed [Th Ac] and lost with One pair : Aces


Winamax Poker - HOLD-UP "Colorado" - HandId: #19116069-204545-1701336664 - Holdem no limit (0.01€/0.02€) - 2023/11/30 09:31:04 UTC
Table: 'Colorado' 6-max (real money) Seat #6 is the button
Seat 1: OscarJR (0.76€)
Seat 2: pelouseverte (0.83€)
Seat 3: curiouz dje (2€)
Seat 4: Snakesolid56 (3.71€)
Seat 5: Fried Berg (1.07€)
Seat 6: slowreplay (2€)
*** ANTE/BLINDS ***
OscarJR posts small blind 0.01€
pelouseverte posts big blind 0.02€
Dealt to Fried Berg [2s 5s]
*** PRE-FLOP *** 
curiouz dje folds
Snakesolid56 folds
Fried Berg folds
slowreplay folds
OscarJR raises 0.05€ to 0.07€
pelouseverte folds
OscarJR collected 0.09€ from pot
*** SUMMARY ***
Total pot 0.09€ | No rake
Seat 1: OscarJR (small blind) won 0.09€


Winamax Poker - HOLD-UP "Colorado" - HandId: #19116069-204565-1701336683 - Holdem no limit (0.01€/0.02€) - 2023/11/30 09:31:23 UTC
Table: 'Colorado' 6-max (real money) Seat #6 is the button
Seat 1: Fried Berg (1.07€)
Seat 2: Effray (2.75€)
Seat 3: Cejargordas (2€)
Seat 4: BTCHodler (0.96€)
Seat 5: KassKhrane76 (2.15€)
Seat 6: Un_brochet (1.64€)
*** ANTE/BLINDS ***
Fried Berg posts small blind 0.01€
Effray posts big blind 0.02€
Dealt to Fried Berg [8c Ad]
*** PRE-FLOP *** 
Cejargordas folds
BTCHodler raises 0.02€ to 0.04€
KassKhrane76 calls 0.04€
Un_brochet calls 0.04€
Fried Berg calls 0.03€
Effray folds
*** FLOP *** [9c 7c 5c]
Fried Berg checks
BTCHodler bets 0.06€
KassKhrane76 raises 0.30€ to 0.36€
Un_brochet calls 0.36€
Fried Berg folds
BTCHodler folds
*** TURN *** [9c 7c 5c][Tc]
KassKhrane76 checks
Un_brochet checks
*** RIVER *** [9c 7c 5c Tc][8s]
KassKhrane76 bets 0.24€
Un_brochet calls 0.24€
*** SHOW DOWN ***
Un_brochet shows [7s 7h] (Trips of 7)
KassKhrane76 shows [4c 3c] (Flush Ten high)
KassKhrane76 collected 1.30€ from pot
*** SUMMARY ***
Total pot 1.30€ | Rake 0.14€
Board: [9c 7c 5c Tc 8s]
Seat 5: KassKhrane76 showed [4c 3c] and won 1.30€ with Flush Ten high
Seat 6: Un_brochet (button) showed [7s 7h] and lost with Trips of 7


Winamax Poker - HOLD-UP "Colorado" - HandId: #19116069-204642-1701336758 - Holdem no limit (0.01€/0.02€) - 2023/11/30 09:32:38 UTC
Table: 'Colorado' 6-max (real money) Seat #6 is the button
Seat 1: curiouz dje (2.11€)
Seat 2: slowreplay (2.18€)
Seat 3: Fried Berg (1.03€)
Seat 4: BlackMoodAAA (0.62€)
Seat 5: LMG22_23 (0.97€)
Seat 6: KassKhrane76 (2.81€)
*** ANTE/BLINDS ***
curiouz dje posts small blind 0.01€
slowreplay posts big blind 0.02€
Dealt to Fried Berg [5s 5h]
*** PRE-FLOP *** 
Fried Berg folds
BlackMoodAAA calls 0.02€
LMG22_23 folds
KassKhrane76 folds
curiouz dje folds
slowreplay checks
*** FLOP *** [4d 2s 9c]
slowreplay checks
BlackMoodAAA bets 0.05€
slowreplay folds
BlackMoodAAA collected 0.09€ from pot
*** SUMMARY ***
Total pot 0.09€ | Rake 0.01€
Board: [4d 2s 9c]
Seat 4: BlackMoodAAA won 0.09€


Winamax Poker - HOLD-UP "Colorado" - HandId: #19116069-204651-1701336766 - Holdem no limit (0.01€/0.02€) - 2023/11/30 09:32:46 UTC
Table: 'Colorado' 6-max (real money) Seat #6 is the button
Seat 1: VashtaNerada (2.03€)
Seat 2: JaviJavi (2.03€)
Seat 3: didi5959 (0.34€)
Seat 4: Fried Berg (1.03€)
Seat 5: PlumedanslQQ (2.44€)
Seat 6: PIQSOU (2.07€)
*** ANTE/BLINDS ***
VashtaNerada posts small blind 0.01€
JaviJavi posts big blind 0.02€
Dealt to Fried Berg [Qd 3h]
*** PRE-FLOP *** 
didi5959 folds
Fried Berg folds
PlumedanslQQ folds
PIQSOU raises 0.03€ to 0.05€
VashtaNerada calls 0.04€
JaviJavi calls 0.03€
*** FLOP *** [Td Ts 7h]
VashtaNerada checks
JaviJavi checks
PIQSOU checks
*** TURN *** [Td Ts 7h][6s]
VashtaNerada bets 0.05€
JaviJavi calls 0.05€
PIQSOU folds
*** RIVER *** [Td Ts 7h 6s][7d]
VashtaNerada checks
JaviJavi bets 0.16€
VashtaNerada calls 0.16€
*** SHOW DOWN ***
VashtaNerada shows [8c 8h] (Two pairs : Tens and 8)
JaviJavi shows [Tc Th] (Quads of Tens)
JaviJavi collected 0.51€ from pot
*** SUMMARY ***
Total pot 0.51€ | Rake 0.06€
Board: [Td Ts 7h 6s 7d]
Seat 1: VashtaNerada (small blind) showed [8c 8h] and lost with Two pairs : Tens and 8
Seat 2: JaviJavi (big blind) showed [Tc Th] and won 0.51€ with Quads of Tens


Winamax Poker - HOLD-UP "Colorado" - HandId: #19116069-204657-1701336771 - Holdem no limit (0.01€/0.02€) - 2023/11/30 09:32:51 UTC
Table: 'Colorado' 6-max (real money) Seat #6 is the button
Seat 1: wAAlterrr (1.03€)
Seat 2: curiouz dje (2€)
Seat 3: Sebidu57 (2.74€)
Seat 4: Cejargordas (2€)
Seat 5: Fried Berg (1.03€)
Seat 6: cygoud (3.67€)
Hold-up to Pot: total 0.10€
*** ANTE/BLINDS ***
wAAlterrr posts small blind 0.01€
curiouz dje posts big blind 0.02€
Dealt to Fried Berg [5d Ad]
*** PRE-FLOP *** 
Sebidu57 calls 0.02€
Cejargordas raises 0.06€ to 0.08€
Fried Berg calls 0.08€
cygoud folds
wAAlterrr folds
curiouz dje calls 0.06€
Sebidu57 calls 0.06€
*** FLOP *** [Qd 4d Th]
curiouz dje checks
Sebidu57 checks
Cejargordas bets 0.22€
Fried Berg calls 0.22€
curiouz dje folds
Sebidu57 folds
*** TURN *** [Qd 4d Th][7c]
Cejargordas bets 1.38€
Fried Berg calls 0.73€ and is all-in
*** RIVER *** [Qd 4d Th 7c][Jd]
*** SHOW DOWN ***
Cejargordas shows [Js Kd] (One pair : Jacks)
Fried Berg shows [5d Ad] (Flush Ace high)
Fried Berg collected 2.11€ from main pot
Cejargordas collected 0.65€ from side pot 1
*** SUMMARY ***
Total pot 2.76€ | Rake 0.22€
Board: [Qd 4d Th 7c Jd]
Seat 4: Cejargordas showed [Js Kd] and won 0.65€ with One pair : Jacks
Seat 5: Fried Berg showed [5d Ad] and won 2.11€ with Flush Ace high


Winamax Poker - HOLD-UP "Colorado" - HandId: #19116069-204743-1701336863 - Holdem no limit (0.01€/0.02€) - 2023/11/30 09:34:23 UTC
Table: 'Colorado' 6-max (real money) Seat #6 is the button
Seat 1: Pierrof24 (1.16€)
Seat 2: Ga31k (2€)
Seat 3: wAAlterrr (0.84€)
Seat 4: ZJER10 (1.68€)
Seat 5: cygoud (3.80€)
Seat 6: Fried Berg (2.11€)
*** ANTE/BLINDS ***
Pierrof24 posts small blind 0.01€
Ga31k posts big blind 0.02€
Dealt to Fried Berg [Th 5c]
*** PRE-FLOP *** 
wAAlterrr folds
ZJER10 calls 0.02€
cygoud folds
Fried Berg folds
Pierrof24 folds
Ga31k checks
*** FLOP *** [8d Jd 9s]
Ga31k checks
ZJER10 checks
*** TURN *** [8d Jd 9s][Kc]
Ga31k bets 0.02€
ZJER10 calls 0.02€
*** RIVER *** [8d Jd 9s Kc][8s]
Ga31k bets 0.05€
ZJER10 calls 0.05€
*** SHOW DOWN ***
Ga31k shows [Js 6c] (Two pairs : Jacks and 8)
ZJER10 shows [Jh Tc] (Two pairs : Jacks and 8)
ZJER10 collected 0.09€ from pot
Ga31k collected 0.08€ from pot
*** SUMMARY ***
Total pot 0.17€ | Rake 0.02€
Board: [8d Jd 9s Kc 8s]
Seat 2: Ga31k (big blind) showed [Js 6c] and won 0.08€ with Two pairs : Jacks and 8
Seat 4: ZJER10 showed [Jh Tc] and won 0.09€ with Two pairs : Jacks and 8


Winamax Poker - HOLD-UP "Colorado" - HandId: #19116069-204763-1701336882 - Holdem no limit (0.01€/0.02€) - 2023/11/30 09:34:42 UTC
Table: 'Colorado' 6-max (real money) Seat #6 is the button
Seat 1: SirX (0.80€)
Seat 2: curiouz dje (2.24€)
Seat 3: steph290 (2€)
Seat 4: PIQSOU (2.23€)
Seat 5: cygoud (3.80€)
Seat 6: Fried Berg (2.11€)
*** ANTE/BLINDS ***
SirX posts small blind 0.01€
curiouz dje posts big blind 0.02€
Dealt to Fried Berg [5h 8d]
*** PRE-FLOP *** 
steph290 calls 0.02€
PIQSOU folds
cygoud folds
Fried Berg folds
SirX raises 0.04€ to 0.06€
curiouz dje calls 0.04€
steph290 calls 0.04€
*** FLOP *** [Th 5c Qd]
SirX bets 0.12€
curiouz dje folds
steph290 folds
SirX collected 0.28€ from pot
*** SUMMARY ***
Total pot 0.28€ | Rake 0.02€
Board: [Th 5c Qd]
Seat 1: SirX (small blind) won 0.28€


Winamax Poker - HOLD-UP "Colorado" - HandId: #19116069-204781-1701336901 - Holdem no limit (0.01€/0.02€) - 2023/11/30 09:35:01 UTC
Table: 'Colorado' 6-max (real money) Seat #6 is the button
Seat 1: cygoud (3.80€)
Seat 2: Fried Berg (2.11€)
Seat 3: wAAlterrr (0.86€)
Seat 4: divin.Ange64 (1.91€)
Seat 5: slowreplay (2.05€)
Seat 6: gagnejamais4 (2.01€)
*** ANTE/BLINDS ***
cygoud posts small blind 0.01€
Fried Berg posts big blind 0.02€
Dealt to Fried Berg [Tc 5h]
*** PRE-FLOP *** 
wAAlterrr folds
divin.Ange64 folds
slowreplay folds
gagnejamais4 folds
cygoud folds
Fried Berg collected 0.03€ from pot
*** SUMMARY ***
Total pot 0.03€ | No rake
Seat 2: Fried Berg (big blind) won 0.03€


Winamax Poker - HOLD-UP "Colorado" - HandId: #19116069-204805-1701336923 - Holdem no limit (0.01€/0.02€) - 2023/11/30 09:35:23 UTC
Table: 'Colorado' 6-max (real money) Seat #6 is the button
Seat 1: widow974 (0.63€)
Seat 2: David Boring (3.02€)
Seat 3: TimToBey (2€)
Seat 4: gitPush (2.07€)
Seat 5: slowreplay (2.05€)
Seat 6: Fried Berg (2.12€)
*** ANTE/BLINDS ***
widow974 posts small blind 0.01€
David Boring posts big blind 0.02€
Dealt to Fried Berg [2s Ts]
*** PRE-FLOP *** 
TimToBey folds
gitPush folds
slowreplay folds
Fried Berg folds
widow974 folds
David Boring collected 0.03€ from pot
*** SUMMARY ***
Total pot 0.03€ | No rake
Seat 2: David Boring (big blind) won 0.03€


Winamax Poker - HOLD-UP "Colorado" - HandId: #19116069-204818-1701336934 - Holdem no limit (0.01€/0.02€) - 2023/11/30 09:35:34 UTC
Table: 'Colorado' 6-max (real money) Seat #6 is the button
Seat 1: CB-Joker6274 (1.98€)
Seat 2: VashtaNerada (2€)
Seat 3: Fried Berg (2.12€)
Seat 4: Pierrof24 (1.13€)
Seat 5: Brut2pok (2.33€)
Seat 6: l artiste ho (1.95€)
*** ANTE/BLINDS ***
CB-Joker6274 posts small blind 0.01€
VashtaNerada posts big blind 0.02€
Dealt to Fried Berg [As 5d]
*** PRE-FLOP *** 
Fried Berg folds
Pierrof24 folds
Brut2pok folds
l artiste ho folds
CB-Joker6274 calls 0.01€
VashtaNerada checks
*** FLOP *** [Qs 6d 5h]
CB-Joker6274 checks
VashtaNerada checks
*** TURN *** [Qs 6d 5h][Jc]
CB-Joker6274 bets 0.04€
VashtaNerada folds
CB-Joker6274 collected 0.08€ from pot
*** SUMMARY ***
Total pot 0.08€ | No rake
Board: [Qs 6d 5h Jc]
Seat 1: CB-Joker6274 (small blind) won 0.08€


Winamax Poker - HOLD-UP "Colorado" - HandId: #19116069-204823-1701336937 - Holdem no limit (0.01€/0.02€) - 2023/11/30 09:35:37 UTC
Table: 'Colorado' 6-max (real money) Seat #6 is the button
Seat 1: Fried Berg (2.12€)
Seat 2: PIQSOU (2.54€)
Seat 3: David Boring (3.03€)
Seat 4: NiggRice (2.08€)
Seat 5: curiouz dje (3.84€)
Seat 6: Solo130486 (0.56€)
*** ANTE/BLINDS ***
Fried Berg posts small blind 0.01€
PIQSOU posts big blind 0.02€
Dealt to Fried Berg [4h 2h]
*** PRE-FLOP *** 
David Boring folds
NiggRice raises 0.03€ to 0.05€
curiouz dje folds
Solo130486 folds
Fried Berg folds
PIQSOU folds
NiggRice collected 0.08€ from pot
*** SUMMARY ***
Total pot 0.08€ | No rake
Seat 4: NiggRice won 0.08€


Winamax Poker - HOLD-UP "Colorado" - HandId: #19116069-204839-1701336953 - Holdem no limit (0.01€/0.02€) - 2023/11/30 09:35:53 UTC
Table: 'Colorado' 6-max (real money) Seat #6 is the button
Seat 1: Un_brochet (1.80€)
Seat 2: WonderPoul (2€)
Seat 3: divin.Ange64 (1.88€)
Seat 4: Fried Berg (2.11€)
Seat 5: JaviJavi (2.22€)
Seat 6: Effray (2.03€)
*** ANTE/BLINDS ***
Un_brochet posts small blind 0.01€
WonderPoul posts big blind 0.02€
Dealt to Fried Berg [3s 7h]
*** PRE-FLOP *** 
divin.Ange64 folds
Fried Berg folds
JaviJavi folds
Effray folds
Un_brochet folds
WonderPoul collected 0.03€ from pot
*** SUMMARY ***
Total pot 0.03€ | No rake
Seat 2: WonderPoul (big blind) won 0.03€


Winamax Poker - HOLD-UP "Colorado" - HandId: #19116069-204845-1701336959 - Holdem no limit (0.01€/0.02€) - 2023/11/30 09:35:59 UTC
Table: 'Colorado' 6-max (real money) Seat #6 is the button
Seat 1: JaviJavi (2.22€)
Seat 2: Fried Berg (2.11€)
Seat 3: kyce974 (4.78€)
Seat 4: kameleon73 (2.14€)
Seat 5: Ga31k (2€)
Seat 6: Cejargordas (2.23€)
*** ANTE/BLINDS ***
JaviJavi posts small blind 0.01€
Fried Berg posts big blind 0.02€
Dealt to Fried Berg [Jh 7s]
*** PRE-FLOP *** 
kyce974 folds
kameleon73 folds
Ga31k folds
Cejargordas folds
JaviJavi raises 0.03€ to 0.05€
Fried Berg folds
JaviJavi collected 0.07€ from pot
*** SUMMARY ***
Total pot 0.07€ | No rake
Seat 1: JaviJavi (small blind) won 0.07€


Winamax Poker - HOLD-UP "Colorado" - HandId: #19116069-204868-1701336972 - Holdem no limit (0.01€/0.02€) - 2023/11/30 09:36:12 UTC
Table: 'Colorado' 6-max (real money) Seat #6 is the button
Seat 1: Fried Berg (2.09€)
Seat 2: gagnejamais4 (2.38€)
Seat 3: Goldinher (0.42€)
Seat 4: slowreplay (2.58€)
Seat 5: LMG22_23 (3.51€)
Seat 6: kameleon73 (2.17€)
*** ANTE/BLINDS ***
Fried Berg posts small blind 0.01€
gagnejamais4 posts big blind 0.02€
Dealt to Fried Berg [Qh 8h]
*** PRE-FLOP *** 
Goldinher raises 0.02€ to 0.04€
slowreplay folds
LMG22_23 folds
kameleon73 folds
Fried Berg calls 0.03€
gagnejamais4 calls 0.02€
*** FLOP *** [Ks Ts 4h]
Fried Berg checks
gagnejamais4 checks
Goldinher bets 0.04€
Fried Berg calls 0.04€
gagnejamais4 folds
*** TURN *** [Ks Ts 4h][6c]
Fried Berg checks
Goldinher checks
*** RIVER *** [Ks Ts 4h 6c][9s]
Fried Berg checks
Goldinher checks
*** SHOW DOWN ***
Fried Berg shows [Qh 8h] (High card : King)
Goldinher shows [Ad 3c] (High card : Ace)
Goldinher collected 0.18€ from pot
*** SUMMARY ***
Total pot 0.18€ | Rake 0.02€
Board: [Ks Ts 4h 6c 9s]
Seat 1: Fried Berg (small blind) showed [Qh 8h] and lost with High card : King
Seat 3: Goldinher showed [Ad 3c] and won 0.18€ with High card : Ace


Winamax Poker - HOLD-UP "Colorado" - HandId: #19116069-204926-1701337027 - Holdem no limit (0.01€/0.02€) - 2023/11/30 09:37:07 UTC
Table: 'Colorado' 6-max (real money) Seat #6 is the button
Seat 1: Ga31k (2.07€)
Seat 2: LMG22_23 (3.22€)
Seat 3: _Croute_ (2.10€)
Seat 4: PIQSOU (2.55€)
Seat 5: haouuum28 (1.35€)
Seat 6: Fried Berg (2.01€)
*** ANTE/BLINDS ***
Ga31k posts small blind 0.01€
LMG22_23 posts big blind 0.02€
Dealt to Fried Berg [Tc 6d]
*** PRE-FLOP *** 
_Croute_ folds
PIQSOU folds
haouuum28 folds
Fried Berg folds
Ga31k raises 0.04€ to 0.06€
LMG22_23 folds
Ga31k collected 0.08€ from pot
*** SUMMARY ***
Total pot 0.08€ | No rake
Seat 1: Ga31k (small blind) won 0.08€


Winamax Poker - HOLD-UP "Colorado" - HandId: #19116069-204930-1701337031 - Holdem no limit (0.01€/0.02€) - 2023/11/30 09:37:11 UTC
Table: 'Colorado' 6-max (real money) Seat #6 is the button
Seat 1: toxi-show (1.89€)
Seat 2: widow974 (0.50€)
Seat 3: Naga Viper (2.33€)
Seat 4: Effray (2.93€)
Seat 5: _Croute_ (2.10€)
Seat 6: Fried Berg (2.01€)
*** ANTE/BLINDS ***
toxi-show posts small blind 0.01€
widow974 posts big blind 0.02€
Dealt to Fried Berg [2s Kc]
*** PRE-FLOP *** 
Naga Viper raises 0.04€ to 0.06€
Effray folds
_Croute_ folds
Fried Berg folds
toxi-show folds
widow974 folds
Naga Viper collected 0.09€ from pot
*** SUMMARY ***
Total pot 0.09€ | No rake
Seat 3: Naga Viper won 0.09€


Winamax Poker - HOLD-UP "Colorado" - HandId: #19116069-204934-1701337033 - Holdem no limit (0.01€/0.02€) - 2023/11/30 09:37:13 UTC
Table: 'Colorado' 6-max (real money) Seat #6 is the button
Seat 1: JG813 (3.49€)
Seat 2: kameleon73 (2€)
Seat 3: Fried Berg (2.01€)
Seat 4: KassKhrane76 (2.67€)
Seat 5: PIQSOU (2.55€)
Seat 6: Clemence75 (3.80€)
*** ANTE/BLINDS ***
JG813 posts small blind 0.01€
kameleon73 posts big blind 0.02€
Dealt to Fried Berg [2s Ah]
*** PRE-FLOP *** 
Fried Berg folds
KassKhrane76 folds
PIQSOU raises 0.03€ to 0.05€
Clemence75 folds
JG813 folds
kameleon73 calls 0.03€
*** FLOP *** [As Td 2h]
kameleon73 checks
PIQSOU checks
*** TURN *** [As Td 2h][5c]
kameleon73 bets 0.10€
PIQSOU folds
kameleon73 collected 0.20€ from pot
*** SUMMARY ***
Total pot 0.20€ | Rake 0.01€
Board: [As Td 2h 5c]
Seat 2: kameleon73 (big blind) won 0.20€


Winamax Poker - HOLD-UP "Colorado" - HandId: #19116069-204939-1701337037 - Holdem no limit (0.01€/0.02€) - 2023/11/30 09:37:17 UTC
Table: 'Colorado' 6-max (real money) Seat #6 is the button
Seat 1: cygoud (3.69€)
Seat 2: steph290 (0.68€)
Seat 3: GriGri24 (1.48€)
Seat 4: Fried Berg (2.01€)
Seat 5: VashtaNerada (2.11€)
Seat 6: toxi-show (1.88€)
*** ANTE/BLINDS ***
cygoud posts small blind 0.01€
steph290 posts big blind 0.02€
Dealt to Fried Berg [4c Ad]
*** PRE-FLOP *** 
GriGri24 raises 0.03€ to 0.05€
Fried Berg folds
VashtaNerada raises 0.13€ to 0.18€
toxi-show folds
cygoud folds
steph290 folds
GriGri24 calls 0.13€
*** FLOP *** [Ts Ac Kd]
GriGri24 checks
VashtaNerada bets 0.14€
GriGri24 calls 0.14€
*** TURN *** [Ts Ac Kd][6c]
GriGri24 checks
VashtaNerada bets 0.17€
GriGri24 calls 0.17€
*** RIVER *** [Ts Ac Kd 6c][7d]
GriGri24 checks
VashtaNerada bets 1.01€
GriGri24 calls 0.99€ and is all-in
*** SHOW DOWN ***
GriGri24 shows [As 3s] (One pair : Aces)
VashtaNerada shows [Kc Kh] (Trips of Kings)
VashtaNerada collected 2.71€ from pot
*** SUMMARY ***
Total pot 2.71€ | Rake 0.30€
Board: [Ts Ac Kd 6c 7d]
Seat 3: GriGri24 showed [As 3s] and lost with One pair : Aces
Seat 5: VashtaNerada showed [Kc Kh] and won 2.71€ with Trips of Kings


Winamax Poker - HOLD-UP "Colorado" - HandId: #19116069-204947-1701337042 - Holdem no limit (0.01€/0.02€) - 2023/11/30 09:37:22 UTC
Table: 'Colorado' 6-max (real money) Seat #6 is the button
Seat 1: Fried Berg (2.01€)
Seat 2: toxi-show (1.87€)
Seat 3: David Boring (2.91€)
Seat 4: Effray (2.19€)
Seat 5: BlackMoodAAA (1.45€)
Seat 6: OscarJR (0.47€)
*** ANTE/BLINDS ***
Fried Berg posts small blind 0.01€
toxi-show posts big blind 0.02€
Dealt to Fried Berg [Qh 2h]
*** PRE-FLOP *** 
David Boring folds
Effray folds
BlackMoodAAA folds
OscarJR calls 0.02€
Fried Berg folds
toxi-show raises 0.03€ to 0.05€
OscarJR calls 0.03€
*** FLOP *** [4c Ac 6c]
toxi-show bets 0.07€
OscarJR calls 0.07€
*** TURN *** [4c Ac 6c][3c]
toxi-show bets 0.16€
OscarJR folds
toxi-show collected 0.38€ from pot
*** SUMMARY ***
Total pot 0.38€ | Rake 0.03€
Board: [4c Ac 6c 3c]
Seat 2: toxi-show (big blind) won 0.38€


Winamax Poker - HOLD-UP "Colorado" - HandId: #19116069-204950-1701337045 - Holdem no limit (0.01€/0.02€) - 2023/11/30 09:37:25 UTC
Table: 'Colorado' 6-max (real money) Seat #6 is the button
Seat 1: edfcain (2€)
Seat 2: ricki64 (1.08€)
Seat 3: Fried Berg (2€)
Seat 4: BlackMoodAAA (1.45€)
Seat 5: David Boring (2.91€)
Seat 6: JG813 (3.48€)
*** ANTE/BLINDS ***
edfcain posts small blind 0.01€
ricki64 posts big blind 0.02€
Dealt to Fried Berg [9s Ks]
*** PRE-FLOP *** 
Fried Berg raises 0.02€ to 0.04€
BlackMoodAAA folds
David Boring folds
JG813 calls 0.04€
edfcain folds
ricki64 calls 0.02€
*** FLOP *** [3d 7c 6h]
ricki64 bets 1.04€ and is all-in
Fried Berg folds
JG813 folds
ricki64 collected 1.16€ from pot
*** SUMMARY ***
Total pot 1.16€ | Rake 0.01€
Board: [3d 7c 6h]
Seat 2: ricki64 (big blind) won 1.16€


Winamax Poker - HOLD-UP "Colorado" - HandId: #19116069-204972-1701337067 - Holdem no limit (0.01€/0.02€) - 2023/11/30 09:37:47 UTC
Table: 'Colorado' 6-max (real money) Seat #6 is the button
Seat 1: Cejargordas (2.08€)
Seat 2: Fried Berg (1.96€)
Seat 3: BlackMoodAAA (1.38€)
Seat 4: Direct Oli (0.99€)
Seat 5: Pierrof24 (2.18€)
Seat 6: cygoud (3.66€)
*** ANTE/BLINDS ***
Cejargordas posts small blind 0.01€
Fried Berg posts big blind 0.02€
Dealt to Fried Berg [4s 3h]
*** PRE-FLOP *** 
BlackMoodAAA folds
Direct Oli folds
Pierrof24 raises 0.04€ to 0.06€
cygoud folds
Cejargordas folds
Fried Berg folds
Pierrof24 collected 0.09€ from pot
*** SUMMARY ***
Total pot 0.09€ | No rake
Seat 5: Pierrof24 won 0.09€


Winamax Poker - HOLD-UP "Colorado" - HandId: #19116069-204979-1701337074 - Holdem no limit (0.01€/0.02€) - 2023/11/30 09:37:54 UTC
Table: 'Colorado' 6-max (real money) Seat #6 is the button
Seat 1: esox086 (0.51€)
Seat 2: Fried Berg (1.94€)
Seat 3: FabWest (2€)
Seat 4: cygoud (3.66€)
Seat 5: kameleon73 (2.01€)
Seat 6: Ga31k (2.59€)
*** ANTE/BLINDS ***
esox086 posts small blind 0.01€
Fried Berg posts big blind 0.02€
Dealt to Fried Berg [Jh 4s]
*** PRE-FLOP *** 
FabWest raises 0.03€ to 0.05€
cygoud folds
kameleon73 folds
Ga31k folds
esox086 folds
Fried Berg folds
FabWest collected 0.08€ from pot
*** SUMMARY ***
Total pot 0.08€ | No rake
Seat 3: FabWest won 0.08€


Winamax Poker - HOLD-UP "Colorado" - HandId: #19116069-204982-1701337077 - Holdem no limit (0.01€/0.02€) - 2023/11/30 09:37:57 UTC
Table: 'Colorado' 6-max (real money) Seat #6 is the button
Seat 1: Fried Berg (1.92€)
Seat 2: Ga31k (2.59€)
Seat 3: Brut2pok (2.09€)
Seat 4: toxi-show (1.97€)
Seat 5: roling670 (1.56€)
Seat 6: kameleon73 (2.01€)
*** ANTE/BLINDS ***
Fried Berg posts small blind 0.01€
Ga31k posts big blind 0.02€
Dealt to Fried Berg [Kd Qd]
*** PRE-FLOP *** 
Brut2pok folds
toxi-show folds
roling670 folds
kameleon73 folds
Fried Berg raises 0.02€ to 0.04€
Ga31k raises 0.12€ to 0.16€
Fried Berg calls 0.12€
*** FLOP *** [4c 7d Ts]
Fried Berg checks
Ga31k bets 0.11€
Fried Berg calls 0.11€
*** TURN *** [4c 7d Ts][2d]
Fried Berg checks
Ga31k bets 0.19€
Fried Berg calls 0.19€
*** RIVER *** [4c 7d Ts 2d][Qc]
Fried Berg checks
Ga31k checks
*** SHOW DOWN ***
Ga31k shows [Jc Jd] (One pair : Jacks)
Fried Berg shows [Kd Qd] (One pair : Queens)
Fried Berg collected 0.83€ from pot
*** SUMMARY ***
Total pot 0.83€ | Rake 0.09€
Board: [4c 7d Ts 2d Qc]
Seat 1: Fried Berg (small blind) showed [Kd Qd] and won 0.83€ with One pair : Queens
Seat 2: Ga31k (big blind) showed [Jc Jd] and lost with One pair : Jacks


Winamax Poker - HOLD-UP "Colorado" - HandId: #19116069-205031-1701337121 - Holdem no limit (0.01€/0.02€) - 2023/11/30 09:38:41 UTC
Table: 'Colorado' 6-max (real money) Seat #6 is the button
Seat 1: David Boring (2.84€)
Seat 2: Cejargordas (2.17€)
Seat 3: slowreplay (2€)
Seat 4: l artiste ho (1.77€)
Seat 5: Fried Berg (2.29€)
Seat 6: Ga31k (2.13€)
*** ANTE/BLINDS ***
David Boring posts small blind 0.01€
Cejargordas posts big blind 0.02€
Dealt to Fried Berg [Tc 4s]
*** PRE-FLOP *** 
slowreplay folds
l artiste ho folds
Fried Berg folds
Ga31k folds
David Boring folds
Cejargordas collected 0.03€ from pot
*** SUMMARY ***
Total pot 0.03€ | No rake
Seat 2: Cejargordas (big blind) won 0.03€


Winamax Poker - HOLD-UP "Colorado" - HandId: #19116069-205046-1701337136 - Holdem no limit (0.01€/0.02€) - 2023/11/30 09:38:56 UTC
Table: 'Colorado' 6-max (real money) Seat #6 is the button
Seat 1: VashtaNerada (3.56€)
Seat 2: kameleon73 (2€)
Seat 3: widow974 (0.29€)
Seat 4: Fried Berg (2.29€)
Seat 5: Brut2pok (2.07€)
Seat 6: Trucs78 (2.76€)
*** ANTE/BLINDS ***
VashtaNerada posts small blind 0.01€
kameleon73 posts big blind 0.02€
Dealt to Fried Berg [Ad 6s]
*** PRE-FLOP *** 
widow974 calls 0.02€
Fried Berg calls 0.02€
Brut2pok calls 0.02€
Trucs78 folds
VashtaNerada folds
kameleon73 checks
*** FLOP *** [9c 3d 4s]
kameleon73 checks
widow974 checks
Fried Berg checks
Brut2pok checks
*** TURN *** [9c 3d 4s][9s]
kameleon73 bets 0.07€
widow974 calls 0.07€
Fried Berg folds
Brut2pok calls 0.07€
*** RIVER *** [9c 3d 4s 9s][8d]
kameleon73 checks
widow974 checks
Brut2pok checks
*** SHOW DOWN ***
kameleon73 shows [4h 2s] (Two pairs : 9 and 4)
widow974 shows [Ts 7s] (One pair : 9)
Brut2pok shows [8s As] (Two pairs : 9 and 8)
Brut2pok collected 0.27€ from pot
*** SUMMARY ***
Total pot 0.27€ | Rake 0.03€
Board: [9c 3d 4s 9s 8d]
Seat 2: kameleon73 (big blind) showed [4h 2s] and lost with Two pairs : 9 and 4
Seat 3: widow974 showed [Ts 7s] and lost with One pair : 9
Seat 5: Brut2pok showed [8s As] and won 0.27€ with Two pairs : 9 and 8


Winamax Poker - HOLD-UP "Colorado" - HandId: #19116069-205095-1701337181 - Holdem no limit (0.01€/0.02€) - 2023/11/30 09:39:41 UTC
Table: 'Colorado' 6-max (real money) Seat #6 is the button
Seat 1: kameleon73 (2€)
Seat 2: Brut2pok (2.25€)
Seat 3: GriGri24 (1.95€)
Seat 4: LMG22_23 (4.70€)
Seat 5: Fried Berg (2.27€)
Seat 6: toxi-show (1.33€)
*** ANTE/BLINDS ***
kameleon73 posts small blind 0.01€
Brut2pok posts big blind 0.02€
Dealt to Fried Berg [4h 2c]
*** PRE-FLOP *** 
GriGri24 folds
LMG22_23 raises 0.03€ to 0.05€
Fried Berg folds
toxi-show folds
kameleon73 folds
Brut2pok folds
LMG22_23 collected 0.08€ from pot
*** SUMMARY ***
Total pot 0.08€ | No rake
Seat 4: LMG22_23 won 0.08€


Winamax Poker - HOLD-UP "Colorado" - HandId: #19116069-205099-1701337184 - Holdem no limit (0.01€/0.02€) - 2023/11/30 09:39:44 UTC
Table: 'Colorado' 6-max (real money) Seat #6 is the button
Seat 1: roling670 (1.34€)
Seat 2: Cejargordas (2.17€)
Seat 3: FabWest (2.11€)
Seat 4: steph290 (0.81€)
Seat 5: Fried Berg (2.27€)
Seat 6: esox086 (0.50€)
*** ANTE/BLINDS ***
roling670 posts small blind 0.01€
Cejargordas posts big blind 0.02€
Dealt to Fried Berg [Kc Th]
*** PRE-FLOP *** 
FabWest folds
steph290 folds
Fried Berg raises 0.02€ to 0.04€
esox086 folds
roling670 folds
Cejargordas folds
Fried Berg collected 0.07€ from pot
*** SUMMARY ***
Total pot 0.07€ | No rake
Seat 5: Fried Berg won 0.07€


Winamax Poker - HOLD-UP "Colorado" - HandId: #19116069-205116-1701337196 - Holdem no limit (0.01€/0.02€) - 2023/11/30 09:39:56 UTC
Table: 'Colorado' 6-max (real money) Seat #6 is the button
Seat 1: Fried Berg (2.30€)
Seat 2: B&CLYDE (2.18€)
Seat 3: edfcain (2.14€)
Seat 4: JaviJavi (2.53€)
Seat 5: curiouz dje (2€)
Seat 6: FabWest (2.11€)
*** ANTE/BLINDS ***
Fried Berg posts small blind 0.01€
B&CLYDE posts big blind 0.02€
Dealt to Fried Berg [7c 3c]
*** PRE-FLOP *** 
edfcain folds
JaviJavi folds
curiouz dje folds
FabWest folds
Fried Berg folds
B&CLYDE collected 0.03€ from pot
*** SUMMARY ***
Total pot 0.03€ | No rake
Seat 2: B&CLYDE (big blind) won 0.03€


Winamax Poker - HOLD-UP "Colorado" - HandId: #19116069-205136-1701337215 - Holdem no limit (0.01€/0.02€) - 2023/11/30 09:40:15 UTC
Table: 'Colorado' 6-max (real money) Seat #6 is the button
Seat 1: gagnejamais4 (4.60€)
Seat 2: PIQSOU (2.24€)
Seat 3: Fried Berg (2.29€)
Seat 4: David Boring (2.39€)
Seat 5: Trucs78 (2.93€)
Seat 6: Cejargordas (2.14€)
*** ANTE/BLINDS ***
gagnejamais4 posts small blind 0.01€
PIQSOU posts big blind 0.02€
Dealt to Fried Berg [6c 8h]
*** PRE-FLOP *** 
Fried Berg folds
David Boring folds
Trucs78 raises 0.02€ to 0.04€
Cejargordas raises 0.16€ to 0.20€
gagnejamais4 folds
PIQSOU folds
Trucs78 folds
Cejargordas collected 0.27€ from pot
*** SUMMARY ***
Total pot 0.27€ | No rake
Seat 6: Cejargordas (button) won 0.27€


Winamax Poker - HOLD-UP "Colorado" - HandId: #19116069-205142-1701337219 - Holdem no limit (0.01€/0.02€) - 2023/11/30 09:40:19 UTC
Table: 'Colorado' 6-max (real money) Seat #6 is the button
Seat 1: Ddm8 (2.46€)
Seat 2: BAAC0 (2.08€)
Seat 3: slowreplay (4.46€)
Seat 4: messor (2€)
Seat 5: Fried Berg (2.29€)
Seat 6: VashtaNerada (3.50€)
*** ANTE/BLINDS ***
Ddm8 posts small blind 0.01€
BAAC0 posts big blind 0.02€
Dealt to Fried Berg [Ad 6d]
*** PRE-FLOP *** 
slowreplay folds
messor folds
Fried Berg raises 0.03€ to 0.05€
VashtaNerada folds
Ddm8 calls 0.04€
BAAC0 calls 0.03€
*** FLOP *** [4d 2s Qc]
Ddm8 checks
BAAC0 checks
Fried Berg checks
*** TURN *** [4d 2s Qc][9d]
Ddm8 bets 0.10€
BAAC0 calls 0.10€
Fried Berg calls 0.10€
*** RIVER *** [4d 2s Qc 9d][6c]
Ddm8 checks
BAAC0 checks
Fried Berg checks
*** SHOW DOWN ***
Ddm8 shows [Th Kh] (High card : King)
BAAC0 shows [Jd Kd] (High card : King)
Fried Berg shows [Ad 6d] (One pair : 6)
Fried Berg collected 0.40€ from pot
*** SUMMARY ***
Total pot 0.40€ | Rake 0.05€
Board: [4d 2s Qc 9d 6c]
Seat 1: Ddm8 (small blind) showed [Th Kh] and lost with High card : King
Seat 2: BAAC0 (big blind) showed [Jd Kd] and lost with High card : King
Seat 5: Fried Berg showed [Ad 6d] and won 0.40€ with One pair : 6


Winamax Poker - HOLD-UP "Colorado" - HandId: #19116069-205224-1701337282 - Holdem no limit (0.01€/0.02€) - 2023/11/30 09:41:22 UTC
Table: 'Colorado' 6-max (real money) Seat #6 is the button
Seat 1: BAAC0 (1.93€)
Seat 2: Fried Berg (2.54€)
Seat 3: Ddm8 (2.31€)
Seat 4: Brut2pok (2.66€)
Seat 5: Chamois 2638 (0.41€)
Seat 6: PIQSOU (2.54€)
*** ANTE/BLINDS ***
BAAC0 posts small blind 0.01€
Fried Berg posts big blind 0.02€
Dealt to Fried Berg [7h 3d]
*** PRE-FLOP *** 
Ddm8 raises 0.03€ to 0.05€
Brut2pok folds
Chamois 2638 calls 0.05€
PIQSOU folds
BAAC0 calls 0.04€
Fried Berg folds
*** FLOP *** [7d 8d 8s]
BAAC0 checks
Ddm8 bets 0.11€
Chamois 2638 folds
BAAC0 folds
Ddm8 collected 0.26€ from pot
*** SUMMARY ***
Total pot 0.26€ | Rake 0.02€
Board: [7d 8d 8s]
Seat 3: Ddm8 won 0.26€


Winamax Poker - HOLD-UP "Colorado" - HandId: #19116069-205242-1701337299 - Holdem no limit (0.01€/0.02€) - 2023/11/30 09:41:39 UTC
Table: 'Colorado' 6-max (real money) Seat #6 is the button
Seat 1: steph290 (0.48€)
Seat 2: slowreplay (4.42€)
Seat 3: curiouz dje (2.04€)
Seat 4: Fried Berg (2.52€)
Seat 5: Fcgb_2907 (0.43€)
Seat 6: GriGri24 (2.20€)
*** ANTE/BLINDS ***
steph290 posts small blind 0.01€
slowreplay posts big blind 0.02€
Dealt to Fried Berg [Ts 2c]
*** PRE-FLOP *** 
curiouz dje folds
Fried Berg folds
Fcgb_2907 folds
GriGri24 folds
steph290 folds
slowreplay collected 0.03€ from pot
*** SUMMARY ***
Total pot 0.03€ | No rake
Seat 2: slowreplay (big blind) won 0.03€


Winamax Poker - HOLD-UP "Colorado" - HandId: #19116069-205249-1701337308 - Holdem no limit (0.01€/0.02€) - 2023/11/30 09:41:48 UTC
Table: 'Colorado' 6-max (real money) Seat #6 is the button
Seat 1: JaviJavi (2.20€)
Seat 2: David Boring (2.58€)
Seat 3: Fried Berg (2.52€)
Seat 4: Ga31k (2.71€)
Seat 5: souliyo25 (0.77€)
Seat 6: KON-2-PEUTE (2€)
*** ANTE/BLINDS ***
JaviJavi posts small blind 0.01€
David Boring posts big blind 0.02€
Dealt to Fried Berg [5h 2d]
*** PRE-FLOP *** 
Fried Berg folds
Ga31k folds
souliyo25 folds
KON-2-PEUTE folds
JaviJavi folds
David Boring collected 0.03€ from pot
*** SUMMARY ***
Total pot 0.03€ | No rake
Seat 2: David Boring (big blind) won 0.03€


Winamax Poker - HOLD-UP "Colorado" - HandId: #19116069-205251-1701337311 - Holdem no limit (0.01€/0.02€) - 2023/11/30 09:41:51 UTC
Table: 'Colorado' 6-max (real money) Seat #6 is the button
Seat 1: Pierrof24 (5.03€)
Seat 2: SabriZ7 (1.20€)
Seat 3: wAAlterrr (2.03€)
Seat 4: slowreplay (4.43€)
Seat 5: Fried Berg (2.52€)
Seat 6: ZenoidZ (1.91€)
*** ANTE/BLINDS ***
Pierrof24 posts small blind 0.01€
SabriZ7 posts big blind 0.02€
Dealt to Fried Berg [4c Qh]
*** PRE-FLOP *** 
wAAlterrr folds
slowreplay folds
Fried Berg folds
ZenoidZ folds
Pierrof24 raises 0.02€ to 0.04€
SabriZ7 calls 0.02€
*** FLOP *** [9s 4s 3d]
Pierrof24 checks
SabriZ7 bets 0.03€
Pierrof24 folds
SabriZ7 collected 0.10€ from pot
*** SUMMARY ***
Total pot 0.10€ | Rake 0.01€
Board: [9s 4s 3d]
Seat 2: SabriZ7 (big blind) won 0.10€


Winamax Poker - HOLD-UP "Colorado" - HandId: #19116069-205256-1701337318 - Holdem no limit (0.01€/0.02€) - 2023/11/30 09:41:58 UTC
Table: 'Colorado' 6-max (real money) Seat #6 is the button
Seat 1: Fried Berg (2.52€)
Seat 2: VashtaNerada (3.67€)
Seat 3: Chamois 2638 (0.36€)
Seat 4: BAAC0 (1.88€)
Seat 5: WonderPoul (2.42€)
Seat 6: kyce974 (4.54€)
*** ANTE/BLINDS ***
Fried Berg posts small blind 0.01€
VashtaNerada posts big blind 0.02€
Dealt to Fried Berg [2s Qc]
*** PRE-FLOP *** 
Chamois 2638 folds
BAAC0 folds
WonderPoul folds
kyce974 raises 0.03€ to 0.05€
Fried Berg folds
VashtaNerada folds
kyce974 collected 0.08€ from pot
*** SUMMARY ***
Total pot 0.08€ | No rake
Seat 6: kyce974 (button) won 0.08€


Winamax Poker - HOLD-UP "Colorado" - HandId: #19116069-205264-1701337324 - Holdem no limit (0.01€/0.02€) - 2023/11/30 09:42:04 UTC
Table: 'Colorado' 6-max (real money) Seat #6 is the button
Seat 1: gagnejamais4 (5.21€)
Seat 2: PIQSOU (2.08€)
Seat 3: Fried Berg (2.51€)
Seat 4: kameleon73 (2€)
Seat 5: divin.Ange64 (4.06€)
Seat 6: Chamois 2638 (0.36€)
Hold-up to Pot: total 0.10€
*** ANTE/BLINDS ***
gagnejamais4 posts small blind 0.01€
PIQSOU posts big blind 0.02€
Dealt to Fried Berg [4c Jc]
*** PRE-FLOP *** 
Fried Berg calls 0.02€
kameleon73 folds
divin.Ange64 folds
Chamois 2638 raises 0.34€ to 0.36€ and is all-in
gagnejamais4 calls 0.35€
PIQSOU folds
Fried Berg folds
*** FLOP *** [Kd Ts 2s]
*** TURN *** [Kd Ts 2s][Ah]
*** RIVER *** [Kd Ts 2s Ah][5h]
*** SHOW DOWN ***
Chamois 2638 shows [6h Qh] (High card : Ace)
gagnejamais4 shows [Ks 9s] (One pair : Kings)
gagnejamais4 collected 0.78€ from pot
*** SUMMARY ***
Total pot 0.78€ | Rake 0.08€
Board: [Kd Ts 2s Ah 5h]
Seat 1: gagnejamais4 (small blind) showed [Ks 9s] and won 0.78€ with One pair : Kings
Seat 6: Chamois 2638 (button) showed [6h Qh] and lost with High card : Ace


Winamax Poker - HOLD-UP "Colorado" - HandId: #19116069-205585-1701337613 - Holdem no limit (0.01€/0.02€) - 2023/11/30 09:46:53 UTC
Table: 'Colorado' 6-max (real money) Seat #6 is the button
Seat 1: David Boring (4.99€)
Seat 2: Fried Berg (0.50€)
Seat 3: Adame199623 (2€)
Seat 4: slowreplay (3.17€)
Seat 5: Naga Viper (2.22€)
Seat 6: kyce974 (4.05€)
Hold-up to Pot: total 0.10€
*** ANTE/BLINDS ***
David Boring posts small blind 0.01€
Fried Berg posts big blind 0.02€
Dealt to Fried Berg [5c 6h]
*** PRE-FLOP *** 
Adame199623 folds
slowreplay calls 0.02€
Naga Viper folds
kyce974 folds
David Boring folds
Fried Berg checks
*** FLOP *** [4d 4s 7c]
Fried Berg checks
slowreplay checks
*** TURN *** [4d 4s 7c][Ah]
Fried Berg checks
slowreplay checks
*** RIVER *** [4d 4s 7c Ah][5d]
Fried Berg checks
slowreplay checks
*** SHOW DOWN ***
slowreplay shows [9s Jc] (One pair : 4)
Fried Berg shows [5c 6h] (Two pairs : 5 and 4)
Fried Berg collected 0.14€ from pot
*** SUMMARY ***
Total pot 0.14€ | Rake 0.01€
Board: [4d 4s 7c Ah 5d]
Seat 2: Fried Berg (big blind) showed [5c 6h] and won 0.14€ with Two pairs : 5 and 4
Seat 4: slowreplay showed [9s Jc] and lost with One pair : 4


Winamax Poker - HOLD-UP "Colorado" - HandId: #19116069-205613-1701337651 - Holdem no limit (0.01€/0.02€) - 2023/11/30 09:47:31 UTC
Table: 'Colorado' 6-max (real money) Seat #6 is the button
Seat 1: Fried Berg (0.62€)
Seat 2: Ga31k (2.49€)
Seat 3: Trucs78 (2.79€)
Seat 4: curiouz dje (2€)
Seat 5: slowreplay (3.15€)
Seat 6: kyce974 (4.35€)
*** ANTE/BLINDS ***
Fried Berg posts small blind 0.01€
Ga31k posts big blind 0.02€
Dealt to Fried Berg [7h 5c]
*** PRE-FLOP *** 
Trucs78 folds
curiouz dje raises 0.03€ to 0.05€
slowreplay folds
kyce974 folds
Fried Berg folds
Ga31k raises 0.15€ to 0.20€
curiouz dje calls 0.15€
*** FLOP *** [2h Jc Qs]
Ga31k bets 0.21€
curiouz dje calls 0.21€
*** TURN *** [2h Jc Qs][Tc]
Ga31k bets 0.29€
curiouz dje calls 0.29€
*** RIVER *** [2h Jc Qs Tc][3c]
Ga31k bets 0.35€
curiouz dje calls 0.35€
*** SHOW DOWN ***
Ga31k shows [Qd Ad] (One pair : Queens)
curiouz dje shows [Jd Jh] (Trips of Jacks)
curiouz dje collected 1.90€ from pot
*** SUMMARY ***
Total pot 1.90€ | Rake 0.21€
Board: [2h Jc Qs Tc 3c]
Seat 2: Ga31k (big blind) showed [Qd Ad] and lost with One pair : Queens
Seat 4: curiouz dje showed [Jd Jh] and won 1.90€ with Trips of Jacks


Winamax Poker - HOLD-UP "Colorado" - HandId: #19116069-205631-1701337667 - Holdem no limit (0.01€/0.02€) - 2023/11/30 09:47:47 UTC
Table: 'Colorado' 6-max (real money) Seat #6 is the button
Seat 1: Pierrof24 (2.02€)
Seat 2: Cedlebon (3.22€)
Seat 3: Fried Berg (0.61€)
Seat 4: lilas-Mulet9 (5.16€)
Seat 5: TimToBey (2.25€)
Seat 6: slowreplay (4.36€)
*** ANTE/BLINDS ***
Pierrof24 posts small blind 0.01€
Cedlebon posts big blind 0.02€
Dealt to Fried Berg [2c 3h]
*** PRE-FLOP *** 
Fried Berg folds
lilas-Mulet9 calls 0.02€
TimToBey folds
slowreplay calls 0.02€
Pierrof24 calls 0.01€
Cedlebon checks
*** FLOP *** [6h Kd 8d]
Pierrof24 checks
Cedlebon checks
lilas-Mulet9 checks
slowreplay checks
*** TURN *** [6h Kd 8d][7h]
Pierrof24 checks
Cedlebon checks
lilas-Mulet9 checks
slowreplay checks
*** RIVER *** [6h Kd 8d 7h][Ac]
Pierrof24 bets 0.04€
Cedlebon folds
lilas-Mulet9 folds
slowreplay folds
Pierrof24 collected 0.11€ from pot
*** SUMMARY ***
Total pot 0.11€ | Rake 0.01€
Board: [6h Kd 8d 7h Ac]
Seat 1: Pierrof24 (small blind) won 0.11€


Winamax Poker - HOLD-UP "Colorado" - HandId: #19116069-205640-1701337675 - Holdem no limit (0.01€/0.02€) - 2023/11/30 09:47:55 UTC
Table: 'Colorado' 6-max (real money) Seat #6 is the button
Seat 1: matmyl (2.25€)
Seat 2: AfgaBoBpoKer (1.52€)
Seat 3: kameleon73 (2.70€)
Seat 4: Fried Berg (0.61€)
Seat 5: haouuum28 (2.31€)
Seat 6: messor (2.20€)
Hold-up to Pot: total 0.10€
*** ANTE/BLINDS ***
matmyl posts small blind 0.01€
AfgaBoBpoKer posts big blind 0.02€
Dealt to Fried Berg [7h 3c]
*** PRE-FLOP *** 
kameleon73 raises 0.02€ to 0.04€
Fried Berg folds
haouuum28 raises 0.21€ to 0.25€
messor folds
matmyl folds
AfgaBoBpoKer folds
kameleon73 folds
haouuum28 collected 0.42€ from pot
*** SUMMARY ***
Total pot 0.42€ | No rake
Seat 5: haouuum28 won 0.42€


Winamax Poker - HOLD-UP "Colorado" - HandId: #19116069-205647-1701337683 - Holdem no limit (0.01€/0.02€) - 2023/11/30 09:48:03 UTC
Table: 'Colorado' 6-max (real money) Seat #6 is the button
Seat 1: JaviJavi (2.10€)
Seat 2: Martiwildest (2.04€)
Seat 3: Adame199623 (2.05€)
Seat 4: Snakesolid56 (3.73€)
Seat 5: Fried Berg (0.61€)
Seat 6: KON-2-PEUTE (2€)
*** ANTE/BLINDS ***
JaviJavi posts small blind 0.01€
Martiwildest posts big blind 0.02€
Dealt to Fried Berg [Ks 5c]
*** PRE-FLOP *** 
Adame199623 folds
Snakesolid56 folds
Fried Berg folds
KON-2-PEUTE folds
JaviJavi raises 0.04€ to 0.06€
Martiwildest folds
JaviJavi collected 0.08€ from pot
*** SUMMARY ***
Total pot 0.08€ | No rake
Seat 1: JaviJavi (small blind) won 0.08€


Winamax Poker - HOLD-UP "Colorado" - HandId: #19116069-205654-1701337694 - Holdem no limit (0.01€/0.02€) - 2023/11/30 09:48:14 UTC
Table: 'Colorado' 6-max (real money) Seat #6 is the button
Seat 1: kameleon73 (2.08€)
Seat 2: Adrianohhhh (2.22€)
Seat 3: pelouseverte (0.69€)
Seat 4: David Boring (2.14€)
Seat 5: A.soto5 (1.12€)
Seat 6: Fried Berg (0.61€)
*** ANTE/BLINDS ***
kameleon73 posts small blind 0.01€
Adrianohhhh posts big blind 0.02€
Dealt to Fried Berg [Th 6d]
*** PRE-FLOP *** 
pelouseverte folds
David Boring folds
A.soto5 raises 0.03€ to 0.05€
Fried Berg folds
kameleon73 calls 0.04€
Adrianohhhh calls 0.03€
*** FLOP *** [8d 2c Kd]
kameleon73 checks
Adrianohhhh checks
A.soto5 bets 0.10€
kameleon73 folds
Adrianohhhh calls 0.10€
*** TURN *** [8d 2c Kd][3h]
Adrianohhhh checks
A.soto5 checks
*** RIVER *** [8d 2c Kd 3h][9h]
Adrianohhhh bets 0.18€
A.soto5 folds
Adrianohhhh collected 0.49€ from pot
*** SUMMARY ***
Total pot 0.49€ | Rake 0.04€
Board: [8d 2c Kd 3h 9h]
Seat 2: Adrianohhhh (big blind) won 0.49€


Winamax Poker - HOLD-UP "Colorado" - HandId: #19116069-205666-1701337706 - Holdem no limit (0.01€/0.02€) - 2023/11/30 09:48:26 UTC
Table: 'Colorado' 6-max (real money) Seat #6 is the button
Seat 1: matmyl (2.22€)
Seat 2: ZJER10 (1.13€)
Seat 3: David Boring (5.06€)
Seat 4: PIQSOU (2.29€)
Seat 5: AfgaBoBpoKer (1.49€)
Seat 6: Fried Berg (0.61€)
*** ANTE/BLINDS ***
matmyl posts small blind 0.01€
ZJER10 posts big blind 0.02€
Dealt to Fried Berg [8s Ac]
*** PRE-FLOP *** 
David Boring folds
PIQSOU folds
AfgaBoBpoKer raises 0.04€ to 0.06€
Fried Berg calls 0.06€
matmyl folds
ZJER10 folds
*** FLOP *** [7s Jd As]
AfgaBoBpoKer bets 0.10€
Fried Berg calls 0.10€
*** TURN *** [7s Jd As][2s]
AfgaBoBpoKer checks
Fried Berg checks
*** RIVER *** [7s Jd As 2s][Qs]
AfgaBoBpoKer bets 0.35€
Fried Berg calls 0.35€
*** SHOW DOWN ***
AfgaBoBpoKer shows [9h Kd] (High card : Ace)
Fried Berg shows [8s Ac] (Flush Ace high)
Fried Berg collected 0.94€ from pot
*** SUMMARY ***
Total pot 0.94€ | Rake 0.11€
Board: [7s Jd As 2s Qs]
Seat 5: AfgaBoBpoKer showed [9h Kd] and lost with High card : Ace
Seat 6: Fried Berg (button) showed [8s Ac] and won 0.94€ with Flush Ace high


Winamax Poker - HOLD-UP "Colorado" - HandId: #19116069-205709-1701337754 - Holdem no limit (0.01€/0.02€) - 2023/11/30 09:49:14 UTC
Table: 'Colorado' 6-max (real money) Seat #6 is the button
Seat 1: AfgaBoBpoKer (0.98€)
Seat 2: Fried Berg (1.04€)
Seat 3: l artiste ho (1.69€)
Seat 4: edfcain (2.08€)
Seat 5: _Croute_ (1.63€)
Seat 6: GriGri24 (2.10€)
*** ANTE/BLINDS ***
AfgaBoBpoKer posts small blind 0.01€
Fried Berg posts big blind 0.02€
Dealt to Fried Berg [8s Ah]
*** PRE-FLOP *** 
l artiste ho folds
edfcain raises 0.03€ to 0.05€
_Croute_ folds
GriGri24 calls 0.05€
AfgaBoBpoKer folds
Fried Berg calls 0.03€
*** FLOP *** [3d 4h 5h]
Fried Berg checks
edfcain checks
GriGri24 checks
*** TURN *** [3d 4h 5h][9d]
Fried Berg checks
edfcain checks
GriGri24 bets 0.06€
Fried Berg calls 0.06€
edfcain folds
*** RIVER *** [3d 4h 5h 9d][8h]
Fried Berg bets 0.07€
GriGri24 raises 0.10€ to 0.17€
Fried Berg folds
GriGri24 collected 0.48€ from pot
*** SUMMARY ***
Total pot 0.48€ | Rake 0.04€
Board: [3d 4h 5h 9d 8h]
Seat 6: GriGri24 (button) won 0.48€


Winamax Poker - HOLD-UP "Colorado" - HandId: #19116069-205776-1701337843 - Holdem no limit (0.01€/0.02€) - 2023/11/30 09:50:43 UTC
Table: 'Colorado' 6-max (real money) Seat #6 is the button
Seat 1: Fried Berg (0.86€)
Seat 2: ironman33 (1.45€)
Seat 3: lilas-Mulet9 (5.12€)
Seat 4: Ga31k (2.57€)
Seat 5: ZJER10 (1.10€)
Seat 6: Pierrof24 (2.36€)
*** ANTE/BLINDS ***
Fried Berg posts small blind 0.01€
ironman33 posts big blind 0.02€
Dealt to Fried Berg [5h 7h]
*** PRE-FLOP *** 
lilas-Mulet9 raises 0.04€ to 0.06€
Ga31k folds
ZJER10 folds
Pierrof24 folds
Fried Berg calls 0.05€
ironman33 folds
*** FLOP *** [3h Kh Td]
Fried Berg checks
lilas-Mulet9 bets 0.09€
Fried Berg calls 0.09€
*** TURN *** [3h Kh Td][6s]
Fried Berg checks
lilas-Mulet9 bets 0.21€
Fried Berg folds
lilas-Mulet9 collected 0.50€ from pot
*** SUMMARY ***
Total pot 0.50€ | Rake 0.03€
Board: [3h Kh Td 6s]
Seat 3: lilas-Mulet9 won 0.50€


Winamax Poker - HOLD-UP "Colorado" - HandId: #19116069-205835-1701337909 - Holdem no limit (0.01€/0.02€) - 2023/11/30 09:51:49 UTC
Table: 'Colorado' 6-max (real money) Seat #6 is the button
Seat 1: Adame199623 (2.11€)
Seat 2: curiouz dje (2.37€)
Seat 3: Fried Berg (0.71€)
Seat 4: LA TOUR FL (2.17€)
Seat 5: Hydramist (2€)
Seat 6: ZJER10 (4.23€)
*** ANTE/BLINDS ***
Adame199623 posts small blind 0.01€
curiouz dje posts big blind 0.02€
Dealt to Fried Berg [Kc 5c]
*** PRE-FLOP *** 
Fried Berg folds
LA TOUR FL folds
Hydramist folds
ZJER10 calls 0.02€
Adame199623 folds
curiouz dje checks
*** FLOP *** [Ad 4d Kh]
curiouz dje checks
ZJER10 checks
*** TURN *** [Ad 4d Kh][7c]
curiouz dje checks
ZJER10 bets 0.05€
curiouz dje folds
ZJER10 collected 0.09€ from pot
*** SUMMARY ***
Total pot 0.09€ | Rake 0.01€
Board: [Ad 4d Kh 7c]
Seat 6: ZJER10 (button) won 0.09€


Winamax Poker - HOLD-UP "Colorado" - HandId: #19116069-205840-1701337916 - Holdem no limit (0.01€/0.02€) - 2023/11/30 09:51:56 UTC
Table: 'Colorado' 6-max (real money) Seat #6 is the button
Seat 1: Trucs78 (0.38€)
Seat 2: ZenoidZ (1.84€)
Seat 3: KON-2-PEUTE (1.98€)
Seat 4: Fried Berg (0.71€)
Seat 5: PIQSOU (2.10€)
Seat 6: Adame199623 (2.02€)
*** ANTE/BLINDS ***
Trucs78 posts small blind 0.01€
ZenoidZ posts big blind 0.02€
Dealt to Fried Berg [Qh Ac]
*** PRE-FLOP *** 
KON-2-PEUTE folds
Fried Berg raises 0.03€ to 0.05€
PIQSOU raises 0.15€ to 0.20€
Adame199623 folds
Trucs78 folds
ZenoidZ folds
Fried Berg calls 0.15€
*** FLOP *** [6h 4s Js]
Fried Berg checks
PIQSOU bets 0.14€
Fried Berg calls 0.14€
*** TURN *** [6h 4s Js][Jh]
Fried Berg checks
PIQSOU bets 0.53€
Fried Berg folds
PIQSOU collected 1.17€ from pot
*** SUMMARY ***
Total pot 1.17€ | Rake 0.07€
Board: [6h 4s Js Jh]
Seat 5: PIQSOU won 1.17€


Winamax Poker - HOLD-UP "Colorado" - HandId: #19116069-205908-1701337986 - Holdem no limit (0.01€/0.02€) - 2023/11/30 09:53:06 UTC
Table: 'Colorado' 6-max (real money) Seat #6 is the button
Seat 1: David Boring (3.71€)
Seat 2: BlackMoodAAA (2.18€)
Seat 3: curiouz dje (2.34€)
Seat 4: Fcgb_2907 (0.33€)
Seat 5: Fried Berg (0.37€)
Seat 6: LimpDoud (2€)
*** ANTE/BLINDS ***
David Boring posts small blind 0.01€
BlackMoodAAA posts big blind 0.02€
Dealt to Fried Berg [Ts 7c]
*** PRE-FLOP *** 
curiouz dje folds
Fcgb_2907 calls 0.02€
Fried Berg folds
LimpDoud folds
David Boring folds
BlackMoodAAA checks
*** FLOP *** [3d 7s As]
BlackMoodAAA checks
Fcgb_2907 bets 0.02€
BlackMoodAAA raises 0.03€ to 0.05€
Fcgb_2907 folds
BlackMoodAAA collected 0.11€ from pot
*** SUMMARY ***
Total pot 0.11€ | Rake 0.01€
Board: [3d 7s As]
Seat 2: BlackMoodAAA (big blind) won 0.11€


Winamax Poker - HOLD-UP "Colorado" - HandId: #19116069-205913-1701337991 - Holdem no limit (0.01€/0.02€) - 2023/11/30 09:53:11 UTC
Table: 'Colorado' 6-max (real money) Seat #6 is the button
Seat 1: Fried Berg (0.37€)
Seat 2: curiouz dje (2.87€)
Seat 3: Ga31k (3.43€)
Seat 4: esox086 (0.85€)
Seat 5: TimToBey (2€)
Seat 6: Adame199623 (2€)
*** ANTE/BLINDS ***
Fried Berg posts small blind 0.01€
curiouz dje posts big blind 0.02€
Dealt to Fried Berg [2c Qs]
*** PRE-FLOP *** 
Ga31k folds
esox086 folds
TimToBey folds
Adame199623 folds
Fried Berg folds
curiouz dje collected 0.03€ from pot
*** SUMMARY ***
Total pot 0.03€ | No rake
Seat 2: curiouz dje (big blind) won 0.03€


Winamax Poker - HOLD-UP "Colorado" - HandId: #19116069-205917-1701337993 - Holdem no limit (0.01€/0.02€) - 2023/11/30 09:53:13 UTC
Table: 'Colorado' 6-max (real money) Seat #6 is the button
Seat 1: LimpDoud (2€)
Seat 2: wAAlterrr (2€)
Seat 3: Fried Berg (0.36€)
Seat 4: Naga Viper (3.74€)
Seat 5: haouuum28 (1.68€)
Seat 6: widow974 (1.32€)
*** ANTE/BLINDS ***
LimpDoud posts small blind 0.01€
wAAlterrr posts big blind 0.02€
Dealt to Fried Berg [6d 8h]
*** PRE-FLOP *** 
Fried Berg folds
Naga Viper raises 0.03€ to 0.05€
haouuum28 folds
widow974 calls 0.05€
LimpDoud calls 0.04€
wAAlterrr folds
*** FLOP *** [Qd 2h 8d]
LimpDoud checks
Naga Viper bets 0.06€
widow974 raises 0.06€ to 0.12€
LimpDoud folds
Naga Viper calls 0.06€
*** TURN *** [Qd 2h 8d][5c]
Naga Viper checks
widow974 bets 0.27€
Naga Viper folds
widow974 collected 0.64€ from pot
*** SUMMARY ***
Total pot 0.64€ | Rake 0.04€
Board: [Qd 2h 8d 5c]
Seat 6: widow974 (button) won 0.64€


Winamax Poker - HOLD-UP "Colorado" - HandId: #19116069-205919-1701337996 - Holdem no limit (0.01€/0.02€) - 2023/11/30 09:53:16 UTC
Table: 'Colorado' 6-max (real money) Seat #6 is the button
Seat 1: Ddm8 (24.54€)
Seat 2: Fried Berg (0.36€)
Seat 3: Pierrof24 (1.76€)
Seat 4: TimToBey (2€)
Seat 5: kameleon73 (3.05€)
Seat 6: Hydramist (2€)
*** ANTE/BLINDS ***
Ddm8 posts small blind 0.01€
Fried Berg posts big blind 0.02€
Dealt to Fried Berg [Js 3s]
*** PRE-FLOP *** 
Pierrof24 folds
TimToBey folds
kameleon73 folds
Hydramist folds
Ddm8 folds
Fried Berg collected 0.03€ from pot
*** SUMMARY ***
Total pot 0.03€ | No rake
Seat 2: Fried Berg (big blind) won 0.03€


Winamax Poker - HOLD-UP "Colorado" - HandId: #19116069-205930-1701338010 - Holdem no limit (0.01€/0.02€) - 2023/11/30 09:53:30 UTC
Table: 'Colorado' 6-max (real money) Seat #6 is the button
Seat 1: curiouz dje (2.32€)
Seat 2: Felixapo (0.32€)
Seat 3: BlackMoodAAA (2.21€)
Seat 4: Fraty-Goul (2€)
Seat 5: Fried Berg (0.37€)
Seat 6: Snakesolid56 (2.43€)
*** ANTE/BLINDS ***
curiouz dje posts small blind 0.01€
Felixapo posts big blind 0.02€
Dealt to Fried Berg [4c 5c]
*** PRE-FLOP *** 
BlackMoodAAA folds
Fraty-Goul folds
Fried Berg raises 0.02€ to 0.04€
Snakesolid56 calls 0.04€
curiouz dje folds
Felixapo folds
*** FLOP *** [Ks Kd Qs]
Fried Berg checks
Snakesolid56 checks
*** TURN *** [Ks Kd Qs][9h]
Fried Berg checks
Snakesolid56 bets 0.07€
Fried Berg folds
Snakesolid56 collected 0.17€ from pot
*** SUMMARY ***
Total pot 0.17€ | Rake 0.01€
Board: [Ks Kd Qs 9h]
Seat 6: Snakesolid56 (button) won 0.17€


Winamax Poker - HOLD-UP "Colorado" - HandId: #19116069-205951-1701338033 - Holdem no limit (0.01€/0.02€) - 2023/11/30 09:53:53 UTC
Table: 'Colorado' 6-max (real money) Seat #6 is the button
Seat 1: slowreplay (3.86€)
Seat 2: Cejargordas (3.78€)
Seat 3: sopra61 (0.32€)
Seat 4: Fried Berg (0.33€)
Seat 5: l artiste ho (2.01€)
Seat 6: Sucre10 (2.58€)
*** ANTE/BLINDS ***
slowreplay posts small blind 0.01€
Cejargordas posts big blind 0.02€
Dealt to Fried Berg [Td Ts]
*** PRE-FLOP *** 
sopra61 folds
Fried Berg raises 0.31€ to 0.33€ and is all-in
l artiste ho folds
Sucre10 folds
slowreplay folds
Cejargordas folds
Fried Berg collected 0.36€ from pot
*** SUMMARY ***
Total pot 0.36€ | No rake
Seat 4: Fried Berg won 0.36€


Winamax Poker - HOLD-UP "Colorado" - HandId: #19116069-205973-1701338051 - Holdem no limit (0.01€/0.02€) - 2023/11/30 09:54:11 UTC
Table: 'Colorado' 6-max (real money) Seat #6 is the button
Seat 1: LEBEAUF57 (1.69€)
Seat 2: _Croute_ (1.88€)
Seat 3: PIQSOU (2.41€)
Seat 4: Hydramist (2€)
Seat 5: BlackMoodAAA (2.18€)
Seat 6: Fried Berg (0.36€)
*** ANTE/BLINDS ***
LEBEAUF57 posts small blind 0.01€
_Croute_ posts big blind 0.02€
Dealt to Fried Berg [Js 5d]
*** PRE-FLOP *** 
PIQSOU folds
Hydramist folds
BlackMoodAAA folds
Fried Berg folds
LEBEAUF57 raises 0.02€ to 0.04€
_Croute_ calls 0.02€
*** FLOP *** [Qc Jh 2c]
LEBEAUF57 bets 0.02€
_Croute_ raises 0.02€ to 0.04€
LEBEAUF57 calls 0.02€
*** TURN *** [Qc Jh 2c][6s]
LEBEAUF57 bets 0.02€
_Croute_ raises 0.06€ to 0.08€
LEBEAUF57 calls 0.06€
*** RIVER *** [Qc Jh 2c 6s][8c]
LEBEAUF57 checks
_Croute_ checks
*** SHOW DOWN ***
LEBEAUF57 shows [Th Kc] (High card : King)
_Croute_ shows [Qs 4c] (One pair : Queens)
_Croute_ collected 0.29€ from pot
*** SUMMARY ***
Total pot 0.29€ | Rake 0.03€
Board: [Qc Jh 2c 6s 8c]
Seat 1: LEBEAUF57 (small blind) showed [Th Kc] and lost with High card : King
Seat 2: _Croute_ (big blind) showed [Qs 4c] and won 0.29€ with One pair : Queens


Winamax Poker - HOLD-UP "Colorado" - HandId: #19116069-205978-1701338055 - Holdem no limit (0.01€/0.02€) - 2023/11/30 09:54:15 UTC
Table: 'Colorado' 6-max (real money) Seat #6 is the button
Seat 1: Fried Berg (0.36€)
Seat 2: Felixapo (0.42€)
Seat 3: slowreplay (3.83€)
Seat 4: wAAlterrr (2.14€)
Seat 5: DUCHE80 (0.35€)
Seat 6: TimToBey (2€)
*** ANTE/BLINDS ***
Fried Berg posts small blind 0.01€
Felixapo posts big blind 0.02€
Dealt to Fried Berg [9d Td]
*** PRE-FLOP *** 
slowreplay folds
wAAlterrr folds
DUCHE80 folds
TimToBey folds
Fried Berg raises 0.02€ to 0.04€
Felixapo folds
Fried Berg collected 0.06€ from pot
*** SUMMARY ***
Total pot 0.06€ | No rake
Seat 1: Fried Berg (small blind) won 0.06€


Winamax Poker - HOLD-UP "Colorado" - HandId: #19116069-205990-1701338064 - Holdem no limit (0.01€/0.02€) - 2023/11/30 09:54:24 UTC
Table: 'Colorado' 6-max (real money) Seat #6 is the button
Seat 1: GriGri24 (2.58€)
Seat 2: Fried Berg (0.38€)
Seat 3: LA TOUR FL (4.30€)
Seat 4: David Boring (3.63€)
Seat 5: TimToBey (2€)
Seat 6: Sucre10 (2.55€)
Hold-up to Pot: total 0.10€
*** ANTE/BLINDS ***
GriGri24 posts small blind 0.01€
Fried Berg posts big blind 0.02€
Dealt to Fried Berg [Kd Qd]
*** PRE-FLOP *** 
LA TOUR FL folds
David Boring raises 0.04€ to 0.06€
TimToBey folds
Sucre10 folds
GriGri24 folds
Fried Berg raises 0.32€ to 0.38€ and is all-in
David Boring calls 0.32€
*** FLOP *** [2d 6c Ah]
*** TURN *** [2d 6c Ah][4h]
*** RIVER *** [2d 6c Ah 4h][7h]
*** SHOW DOWN ***
David Boring shows [9s 8s] (High card : Ace)
Fried Berg shows [Kd Qd] (High card : Ace)
Fried Berg collected 0.79€ from pot
*** SUMMARY ***
Total pot 0.79€ | Rake 0.08€
Board: [2d 6c Ah 4h 7h]
Seat 2: Fried Berg (big blind) showed [Kd Qd] and won 0.79€ with High card : Ace
Seat 4: David Boring showed [9s 8s] and lost with High card : Ace


Winamax Poker - HOLD-UP "Colorado" - HandId: #19116069-206020-1701338105 - Holdem no limit (0.01€/0.02€) - 2023/11/30 09:55:05 UTC
Table: 'Colorado' 6-max (real money) Seat #6 is the button
Seat 1: LA TOUR FL (4.28€)
Seat 2: curiouz dje (2.97€)
Seat 3: Fried Berg (0.79€)
Seat 4: Cejargordas (2.12€)
Seat 5: DUCHE80 (0.40€)
Seat 6: esox086 (0.80€)
*** ANTE/BLINDS ***
LA TOUR FL posts small blind 0.01€
curiouz dje posts big blind 0.02€
Dealt to Fried Berg [8d Js]
*** PRE-FLOP *** 
Fried Berg folds
Cejargordas folds
DUCHE80 raises 0.05€ to 0.07€
esox086 folds
LA TOUR FL folds
curiouz dje folds
DUCHE80 collected 0.10€ from pot
*** SUMMARY ***
Total pot 0.10€ | No rake
Seat 5: DUCHE80 won 0.10€


Winamax Poker - HOLD-UP "Colorado" - HandId: #19116069-206026-1701338110 - Holdem no limit (0.01€/0.02€) - 2023/11/30 09:55:10 UTC
Table: 'Colorado' 6-max (real money) Seat #6 is the button
Seat 1: CB-Joker6274 (6.31€)
Seat 2: ironman33 (2.37€)
Seat 3: David Boring (3.25€)
Seat 4: Fried Berg (0.79€)
Seat 5: le_chat88 (2.11€)
Seat 6: A.soto5 (0.90€)
*** ANTE/BLINDS ***
CB-Joker6274 posts small blind 0.01€
ironman33 posts big blind 0.02€
Dealt to Fried Berg [6h 2h]
*** PRE-FLOP *** 
David Boring raises 0.04€ to 0.06€
Fried Berg folds
le_chat88 folds
A.soto5 folds
CB-Joker6274 folds
ironman33 folds
David Boring collected 0.09€ from pot
*** SUMMARY ***
Total pot 0.09€ | No rake
Seat 3: David Boring won 0.09€


Winamax Poker - HOLD-UP "Colorado" - HandId: #19116069-206031-1701338115 - Holdem no limit (0.01€/0.02€) - 2023/11/30 09:55:15 UTC
Table: 'Colorado' 6-max (real money) Seat #6 is the button
Seat 1: BAAC0 (1.76€)
Seat 2: wAAlterrr (2€)
Seat 3: baptb10 (2.47€)
Seat 4: Ddm8 (26.19€)
Seat 5: Hydramist (2€)
Seat 6: Fried Berg (0.79€)
Hold-up to Pot: total 0.10€
*** ANTE/BLINDS ***
BAAC0 posts small blind 0.01€
wAAlterrr posts big blind 0.02€
Dealt to Fried Berg [2d Qh]
*** PRE-FLOP *** 
baptb10 raises 0.02€ to 0.04€
Ddm8 folds
Hydramist folds
Fried Berg folds
BAAC0 folds
wAAlterrr calls 0.02€
*** FLOP *** [9c 7d 7c]
wAAlterrr checks
baptb10 bets 0.02€
wAAlterrr folds
baptb10 collected 0.20€ from pot
*** SUMMARY ***
Total pot 0.20€ | Rake 0.01€
Board: [9c 7d 7c]
Seat 3: baptb10 won 0.20€


Winamax Poker - HOLD-UP "Colorado" - HandId: #19116069-206037-1701338122 - Holdem no limit (0.01€/0.02€) - 2023/11/30 09:55:22 UTC
Table: 'Colorado' 6-max (real money) Seat #6 is the button
Seat 1: sportsmax006 (1.97€)
Seat 2: kameleon73 (2.84€)
Seat 3: TimToBey (2.61€)
Seat 4: widow974 (1.24€)
Seat 5: Fried Berg (0.79€)
Seat 6: le_chat88 (2.11€)
*** ANTE/BLINDS ***
sportsmax006 posts small blind 0.01€
kameleon73 posts big blind 0.02€
Dealt to Fried Berg [6h 8c]
*** PRE-FLOP *** 
TimToBey raises 0.03€ to 0.05€
widow974 folds
Fried Berg folds
le_chat88 folds
sportsmax006 folds
kameleon73 folds
TimToBey collected 0.08€ from pot
*** SUMMARY ***
Total pot 0.08€ | No rake
Seat 3: TimToBey won 0.08€


Winamax Poker - HOLD-UP "Colorado" - HandId: #19116069-206042-1701338127 - Holdem no limit (0.01€/0.02€) - 2023/11/30 09:55:27 UTC
Table: 'Colorado' 6-max (real money) Seat #6 is the button
Seat 1: David Boring (3.28€)
Seat 2: KON-2-PEUTE (6.92€)
Seat 3: _Croute_ (2.06€)
Seat 4: Adame199623 (2€)
Seat 5: slowreplay (4.03€)
Seat 6: Fried Berg (0.79€)
*** ANTE/BLINDS ***
David Boring posts small blind 0.01€
KON-2-PEUTE posts big blind 0.02€
Dealt to Fried Berg [8h Qd]
*** PRE-FLOP *** 
_Croute_ folds
Adame199623 folds
slowreplay folds
Fried Berg raises 0.02€ to 0.04€
David Boring folds
KON-2-PEUTE folds
Fried Berg collected 0.07€ from pot
*** SUMMARY ***
Total pot 0.07€ | No rake
Seat 6: Fried Berg (button) won 0.07€


Winamax Poker - HOLD-UP "Colorado" - HandId: #19116069-206055-1701338137 - Holdem no limit (0.01€/0.02€) - 2023/11/30 09:55:37 UTC
Table: 'Colorado' 6-max (real money) Seat #6 is the button
Seat 1: Trucs78 (0.60€)
Seat 2: Fried Berg (0.82€)
Seat 3: David Boring (3.27€)
Seat 4: sportsmax006 (1.94€)
Seat 5: Adame199623 (2€)
Seat 6: Hydramist (2.06€)
*** ANTE/BLINDS ***
Trucs78 posts small blind 0.01€
Fried Berg posts big blind 0.02€
Dealt to Fried Berg [Kd Tc]
*** PRE-FLOP *** 
David Boring folds
sportsmax006 folds
Adame199623 folds
Hydramist folds
Trucs78 raises 0.04€ to 0.06€
Fried Berg calls 0.04€
*** FLOP *** [Qd Td Ac]
Trucs78 checks
Fried Berg checks
*** TURN *** [Qd Td Ac][7s]
Trucs78 bets 0.04€
Fried Berg calls 0.04€
*** RIVER *** [Qd Td Ac 7s][3d]
Trucs78 bets 0.13€
Fried Berg folds
Trucs78 collected 0.31€ from pot
*** SUMMARY ***
Total pot 0.31€ | Rake 0.02€
Board: [Qd Td Ac 7s 3d]
Seat 1: Trucs78 (small blind) won 0.31€


Winamax Poker - HOLD-UP "Colorado" - HandId: #19116069-206087-1701338167 - Holdem no limit (0.01€/0.02€) - 2023/11/30 09:56:07 UTC
Table: 'Colorado' 6-max (real money) Seat #6 is the button
Seat 1: Fried Berg (0.72€)
Seat 2: VashtaNerada (3.16€)
Seat 3: curiouz dje (4.80€)
Seat 4: matmyl (2.76€)
Seat 5: haouuum28 (1.94€)
Seat 6: Cejargordas (3.68€)
*** ANTE/BLINDS ***
Fried Berg posts small blind 0.01€
VashtaNerada posts big blind 0.02€
Dealt to Fried Berg [2d 7d]
*** PRE-FLOP *** 
curiouz dje folds
matmyl folds
haouuum28 folds
Cejargordas folds
Fried Berg folds
VashtaNerada collected 0.03€ from pot
*** SUMMARY ***
Total pot 0.03€ | No rake
Seat 2: VashtaNerada (big blind) won 0.03€


Winamax Poker - HOLD-UP "Colorado" - HandId: #19116069-206095-1701338176 - Holdem no limit (0.01€/0.02€) - 2023/11/30 09:56:16 UTC
Table: 'Colorado' 6-max (real money) Seat #6 is the button
Seat 1: sportsmax006 (1.87€)
Seat 2: slowreplay (4€)
Seat 3: Fried Berg (0.71€)
Seat 4: David Boring (3.08€)
Seat 5: KON-2-PEUTE (2€)
Seat 6: TimToBey (2.03€)
*** ANTE/BLINDS ***
sportsmax006 posts small blind 0.01€
slowreplay posts big blind 0.02€
Dealt to Fried Berg [9d Ad]
*** PRE-FLOP *** 
Fried Berg raises 0.03€ to 0.05€
David Boring folds
KON-2-PEUTE folds
TimToBey folds
sportsmax006 folds
slowreplay folds
Fried Berg collected 0.08€ from pot
*** SUMMARY ***
Total pot 0.08€ | No rake
Seat 3: Fried Berg won 0.08€


Winamax Poker - HOLD-UP "Colorado" - HandId: #19116069-206105-1701338187 - Holdem no limit (0.01€/0.02€) - 2023/11/30 09:56:27 UTC
Table: 'Colorado' 6-max (real money) Seat #6 is the button
Seat 1: haouuum28 (1.78€)
Seat 2: Hydramist (2.08€)
Seat 3: Cejargordas (2.21€)
Seat 4: Fried Berg (0.74€)
Seat 5: David Boring (4.36€)
Seat 6: KON-2-PEUTE (6.92€)
*** ANTE/BLINDS ***
haouuum28 posts small blind 0.01€
Hydramist posts big blind 0.02€
Dealt to Fried Berg [9s Td]
*** PRE-FLOP *** 
Cejargordas raises 0.04€ to 0.06€
Fried Berg folds
David Boring folds
KON-2-PEUTE calls 0.06€
haouuum28 folds
Hydramist calls 0.04€
*** FLOP *** [9h 6d Tc]
Hydramist checks
Cejargordas checks
KON-2-PEUTE checks
*** TURN *** [9h 6d Tc][2s]
Hydramist checks
Cejargordas checks
KON-2-PEUTE checks
*** RIVER *** [9h 6d Tc 2s][9c]
Hydramist checks
Cejargordas checks
KON-2-PEUTE checks
*** SHOW DOWN ***
Hydramist shows [7h Ah] (One pair : 9)
Cejargordas shows [Ks Ac] (One pair : 9)
KON-2-PEUTE shows [5s 5c] (Two pairs : 9 and 5)
KON-2-PEUTE collected 0.17€ from pot
*** SUMMARY ***
Total pot 0.17€ | Rake 0.02€
Board: [9h 6d Tc 2s 9c]
Seat 2: Hydramist (big blind) showed [7h Ah] and lost with One pair : 9
Seat 3: Cejargordas showed [Ks Ac] and lost with One pair : 9
Seat 6: KON-2-PEUTE (button) showed [5s 5c] and won 0.17€ with Two pairs : 9 and 5


Winamax Poker - HOLD-UP "Colorado" - HandId: #19116069-206123-1701338202 - Holdem no limit (0.01€/0.02€) - 2023/11/30 09:56:42 UTC
Table: 'Colorado' 6-max (real money) Seat #6 is the button
Seat 1: sportsmax006 (1.81€)
Seat 2: BlackMoodAAA (1.61€)
Seat 3: widow974 (1.27€)
Seat 4: Adame199623 (2€)
Seat 5: Fried Berg (0.74€)
Seat 6: wAAlterrr (2€)
*** ANTE/BLINDS ***
sportsmax006 posts small blind 0.01€
BlackMoodAAA posts big blind 0.02€
Dealt to Fried Berg [5c 7h]
*** PRE-FLOP *** 
widow974 calls 0.02€
Adame199623 folds
Fried Berg folds
wAAlterrr folds
sportsmax006 raises 0.10€ to 0.12€
BlackMoodAAA folds
widow974 calls 0.10€
*** FLOP *** [Td Jd Ad]
sportsmax006 bets 0.09€
widow974 calls 0.09€
*** TURN *** [Td Jd Ad][Ac]
sportsmax006 bets 0.15€
widow974 folds
sportsmax006 collected 0.55€ from pot
*** SUMMARY ***
Total pot 0.55€ | Rake 0.04€
Board: [Td Jd Ad Ac]
Seat 1: sportsmax006 (small blind) won 0.55€


Winamax Poker - HOLD-UP "Colorado" - HandId: #19116069-206127-1701338205 - Holdem no limit (0.01€/0.02€) - 2023/11/30 09:56:45 UTC
Table: 'Colorado' 6-max (real money) Seat #6 is the button
Seat 1: Fried Berg (0.74€)
Seat 2: wAAlterrr (2€)
Seat 3: Baston57 (2€)
Seat 4: Trucs78 (0.54€)
Seat 5: Sucre10 (2.75€)
Seat 6: PIQSOU (2.36€)
*** ANTE/BLINDS ***
Fried Berg posts small blind 0.01€
wAAlterrr posts big blind 0.02€
Dealt to Fried Berg [Tc Th]
*** PRE-FLOP *** 
Baston57 folds
Trucs78 calls 0.02€
Sucre10 folds
PIQSOU folds
Fried Berg raises 0.04€ to 0.06€
wAAlterrr folds
Trucs78 calls 0.04€
*** FLOP *** [3s Jd Kd]
Fried Berg bets 0.04€
Trucs78 folds
Fried Berg collected 0.17€ from pot
*** SUMMARY ***
Total pot 0.17€ | Rake 0.01€
Board: [3s Jd Kd]
Seat 1: Fried Berg (small blind) won 0.17€


Winamax Poker - HOLD-UP "Colorado" - HandId: #19116069-206145-1701338225 - Holdem no limit (0.01€/0.02€) - 2023/11/30 09:57:05 UTC
Table: 'Colorado' 6-max (real money) Seat #6 is the button
Seat 1: BlackMoodAAA (1.58€)
Seat 2: Fried Berg (0.81€)
Seat 3: David Boring (4.37€)
Seat 4: GriGri24 (2.56€)
Seat 5: slowreplay (3.98€)
Seat 6: TimToBey (2.64€)
*** ANTE/BLINDS ***
BlackMoodAAA posts small blind 0.01€
Fried Berg posts big blind 0.02€
Dealt to Fried Berg [Ah Kc]
*** PRE-FLOP *** 
David Boring folds
GriGri24 folds
slowreplay folds
TimToBey raises 0.03€ to 0.05€
BlackMoodAAA folds
Fried Berg calls 0.03€
*** FLOP *** [Qc Kh 6c]
Fried Berg bets 0.04€
TimToBey folds
Fried Berg collected 0.14€ from pot
*** SUMMARY ***
Total pot 0.14€ | Rake 0.01€
Board: [Qc Kh 6c]
Seat 2: Fried Berg (big blind) won 0.14€


Winamax Poker - HOLD-UP "Colorado" - HandId: #19116069-206172-1701338249 - Holdem no limit (0.01€/0.02€) - 2023/11/30 09:57:29 UTC
Table: 'Colorado' 6-max (real money) Seat #6 is the button
Seat 1: Cejargordas (2.15€)
Seat 2: Sucre10 (2.29€)
Seat 3: Fried Berg (0.86€)
Seat 4: OscarJR (1.28€)
Seat 5: Adame199623 (2€)
Seat 6: slowreplay (2€)
*** ANTE/BLINDS ***
Cejargordas posts small blind 0.01€
Sucre10 posts big blind 0.02€
Dealt to Fried Berg [9c 8d]
*** PRE-FLOP *** 
Fried Berg folds
OscarJR calls 0.02€
Adame199623 folds
slowreplay folds
Cejargordas folds
Sucre10 checks
*** FLOP *** [As 4h 7h]
Sucre10 checks
OscarJR checks
*** TURN *** [As 4h 7h][6h]
Sucre10 checks
OscarJR checks
*** RIVER *** [As 4h 7h 6h][6d]
Sucre10 checks
OscarJR checks
*** SHOW DOWN ***
OscarJR shows [8s 9s] (One pair : 6)
Sucre10 shows [Tc 4s] (Two pairs : 6 and 4)
Sucre10 collected 0.04€ from pot
*** SUMMARY ***
Total pot 0.04€ | Rake 0.01€
Board: [As 4h 7h 6h 6d]
Seat 2: Sucre10 (big blind) showed [Tc 4s] and won 0.04€ with Two pairs : 6 and 4
Seat 4: OscarJR showed [8s 9s] and lost with One pair : 6


Winamax Poker - HOLD-UP "Colorado" - HandId: #19116069-206174-1701338252 - Holdem no limit (0.01€/0.02€) - 2023/11/30 09:57:32 UTC
Table: 'Colorado' 6-max (real money) Seat #6 is the button
Seat 1: l artiste ho (2.25€)
Seat 2: bandarra8520 (2€)
Seat 3: PIQSOU (2.77€)
Seat 4: Fried Berg (0.86€)
Seat 5: matmyl (2.45€)
Seat 6: Ddm8 (26.74€)
*** ANTE/BLINDS ***
l artiste ho posts small blind 0.01€
bandarra8520 posts big blind 0.02€
Dealt to Fried Berg [Th Ac]
*** PRE-FLOP *** 
PIQSOU folds
Fried Berg raises 0.02€ to 0.04€
matmyl folds
Ddm8 calls 0.04€
l artiste ho folds
bandarra8520 folds
*** FLOP *** [8c 9h Kc]
Fried Berg checks
Ddm8 bets 0.07€
Fried Berg calls 0.07€
*** TURN *** [8c 9h Kc][4h]
Fried Berg checks
Ddm8 checks
*** RIVER *** [8c 9h Kc 4h][3d]
Fried Berg checks
Ddm8 bets 0.25€
Fried Berg folds
Ddm8 collected 0.47€ from pot
*** SUMMARY ***
Total pot 0.47€ | Rake 0.03€
Board: [8c 9h Kc 4h 3d]
Seat 6: Ddm8 (button) won 0.47€


Winamax Poker - HOLD-UP "Colorado" - HandId: #19116069-206220-1701338292 - Holdem no limit (0.01€/0.02€) - 2023/11/30 09:58:12 UTC
Table: 'Colorado' 6-max (real money) Seat #6 is the button
Seat 1: sportsmax006 (1.74€)
Seat 2: curiouz dje (3.47€)
Seat 3: haouuum28 (2.18€)
Seat 4: didi5959 (0.44€)
Seat 5: Fried Berg (0.75€)
Seat 6: OscarJR (1.27€)
*** ANTE/BLINDS ***
sportsmax006 posts small blind 0.01€
curiouz dje posts big blind 0.02€
Dealt to Fried Berg [Kh 6h]
*** PRE-FLOP *** 
haouuum28 raises 0.02€ to 0.04€
didi5959 folds
Fried Berg calls 0.04€
OscarJR calls 0.04€
sportsmax006 raises 0.24€ to 0.28€
curiouz dje folds
haouuum28 folds
Fried Berg folds
OscarJR folds
sportsmax006 collected 0.42€ from pot
*** SUMMARY ***
Total pot 0.42€ | No rake
Seat 1: sportsmax006 (small blind) won 0.42€


Winamax Poker - HOLD-UP "Colorado" - HandId: #19116069-206266-1701338339 - Holdem no limit (0.01€/0.02€) - 2023/11/30 09:58:59 UTC
Table: 'Colorado' 6-max (real money) Seat #6 is the button
Seat 1: David Boring (2.27€)
Seat 2: Nicoo6259 (0.25€)
Seat 3: LA TOUR FL (4.39€)
Seat 4: haouuum28 (2€)
Seat 5: curiouz dje (3.44€)
Seat 6: Fried Berg (0.71€)
*** ANTE/BLINDS ***
David Boring posts small blind 0.01€
Nicoo6259 posts big blind 0.02€
Dealt to Fried Berg [Kc Tc]
*** PRE-FLOP *** 
LA TOUR FL folds
haouuum28 raises 0.03€ to 0.05€
curiouz dje folds
Fried Berg calls 0.05€
David Boring folds
Nicoo6259 folds
*** FLOP *** [Js Qc 6d]
haouuum28 checks
Fried Berg checks
*** TURN *** [Js Qc 6d][5h]
haouuum28 checks
Fried Berg checks
*** RIVER *** [Js Qc 6d 5h][8c]
haouuum28 bets 0.08€
Fried Berg calls 0.08€
*** SHOW DOWN ***
Fried Berg shows [Kc Tc] (High card : King)
haouuum28 shows [Td Ad] (High card : Ace)
haouuum28 collected 0.26€ from pot
*** SUMMARY ***
Total pot 0.26€ | Rake 0.03€
Board: [Js Qc 6d 5h 8c]
Seat 4: haouuum28 showed [Td Ad] and won 0.26€ with High card : Ace
Seat 6: Fried Berg (button) showed [Kc Tc] and lost with High card : King


Winamax Poker - HOLD-UP "Colorado" - HandId: #19116069-206309-1701338383 - Holdem no limit (0.01€/0.02€) - 2023/11/30 09:59:43 UTC
Table: 'Colorado' 6-max (real money) Seat #6 is the button
Seat 1: haouuum28 (2.30€)
Seat 2: josep2170 (2€)
Seat 3: Fried Berg (0.58€)
Seat 4: David Boring (2.16€)
Seat 5: wAAlterrr (2€)
Seat 6: n13tless (1.47€)
*** ANTE/BLINDS ***
haouuum28 posts small blind 0.01€
josep2170 posts big blind 0.02€
Dealt to Fried Berg [Jh 3d]
*** PRE-FLOP *** 
Fried Berg folds
David Boring folds
wAAlterrr folds
n13tless raises 0.03€ to 0.05€
haouuum28 folds
josep2170 calls 0.03€
*** FLOP *** [Qd Ad Qh]
josep2170 checks
n13tless bets 0.03€
josep2170 calls 0.03€
*** TURN *** [Qd Ad Qh][Jd]
josep2170 checks
n13tless checks
*** RIVER *** [Qd Ad Qh Jd][9d]
josep2170 checks
n13tless bets 0.04€
josep2170 calls 0.04€
*** SHOW DOWN ***
josep2170 shows [Tc Kh] (Straight Ace high)
n13tless shows [4d Ac] (Flush Ace high)
n13tless collected 0.22€ from pot
*** SUMMARY ***
Total pot 0.22€ | Rake 0.03€
Board: [Qd Ad Qh Jd 9d]
Seat 2: josep2170 (big blind) showed [Tc Kh] and lost with Straight Ace high
Seat 6: n13tless (button) showed [4d Ac] and won 0.22€ with Flush Ace high


Winamax Poker - HOLD-UP "Colorado" - HandId: #19116069-206312-1701338386 - Holdem no limit (0.01€/0.02€) - 2023/11/30 09:59:46 UTC
Table: 'Colorado' 6-max (real money) Seat #6 is the button
Seat 1: Fried Berg (0.58€)
Seat 2: 3411 (2€)
Seat 3: Idf83 (4.51€)
Seat 4: LA TOUR FL (2.14€)
Seat 5: VashtaNerada (2€)
Seat 6: wAAlterrr (2€)
*** ANTE/BLINDS ***
Fried Berg posts small blind 0.01€
3411 posts big blind 0.02€
Dealt to Fried Berg [8c 4h]
*** PRE-FLOP *** 
Idf83 folds
LA TOUR FL folds
VashtaNerada folds
wAAlterrr raises 0.03€ to 0.05€
Fried Berg folds
3411 calls 0.03€
*** FLOP *** [4c Th As]
3411 checks
wAAlterrr checks
*** TURN *** [4c Th As][5d]
3411 checks
wAAlterrr checks
*** RIVER *** [4c Th As 5d][Qc]
3411 checks
wAAlterrr checks
*** SHOW DOWN ***
wAAlterrr shows [8d 9c] (High card : Ace)
3411 shows [Td Js] (One pair : Tens)
3411 collected 0.10€ from pot
*** SUMMARY ***
Total pot 0.10€ | Rake 0.01€
Board: [4c Th As 5d Qc]
Seat 2: 3411 (big blind) showed [Td Js] and won 0.10€ with One pair : Tens
Seat 6: wAAlterrr (button) showed [8d 9c] and lost with High card : Ace


Winamax Poker - HOLD-UP "Colorado" - HandId: #19116069-206322-1701338396 - Holdem no limit (0.01€/0.02€) - 2023/11/30 09:59:56 UTC
Table: 'Colorado' 6-max (real money) Seat #6 is the button
Seat 1: OTE BABA (2.08€)
Seat 2: didi5959 (0.35€)
Seat 3: slowreplay (3.77€)
Seat 4: Fried Berg (0.57€)
Seat 5: kameleon73 (3.20€)
Seat 6: curiouz dje (4.40€)
*** ANTE/BLINDS ***
OTE BABA posts small blind 0.01€
didi5959 posts big blind 0.02€
Dealt to Fried Berg [4d 3h]
*** PRE-FLOP *** 
slowreplay folds
Fried Berg folds
kameleon73 raises 0.04€ to 0.06€
curiouz dje folds
OTE BABA folds
didi5959 calls 0.04€
*** FLOP *** [2c 6s 7d]
didi5959 checks
kameleon73 bets 0.08€
didi5959 calls 0.08€
*** TURN *** [2c 6s 7d][7s]
didi5959 checks
kameleon73 checks
*** RIVER *** [2c 6s 7d 7s][Kc]
didi5959 bets 0.21€ and is all-in
kameleon73 folds
didi5959 collected 0.47€ from pot
*** SUMMARY ***
Total pot 0.47€ | Rake 0.03€
Board: [2c 6s 7d 7s Kc]
Seat 2: didi5959 (big blind) won 0.47€


Winamax Poker - HOLD-UP "Colorado" - HandId: #19116069-206327-1701338400 - Holdem no limit (0.01€/0.02€) - 2023/11/30 10:00:00 UTC
Table: 'Colorado' 6-max (real money) Seat #6 is the button
Seat 1: sportsmax006 (1.79€)
Seat 2: Fried Berg (0.57€)
Seat 3: OURSMARIN (2.04€)
Seat 4: lilas-Mulet9 (5.20€)
Seat 5: BAAC0 (2.81€)
Seat 6: curiouz dje (3.45€)
*** ANTE/BLINDS ***
sportsmax006 posts small blind 0.01€
Fried Berg posts big blind 0.02€
Dealt to Fried Berg [Jd Tc]
*** PRE-FLOP *** 
OURSMARIN folds
lilas-Mulet9 raises 0.04€ to 0.06€
BAAC0 folds
curiouz dje folds
sportsmax006 raises 0.19€ to 0.25€
Fried Berg folds
lilas-Mulet9 raises 0.50€ to 0.75€
sportsmax006 calls 0.50€
*** FLOP *** [8h Qc As]
sportsmax006 checks
lilas-Mulet9 bets 0.53€
sportsmax006 raises 0.51€ to 1.04€ and is all-in
lilas-Mulet9 calls 0.51€
*** TURN *** [8h Qc As][7d]
*** RIVER *** [8h Qc As 7d][9h]
*** SHOW DOWN ***
sportsmax006 shows [Kc Ac] (One pair : Aces)
lilas-Mulet9 shows [Ah Qh] (Two pairs : Aces and Queens)
lilas-Mulet9 collected 3.24€ from pot
*** SUMMARY ***
Total pot 3.24€ | Rake 0.36€
Board: [8h Qc As 7d 9h]
Seat 1: sportsmax006 (small blind) showed [Kc Ac] and lost with One pair : Aces
Seat 4: lilas-Mulet9 showed [Ah Qh] and won 3.24€ with Two pairs : Aces and Queens


Winamax Poker - HOLD-UP "Colorado" - HandId: #19116069-206350-1701338420 - Holdem no limit (0.01€/0.02€) - 2023/11/30 10:00:20 UTC
Table: 'Colorado' 6-max (real money) Seat #6 is the button
Seat 1: Adame199623 (2.06€)
Seat 2: slowreplay (2€)
Seat 3: bandarra8520 (2€)
Seat 4: DUCHE80 (0.31€)
Seat 5: Fried Berg (0.55€)
Seat 6: Felixapo (1.15€)
*** ANTE/BLINDS ***
Adame199623 posts small blind 0.01€
slowreplay posts big blind 0.02€
Dealt to Fried Berg [3h 4c]
*** PRE-FLOP *** 
bandarra8520 folds
DUCHE80 folds
Fried Berg folds
Felixapo calls 0.02€
Adame199623 folds
slowreplay checks
*** FLOP *** [5c Ts 6c]
slowreplay checks
Felixapo bets 0.02€
slowreplay calls 0.02€
*** TURN *** [5c Ts 6c][3d]
slowreplay checks
Felixapo checks
*** RIVER *** [5c Ts 6c 3d][Td]
slowreplay checks
Felixapo bets 0.09€
slowreplay folds
Felixapo collected 0.17€ from pot
*** SUMMARY ***
Total pot 0.17€ | Rake 0.01€
Board: [5c Ts 6c 3d Td]
Seat 6: Felixapo (button) won 0.17€


Winamax Poker - HOLD-UP "Colorado" - HandId: #19116069-206353-1701338422 - Holdem no limit (0.01€/0.02€) - 2023/11/30 10:00:22 UTC
Table: 'Colorado' 6-max (real money) Seat #6 is the button
Seat 1: Martiwildest (2€)
Seat 2: LA TOUR FL (2.17€)
Seat 3: Adame199623 (2.05€)
Seat 4: David Boring (2.13€)
Seat 5: sopra61 (0.82€)
Seat 6: Fried Berg (0.55€)
*** ANTE/BLINDS ***
Martiwildest posts small blind 0.01€
LA TOUR FL posts big blind 0.02€
Dealt to Fried Berg [Ad Qd]
*** PRE-FLOP *** 
Adame199623 folds
David Boring folds
sopra61 folds
Fried Berg raises 0.04€ to 0.06€
Martiwildest raises 0.12€ to 0.18€
LA TOUR FL folds
Fried Berg calls 0.12€
*** FLOP *** [Jh 3s 9h]
Martiwildest checks
Fried Berg checks
*** TURN *** [Jh 3s 9h][3d]
Martiwildest bets 0.13€
Fried Berg calls 0.13€
*** RIVER *** [Jh 3s 9h 3d][8d]
Martiwildest bets 0.42€
Fried Berg calls 0.24€ and is all-in
*** SHOW DOWN ***
Martiwildest shows [Kc Qh] (One pair : 3)
Fried Berg shows [Ad Qd] (One pair : 3)
Fried Berg collected 1.01€ from main pot
Martiwildest collected 0.18€ from side pot 1
*** SUMMARY ***
Total pot 1.19€ | Rake 0.11€
Board: [Jh 3s 9h 3d 8d]
Seat 1: Martiwildest (small blind) showed [Kc Qh] and won 0.18€ with One pair : 3
Seat 6: Fried Berg (button) showed [Ad Qd] and won 1.01€ with One pair : 3


Winamax Poker - HOLD-UP "Colorado" - HandId: #19116069-206409-1701338483 - Holdem no limit (0.01€/0.02€) - 2023/11/30 10:01:23 UTC
Table: 'Colorado' 6-max (real money) Seat #6 is the button
Seat 1: bandarra8520 (2.06€)
Seat 2: Hydramist (2€)
Seat 3: ZenoidZ (2.94€)
Seat 4: slowreplay (3.85€)
Seat 5: curiouz dje (4.63€)
Seat 6: Fried Berg (1.01€)
*** ANTE/BLINDS ***
bandarra8520 posts small blind 0.01€
Hydramist posts big blind 0.02€
Dealt to Fried Berg [4c Jc]
*** PRE-FLOP *** 
ZenoidZ folds
slowreplay folds
curiouz dje folds
Fried Berg folds
bandarra8520 raises 0.03€ to 0.05€
Hydramist folds
bandarra8520 collected 0.07€ from pot
*** SUMMARY ***
Total pot 0.07€ | No rake
Seat 1: bandarra8520 (small blind) won 0.07€


Winamax Poker - HOLD-UP "Colorado" - HandId: #19116069-206420-1701338494 - Holdem no limit (0.01€/0.02€) - 2023/11/30 10:01:34 UTC
Table: 'Colorado' 6-max (real money) Seat #6 is the button
Seat 1: KON-2-PEUTE (2.03€)
Seat 2: Fried Berg (1.01€)
Seat 3: Adame199623 (2.17€)
Seat 4: LimpDoud (2.42€)
Seat 5: fab19641964 (0.50€)
Seat 6: GriGri24 (2.80€)
*** ANTE/BLINDS ***
KON-2-PEUTE posts small blind 0.01€
Fried Berg posts big blind 0.02€
Dealt to Fried Berg [6h Js]
*** PRE-FLOP *** 
Adame199623 folds
LimpDoud folds
fab19641964 raises 0.02€ to 0.04€
GriGri24 calls 0.04€
KON-2-PEUTE folds
Fried Berg folds
*** FLOP *** [6d Ks 2h]
fab19641964 bets 0.05€
GriGri24 calls 0.05€
*** TURN *** [6d Ks 2h][6c]
fab19641964 checks
GriGri24 checks
*** RIVER *** [6d Ks 2h 6c][Qd]
fab19641964 checks
GriGri24 bets 0.11€
fab19641964 folds
GriGri24 collected 0.30€ from pot
*** SUMMARY ***
Total pot 0.30€ | Rake 0.02€
Board: [6d Ks 2h 6c Qd]
Seat 6: GriGri24 (button) won 0.30€


Winamax Poker - HOLD-UP "Colorado" - HandId: #19116069-206429-1701338504 - Holdem no limit (0.01€/0.02€) - 2023/11/30 10:01:44 UTC
Table: 'Colorado' 6-max (real money) Seat #6 is the button
Seat 1: esox086 (0.88€)
Seat 2: SirX (2.93€)
Seat 3: A.soto5 (2.06€)
Seat 4: Fried Berg (0.99€)
Seat 5: TimToBey (2.25€)
Seat 6: matmyl (2.16€)
*** ANTE/BLINDS ***
esox086 posts small blind 0.01€
SirX posts big blind 0.02€
Dealt to Fried Berg [4c 3c]
*** PRE-FLOP *** 
A.soto5 folds
Fried Berg calls 0.02€
TimToBey folds
matmyl folds
esox086 folds
SirX raises 0.05€ to 0.07€
Fried Berg folds
SirX collected 0.10€ from pot
*** SUMMARY ***
Total pot 0.10€ | No rake
Seat 2: SirX (big blind) won 0.10€


Winamax Poker - HOLD-UP "Colorado" - HandId: #19116069-206442-1701338522 - Holdem no limit (0.01€/0.02€) - 2023/11/30 10:02:02 UTC
Table: 'Colorado' 6-max (real money) Seat #6 is the button
Seat 1: Adame199623 (2€)
Seat 2: sopra61 (0.70€)
Seat 3: Fried Berg (0.97€)
Seat 4: didi5959 (0.65€)
Seat 5: lefraisier (4.29€)
Seat 6: Cejargordas (3.77€)
*** ANTE/BLINDS ***
Adame199623 posts small blind 0.01€
sopra61 posts big blind 0.02€
Dealt to Fried Berg [4d 7h]
*** PRE-FLOP *** 
Fried Berg folds
didi5959 calls 0.02€
lefraisier folds
Cejargordas folds
Adame199623 folds
sopra61 checks
*** FLOP *** [Qd Jd 6d]
sopra61 checks
didi5959 bets 0.02€
sopra61 folds
didi5959 collected 0.06€ from pot
*** SUMMARY ***
Total pot 0.06€ | Rake 0.01€
Board: [Qd Jd 6d]
Seat 4: didi5959 won 0.06€


Winamax Poker - HOLD-UP "Colorado" - HandId: #19116069-206447-1701338524 - Holdem no limit (0.01€/0.02€) - 2023/11/30 10:02:04 UTC
Table: 'Colorado' 6-max (real money) Seat #6 is the button
Seat 1: Fried Berg (0.97€)
Seat 2: fab19641964 (0.41€)
Seat 3: Hydramist (2€)
Seat 4: _Croute_ (2.35€)
Seat 5: bandarra8520 (2.08€)
Seat 6: Adrianohhhh (2.21€)
Hold-up to Pot: total 0.20€
*** ANTE/BLINDS ***
Fried Berg posts small blind 0.01€
fab19641964 posts big blind 0.02€
Dealt to Fried Berg [9d 4d]
*** PRE-FLOP *** 
Hydramist folds
_Croute_ folds
bandarra8520 folds
Adrianohhhh raises 0.05€ to 0.07€
Fried Berg folds
fab19641964 folds
Adrianohhhh collected 0.30€ from pot
*** SUMMARY ***
Total pot 0.30€ | No rake
Seat 6: Adrianohhhh (button) won 0.30€


Winamax Poker - HOLD-UP "Colorado" - HandId: #19116069-206461-1701338540 - Holdem no limit (0.01€/0.02€) - 2023/11/30 10:02:20 UTC
Table: 'Colorado' 6-max (real money) Seat #6 is the button
Seat 1: babe35 (1.44€)
Seat 2: Adame199623 (2€)
Seat 3: Sucre10 (2.52€)
Seat 4: Hydramist (2€)
Seat 5: didi5959 (0.67€)
Seat 6: Fried Berg (0.96€)
*** ANTE/BLINDS ***
babe35 posts small blind 0.01€
Adame199623 posts big blind 0.02€
Dealt to Fried Berg [Qd 2h]
*** PRE-FLOP *** 
Sucre10 raises 0.03€ to 0.05€
Hydramist folds
didi5959 calls 0.05€
Fried Berg folds
babe35 folds
Adame199623 folds
*** FLOP *** [7c 8c 2c]
Sucre10 bets 0.05€
didi5959 calls 0.05€
*** TURN *** [7c 8c 2c][6c]
Sucre10 checks
didi5959 bets 0.02€
Sucre10 calls 0.02€
*** RIVER *** [7c 8c 2c 6c][Js]
Sucre10 checks
didi5959 checks
*** SHOW DOWN ***
didi5959 shows [9d 9s] (One pair : 9)
Sucre10 shows [Ac Ks] (Flush Ace high)
Sucre10 collected 0.24€ from pot
*** SUMMARY ***
Total pot 0.24€ | Rake 0.03€
Board: [7c 8c 2c 6c Js]
Seat 3: Sucre10 showed [Ac Ks] and won 0.24€ with Flush Ace high
Seat 5: didi5959 showed [9d 9s] and lost with One pair : 9


Winamax Poker - HOLD-UP "Colorado" - HandId: #19116069-206464-1701338542 - Holdem no limit (0.01€/0.02€) - 2023/11/30 10:02:22 UTC
Table: 'Colorado' 6-max (real money) Seat #6 is the button
Seat 1: l artiste ho (2.08€)
Seat 2: babe35 (1.43€)
Seat 3: Adame199623 (2€)
Seat 4: KON-2-PEUTE (2€)
Seat 5: Fried Berg (0.96€)
Seat 6: Adrianohhhh (2.44€)
*** ANTE/BLINDS ***
l artiste ho posts small blind 0.01€
babe35 posts big blind 0.02€
Dealt to Fried Berg [Jh Tc]
*** PRE-FLOP *** 
Adame199623 folds
KON-2-PEUTE folds
Fried Berg calls 0.02€
Adrianohhhh raises 0.04€ to 0.06€
l artiste ho folds
babe35 folds
Fried Berg folds
Adrianohhhh collected 0.11€ from pot
*** SUMMARY ***
Total pot 0.11€ | No rake
Seat 6: Adrianohhhh (button) won 0.11€


Winamax Poker - HOLD-UP "Colorado" - HandId: #19116069-206485-1701338567 - Holdem no limit (0.01€/0.02€) - 2023/11/30 10:02:47 UTC
Table: 'Colorado' 6-max (real money) Seat #6 is the button
Seat 1: Fried Berg (0.94€)
Seat 2: curiouz dje (3.23€)
Seat 3: slowreplay (2.66€)
Seat 4: lefraisier (4.28€)
Seat 5: matmyl (2.22€)
Seat 6: babe35 (1.41€)
*** ANTE/BLINDS ***
Fried Berg posts small blind 0.01€
curiouz dje posts big blind 0.02€
Dealt to Fried Berg [Jh As]
*** PRE-FLOP *** 
slowreplay folds
lefraisier calls 0.02€
matmyl folds
babe35 calls 0.02€
Fried Berg raises 0.02€ to 0.04€
curiouz dje folds
lefraisier calls 0.02€
babe35 calls 0.02€
*** FLOP *** [6s 6d Jc]
Fried Berg bets 0.02€
lefraisier raises 0.02€ to 0.04€
babe35 folds
Fried Berg raises 0.02€ to 0.06€
lefraisier raises 4.18€ to 4.24€ and is all-in
Fried Berg folds
lefraisier collected 4.41€ from pot
*** SUMMARY ***
Total pot 4.41€ | Rake 0.03€
Board: [6s 6d Jc]
Seat 4: lefraisier won 4.41€


Winamax Poker - HOLD-UP "Colorado" - HandId: #19116069-206543-1701338630 - Holdem no limit (0.01€/0.02€) - 2023/11/30 10:03:50 UTC
Table: 'Colorado' 6-max (real money) Seat #6 is the button
Seat 1: samaris24 (1.94€)
Seat 2: DJlB (1.86€)
Seat 3: Hypra-taz (2€)
Seat 4: ITALIA291 (2.07€)
Seat 5: Fried Berg (0.84€)
Seat 6: DUCHE80 (0.50€)
Hold-up to Pot: total 0.20€
*** ANTE/BLINDS ***
samaris24 posts small blind 0.01€
DJlB posts big blind 0.02€
Dealt to Fried Berg [Jd 2h]
*** PRE-FLOP *** 
Hypra-taz raises 1.98€ to 2€ and is all-in
ITALIA291 folds
Fried Berg folds
DUCHE80 folds
samaris24 folds
DJlB folds
Hypra-taz collected 2.23€ from pot
*** SUMMARY ***
Total pot 2.23€ | No rake
Seat 3: Hypra-taz won 2.23€


Winamax Poker - HOLD-UP "Colorado" - HandId: #19116069-206553-1701338642 - Holdem no limit (0.01€/0.02€) - 2023/11/30 10:04:02 UTC
Table: 'Colorado' 6-max (real money) Seat #6 is the button
Seat 1: curiouz dje (3.19€)
Seat 2: Fried Berg (0.84€)
Seat 3: Perf-31 (2.23€)
Seat 4: Giucar (1.05€)
Seat 5: DUCHE80 (0.50€)
Seat 6: slowreplay (2.40€)
*** ANTE/BLINDS ***
curiouz dje posts small blind 0.01€
Fried Berg posts big blind 0.02€
Dealt to Fried Berg [Td 6d]
*** PRE-FLOP *** 
Perf-31 folds
Giucar folds
DUCHE80 folds
slowreplay raises 0.04€ to 0.06€
curiouz dje folds
Fried Berg folds
slowreplay collected 0.09€ from pot
*** SUMMARY ***
Total pot 0.09€ | No rake
Seat 6: slowreplay (button) won 0.09€


Winamax Poker - HOLD-UP "Colorado" - HandId: #19116069-206562-1701338654 - Holdem no limit (0.01€/0.02€) - 2023/11/30 10:04:14 UTC
Table: 'Colorado' 6-max (real money) Seat #6 is the button
Seat 1: LA TOUR FL (2.11€)
Seat 2: PIQSOU (3.03€)
Seat 3: Fried Berg (0.82€)
Seat 4: Adame199623 (2€)
Seat 5: Baston57 (2.65€)
Seat 6: DavidGod (1.61€)
*** ANTE/BLINDS ***
LA TOUR FL posts small blind 0.01€
PIQSOU posts big blind 0.02€
Dealt to Fried Berg [2h 9c]
*** PRE-FLOP *** 
Fried Berg folds
Adame199623 raises 0.06€ to 0.08€
Baston57 folds
DavidGod calls 0.08€
LA TOUR FL folds
PIQSOU raises 0.32€ to 0.40€
Adame199623 raises 1.60€ to 2€ and is all-in
DavidGod folds
PIQSOU calls 1.60€
*** FLOP *** [4s 3s Qd]
*** TURN *** [4s 3s Qd][Td]
*** RIVER *** [4s 3s Qd Td][Tc]
*** SHOW DOWN ***
PIQSOU shows [Kh Kd] (Two pairs : Kings and Tens)
Adame199623 shows [Ad Ac] (Two pairs : Aces and Tens)
Adame199623 collected 3.68€ from pot
*** SUMMARY ***
Total pot 3.68€ | Rake 0.41€
Board: [4s 3s Qd Td Tc]
Seat 2: PIQSOU (big blind) showed [Kh Kd] and lost with Two pairs : Kings and Tens
Seat 4: Adame199623 showed [Ad Ac] and won 3.68€ with Two pairs : Aces and Tens


Winamax Poker - HOLD-UP "Colorado" - HandId: #19116069-206564-1701338656 - Holdem no limit (0.01€/0.02€) - 2023/11/30 10:04:16 UTC
Table: 'Colorado' 6-max (real money) Seat #6 is the button
Seat 1: Hydramist (2€)
Seat 2: Giucar (1.04€)
Seat 3: Dolph66 (1.56€)
Seat 4: Fried Berg (0.82€)
Seat 5: josep2170 (2.04€)
Seat 6: Cejargordas (4.83€)
*** ANTE/BLINDS ***
Hydramist posts small blind 0.01€
Giucar posts big blind 0.02€
Dealt to Fried Berg [5c Ac]
*** PRE-FLOP *** 
Dolph66 calls 0.02€
Fried Berg calls 0.02€
josep2170 folds
Cejargordas folds
Hydramist folds
Giucar checks
*** FLOP *** [Ad Qh 4s]
Giucar checks
Dolph66 checks
Fried Berg bets 0.04€
Giucar folds
Dolph66 calls 0.04€
*** TURN *** [Ad Qh 4s][5d]
Dolph66 checks
Fried Berg bets 0.04€
Dolph66 calls 0.04€
*** RIVER *** [Ad Qh 4s 5d][Ks]
Dolph66 checks
Fried Berg bets 0.08€
Dolph66 calls 0.08€
*** SHOW DOWN ***
Dolph66 shows [As Ts] (One pair : Aces)
Fried Berg shows [5c Ac] (Two pairs : Aces and 5)
Fried Berg collected 0.35€ from pot
*** SUMMARY ***
Total pot 0.35€ | Rake 0.04€
Board: [Ad Qh 4s 5d Ks]
Seat 3: Dolph66 showed [As Ts] and lost with One pair : Aces
Seat 4: Fried Berg showed [5c Ac] and won 0.35€ with Two pairs : Aces and 5


Winamax Poker - HOLD-UP "Colorado" - HandId: #19116069-206607-1701338698 - Holdem no limit (0.01€/0.02€) - 2023/11/30 10:04:58 UTC
Table: 'Colorado' 6-max (real money) Seat #6 is the button
Seat 1: Fried Berg (0.99€)
Seat 2: j0selu1s (0.31€)
Seat 3: PIQSOU (2.51€)
Seat 4: curiouz dje (4.46€)
Seat 5: Dolph66 (1.38€)
Seat 6: DJlB (1.73€)
*** ANTE/BLINDS ***
Fried Berg posts small blind 0.01€
j0selu1s posts big blind 0.02€
Dealt to Fried Berg [3s 5h]
*** PRE-FLOP *** 
PIQSOU folds
curiouz dje folds
Dolph66 folds
DJlB folds
Fried Berg folds
j0selu1s collected 0.03€ from pot
*** SUMMARY ***
Total pot 0.03€ | No rake
Seat 2: j0selu1s (big blind) won 0.03€


Winamax Poker - HOLD-UP "Colorado" - HandId: #19116069-206622-1701338712 - Holdem no limit (0.01€/0.02€) - 2023/11/30 10:05:12 UTC
Table: 'Colorado' 6-max (real money) Seat #6 is the button
Seat 1: Cejargordas (7.93€)
Seat 2: curiouz dje (4.46€)
Seat 3: Fried Berg (0.98€)
Seat 4: haouuum28 (1.88€)
Seat 5: AfgaBoBpoKer (1.87€)
Seat 6: Idf83 (5.96€)
*** ANTE/BLINDS ***
Cejargordas posts small blind 0.01€
curiouz dje posts big blind 0.02€
Dealt to Fried Berg [6s Qc]
*** PRE-FLOP *** 
Fried Berg folds
haouuum28 folds
AfgaBoBpoKer folds
Idf83 folds
Cejargordas folds
curiouz dje collected 0.03€ from pot
*** SUMMARY ***
Total pot 0.03€ | No rake
Seat 2: curiouz dje (big blind) won 0.03€


Winamax Poker - HOLD-UP "Colorado" - HandId: #19116069-206624-1701338714 - Holdem no limit (0.01€/0.02€) - 2023/11/30 10:05:14 UTC
Table: 'Colorado' 6-max (real money) Seat #6 is the button
Seat 1: slowreplay (2.44€)
Seat 2: DaniGonzalo0 (2€)
Seat 3: j0selu1s (0.32€)
Seat 4: Perf-31 (2.08€)
Seat 5: Fried Berg (0.98€)
Seat 6: Cejargordas (7.92€)
*** ANTE/BLINDS ***
slowreplay posts small blind 0.01€
DaniGonzalo0 posts big blind 0.02€
Dealt to Fried Berg [3s Td]
*** PRE-FLOP *** 
j0selu1s raises 0.30€ to 0.32€ and is all-in
Perf-31 folds
Fried Berg folds
Cejargordas folds
slowreplay folds
DaniGonzalo0 calls 0.30€
*** FLOP *** [3h 8s 2d]
*** TURN *** [3h 8s 2d][5c]
*** RIVER *** [3h 8s 2d 5c][As]
*** SHOW DOWN ***
DaniGonzalo0 shows [9s 8d] (One pair : 8)
j0selu1s shows [6d Ah] (One pair : Aces)
j0selu1s collected 0.58€ from pot
*** SUMMARY ***
Total pot 0.58€ | Rake 0.07€
Board: [3h 8s 2d 5c As]
Seat 2: DaniGonzalo0 (big blind) showed [9s 8d] and lost with One pair : 8
Seat 3: j0selu1s showed [6d Ah] and won 0.58€ with One pair : Aces


Winamax Poker - HOLD-UP "Colorado" - HandId: #19116069-206628-1701338718 - Holdem no limit (0.01€/0.02€) - 2023/11/30 10:05:18 UTC
Table: 'Colorado' 6-max (real money) Seat #6 is the button
Seat 1: n13tless (2.58€)
Seat 2: Fried Berg (0.98€)
Seat 3: Adame199623 (2.03€)
Seat 4: Cejargordas (7.92€)
Seat 5: Perf-31 (2.08€)
Seat 6: KON-2-PEUTE (6.73€)
Hold-up to Pot: total 0.20€
*** ANTE/BLINDS ***
n13tless posts small blind 0.01€
Fried Berg posts big blind 0.02€
Dealt to Fried Berg [Ah 7d]
*** PRE-FLOP *** 
Adame199623 folds
Cejargordas folds
Perf-31 folds
KON-2-PEUTE raises 0.03€ to 0.05€
n13tless raises 0.32€ to 0.37€
Fried Berg folds
KON-2-PEUTE folds
n13tless collected 0.64€ from pot
*** SUMMARY ***
Total pot 0.64€ | No rake
Seat 1: n13tless (small blind) won 0.64€


Winamax Poker - HOLD-UP "Colorado" - HandId: #19116069-206655-1701338757 - Holdem no limit (0.01€/0.02€) - 2023/11/30 10:05:57 UTC
Table: 'Colorado' 6-max (real money) Seat #6 is the button
Seat 1: TimToBey (3.04€)
Seat 2: slowreplay (3.82€)
Seat 3: le-chartreux (1.97€)
Seat 4: Hydramist (1.98€)
Seat 5: kameleon73 (2.82€)
Seat 6: Fried Berg (0.96€)
*** ANTE/BLINDS ***
TimToBey posts small blind 0.01€
slowreplay posts big blind 0.02€
Dealt to Fried Berg [Jd 7s]
*** PRE-FLOP *** 
le-chartreux folds
Hydramist raises 0.03€ to 0.05€
kameleon73 calls 0.05€
Fried Berg folds
TimToBey folds
slowreplay folds
*** FLOP *** [7h 8d Jh]
Hydramist bets 0.07€
kameleon73 folds
Hydramist collected 0.19€ from pot
*** SUMMARY ***
Total pot 0.19€ | Rake 0.01€
Board: [7h 8d Jh]
Seat 4: Hydramist won 0.19€


Winamax Poker - HOLD-UP "Colorado" - HandId: #19116069-206658-1701338761 - Holdem no limit (0.01€/0.02€) - 2023/11/30 10:06:01 UTC
Table: 'Colorado' 6-max (real money) Seat #6 is the button
Seat 1: CHANGAS (1.94€)
Seat 2: Adame199623 (2€)
Seat 3: Fried Berg (0.96€)
Seat 4: le-chartreux (1.97€)
Seat 5: LA TOUR FL (2.28€)
Seat 6: S-aaron24 (2.19€)
*** ANTE/BLINDS ***
CHANGAS posts small blind 0.01€
Adame199623 posts big blind 0.02€
Dealt to Fried Berg [3d 6h]
*** PRE-FLOP *** 
Fried Berg folds
le-chartreux folds
LA TOUR FL raises 0.04€ to 0.06€
S-aaron24 calls 0.06€
CHANGAS folds
Adame199623 folds
*** FLOP *** [2s 2c Jh]
LA TOUR FL checks
S-aaron24 checks
*** TURN *** [2s 2c Jh][2h]
LA TOUR FL bets 0.08€
S-aaron24 calls 0.08€
*** RIVER *** [2s 2c Jh 2h][Th]
LA TOUR FL bets 0.22€
S-aaron24 folds
LA TOUR FL collected 0.50€ from pot
*** SUMMARY ***
Total pot 0.50€ | Rake 0.03€
Board: [2s 2c Jh 2h Th]
Seat 5: LA TOUR FL won 0.50€


Winamax Poker - HOLD-UP "Colorado" - HandId: #19116069-206661-1701338763 - Holdem no limit (0.01€/0.02€) - 2023/11/30 10:06:03 UTC
Table: 'Colorado' 6-max (real money) Seat #6 is the button
Seat 1: B&CLYDE (2.04€)
Seat 2: l artiste ho (2.02€)
Seat 3: nico033 (1.48€)
Seat 4: Fried Berg (0.96€)
Seat 5: samaris24 (1.56€)
Seat 6: David Boring (2.01€)
*** ANTE/BLINDS ***
B&CLYDE posts small blind 0.01€
l artiste ho posts big blind 0.02€
Dealt to Fried Berg [5h Jd]
*** PRE-FLOP *** 
nico033 folds
Fried Berg folds
samaris24 folds
David Boring folds
B&CLYDE folds
l artiste ho collected 0.03€ from pot
*** SUMMARY ***
Total pot 0.03€ | No rake
Seat 2: l artiste ho (big blind) won 0.03€


Winamax Poker - HOLD-UP "Colorado" - HandId: #19116069-206667-1701338768 - Holdem no limit (0.01€/0.02€) - 2023/11/30 10:06:08 UTC
Table: 'Colorado' 6-max (real money) Seat #6 is the button
Seat 1: Fried Berg (0.96€)
Seat 2: David Boring (5.36€)
Seat 3: ABDELBEYADH (0.28€)
Seat 4: Nash123 (2€)
Seat 5: curiouz dje (4.79€)
Seat 6: Baston57 (2.69€)
*** ANTE/BLINDS ***
Fried Berg posts small blind 0.01€
David Boring posts big blind 0.02€
Dealt to Fried Berg [8c 4d]
*** PRE-FLOP *** 
ABDELBEYADH raises 0.26€ to 0.28€ and is all-in
Nash123 folds
curiouz dje folds
Baston57 folds
Fried Berg folds
David Boring folds
ABDELBEYADH collected 0.31€ from pot
*** SUMMARY ***
Total pot 0.31€ | No rake
Seat 3: ABDELBEYADH won 0.31€


Winamax Poker - HOLD-UP "Colorado" - HandId: #19116069-206673-1701338772 - Holdem no limit (0.01€/0.02€) - 2023/11/30 10:06:12 UTC
Table: 'Colorado' 6-max (real money) Seat #6 is the button
Seat 1: curiouz dje (4.48€)
Seat 2: Fried Berg (0.95€)
Seat 3: DaniGonzalo0 (1.62€)
Seat 4: slowreplay (2.75€)
Seat 5: josep2170 (2.05€)
Seat 6: wAAlterrr (2€)
*** ANTE/BLINDS ***
curiouz dje posts small blind 0.01€
Fried Berg posts big blind 0.02€
Dealt to Fried Berg [Ts Th]
*** PRE-FLOP *** 
DaniGonzalo0 raises 0.05€ to 0.07€
slowreplay folds
josep2170 folds
wAAlterrr folds
curiouz dje folds
Fried Berg calls 0.05€
*** FLOP *** [4s Kd 6d]
Fried Berg checks
DaniGonzalo0 checks
*** TURN *** [4s Kd 6d][3c]
Fried Berg checks
DaniGonzalo0 checks
*** RIVER *** [4s Kd 6d 3c][Qs]
Fried Berg checks
DaniGonzalo0 checks
*** SHOW DOWN ***
DaniGonzalo0 shows [Ac 9c] (High card : Ace)
Fried Berg shows [Ts Th] (One pair : Tens)
Fried Berg collected 0.13€ from pot
*** SUMMARY ***
Total pot 0.13€ | Rake 0.02€
Board: [4s Kd 6d 3c Qs]
Seat 2: Fried Berg (big blind) showed [Ts Th] and won 0.13€ with One pair : Tens
Seat 3: DaniGonzalo0 showed [Ac 9c] and lost with High card : Ace


Winamax Poker - HOLD-UP "Colorado" - HandId: #19116069-206704-1701338798 - Holdem no limit (0.01€/0.02€) - 2023/11/30 10:06:38 UTC
Table: 'Colorado' 6-max (real money) Seat #6 is the button
Seat 1: Hypra-taz (3.79€)
Seat 2: Hydramist (2€)
Seat 3: Cejargordas (8.17€)
Seat 4: Fried Berg (1.01€)
Seat 5: Adame199623 (2€)
Seat 6: PIQSOU (2.27€)
*** ANTE/BLINDS ***
Hypra-taz posts small blind 0.01€
Hydramist posts big blind 0.02€
Dealt to Fried Berg [5c 6h]
*** PRE-FLOP *** 
Cejargordas folds
Fried Berg folds
Adame199623 folds
PIQSOU folds
Hypra-taz calls 0.01€
Hydramist checks
*** FLOP *** [8h Ac Js]
Hypra-taz bets 0.02€
Hydramist folds
Hypra-taz collected 0.06€ from pot
*** SUMMARY ***
Total pot 0.06€ | No rake
Board: [8h Ac Js]
Seat 1: Hypra-taz (small blind) won 0.06€


Winamax Poker - HOLD-UP "Colorado" - HandId: #19116069-206716-1701338808 - Holdem no limit (0.01€/0.02€) - 2023/11/30 10:06:48 UTC
Table: 'Colorado' 6-max (real money) Seat #6 is the button
Seat 1: sopra61 (2.10€)
Seat 2: KON-2-PEUTE (6.64€)
Seat 3: David Boring (5.34€)
Seat 4: slowreplay (1.85€)
Seat 5: Nash123 (2€)
Seat 6: Fried Berg (1.01€)
*** ANTE/BLINDS ***
sopra61 posts small blind 0.01€
KON-2-PEUTE posts big blind 0.02€
Dealt to Fried Berg [4d 9d]
*** PRE-FLOP *** 
David Boring folds
slowreplay folds
Nash123 raises 0.03€ to 0.05€
Fried Berg folds
sopra61 folds
KON-2-PEUTE folds
Nash123 collected 0.08€ from pot
*** SUMMARY ***
Total pot 0.08€ | No rake
Seat 5: Nash123 won 0.08€


Winamax Poker - HOLD-UP "Colorado" - HandId: #19116069-206718-1701338810 - Holdem no limit (0.01€/0.02€) - 2023/11/30 10:06:50 UTC
Table: 'Colorado' 6-max (real money) Seat #6 is the button
Seat 1: Adame199623 (2€)
Seat 2: sportsmax006 (1.83€)
Seat 3: GTO-Mieko (2€)
Seat 4: sopra61 (2.09€)
Seat 5: Fried Berg (1.01€)
Seat 6: David Boring (5.34€)
*** ANTE/BLINDS ***
Adame199623 posts small blind 0.01€
sportsmax006 posts big blind 0.02€
Dealt to Fried Berg [Tc 5s]
*** PRE-FLOP *** 
GTO-Mieko folds
sopra61 folds
Fried Berg folds
David Boring folds
Adame199623 folds
sportsmax006 collected 0.03€ from pot
*** SUMMARY ***
Total pot 0.03€ | No rake
Seat 2: sportsmax006 (big blind) won 0.03€


Winamax Poker - HOLD-UP "Colorado" - HandId: #19116069-206722-1701338813 - Holdem no limit (0.01€/0.02€) - 2023/11/30 10:06:53 UTC
Table: 'Colorado' 6-max (real money) Seat #6 is the button
Seat 1: David Boring (5.34€)
Seat 2: slowreplay (1.85€)
Seat 3: sopra61 (2.09€)
Seat 4: Ddm8 (25.31€)
Seat 5: SirX (3.98€)
Seat 6: Fried Berg (1.01€)
*** ANTE/BLINDS ***
David Boring posts small blind 0.01€
slowreplay posts big blind 0.02€
Dealt to Fried Berg [3h 9d]
*** PRE-FLOP *** 
sopra61 folds
Ddm8 folds
SirX raises 0.04€ to 0.06€
Fried Berg folds
David Boring folds
slowreplay folds
SirX collected 0.09€ from pot
*** SUMMARY ***
Total pot 0.09€ | No rake
Seat 5: SirX won 0.09€


Winamax Poker - HOLD-UP "Colorado" - HandId: #19116069-206725-1701338815 - Holdem no limit (0.01€/0.02€) - 2023/11/30 10:06:55 UTC
Table: 'Colorado' 6-max (real money) Seat #6 is the button
Seat 1: Fried Berg (1.01€)
Seat 2: TimToBey (2.80€)
Seat 3: Cedlebon (2€)
Seat 4: Oxmau5 (2€)
Seat 5: David Boring (5.33€)
Seat 6: sopra61 (2.09€)
*** ANTE/BLINDS ***
Fried Berg posts small blind 0.01€
TimToBey posts big blind 0.02€
Dealt to Fried Berg [2s 3h]
*** PRE-FLOP *** 
Cedlebon folds
Oxmau5 folds
David Boring folds
sopra61 calls 0.02€
Fried Berg folds
TimToBey raises 0.16€ to 0.18€
sopra61 calls 0.16€
*** FLOP *** [Kd Jc Jh]
TimToBey bets 0.33€
sopra61 folds
TimToBey collected 0.66€ from pot
*** SUMMARY ***
Total pot 0.66€ | Rake 0.04€
Board: [Kd Jc Jh]
Seat 2: TimToBey (big blind) won 0.66€


Winamax Poker - HOLD-UP "Colorado" - HandId: #19116069-206730-1701338819 - Holdem no limit (0.01€/0.02€) - 2023/11/30 10:06:59 UTC
Table: 'Colorado' 6-max (real money) Seat #6 is the button
Seat 1: baptb10 (1.02€)
Seat 2: Fried Berg (1€)
Seat 3: ZenoidZ (2.31€)
Seat 4: David Boring (5.32€)
Seat 5: le-chartreux (1.91€)
Seat 6: Oxmau5 (2€)
*** ANTE/BLINDS ***
baptb10 posts small blind 0.01€
Fried Berg posts big blind 0.02€
Dealt to Fried Berg [9s 4c]
*** PRE-FLOP *** 
ZenoidZ calls 0.02€
David Boring folds
le-chartreux raises 0.03€ to 0.05€
Oxmau5 folds
baptb10 calls 0.04€
Fried Berg folds
ZenoidZ calls 0.03€
*** FLOP *** [Qs 2h 2s]
baptb10 checks
ZenoidZ checks
le-chartreux checks
*** TURN *** [Qs 2h 2s][Ad]
baptb10 checks
ZenoidZ checks
le-chartreux bets 0.06€
baptb10 folds
ZenoidZ folds
le-chartreux collected 0.21€ from pot
*** SUMMARY ***
Total pot 0.21€ | Rake 0.02€
Board: [Qs 2h 2s Ad]
Seat 5: le-chartreux won 0.21€


Winamax Poker - HOLD-UP "Colorado" - HandId: #19116069-206742-1701338834 - Holdem no limit (0.01€/0.02€) - 2023/11/30 10:07:14 UTC
Table: 'Colorado' 6-max (real money) Seat #6 is the button
Seat 1: kameleon73 (2.52€)
Seat 2: j0selu1s (0.37€)
Seat 3: Oxmau5 (2€)
Seat 4: Fried Berg (0.98€)
Seat 5: Nash123 (2.03€)
Seat 6: Titounet70 (4.04€)
Hold-up to Pot: total 0.10€
*** ANTE/BLINDS ***
kameleon73 posts small blind 0.01€
j0selu1s posts big blind 0.02€
Dealt to Fried Berg [7c 9s]
*** PRE-FLOP *** 
Oxmau5 folds
Fried Berg folds
Nash123 raises 0.06€ to 0.08€
Titounet70 folds
kameleon73 calls 0.07€
j0selu1s folds
*** FLOP *** [Ks Ah Kc]
kameleon73 checks
Nash123 bets 0.09€
kameleon73 folds
Nash123 collected 0.35€ from pot
*** SUMMARY ***
Total pot 0.35€ | Rake 0.02€
Board: [Ks Ah Kc]
Seat 5: Nash123 won 0.35€


Winamax Poker - HOLD-UP "Colorado" - HandId: #19116069-206750-1701338843 - Holdem no limit (0.01€/0.02€) - 2023/11/30 10:07:23 UTC
Table: 'Colorado' 6-max (real money) Seat #6 is the button
Seat 1: Adame199623 (2€)
Seat 2: Perf-31 (2.16€)
Seat 3: Fried Berg (0.98€)
Seat 4: wAAlterrr (2.45€)
Seat 5: grut28 (1.95€)
Seat 6: lilas-Mulet9 (6.46€)
*** ANTE/BLINDS ***
Adame199623 posts small blind 0.01€
Perf-31 posts big blind 0.02€
Dealt to Fried Berg [Tc 3c]
*** PRE-FLOP *** 
Fried Berg folds
wAAlterrr folds
grut28 folds
lilas-Mulet9 calls 0.02€
Adame199623 calls 0.01€
Perf-31 checks
*** FLOP *** [Ad 6h 5h]
Adame199623 checks
Perf-31 checks
lilas-Mulet9 checks
*** TURN *** [Ad 6h 5h][9c]
Adame199623 bets 0.06€
Perf-31 folds
lilas-Mulet9 folds
Adame199623 collected 0.11€ from pot
*** SUMMARY ***
Total pot 0.11€ | Rake 0.01€
Board: [Ad 6h 5h 9c]
Seat 1: Adame199623 (small blind) won 0.11€


Winamax Poker - HOLD-UP "Colorado" - HandId: #19116069-206754-1701338846 - Holdem no limit (0.01€/0.02€) - 2023/11/30 10:07:26 UTC
Table: 'Colorado' 6-max (real money) Seat #6 is the button
Seat 1: grut28 (1.95€)
Seat 2: rick26 (2€)
Seat 3: Fried Berg (0.98€)
Seat 4: wAAlterrr (2€)
Seat 5: Oxmau5 (2€)
Seat 6: slowreplay (1.82€)
*** ANTE/BLINDS ***
grut28 posts small blind 0.01€
rick26 posts big blind 0.02€
Dealt to Fried Berg [Td 4c]
*** PRE-FLOP *** 
Fried Berg folds
wAAlterrr folds
Oxmau5 folds
slowreplay raises 0.04€ to 0.06€
grut28 folds
rick26 folds
slowreplay collected 0.09€ from pot
*** SUMMARY ***
Total pot 0.09€ | No rake
Seat 6: slowreplay (button) won 0.09€


Winamax Poker - HOLD-UP "Colorado" - HandId: #19116069-206757-1701338848 - Holdem no limit (0.01€/0.02€) - 2023/11/30 10:07:28 UTC
Table: 'Colorado' 6-max (real money) Seat #6 is the button
Seat 1: Oxmau5 (2€)
Seat 2: nico033 (1.45€)
Seat 3: Sucre10 (2.49€)
Seat 4: sopra61 (1.91€)
Seat 5: Fried Berg (0.98€)
Seat 6: ricki64 (1.92€)
*** ANTE/BLINDS ***
Oxmau5 posts small blind 0.01€
nico033 posts big blind 0.02€
Dealt to Fried Berg [9h 4s]
*** PRE-FLOP *** 
Sucre10 folds
sopra61 folds
Fried Berg folds
ricki64 folds
Oxmau5 folds
nico033 collected 0.03€ from pot
*** SUMMARY ***
Total pot 0.03€ | No rake
Seat 2: nico033 (big blind) won 0.03€


Winamax Poker - HOLD-UP "Colorado" - HandId: #19116069-206762-1701338852 - Holdem no limit (0.01€/0.02€) - 2023/11/30 10:07:32 UTC
Table: 'Colorado' 6-max (real money) Seat #6 is the button
Seat 1: TimToBey (2.95€)
Seat 2: Adrianohhhh (2.14€)
Seat 3: Hydramist (2.08€)
Seat 4: Fried Berg (0.98€)
Seat 5: Sucre10 (2.49€)
Seat 6: Idf83 (5.37€)
*** ANTE/BLINDS ***
TimToBey posts small blind 0.01€
Adrianohhhh posts big blind 0.02€
Dealt to Fried Berg [Js 7s]
*** PRE-FLOP *** 
Hydramist folds
Fried Berg raises 0.02€ to 0.04€
Sucre10 folds
Idf83 folds
TimToBey folds
Adrianohhhh folds
Fried Berg collected 0.07€ from pot
*** SUMMARY ***
Total pot 0.07€ | No rake
Seat 4: Fried Berg won 0.07€


Winamax Poker - HOLD-UP "Colorado" - HandId: #19116069-206781-1701338866 - Holdem no limit (0.01€/0.02€) - 2023/11/30 10:07:46 UTC
Table: 'Colorado' 6-max (real money) Seat #6 is the button
Seat 1: Adrianohhhh (2.12€)
Seat 2: wAAlterrr (2.45€)
Seat 3: l artiste ho (1.95€)
Seat 4: Ddm8 (25.42€)
Seat 5: Fried Berg (1.01€)
Seat 6: David Boring (5.36€)
*** ANTE/BLINDS ***
Adrianohhhh posts small blind 0.01€
wAAlterrr posts big blind 0.02€
Dealt to Fried Berg [Th 4d]
*** PRE-FLOP *** 
l artiste ho folds
Ddm8 folds
Fried Berg folds
David Boring folds
Adrianohhhh folds
wAAlterrr collected 0.03€ from pot
*** SUMMARY ***
Total pot 0.03€ | No rake
Seat 2: wAAlterrr (big blind) won 0.03€


Winamax Poker - HOLD-UP "Colorado" - HandId: #19116069-206797-1701338878 - Holdem no limit (0.01€/0.02€) - 2023/11/30 10:07:58 UTC
Table: 'Colorado' 6-max (real money) Seat #6 is the button
Seat 1: CHANGAS (1.94€)
Seat 2: Fried Berg (1.01€)
Seat 3: Hypra-taz (4.19€)
Seat 4: Nash123 (2.12€)
Seat 5: Martiwildest (4.97€)
Seat 6: nico033 (1.49€)
*** ANTE/BLINDS ***
CHANGAS posts small blind 0.01€
Fried Berg posts big blind 0.02€
Dealt to Fried Berg [9d 7s]
*** PRE-FLOP *** 
Hypra-taz raises 2.65€ to 2.67€
Nash123 folds
Martiwildest folds
nico033 folds
CHANGAS folds
Fried Berg folds
Hypra-taz collected 2.70€ from pot
*** SUMMARY ***
Total pot 2.70€ | No rake
Seat 3: Hypra-taz won 2.70€


Winamax Poker - HOLD-UP "Colorado" - HandId: #19116069-206808-1701338887 - Holdem no limit (0.01€/0.02€) - 2023/11/30 10:08:07 UTC
Table: 'Colorado' 6-max (real money) Seat #6 is the button
Seat 1: Hydramist (2.09€)
Seat 2: PIQSOU (2.24€)
Seat 3: S-aaron24 (2.05€)
Seat 4: josep2170 (2€)
Seat 5: Nash123 (2€)
Seat 6: Fried Berg (0.99€)
*** ANTE/BLINDS ***
Hydramist posts small blind 0.01€
PIQSOU posts big blind 0.02€
Dealt to Fried Berg [4c 8d]
*** PRE-FLOP *** 
S-aaron24 raises 0.03€ to 0.05€
josep2170 folds
Nash123 folds
Fried Berg folds
Hydramist folds
PIQSOU folds
S-aaron24 collected 0.08€ from pot
*** SUMMARY ***
Total pot 0.08€ | No rake
Seat 3: S-aaron24 won 0.08€


Winamax Poker - HOLD-UP "Colorado" - HandId: #19116069-206813-1701338890 - Holdem no limit (0.01€/0.02€) - 2023/11/30 10:08:10 UTC
Table: 'Colorado' 6-max (real money) Seat #6 is the button
Seat 1: slowreplay (1.83€)
Seat 2: curiouz dje (2.23€)
Seat 3: Baston57 (2.25€)
Seat 4: Jimmy91lenny (1.88€)
Seat 5: Fried Berg (0.99€)
Seat 6: josep2170 (2€)
*** ANTE/BLINDS ***
slowreplay posts small blind 0.01€
curiouz dje posts big blind 0.02€
Dealt to Fried Berg [9c 5s]
*** PRE-FLOP *** 
Baston57 calls 0.02€
Jimmy91lenny folds
Fried Berg folds
josep2170 folds
slowreplay folds
curiouz dje checks
*** FLOP *** [6d Qc Th]
curiouz dje bets 0.04€
Baston57 calls 0.04€
*** TURN *** [6d Qc Th][Jh]
curiouz dje checks
Baston57 bets 0.08€
curiouz dje folds
Baston57 collected 0.20€ from pot
*** SUMMARY ***
Total pot 0.20€ | Rake 0.01€
Board: [6d Qc Th Jh]
Seat 3: Baston57 won 0.20€


Winamax Poker - HOLD-UP "Colorado" - HandId: #19116069-206815-1701338892 - Holdem no limit (0.01€/0.02€) - 2023/11/30 10:08:12 UTC
Table: 'Colorado' 6-max (real money) Seat #6 is the button
Seat 1: Fried Berg (0.99€)
Seat 2: Berig (2€)
Seat 3: DUCHE80 (0.29€)
Seat 4: PIQSOU (2.22€)
Seat 5: Jimmy91lenny (1.88€)
Seat 6: Nash123 (2€)
*** ANTE/BLINDS ***
Fried Berg posts small blind 0.01€
Berig posts big blind 0.02€
Dealt to Fried Berg [5d Kd]
*** PRE-FLOP *** 
DUCHE80 folds
PIQSOU folds
Jimmy91lenny raises 0.05€ to 0.07€
Nash123 folds
Fried Berg calls 0.06€
Berig folds
*** FLOP *** [6d 2c 8d]
Fried Berg checks
Jimmy91lenny bets 0.06€
Fried Berg calls 0.06€
*** TURN *** [6d 2c 8d][4c]
Fried Berg checks
Jimmy91lenny bets 0.10€
Fried Berg calls 0.10€
*** RIVER *** [6d 2c 8d 4c][Jc]
Fried Berg checks
Jimmy91lenny checks
*** SHOW DOWN ***
Fried Berg shows [5d Kd] (High card : King)
Jimmy91lenny shows [Ac 9d] (High card : Ace)
Jimmy91lenny collected 0.43€ from pot
*** SUMMARY ***
Total pot 0.43€ | Rake 0.05€
Board: [6d 2c 8d 4c Jc]
Seat 1: Fried Berg (small blind) showed [5d Kd] and lost with High card : King
Seat 5: Jimmy91lenny showed [Ac 9d] and won 0.43€ with High card : Ace


Winamax Poker - HOLD-UP "Colorado" - HandId: #19116069-206862-1701338939 - Holdem no limit (0.01€/0.02€) - 2023/11/30 10:08:59 UTC
Table: 'Colorado' 6-max (real money) Seat #6 is the button
Seat 1: Oxmau5 (2€)
Seat 2: sopra61 (1.93€)
Seat 3: Fried Berg (0.76€)
Seat 4: slowreplay (4.01€)
Seat 5: Baston57 (2.31€)
Seat 6: Jimmy91lenny (2.08€)
*** ANTE/BLINDS ***
Oxmau5 posts small blind 0.01€
sopra61 posts big blind 0.02€
Dealt to Fried Berg [Jh Tc]
*** PRE-FLOP *** 
Fried Berg folds
slowreplay folds
Baston57 folds
Jimmy91lenny folds
Oxmau5 calls 0.01€
sopra61 checks
*** FLOP *** [Qh Ks Qs]
Oxmau5 checks
sopra61 checks
*** TURN *** [Qh Ks Qs][Ts]
Oxmau5 checks
sopra61 bets 0.03€
Oxmau5 calls 0.03€
*** RIVER *** [Qh Ks Qs Ts][5d]
Oxmau5 checks
sopra61 bets 0.03€
Oxmau5 calls 0.03€
*** SHOW DOWN ***
sopra61 shows [Th 8c] (Two pairs : Queens and Tens)
Oxmau5 shows [Jd Jc] (Two pairs : Queens and Jacks)
Oxmau5 collected 0.14€ from pot
*** SUMMARY ***
Total pot 0.14€ | Rake 0.02€
Board: [Qh Ks Qs Ts 5d]
Seat 1: Oxmau5 (small blind) showed [Jd Jc] and won 0.14€ with Two pairs : Queens and Jacks
Seat 2: sopra61 (big blind) showed [Th 8c] and lost with Two pairs : Queens and Tens


Winamax Poker - HOLD-UP "Colorado" - HandId: #19116069-206867-1701338944 - Holdem no limit (0.01€/0.02€) - 2023/11/30 10:09:04 UTC
Table: 'Colorado' 6-max (real money) Seat #6 is the button
Seat 1: Mimton1013 (1.88€)
Seat 2: Baston57 (2.30€)
Seat 3: wAAlterrr (2.45€)
Seat 4: Fried Berg (0.76€)
Seat 5: ITALIA291 (2.22€)
Seat 6: bandarra8520 (3.03€)
*** ANTE/BLINDS ***
Mimton1013 posts small blind 0.01€
Baston57 posts big blind 0.02€
Dealt to Fried Berg [3d Kc]
*** PRE-FLOP *** 
wAAlterrr folds
Fried Berg folds
ITALIA291 folds
bandarra8520 folds
Mimton1013 raises 0.04€ to 0.06€
Baston57 folds
Mimton1013 collected 0.08€ from pot
*** SUMMARY ***
Total pot 0.08€ | No rake
Seat 1: Mimton1013 (small blind) won 0.08€


Winamax Poker - HOLD-UP "Colorado" - HandId: #19116069-206872-1701338947 - Holdem no limit (0.01€/0.02€) - 2023/11/30 10:09:07 UTC
Table: 'Colorado' 6-max (real money) Seat #6 is the button
Seat 1: Fried Berg (0.76€)
Seat 2: slowreplay (1.81€)
Seat 3: curiouz dje (2.20€)
Seat 4: LA TOUR FL (2.10€)
Seat 5: Ddm8 (25.34€)
Seat 6: l artiste ho (2.05€)
*** ANTE/BLINDS ***
Fried Berg posts small blind 0.01€
slowreplay posts big blind 0.02€
Dealt to Fried Berg [7c Qh]
*** PRE-FLOP *** 
curiouz dje folds
LA TOUR FL raises 0.04€ to 0.06€
Ddm8 folds
l artiste ho folds
Fried Berg folds
slowreplay folds
LA TOUR FL collected 0.09€ from pot
*** SUMMARY ***
Total pot 0.09€ | No rake
Seat 4: LA TOUR FL won 0.09€


Winamax Poker - HOLD-UP "Colorado" - HandId: #19116069-206874-1701338949 - Holdem no limit (0.01€/0.02€) - 2023/11/30 10:09:09 UTC
Table: 'Colorado' 6-max (real money) Seat #6 is the button
Seat 1: TTry-AgAin (2.01€)
Seat 2: samaris24 (1.42€)
Seat 3: ITALIA291 (2.22€)
Seat 4: curiouz dje (2.20€)
Seat 5: Fried Berg (0.75€)
Seat 6: Ddm8 (25.34€)
*** ANTE/BLINDS ***
TTry-AgAin posts small blind 0.01€
samaris24 posts big blind 0.02€
Dealt to Fried Berg [4d 6c]
*** PRE-FLOP *** 
ITALIA291 folds
curiouz dje raises 0.03€ to 0.05€
Fried Berg folds
Ddm8 calls 0.05€
TTry-AgAin folds
samaris24 calls 0.03€
*** FLOP *** [Ad 9s Js]
samaris24 checks
curiouz dje bets 0.07€
Ddm8 calls 0.07€
samaris24 folds
*** TURN *** [Ad 9s Js][As]
curiouz dje checks
Ddm8 bets 0.20€
curiouz dje calls 0.20€
*** RIVER *** [Ad 9s Js As][7s]
curiouz dje checks
Ddm8 bets 0.70€
curiouz dje folds
Ddm8 collected 1.33€ from pot
*** SUMMARY ***
Total pot 1.33€ | Rake 0.07€
Board: [Ad 9s Js As 7s]
Seat 6: Ddm8 (button) won 1.33€


Winamax Poker - HOLD-UP "Colorado" - HandId: #19116069-206877-1701338951 - Holdem no limit (0.01€/0.02€) - 2023/11/30 10:09:11 UTC
Table: 'Colorado' 6-max (real money) Seat #6 is the button
Seat 1: S-aaron24 (4.25€)
Seat 2: Fried Berg (0.75€)
Seat 3: TTry-AgAin (2€)
Seat 4: Hydramist (2.47€)
Seat 5: Sucre10 (3.28€)
Seat 6: Baston57 (2.28€)
*** ANTE/BLINDS ***
S-aaron24 posts small blind 0.01€
Fried Berg posts big blind 0.02€
Dealt to Fried Berg [Qh Td]
*** PRE-FLOP *** 
TTry-AgAin folds
Hydramist folds
Sucre10 folds
Baston57 folds
S-aaron24 folds
Fried Berg collected 0.03€ from pot
*** SUMMARY ***
Total pot 0.03€ | No rake
Seat 2: Fried Berg (big blind) won 0.03€


Winamax Poker - HOLD-UP "Colorado" - HandId: #19116069-206890-1701338960 - Holdem no limit (0.01€/0.02€) - 2023/11/30 10:09:20 UTC
Table: 'Colorado' 6-max (real money) Seat #6 is the button
Seat 1: kameleon73 (2€)
Seat 2: slowreplay (2.83€)
Seat 3: Fried Berg (0.76€)
Seat 4: CHANGAS (3.68€)
Seat 5: Hydramist (2.04€)
Seat 6: SirX (4.25€)
*** ANTE/BLINDS ***
kameleon73 posts small blind 0.01€
slowreplay posts big blind 0.02€
Dealt to Fried Berg [9s 7c]
*** PRE-FLOP *** 
Fried Berg folds
CHANGAS folds
Hydramist folds
SirX raises 0.05€ to 0.07€
kameleon73 calls 0.06€
slowreplay folds
*** FLOP *** [3s 6s 8s]
kameleon73 checks
SirX bets 0.16€
kameleon73 folds
SirX collected 0.30€ from pot
*** SUMMARY ***
Total pot 0.30€ | Rake 0.02€
Board: [3s 6s 8s]
Seat 6: SirX (button) won 0.30€


Winamax Poker - HOLD-UP "Colorado" - HandId: #19116069-206893-1701338964 - Holdem no limit (0.01€/0.02€) - 2023/11/30 10:09:24 UTC
Table: 'Colorado' 6-max (real money) Seat #6 is the button
Seat 1: Fried Berg (0.76€)
Seat 2: TTry-AgAin (2€)
Seat 3: josep2170 (2.03€)
Seat 4: Perf-31 (2.24€)
Seat 5: Hydramist (2.04€)
Seat 6: CHANGAS (3.68€)
*** ANTE/BLINDS ***
Fried Berg posts small blind 0.01€
TTry-AgAin posts big blind 0.02€
Dealt to Fried Berg [Kc Jc]
*** PRE-FLOP *** 
josep2170 folds
Perf-31 folds
Hydramist raises 0.03€ to 0.05€
CHANGAS folds
Fried Berg calls 0.04€
TTry-AgAin calls 0.03€
*** FLOP *** [2d Qs 4h]
Fried Berg bets 0.02€
TTry-AgAin calls 0.02€
Hydramist calls 0.02€
*** TURN *** [2d Qs 4h][Ts]
Fried Berg checks
TTry-AgAin checks
Hydramist bets 0.11€
Fried Berg calls 0.11€
TTry-AgAin calls 0.11€
*** RIVER *** [2d Qs 4h Ts][Ad]
Fried Berg bets 0.14€
TTry-AgAin folds
Hydramist raises 0.48€ to 0.62€
Fried Berg calls 0.44€ and is all-in
*** SHOW DOWN ***
Fried Berg shows [Kc Jc] (Straight Ace high)
Hydramist shows [4c 4d] (Trips of 4)
Hydramist collected 0.04€ from side pot 1
Fried Berg collected 1.53€ from main pot
*** SUMMARY ***
Total pot 1.57€ | Rake 0.17€
Board: [2d Qs 4h Ts Ad]
Seat 1: Fried Berg (small blind) showed [Kc Jc] and won 1.53€ with Straight Ace high
Seat 5: Hydramist showed [4c 4d] and won 0.04€ with Trips of 4


Winamax Poker - HOLD-UP "Colorado" - HandId: #19116069-206982-1701339048 - Holdem no limit (0.01€/0.02€) - 2023/11/30 10:10:48 UTC
Table: 'Colorado' 6-max (real money) Seat #6 is the button
Seat 1: TTry-AgAin (1.82€)
Seat 2: CHANGAS (1.94€)
Seat 3: wAAlterrr (2.37€)
Seat 4: Adame199623 (2€)
Seat 5: haouuum28 (4.16€)
Seat 6: Fried Berg (1.53€)
*** ANTE/BLINDS ***
TTry-AgAin posts small blind 0.01€
CHANGAS posts big blind 0.02€
Dealt to Fried Berg [8h 6s]
*** PRE-FLOP *** 
wAAlterrr raises 0.04€ to 0.06€
Adame199623 folds
haouuum28 folds
Fried Berg folds
TTry-AgAin folds
CHANGAS folds
wAAlterrr collected 0.09€ from pot
*** SUMMARY ***
Total pot 0.09€ | No rake
Seat 3: wAAlterrr won 0.09€


Winamax Poker - HOLD-UP "Colorado" - HandId: #19116069-206993-1701339057 - Holdem no limit (0.01€/0.02€) - 2023/11/30 10:10:57 UTC
Table: 'Colorado' 6-max (real money) Seat #6 is the button
Seat 1: PIQSOU (5.17€)
Seat 2: Fried Berg (1.53€)
Seat 3: ricki64 (2.68€)
Seat 4: Oxmau5 (2.06€)
Seat 5: Aggro Loser (2.47€)
Seat 6: Berig (1.88€)
*** ANTE/BLINDS ***
PIQSOU posts small blind 0.01€
Fried Berg posts big blind 0.02€
Dealt to Fried Berg [2c Qd]
*** PRE-FLOP *** 
ricki64 folds
Oxmau5 folds
Aggro Loser folds
Berig folds
PIQSOU folds
Fried Berg collected 0.03€ from pot
*** SUMMARY ***
Total pot 0.03€ | No rake
Seat 2: Fried Berg (big blind) won 0.03€


Winamax Poker - HOLD-UP "Colorado" - HandId: #19116069-207030-1701339087 - Holdem no limit (0.01€/0.02€) - 2023/11/30 10:11:27 UTC
Table: 'Colorado' 6-max (real money) Seat #6 is the button
Seat 1: rick26 (1.95€)
Seat 2: Ragusnik00 (1.04€)
Seat 3: B&CLYDE (1.91€)
Seat 4: Fried Berg (1.54€)
Seat 5: curiouz dje (2€)
Seat 6: sopra61 (1.24€)
*** ANTE/BLINDS ***
rick26 posts small blind 0.01€
Ragusnik00 posts big blind 0.02€
Dealt to Fried Berg [Js 2s]
*** PRE-FLOP *** 
B&CLYDE raises 0.02€ to 0.04€
Fried Berg folds
curiouz dje folds
sopra61 calls 0.04€
rick26 folds
Ragusnik00 calls 0.02€
*** FLOP *** [3c 9c Kd]
Ragusnik00 checks
B&CLYDE checks
sopra61 bets 0.05€
Ragusnik00 calls 0.05€
B&CLYDE folds
*** TURN *** [3c 9c Kd][8c]
Ragusnik00 checks
sopra61 bets 0.08€
Ragusnik00 folds
sopra61 collected 0.29€ from pot
*** SUMMARY ***
Total pot 0.29€ | Rake 0.02€
Board: [3c 9c Kd 8c]
Seat 6: sopra61 (button) won 0.29€


Winamax Poker - HOLD-UP "Colorado" - HandId: #19116069-207039-1701339097 - Holdem no limit (0.01€/0.02€) - 2023/11/30 10:11:37 UTC
Table: 'Colorado' 6-max (real money) Seat #6 is the button
Seat 1: n13tless (2.22€)
Seat 2: haouuum28 (1.31€)
Seat 3: David Boring (5.20€)
Seat 4: Clemence75 (2€)
Seat 5: Hydramist (2€)
Seat 6: Fried Berg (1.54€)
*** ANTE/BLINDS ***
n13tless posts small blind 0.01€
haouuum28 posts big blind 0.02€
Dealt to Fried Berg [Js 7c]
*** PRE-FLOP *** 
David Boring folds
Clemence75 raises 0.04€ to 0.06€
Hydramist folds
Fried Berg folds
n13tless raises 0.15€ to 0.21€
haouuum28 folds
Clemence75 folds
n13tless collected 0.29€ from pot
*** SUMMARY ***
Total pot 0.29€ | No rake
Seat 1: n13tless (small blind) won 0.29€


Winamax Poker - HOLD-UP "Colorado" - HandId: #19116069-207058-1701339117 - Holdem no limit (0.01€/0.02€) - 2023/11/30 10:11:57 UTC
Table: 'Colorado' 6-max (real money) Seat #6 is the button
Seat 1: Berig (2€)
Seat 2: Aggro Loser (2.37€)
Seat 3: nico033 (1.61€)
Seat 4: Fried Berg (1.54€)
Seat 5: B&CLYDE (1.87€)
Seat 6: Giucar (2.09€)
*** ANTE/BLINDS ***
Berig posts small blind 0.01€
Aggro Loser posts big blind 0.02€
Dealt to Fried Berg [Qh Ac]
*** PRE-FLOP *** 
nico033 folds
Fried Berg raises 0.04€ to 0.06€
B&CLYDE folds
Giucar folds
Berig calls 0.05€
Aggro Loser folds
*** FLOP *** [6c Ah Jc]
Berig checks
Fried Berg checks
*** TURN *** [6c Ah Jc][2c]
Berig checks
Fried Berg checks
*** RIVER *** [6c Ah Jc 2c][2h]
Berig checks
Fried Berg bets 0.05€
Berig folds
Fried Berg collected 0.18€ from pot
*** SUMMARY ***
Total pot 0.18€ | Rake 0.01€
Board: [6c Ah Jc 2c 2h]
Seat 4: Fried Berg won 0.18€


Winamax Poker - HOLD-UP "Colorado" - HandId: #19116069-207121-1701339170 - Holdem no limit (0.01€/0.02€) - 2023/11/30 10:12:50 UTC
Table: 'Colorado' 6-max (real money) Seat #6 is the button
Seat 1: Aggro Loser (2.64€)
Seat 2: Fried Berg (1.61€)
Seat 3: Berig (1.97€)
Seat 4: Dolph66 (1.87€)
Seat 5: TTry-AgAin (1.84€)
Seat 6: Oxmau5 (2€)
*** ANTE/BLINDS ***
Aggro Loser posts small blind 0.01€
Fried Berg posts big blind 0.02€
Dealt to Fried Berg [7s Td]
*** PRE-FLOP *** 
Berig folds
Dolph66 folds
TTry-AgAin folds
Oxmau5 folds
Aggro Loser folds
Fried Berg collected 0.03€ from pot
*** SUMMARY ***
Total pot 0.03€ | No rake
Seat 2: Fried Berg (big blind) won 0.03€


Winamax Poker - HOLD-UP "Colorado" - HandId: #19116069-207146-1701339197 - Holdem no limit (0.01€/0.02€) - 2023/11/30 10:13:17 UTC
Table: 'Colorado' 6-max (real money) Seat #6 is the button
Seat 1: TTry-AgAin (1.85€)
Seat 2: josep2170 (2.56€)
Seat 3: B&CLYDE (1.83€)
Seat 4: curiouz dje (5.17€)
Seat 5: Fried Berg (1.62€)
Seat 6: David Boring (5.13€)
*** ANTE/BLINDS ***
TTry-AgAin posts small blind 0.01€
josep2170 posts big blind 0.02€
Dealt to Fried Berg [Qc Jd]
*** PRE-FLOP *** 
B&CLYDE folds
curiouz dje folds
Fried Berg raises 0.02€ to 0.04€
David Boring folds
TTry-AgAin folds
josep2170 folds
Fried Berg collected 0.07€ from pot
*** SUMMARY ***
Total pot 0.07€ | No rake
Seat 5: Fried Berg won 0.07€


Winamax Poker - HOLD-UP "Colorado" - HandId: #19116069-207168-1701339210 - Holdem no limit (0.01€/0.02€) - 2023/11/30 10:13:30 UTC
Table: 'Colorado' 6-max (real money) Seat #6 is the button
Seat 1: Fried Berg (1.65€)
Seat 2: slowreplay (2.04€)
Seat 3: Waucan (2.02€)
Seat 4: LA TOUR FL (7.16€)
Seat 5: Ddm8 (27.41€)
Seat 6: kameleon73 (2.01€)
*** ANTE/BLINDS ***
Fried Berg posts small blind 0.01€
slowreplay posts big blind 0.02€
Dealt to Fried Berg [3s 5h]
*** PRE-FLOP *** 
Waucan raises 0.03€ to 0.05€
LA TOUR FL folds
Ddm8 folds
kameleon73 folds
Fried Berg folds
slowreplay calls 0.03€
*** FLOP *** [6d 7c 9d]
slowreplay checks
Waucan checks
*** TURN *** [6d 7c 9d][Qc]
slowreplay checks
Waucan checks
*** RIVER *** [6d 7c 9d Qc][6h]
slowreplay checks
Waucan checks
*** SHOW DOWN ***
slowreplay shows [Ts Jd] (One pair : 6)
Waucan shows [Ah 4h] (One pair : 6)
Waucan collected 0.10€ from pot
*** SUMMARY ***
Total pot 0.10€ | Rake 0.01€
Board: [6d 7c 9d Qc 6h]
Seat 2: slowreplay (big blind) showed [Ts Jd] and lost with One pair : 6
Seat 3: Waucan showed [Ah 4h] and won 0.10€ with One pair : 6


Winamax Poker - HOLD-UP "Colorado" - HandId: #19116069-207178-1701339218 - Holdem no limit (0.01€/0.02€) - 2023/11/30 10:13:38 UTC
Table: 'Colorado' 6-max (real money) Seat #6 is the button
Seat 1: finalmoon (2.17€)
Seat 2: Adame199623 (2.06€)
Seat 3: Fried Berg (1.64€)
Seat 4: S-aaron24 (2.68€)
Seat 5: l artiste ho (2.05€)
Seat 6: kameleon73 (2.01€)
*** ANTE/BLINDS ***
finalmoon posts small blind 0.01€
Adame199623 posts big blind 0.02€
Dealt to Fried Berg [8c Qh]
*** PRE-FLOP *** 
Fried Berg folds
S-aaron24 folds
l artiste ho folds
kameleon73 raises 0.08€ to 0.10€
finalmoon folds
Adame199623 folds
kameleon73 collected 0.13€ from pot
*** SUMMARY ***
Total pot 0.13€ | No rake
Seat 6: kameleon73 (button) won 0.13€


Winamax Poker - HOLD-UP "Colorado" - HandId: #19116069-207181-1701339220 - Holdem no limit (0.01€/0.02€) - 2023/11/30 10:13:40 UTC
Table: 'Colorado' 6-max (real money) Seat #6 is the button
Seat 1: curiouz dje (2€)
Seat 2: PIQSOU (3.66€)
Seat 3: wAAlterrr (2.31€)
Seat 4: ricki64 (2.56€)
Seat 5: finalmoon (2.16€)
Seat 6: Fried Berg (1.64€)
*** ANTE/BLINDS ***
curiouz dje posts small blind 0.01€
PIQSOU posts big blind 0.02€
Dealt to Fried Berg [7c 8c]
*** PRE-FLOP *** 
wAAlterrr folds
ricki64 folds
finalmoon raises 0.03€ to 0.05€
Fried Berg calls 0.05€
curiouz dje folds
PIQSOU folds
*** FLOP *** [Jc 8h 4c]
finalmoon bets 0.07€
Fried Berg calls 0.07€
*** TURN *** [Jc 8h 4c][6c]
finalmoon checks
Fried Berg checks
*** RIVER *** [Jc 8h 4c 6c][6s]
finalmoon bets 0.09€
Fried Berg raises 0.09€ to 0.18€
finalmoon folds
Fried Berg collected 0.49€ from pot
*** SUMMARY ***
Total pot 0.49€ | Rake 0.05€
Board: [Jc 8h 4c 6c 6s]
Seat 6: Fried Berg (button) won 0.49€


Winamax Poker - HOLD-UP "Colorado" - HandId: #19116069-207251-1701339273 - Holdem no limit (0.01€/0.02€) - 2023/11/30 10:14:33 UTC
Table: 'Colorado' 6-max (real money) Seat #6 is the button
Seat 1: WonderPoul (2.08€)
Seat 2: Oxmau5 (2.12€)
Seat 3: Killim (0.98€)
Seat 4: Adame199623 (2.08€)
Seat 5: josep2170 (2.55€)
Seat 6: Fried Berg (1.83€)
*** ANTE/BLINDS ***
WonderPoul posts small blind 0.01€
Oxmau5 posts big blind 0.02€
Dealt to Fried Berg [2d 8s]
*** PRE-FLOP *** 
Killim folds
Adame199623 folds
josep2170 folds
Fried Berg folds
WonderPoul raises 0.04€ to 0.06€
Oxmau5 folds
WonderPoul collected 0.08€ from pot
*** SUMMARY ***
Total pot 0.08€ | No rake
Seat 1: WonderPoul (small blind) won 0.08€


Winamax Poker - HOLD-UP "Colorado" - HandId: #19116069-207259-1701339278 - Holdem no limit (0.01€/0.02€) - 2023/11/30 10:14:38 UTC
Table: 'Colorado' 6-max (real money) Seat #6 is the button
Seat 1: Ragusnik00 (0.94€)
Seat 2: finalmoon (2€)
Seat 3: slowreplay (2€)
Seat 4: Fried Berg (1.83€)
Seat 5: Berig (1.97€)
Seat 6: Hydramist (2€)
*** ANTE/BLINDS ***
Ragusnik00 posts small blind 0.01€
finalmoon posts big blind 0.02€
Dealt to Fried Berg [2s 6s]
*** PRE-FLOP *** 
slowreplay folds
Fried Berg folds
Berig folds
Hydramist folds
Ragusnik00 folds
finalmoon collected 0.03€ from pot
*** SUMMARY ***
Total pot 0.03€ | No rake
Seat 2: finalmoon (big blind) won 0.03€


Winamax Poker - HOLD-UP "Colorado" - HandId: #19116069-207269-1701339285 - Holdem no limit (0.01€/0.02€) - 2023/11/30 10:14:45 UTC
Table: 'Colorado' 6-max (real money) Seat #6 is the button
Seat 1: TimToBey (2€)
Seat 2: slowreplay (1.99€)
Seat 3: Fried Berg (1.83€)
Seat 4: LA TOUR FL (2€)
Seat 5: Giucar (2.12€)
Seat 6: Cedlebon (2.11€)
*** ANTE/BLINDS ***
TimToBey posts small blind 0.01€
slowreplay posts big blind 0.02€
Dealt to Fried Berg [2c 3d]
*** PRE-FLOP *** 
Fried Berg folds
LA TOUR FL raises 0.04€ to 0.06€
Giucar folds
Cedlebon folds
TimToBey folds
slowreplay folds
LA TOUR FL collected 0.09€ from pot
*** SUMMARY ***
Total pot 0.09€ | No rake
Seat 4: LA TOUR FL won 0.09€


Winamax Poker - HOLD-UP "Colorado" - HandId: #19116069-207273-1701339286 - Holdem no limit (0.01€/0.02€) - 2023/11/30 10:14:46 UTC
Table: 'Colorado' 6-max (real money) Seat #6 is the button
Seat 1: 1trospecti0n (2€)
Seat 2: ironman33 (1.71€)
Seat 3: Nash123 (2€)
Seat 4: lefraisier (5.25€)
Seat 5: Fried Berg (1.83€)
Seat 6: haouuum28 (3.83€)
*** ANTE/BLINDS ***
1trospecti0n posts small blind 0.01€
ironman33 posts big blind 0.02€
Dealt to Fried Berg [3c 2s]
*** PRE-FLOP *** 
Nash123 folds
lefraisier folds
Fried Berg folds
haouuum28 folds
1trospecti0n folds
ironman33 collected 0.03€ from pot
*** SUMMARY ***
Total pot 0.03€ | No rake
Seat 2: ironman33 (big blind) won 0.03€


Winamax Poker - HOLD-UP "Colorado" - HandId: #19116069-207287-1701339294 - Holdem no limit (0.01€/0.02€) - 2023/11/30 10:14:54 UTC
Table: 'Colorado' 6-max (real money) Seat #6 is the button
Seat 1: CHANGAS (3.74€)
Seat 2: Fried Berg (1.83€)
Seat 3: Clemence75 (2.01€)
Seat 4: S-aaron24 (2.10€)
Seat 5: Cedlebon (2.11€)
Seat 6: slowreplay (1.97€)
*** ANTE/BLINDS ***
CHANGAS posts small blind 0.01€
Fried Berg posts big blind 0.02€
Dealt to Fried Berg [6c Js]
*** PRE-FLOP *** 
Clemence75 folds
S-aaron24 folds
Cedlebon folds
slowreplay raises 0.04€ to 0.06€
CHANGAS folds
Fried Berg folds
slowreplay collected 0.09€ from pot
*** SUMMARY ***
Total pot 0.09€ | No rake
Seat 6: slowreplay (button) won 0.09€


Winamax Poker - HOLD-UP "Colorado" - HandId: #19116069-207309-1701339306 - Holdem no limit (0.01€/0.02€) - 2023/11/30 10:15:06 UTC
Table: 'Colorado' 6-max (real money) Seat #6 is the button
Seat 1: Berig (1.95€)
Seat 2: TimToBey (2€)
Seat 3: josep2170 (2.54€)
Seat 4: Fried Berg (1.81€)
Seat 5: Clemence75 (2.06€)
Seat 6: David Boring (5.09€)
*** ANTE/BLINDS ***
Berig posts small blind 0.01€
TimToBey posts big blind 0.02€
Dealt to Fried Berg [Qh 3c]
*** PRE-FLOP *** 
josep2170 folds
Fried Berg folds
Clemence75 folds
David Boring folds
Berig folds
TimToBey collected 0.03€ from pot
*** SUMMARY ***
Total pot 0.03€ | No rake
Seat 2: TimToBey (big blind) won 0.03€


Winamax Poker - HOLD-UP "Colorado" - HandId: #19116069-207314-1701339309 - Holdem no limit (0.01€/0.02€) - 2023/11/30 10:15:09 UTC
Table: 'Colorado' 6-max (real money) Seat #6 is the button
Seat 1: slowreplay (2€)
Seat 2: Retail Row (2€)
Seat 3: sportsmax006 (1.85€)
Seat 4: Aggro Loser (2.51€)
Seat 5: Fried Berg (1.81€)
Seat 6: Cedlebon (2.09€)
*** ANTE/BLINDS ***
slowreplay posts small blind 0.01€
Retail Row posts big blind 0.02€
Dealt to Fried Berg [6h 4s]
*** PRE-FLOP *** 
sportsmax006 folds
Aggro Loser folds
Fried Berg folds
Cedlebon folds
slowreplay folds
Retail Row collected 0.03€ from pot
*** SUMMARY ***
Total pot 0.03€ | No rake
Seat 2: Retail Row (big blind) won 0.03€


Winamax Poker - HOLD-UP "Colorado" - HandId: #19116069-207337-1701339324 - Holdem no limit (0.01€/0.02€) - 2023/11/30 10:15:24 UTC
Table: 'Colorado' 6-max (real money) Seat #6 is the button
Seat 1: Fried Berg (1.81€)
Seat 2: Berig (2.12€)
Seat 3: curiouz dje (2.03€)
Seat 4: Ddm8 (27.32€)
Seat 5: bandarra8520 (3.03€)
Seat 6: Aggro Loser (2.51€)
*** ANTE/BLINDS ***
Fried Berg posts small blind 0.01€
Berig posts big blind 0.02€
Dealt to Fried Berg [Jd Qh]
*** PRE-FLOP *** 
curiouz dje folds
Ddm8 raises 0.03€ to 0.05€
bandarra8520 folds
Aggro Loser folds
Fried Berg calls 0.04€
Berig calls 0.03€
*** FLOP *** [Ad Ac 6s]
Fried Berg checks
Berig checks
Ddm8 bets 0.10€
Fried Berg folds
Berig folds
Ddm8 collected 0.23€ from pot
*** SUMMARY ***
Total pot 0.23€ | Rake 0.02€
Board: [Ad Ac 6s]
Seat 4: Ddm8 won 0.23€


Winamax Poker - HOLD-UP "Colorado" - HandId: #19116069-207401-1701339374 - Holdem no limit (0.01€/0.02€) - 2023/11/30 10:16:14 UTC
Table: 'Colorado' 6-max (real money) Seat #6 is the button
Seat 1: 1trospecti0n (2.04€)
Seat 2: nico033 (1.95€)
Seat 3: Fried Berg (1.76€)
Seat 4: PIQSOU (2.24€)
Seat 5: Charivari_ (1.03€)
Seat 6: n13tless (2.98€)
*** ANTE/BLINDS ***
1trospecti0n posts small blind 0.01€
nico033 posts big blind 0.02€
Dealt to Fried Berg [5h 2d]
*** PRE-FLOP *** 
Fried Berg folds
PIQSOU folds
Charivari_ folds
n13tless raises 0.03€ to 0.05€
1trospecti0n raises 0.17€ to 0.22€
nico033 folds
n13tless folds
1trospecti0n collected 0.29€ from pot
*** SUMMARY ***
Total pot 0.29€ | No rake
Seat 1: 1trospecti0n (small blind) won 0.29€


Winamax Poker - HOLD-UP "Colorado" - HandId: #19116069-207403-1701339376 - Holdem no limit (0.01€/0.02€) - 2023/11/30 10:16:16 UTC
Table: 'Colorado' 6-max (real money) Seat #6 is the button
Seat 1: babe35 (1.04€)
Seat 2: Fried Berg (1.76€)
Seat 3: Titounet70 (3.22€)
Seat 4: Adame199623 (2.07€)
Seat 5: Clemence75 (2€)
Seat 6: MFA_Mathis (3.76€)
*** ANTE/BLINDS ***
babe35 posts small blind 0.01€
Fried Berg posts big blind 0.02€
Dealt to Fried Berg [Js 8c]
*** PRE-FLOP *** 
Titounet70 raises 0.05€ to 0.07€
Adame199623 folds
Clemence75 folds
MFA_Mathis folds
babe35 folds
Fried Berg folds
Titounet70 collected 0.10€ from pot
*** SUMMARY ***
Total pot 0.10€ | No rake
Seat 3: Titounet70 won 0.10€


Winamax Poker - HOLD-UP "Colorado" - HandId: #19116069-207409-1701339381 - Holdem no limit (0.01€/0.02€) - 2023/11/30 10:16:21 UTC
Table: 'Colorado' 6-max (real money) Seat #6 is the button
Seat 1: Fried Berg (1.74€)
Seat 2: Zaerts (2.54€)
Seat 3: babe35 (1.03€)
Seat 4: haouuum28 (3.89€)
Seat 5: Adame199623 (2.06€)
Seat 6: Aggro Loser (2.86€)
*** ANTE/BLINDS ***
Fried Berg posts small blind 0.01€
Zaerts posts big blind 0.02€
Dealt to Fried Berg [Js 3c]
*** PRE-FLOP *** 
babe35 folds
haouuum28 folds
Adame199623 folds
Aggro Loser folds
Fried Berg folds
Zaerts collected 0.03€ from pot
*** SUMMARY ***
Total pot 0.03€ | No rake
Seat 2: Zaerts (big blind) won 0.03€


Winamax Poker - HOLD-UP "Colorado" - HandId: #19116069-207413-1701339384 - Holdem no limit (0.01€/0.02€) - 2023/11/30 10:16:24 UTC
Table: 'Colorado' 6-max (real money) Seat #6 is the button
Seat 1: haouuum28 (1.03€)
Seat 2: Adame199623 (2.06€)
Seat 3: S-aaron24 (2.04€)
Seat 4: Aggro Loser (2.86€)
Seat 5: ironman33 (1.53€)
Seat 6: Fried Berg (1.73€)
*** ANTE/BLINDS ***
haouuum28 posts small blind 0.01€
Adame199623 posts big blind 0.02€
Dealt to Fried Berg [Jh Qc]
*** PRE-FLOP *** 
S-aaron24 folds
Aggro Loser folds
ironman33 calls 0.02€
Fried Berg calls 0.02€
haouuum28 folds
Adame199623 checks
*** FLOP *** [6h 2c 8h]
Adame199623 checks
ironman33 checks
Fried Berg checks
*** TURN *** [6h 2c 8h][7s]
Adame199623 checks
ironman33 checks
Fried Berg checks
*** RIVER *** [6h 2c 8h 7s][Ac]
Adame199623 checks
ironman33 bets 0.04€
Fried Berg calls 0.04€
Adame199623 folds
*** SHOW DOWN ***
Fried Berg shows [Jh Qc] (High card : Ace)
ironman33 shows [As 2h] (Two pairs : Aces and 2)
ironman33 collected 0.13€ from pot
*** SUMMARY ***
Total pot 0.13€ | Rake 0.02€
Board: [6h 2c 8h 7s Ac]
Seat 5: ironman33 showed [As 2h] and won 0.13€ with Two pairs : Aces and 2
Seat 6: Fried Berg (button) showed [Jh Qc] and lost with High card : Ace


Winamax Poker - HOLD-UP "Colorado" - HandId: #19116069-207484-1701339437 - Holdem no limit (0.01€/0.02€) - 2023/11/30 10:17:17 UTC
Table: 'Colorado' 6-max (real money) Seat #6 is the button
Seat 1: curiouz dje (5.03€)
Seat 2: franco100 (0.47€)
Seat 3: Ragusnik00 (0.72€)
Seat 4: sportsmax006 (1.67€)
Seat 5: Fried Berg (1.67€)
Seat 6: Charivari_ (0.94€)
*** ANTE/BLINDS ***
curiouz dje posts small blind 0.01€
franco100 posts big blind 0.02€
Dealt to Fried Berg [9d Th]
*** PRE-FLOP *** 
Ragusnik00 raises 0.04€ to 0.06€
sportsmax006 folds
Fried Berg folds
Charivari_ folds
curiouz dje folds
franco100 folds
Ragusnik00 collected 0.09€ from pot
*** SUMMARY ***
Total pot 0.09€ | No rake
Seat 3: Ragusnik00 won 0.09€


Winamax Poker - HOLD-UP "Colorado" - HandId: #19116069-207513-1701339458 - Holdem no limit (0.01€/0.02€) - 2023/11/30 10:17:38 UTC
Table: 'Colorado' 6-max (real money) Seat #6 is the button
Seat 1: Baston57 (2.19€)
Seat 2: Perf-31 (2.87€)
Seat 3: Fried Berg (1.67€)
Seat 4: slowreplay (2.22€)
Seat 5: Charivari_ (0.94€)
Seat 6: Aggro Loser (2.78€)
*** ANTE/BLINDS ***
Baston57 posts small blind 0.01€
Perf-31 posts big blind 0.02€
Dealt to Fried Berg [4d Jc]
*** PRE-FLOP *** 
Fried Berg folds
slowreplay folds
Charivari_ folds
Aggro Loser folds
Baston57 folds
Perf-31 collected 0.03€ from pot
*** SUMMARY ***
Total pot 0.03€ | No rake
Seat 2: Perf-31 (big blind) won 0.03€


Winamax Poker - HOLD-UP "Colorado" - HandId: #19116069-207518-1701339460 - Holdem no limit (0.01€/0.02€) - 2023/11/30 10:17:40 UTC
Table: 'Colorado' 6-max (real money) Seat #6 is the button
Seat 1: Retail Row (2.04€)
Seat 2: Waucan (2.03€)
Seat 3: Baston57 (2.18€)
Seat 4: Fried Berg (1.67€)
Seat 5: 1trospecti0n (3.17€)
Seat 6: curiouz dje (4.06€)
*** ANTE/BLINDS ***
Retail Row posts small blind 0.01€
Waucan posts big blind 0.02€
Dealt to Fried Berg [8s 2d]
*** PRE-FLOP *** 
Baston57 folds
Fried Berg folds
1trospecti0n folds
curiouz dje folds
Retail Row folds
Waucan collected 0.03€ from pot
*** SUMMARY ***
Total pot 0.03€ | No rake
Seat 2: Waucan (big blind) won 0.03€


Winamax Poker - HOLD-UP "Colorado" - HandId: #19116069-207522-1701339463 - Holdem no limit (0.01€/0.02€) - 2023/11/30 10:17:43 UTC
Table: 'Colorado' 6-max (real money) Seat #6 is the button
Seat 1: Charivari_ (0.94€)
Seat 2: 1trospecti0n (3.17€)
Seat 3: Retail Row (2.03€)
Seat 4: bandarra8520 (2.89€)
Seat 5: Hydramist (3.86€)
Seat 6: Fried Berg (1.67€)
*** ANTE/BLINDS ***
Charivari_ posts small blind 0.01€
1trospecti0n posts big blind 0.02€
Dealt to Fried Berg [Jc 9d]
*** PRE-FLOP *** 
Retail Row folds
bandarra8520 folds
Hydramist raises 0.03€ to 0.05€
Fried Berg folds
Charivari_ folds
1trospecti0n folds
Hydramist collected 0.08€ from pot
*** SUMMARY ***
Total pot 0.08€ | No rake
Seat 5: Hydramist won 0.08€


Winamax Poker - HOLD-UP "Colorado" - HandId: #19116069-207533-1701339467 - Holdem no limit (0.01€/0.02€) - 2023/11/30 10:17:47 UTC
Table: 'Colorado' 6-max (real money) Seat #6 is the button
Seat 1: Fried Berg (1.67€)
Seat 2: bandarra8520 (2.88€)
Seat 3: grut28 (3.59€)
Seat 4: Aggro Loser (2.78€)
Seat 5: SirX (4.60€)
Seat 6: haouuum28 (1.40€)
*** ANTE/BLINDS ***
Fried Berg posts small blind 0.01€
bandarra8520 posts big blind 0.02€
Dealt to Fried Berg [9h 3h]
*** PRE-FLOP *** 
grut28 folds
Aggro Loser folds
SirX raises 0.04€ to 0.06€
haouuum28 calls 0.06€
Fried Berg folds
bandarra8520 calls 0.04€
*** FLOP *** [Js 2c 9c]
bandarra8520 checks
SirX checks
haouuum28 checks
*** TURN *** [Js 2c 9c][4c]
bandarra8520 checks
SirX checks
haouuum28 checks
*** RIVER *** [Js 2c 9c 4c][Tc]
bandarra8520 checks
SirX checks
haouuum28 checks
*** SHOW DOWN ***
bandarra8520 shows [6d 5d] (High card : Jack)
SirX shows [2d Ad] (One pair : 2)
haouuum28 shows [5s 5h] (One pair : 5)
haouuum28 collected 0.17€ from pot
*** SUMMARY ***
Total pot 0.17€ | Rake 0.02€
Board: [Js 2c 9c 4c Tc]
Seat 2: bandarra8520 (big blind) showed [6d 5d] and lost with High card : Jack
Seat 5: SirX showed [2d Ad] and lost with One pair : 2
Seat 6: haouuum28 (button) showed [5s 5h] and won 0.17€ with One pair : 5


Winamax Poker - HOLD-UP "Colorado" - HandId: #19116069-207536-1701339469 - Holdem no limit (0.01€/0.02€) - 2023/11/30 10:17:49 UTC
Table: 'Colorado' 6-max (real money) Seat #6 is the button
Seat 1: josep2170 (2.54€)
Seat 2: Clemence75 (2.04€)
Seat 3: Fried Berg (1.66€)
Seat 4: Cedlebon (2.21€)
Seat 5: slowreplay (1.89€)
Seat 6: ricki64 (1€)
*** ANTE/BLINDS ***
josep2170 posts small blind 0.01€
Clemence75 posts big blind 0.02€
Dealt to Fried Berg [6s 8c]
*** PRE-FLOP *** 
Fried Berg folds
Cedlebon folds
slowreplay folds
ricki64 raises 0.98€ to 1€ and is all-in
josep2170 folds
Clemence75 folds
ricki64 collected 1.03€ from pot
*** SUMMARY ***
Total pot 1.03€ | No rake
Seat 6: ricki64 (button) won 1.03€


Winamax Poker - HOLD-UP "Colorado" - HandId: #19116069-207539-1701339471 - Holdem no limit (0.01€/0.02€) - 2023/11/30 10:17:51 UTC
Table: 'Colorado' 6-max (real money) Seat #6 is the button
Seat 1: Hydramist (2€)
Seat 2: nico033 (1.88€)
Seat 3: S-aaron24 (2€)
Seat 4: Fried Berg (1.66€)
Seat 5: curiouz dje (5€)
Seat 6: Nash123 (3.83€)
*** ANTE/BLINDS ***
Hydramist posts small blind 0.01€
nico033 posts big blind 0.02€
Dealt to Fried Berg [5c 9h]
*** PRE-FLOP *** 
S-aaron24 folds
Fried Berg folds
curiouz dje folds
Nash123 folds
Hydramist raises 0.04€ to 0.06€
nico033 folds
Hydramist collected 0.08€ from pot
*** SUMMARY ***
Total pot 0.08€ | No rake
Seat 1: Hydramist (small blind) won 0.08€


Winamax Poker - HOLD-UP "Colorado" - HandId: #19116069-207544-1701339473 - Holdem no limit (0.01€/0.02€) - 2023/11/30 10:17:53 UTC
Table: 'Colorado' 6-max (real money) Seat #6 is the button
Seat 1: Cedlebon (2.21€)
Seat 2: Fried Berg (1.66€)
Seat 3: grut28 (3.59€)
Seat 4: rick26 (2.12€)
Seat 5: Oxmau5 (2.07€)
Seat 6: ITALIA291 (2€)
*** ANTE/BLINDS ***
Cedlebon posts small blind 0.01€
Fried Berg posts big blind 0.02€
Dealt to Fried Berg [9d Jh]
*** PRE-FLOP *** 
grut28 folds
rick26 folds
Oxmau5 folds
ITALIA291 folds
Cedlebon raises 0.04€ to 0.06€
Fried Berg folds
Cedlebon collected 0.08€ from pot
*** SUMMARY ***
Total pot 0.08€ | No rake
Seat 1: Cedlebon (small blind) won 0.08€


Winamax Poker - HOLD-UP "Colorado" - HandId: #19116069-207560-1701339485 - Holdem no limit (0.01€/0.02€) - 2023/11/30 10:18:05 UTC
Table: 'Colorado' 6-max (real money) Seat #6 is the button
Seat 1: 1trospecti0n (2.35€)
Seat 2: Fried Berg (1.64€)
Seat 3: Aggro Loser (2.76€)
Seat 4: rick26 (1.82€)
Seat 5: nico033 (1.86€)
Seat 6: franco100 (0.41€)
*** ANTE/BLINDS ***
1trospecti0n posts small blind 0.01€
Fried Berg posts big blind 0.02€
Dealt to Fried Berg [Kd Td]
*** PRE-FLOP *** 
Aggro Loser folds
rick26 folds
nico033 raises 0.03€ to 0.05€
franco100 calls 0.05€
1trospecti0n raises 0.22€ to 0.27€
Fried Berg folds
nico033 folds
franco100 folds
1trospecti0n collected 0.39€ from pot
*** SUMMARY ***
Total pot 0.39€ | No rake
Seat 1: 1trospecti0n (small blind) won 0.39€


Winamax Poker - HOLD-UP "Colorado" - HandId: #19116069-207597-1701339515 - Holdem no limit (0.01€/0.02€) - 2023/11/30 10:18:35 UTC
Table: 'Colorado' 6-max (real money) Seat #6 is the button
Seat 1: Fried Berg (1.62€)
Seat 2: TTry-AgAin (2.06€)
Seat 3: wAAlterrr (2.42€)
Seat 4: nico033 (1.81€)
Seat 5: CHANGAS (3.67€)
Seat 6: Aggro Loser (2.75€)
*** ANTE/BLINDS ***
Fried Berg posts small blind 0.01€
TTry-AgAin posts big blind 0.02€
Dealt to Fried Berg [Th 7c]
*** PRE-FLOP *** 
wAAlterrr raises 0.03€ to 0.05€
nico033 folds
CHANGAS folds
Aggro Loser folds
Fried Berg folds
TTry-AgAin folds
wAAlterrr collected 0.08€ from pot
*** SUMMARY ***
Total pot 0.08€ | No rake
Seat 3: wAAlterrr won 0.08€


Winamax Poker - HOLD-UP "Colorado" - HandId: #19116069-207607-1701339520 - Holdem no limit (0.01€/0.02€) - 2023/11/30 10:18:40 UTC
Table: 'Colorado' 6-max (real money) Seat #6 is the button
Seat 1: Ga31k (2€)
Seat 2: Thommynabo (2€)
Seat 3: slowreplay (2.03€)
Seat 4: samaris24 (0.67€)
Seat 5: Fried Berg (1.61€)
Seat 6: nico033 (1.81€)
*** ANTE/BLINDS ***
Ga31k posts small blind 0.01€
Thommynabo posts big blind 0.02€
Dealt to Fried Berg [Qh Jc]
*** PRE-FLOP *** 
slowreplay folds
samaris24 raises 0.02€ to 0.04€
Fried Berg raises 0.05€ to 0.09€
nico033 folds
Ga31k folds
Thommynabo folds
samaris24 calls 0.05€
*** FLOP *** [9h 5s 7h]
samaris24 bets 0.11€
Fried Berg calls 0.11€
*** TURN *** [9h 5s 7h][5c]
samaris24 checks
Fried Berg checks
*** RIVER *** [9h 5s 7h 5c][9s]
samaris24 bets 0.22€
Fried Berg calls 0.22€
*** SHOW DOWN ***
samaris24 shows [3c 3h] (Two pairs : 9 and 5)
Fried Berg shows [Qh Jc] (Two pairs : 9 and 5)
Fried Berg collected 0.78€ from pot
*** SUMMARY ***
Total pot 0.78€ | Rake 0.09€
Board: [9h 5s 7h 5c 9s]
Seat 4: samaris24 showed [3c 3h] and lost with Two pairs : 9 and 5
Seat 5: Fried Berg showed [Qh Jc] and won 0.78€ with Two pairs : 9 and 5


Winamax Poker - HOLD-UP "Colorado" - HandId: #19116069-207695-1701339581 - Holdem no limit (0.01€/0.02€) - 2023/11/30 10:19:41 UTC
Table: 'Colorado' 6-max (real money) Seat #6 is the button
Seat 1: matmyl (2.18€)
Seat 2: haouuum28 (1.46€)
Seat 3: Fried Berg (1.97€)
Seat 4: Ga31k (2€)
Seat 5: KKamarAAde (1.97€)
Seat 6: Hydramist (2.41€)
*** ANTE/BLINDS ***
matmyl posts small blind 0.01€
haouuum28 posts big blind 0.02€
Dealt to Fried Berg [5c 4s]
*** PRE-FLOP *** 
Fried Berg folds
Ga31k folds
KKamarAAde folds
Hydramist folds
matmyl folds
haouuum28 collected 0.03€ from pot
*** SUMMARY ***
Total pot 0.03€ | No rake
Seat 2: haouuum28 (big blind) won 0.03€


Winamax Poker - HOLD-UP "Colorado" - HandId: #19116069-207712-1701339594 - Holdem no limit (0.01€/0.02€) - 2023/11/30 10:19:54 UTC
Table: 'Colorado' 6-max (real money) Seat #6 is the button
Seat 1: Aggro Loser (2.68€)
Seat 2: SirX (4.64€)
Seat 3: Ragusnik00 (0.75€)
Seat 4: Suaterna207 (2.25€)
Seat 5: S-aaron24 (2.65€)
Seat 6: Fried Berg (1.97€)
*** ANTE/BLINDS ***
Aggro Loser posts small blind 0.01€
SirX posts big blind 0.02€
Dealt to Fried Berg [Tc Qs]
*** PRE-FLOP *** 
Ragusnik00 folds
Suaterna207 folds
S-aaron24 folds
Fried Berg raises 0.02€ to 0.04€
Aggro Loser folds
SirX calls 0.02€
*** FLOP *** [Ad 5s 5d]
SirX checks
Fried Berg checks
*** TURN *** [Ad 5s 5d][7d]
SirX checks
Fried Berg checks
*** RIVER *** [Ad 5s 5d 7d][As]
SirX checks
Fried Berg checks
*** SHOW DOWN ***
Fried Berg shows [Tc Qs] (Two pairs : Aces and 5)
SirX shows [Ts Kd] (Two pairs : Aces and 5)
SirX collected 0.08€ from pot
*** SUMMARY ***
Total pot 0.08€ | Rake 0.01€
Board: [Ad 5s 5d 7d As]
Seat 2: SirX (big blind) showed [Ts Kd] and won 0.08€ with Two pairs : Aces and 5
Seat 6: Fried Berg (button) showed [Tc Qs] and lost with Two pairs : Aces and 5


Winamax Poker - HOLD-UP "Colorado" - HandId: #19116069-207761-1701339627 - Holdem no limit (0.01€/0.02€) - 2023/11/30 10:20:27 UTC
Table: 'Colorado' 6-max (real money) Seat #6 is the button
Seat 1: SirX (4.68€)
Seat 2: Oxmau5 (2.08€)
Seat 3: Adame199623 (2€)
Seat 4: rick26 (2.09€)
Seat 5: Fried Berg (1.93€)
Seat 6: Hydramist (2.96€)
*** ANTE/BLINDS ***
SirX posts small blind 0.01€
Oxmau5 posts big blind 0.02€
Dealt to Fried Berg [Jc 5d]
*** PRE-FLOP *** 
Adame199623 folds
rick26 folds
Fried Berg folds
Hydramist folds
SirX raises 0.04€ to 0.06€
Oxmau5 folds
SirX collected 0.08€ from pot
*** SUMMARY ***
Total pot 0.08€ | No rake
Seat 1: SirX (small blind) won 0.08€


Winamax Poker - HOLD-UP "Colorado" - HandId: #19116069-207779-1701339641 - Holdem no limit (0.01€/0.02€) - 2023/11/30 10:20:41 UTC
Table: 'Colorado' 6-max (real money) Seat #6 is the button
Seat 1: GTO-Mieko (4.28€)
Seat 2: Fried Berg (1.93€)
Seat 3: rick26 (1.85€)
Seat 4: AMORFOU (2€)
Seat 5: Alice2525 (1.14€)
Seat 6: Nash123 (2.47€)
*** ANTE/BLINDS ***
GTO-Mieko posts small blind 0.01€
Fried Berg posts big blind 0.02€
Dealt to Fried Berg [3h Jc]
*** PRE-FLOP *** 
rick26 folds
AMORFOU folds
Alice2525 raises 0.05€ to 0.07€
Nash123 folds
GTO-Mieko folds
Fried Berg folds
Alice2525 collected 0.10€ from pot
*** SUMMARY ***
Total pot 0.10€ | No rake
Seat 5: Alice2525 won 0.10€


Winamax Poker - HOLD-UP "Colorado" - HandId: #19116069-207789-1701339648 - Holdem no limit (0.01€/0.02€) - 2023/11/30 10:20:48 UTC
Table: 'Colorado' 6-max (real money) Seat #6 is the button
Seat 1: Fried Berg (1.91€)
Seat 2: Clemence75 (2.05€)
Seat 3: AMORFOU (2.03€)
Seat 4: kameleon73 (2.02€)
Seat 5: SUMO LARDON (2€)
Seat 6: slowreplay (2€)
*** ANTE/BLINDS ***
Fried Berg posts small blind 0.01€
Clemence75 posts big blind 0.02€
Dealt to Fried Berg [6c 3d]
*** PRE-FLOP *** 
AMORFOU folds
kameleon73 folds
SUMO LARDON folds
slowreplay raises 0.04€ to 0.06€
Fried Berg folds
Clemence75 folds
slowreplay collected 0.09€ from pot
*** SUMMARY ***
Total pot 0.09€ | No rake
Seat 6: slowreplay (button) won 0.09€


Winamax Poker - HOLD-UP "Colorado" - HandId: #19116069-207793-1701339651 - Holdem no limit (0.01€/0.02€) - 2023/11/30 10:20:51 UTC
Table: 'Colorado' 6-max (real money) Seat #6 is the button
Seat 1: kameleon73 (2.02€)
Seat 2: babe35 (1.20€)
Seat 3: Baston57 (2.53€)
Seat 4: Fried Berg (1.90€)
Seat 5: wAAlterrr (2.67€)
Seat 6: TTry-AgAin (2.49€)
*** ANTE/BLINDS ***
kameleon73 posts small blind 0.01€
babe35 posts big blind 0.02€
Dealt to Fried Berg [6d 6s]
*** PRE-FLOP *** 
Baston57 folds
Fried Berg raises 0.03€ to 0.05€
wAAlterrr folds
TTry-AgAin folds
kameleon73 calls 0.04€
babe35 folds
*** FLOP *** [4d Qd 7c]
kameleon73 bets 0.10€
Fried Berg calls 0.10€
*** TURN *** [4d Qd 7c][2h]
kameleon73 bets 0.12€
Fried Berg calls 0.12€
*** RIVER *** [4d Qd 7c 2h][9h]
kameleon73 checks
Fried Berg checks
*** SHOW DOWN ***
kameleon73 shows [Ad 8d] (High card : Ace)
Fried Berg shows [6d 6s] (One pair : 6)
Fried Berg collected 0.50€ from pot
*** SUMMARY ***
Total pot 0.50€ | Rake 0.06€
Board: [4d Qd 7c 2h 9h]
Seat 1: kameleon73 (small blind) showed [Ad 8d] and lost with High card : Ace
Seat 4: Fried Berg showed [6d 6s] and won 0.50€ with One pair : 6


Winamax Poker - HOLD-UP "Colorado" - HandId: #19116069-207875-1701339709 - Holdem no limit (0.01€/0.02€) - 2023/11/30 10:21:49 UTC
Table: 'Colorado' 6-max (real money) Seat #6 is the button
Seat 1: Ga31k (2.01€)
Seat 2: Suaterna207 (2.13€)
Seat 3: kameleon73 (2.06€)
Seat 4: GF Warrior82 (2.38€)
Seat 5: Cedlebon (2.55€)
Seat 6: Fried Berg (2.13€)
*** ANTE/BLINDS ***
Ga31k posts small blind 0.01€
Suaterna207 posts big blind 0.02€
Dealt to Fried Berg [6c 3h]
*** PRE-FLOP *** 
kameleon73 raises 0.02€ to 0.04€
GF Warrior82 folds
Cedlebon folds
Fried Berg calls 0.04€
Ga31k folds
Suaterna207 folds
*** FLOP *** [2h 2s Ks]
kameleon73 checks
Fried Berg checks
*** TURN *** [2h 2s Ks][7h]
kameleon73 checks
Fried Berg checks
*** RIVER *** [2h 2s Ks 7h][Tc]
kameleon73 bets 0.11€
Fried Berg folds
kameleon73 collected 0.21€ from pot
*** SUMMARY ***
Total pot 0.21€ | Rake 0.01€
Board: [2h 2s Ks 7h Tc]
Seat 3: kameleon73 won 0.21€


Winamax Poker - HOLD-UP "Colorado" - HandId: #19116069-207928-1701339744 - Holdem no limit (0.01€/0.02€) - 2023/11/30 10:22:24 UTC
Table: 'Colorado' 6-max (real money) Seat #6 is the button
Seat 1: Fried Berg (2.09€)
Seat 2: Giucar (2.42€)
Seat 3: LA TOUR FL (2€)
Seat 4: Thommynabo (2.09€)
Seat 5: rick26 (1.79€)
Seat 6: AfgaBoBpoKer (2.07€)
*** ANTE/BLINDS ***
Fried Berg posts small blind 0.01€
Giucar posts big blind 0.02€
Dealt to Fried Berg [7d 5c]
*** PRE-FLOP *** 
LA TOUR FL raises 0.04€ to 0.06€
Thommynabo folds
rick26 folds
AfgaBoBpoKer calls 0.06€
Fried Berg folds
Giucar calls 0.04€
*** FLOP *** [9s Kh 6d]
Giucar checks
LA TOUR FL bets 0.05€
AfgaBoBpoKer calls 0.05€
Giucar calls 0.05€
*** TURN *** [9s Kh 6d][5h]
Giucar checks
LA TOUR FL checks
AfgaBoBpoKer bets 0.34€
Giucar folds
LA TOUR FL folds
AfgaBoBpoKer collected 0.65€ from pot
*** SUMMARY ***
Total pot 0.65€ | Rake 0.03€
Board: [9s Kh 6d 5h]
Seat 6: AfgaBoBpoKer (button) won 0.65€


Winamax Poker - HOLD-UP "Colorado" - HandId: #19116069-207946-1701339757 - Holdem no limit (0.01€/0.02€) - 2023/11/30 10:22:37 UTC
Table: 'Colorado' 6-max (real money) Seat #6 is the button
Seat 1: Oxmau5 (2.13€)
Seat 2: slowreplay (2.09€)
Seat 3: Fried Berg (2.08€)
Seat 4: FILTONFLOUSE (2€)
Seat 5: wAAlterrr (2.13€)
Seat 6: grut28 (3.71€)
*** ANTE/BLINDS ***
Oxmau5 posts small blind 0.01€
slowreplay posts big blind 0.02€
Dealt to Fried Berg [3s 5c]
*** PRE-FLOP *** 
Fried Berg folds
FILTONFLOUSE folds
wAAlterrr folds
grut28 folds
Oxmau5 folds
slowreplay collected 0.03€ from pot
*** SUMMARY ***
Total pot 0.03€ | No rake
Seat 2: slowreplay (big blind) won 0.03€


Winamax Poker - HOLD-UP "Colorado" - HandId: #19116069-207951-1701339760 - Holdem no limit (0.01€/0.02€) - 2023/11/30 10:22:40 UTC
Table: 'Colorado' 6-max (real money) Seat #6 is the button
Seat 1: grut28 (3.71€)
Seat 2: VashtaNerada (2.33€)
Seat 3: wAAlterrr (2.13€)
Seat 4: Fried Berg (2.08€)
Seat 5: CB-Joker6274 (7.58€)
Seat 6: Oxmau5 (2.12€)
*** ANTE/BLINDS ***
grut28 posts small blind 0.01€
VashtaNerada posts big blind 0.02€
Dealt to Fried Berg [2c 3s]
*** PRE-FLOP *** 
wAAlterrr folds
Fried Berg folds
CB-Joker6274 folds
Oxmau5 folds
grut28 folds
VashtaNerada collected 0.03€ from pot
*** SUMMARY ***
Total pot 0.03€ | No rake
Seat 2: VashtaNerada (big blind) won 0.03€


Winamax Poker - HOLD-UP "Colorado" - HandId: #19116069-207954-1701339763 - Holdem no limit (0.01€/0.02€) - 2023/11/30 10:22:43 UTC
Table: 'Colorado' 6-max (real money) Seat #6 is the button
Seat 1: Hydramist (2.15€)
Seat 2: Pierrof24 (1.91€)
Seat 3: Oxmau5 (2.11€)
Seat 4: CHANGAS (3.44€)
Seat 5: Fried Berg (2.08€)
Seat 6: grut28 (3.70€)
*** ANTE/BLINDS ***
Hydramist posts small blind 0.01€
Pierrof24 posts big blind 0.02€
Dealt to Fried Berg [4d Jh]
*** PRE-FLOP *** 
Oxmau5 folds
CHANGAS folds
Fried Berg folds
grut28 folds
Hydramist folds
Pierrof24 collected 0.03€ from pot
*** SUMMARY ***
Total pot 0.03€ | No rake
Seat 2: Pierrof24 (big blind) won 0.03€


Winamax Poker - HOLD-UP "Colorado" - HandId: #19116069-207966-1701339771 - Holdem no limit (0.01€/0.02€) - 2023/11/30 10:22:51 UTC
Table: 'Colorado' 6-max (real money) Seat #6 is the button
Seat 1: CB-Joker6274 (7.58€)
Seat 2: CHANGAS (3.44€)
Seat 3: Ddm8 (27.41€)
Seat 4: Oxmau5 (2.09€)
Seat 5: FILTONFLOUSE (2€)
Seat 6: Fried Berg (2.08€)
*** ANTE/BLINDS ***
CB-Joker6274 posts small blind 0.01€
CHANGAS posts big blind 0.02€
Dealt to Fried Berg [9s Qc]
*** PRE-FLOP *** 
Ddm8 folds
Oxmau5 folds
FILTONFLOUSE folds
Fried Berg raises 0.02€ to 0.04€
CB-Joker6274 folds
CHANGAS calls 0.02€
*** FLOP *** [7c Ts 4c]
CHANGAS bets 0.05€
Fried Berg folds
CHANGAS collected 0.13€ from pot
*** SUMMARY ***
Total pot 0.13€ | Rake 0.01€
Board: [7c Ts 4c]
Seat 2: CHANGAS (big blind) won 0.13€


Winamax Poker - HOLD-UP "Colorado" - HandId: #19116069-207999-1701339795 - Holdem no limit (0.01€/0.02€) - 2023/11/30 10:23:15 UTC
Table: 'Colorado' 6-max (real money) Seat #6 is the button
Seat 1: Killim (1.24€)
Seat 2: 1trospecti0n (6.13€)
Seat 3: Oxmau5 (2.03€)
Seat 4: Ddm8 (27.41€)
Seat 5: Fried Berg (2.04€)
Seat 6: FILTONFLOUSE (2€)
*** ANTE/BLINDS ***
Killim posts small blind 0.01€
1trospecti0n posts big blind 0.02€
Dealt to Fried Berg [7d 9s]
*** PRE-FLOP *** 
Oxmau5 folds
Ddm8 folds
Fried Berg folds
FILTONFLOUSE raises 0.03€ to 0.05€
Killim folds
1trospecti0n folds
FILTONFLOUSE collected 0.08€ from pot
*** SUMMARY ***
Total pot 0.08€ | No rake
Seat 6: FILTONFLOUSE (button) won 0.08€


Winamax Poker - HOLD-UP "Colorado" - HandId: #19116069-208004-1701339799 - Holdem no limit (0.01€/0.02€) - 2023/11/30 10:23:19 UTC
Table: 'Colorado' 6-max (real money) Seat #6 is the button
Seat 1: Vinclesu2 (0.69€)
Seat 2: Fried Berg (2.04€)
Seat 3: rick26 (2.84€)
Seat 4: grut28 (3.65€)
Seat 5: AMORFOU (2€)
Seat 6: matmyl (2€)
*** ANTE/BLINDS ***
Vinclesu2 posts small blind 0.01€
Fried Berg posts big blind 0.02€
Dealt to Fried Berg [4s Th]
*** PRE-FLOP *** 
rick26 folds
grut28 folds
AMORFOU raises 0.03€ to 0.05€
matmyl folds
Vinclesu2 folds
Fried Berg folds
AMORFOU collected 0.08€ from pot
*** SUMMARY ***
Total pot 0.08€ | No rake
Seat 5: AMORFOU won 0.08€


Winamax Poker - HOLD-UP "Colorado" - HandId: #19116069-208018-1701339808 - Holdem no limit (0.01€/0.02€) - 2023/11/30 10:23:28 UTC
Table: 'Colorado' 6-max (real money) Seat #6 is the button
Seat 1: Idf83 (3.67€)
Seat 2: grut28 (3.65€)
Seat 3: Fried Berg (2.02€)
Seat 4: 1trospecti0n (2.27€)
Seat 5: Killim (1.21€)
Seat 6: Suaterna207 (2.10€)
*** ANTE/BLINDS ***
Idf83 posts small blind 0.01€
grut28 posts big blind 0.02€
Dealt to Fried Berg [7c 5d]
*** PRE-FLOP *** 
Fried Berg folds
1trospecti0n folds
Killim folds
Suaterna207 folds
Idf83 folds
grut28 collected 0.03€ from pot
*** SUMMARY ***
Total pot 0.03€ | No rake
Seat 2: grut28 (big blind) won 0.03€


Winamax Poker - HOLD-UP "Colorado" - HandId: #19116069-208022-1701339810 - Holdem no limit (0.01€/0.02€) - 2023/11/30 10:23:30 UTC
Table: 'Colorado' 6-max (real money) Seat #6 is the button
Seat 1: Oxmau5 (2.03€)
Seat 2: Fried Berg (2.02€)
Seat 3: slowreplay (2.19€)
Seat 4: CHANGAS (1.58€)
Seat 5: ironman33 (0.95€)
Seat 6: Vinclesu2 (0.69€)
*** ANTE/BLINDS ***
Oxmau5 posts small blind 0.01€
Fried Berg posts big blind 0.02€
Dealt to Fried Berg [4d 7s]
*** PRE-FLOP *** 
slowreplay folds
CHANGAS raises 0.04€ to 0.06€
ironman33 folds
Vinclesu2 calls 0.06€
Oxmau5 folds
Fried Berg folds
*** FLOP *** [6s Jd 4h]
CHANGAS checks
Vinclesu2 checks
*** TURN *** [6s Jd 4h][8h]
CHANGAS checks
Vinclesu2 checks
*** RIVER *** [6s Jd 4h 8h][6d]
CHANGAS checks
Vinclesu2 checks
*** SHOW DOWN ***
Vinclesu2 shows [Qs Td] (One pair : 6)
CHANGAS shows [Ad Kc] (One pair : 6)
CHANGAS collected 0.13€ from pot
*** SUMMARY ***
Total pot 0.13€ | Rake 0.02€
Board: [6s Jd 4h 8h 6d]
Seat 4: CHANGAS showed [Ad Kc] and won 0.13€ with One pair : 6
Seat 6: Vinclesu2 (button) showed [Qs Td] and lost with One pair : 6


Winamax Poker - HOLD-UP "Colorado" - HandId: #19116069-208036-1701339820 - Holdem no limit (0.01€/0.02€) - 2023/11/30 10:23:40 UTC
Table: 'Colorado' 6-max (real money) Seat #6 is the button
Seat 1: Fried Berg (2€)
Seat 2: AMORFOU (2€)
Seat 3: TTry-AgAin (2.45€)
Seat 4: matmyl (2€)
Seat 5: Oxmau5 (2.02€)
Seat 6: David Boring (8.62€)
*** ANTE/BLINDS ***
Fried Berg posts small blind 0.01€
AMORFOU posts big blind 0.02€
Dealt to Fried Berg [7c 5s]
*** PRE-FLOP *** 
TTry-AgAin folds
matmyl raises 0.03€ to 0.05€
Oxmau5 folds
David Boring folds
Fried Berg folds
AMORFOU raises 0.11€ to 0.16€
matmyl raises 0.24€ to 0.40€
AMORFOU calls 0.24€
*** FLOP *** [4h Qh Qc]
AMORFOU checks
matmyl checks
*** TURN *** [4h Qh Qc][8c]
AMORFOU checks
matmyl bets 0.53€
AMORFOU calls 0.53€
*** RIVER *** [4h Qh Qc 8c][Qs]
AMORFOU checks
matmyl checks
*** SHOW DOWN ***
matmyl shows [Kd As] (Trips of Queens)
AMORFOU shows [Td Ts] (Full of Queens and Tens)
AMORFOU collected 1.68€ from pot
*** SUMMARY ***
Total pot 1.68€ | Rake 0.19€
Board: [4h Qh Qc 8c Qs]
Seat 2: AMORFOU (big blind) showed [Td Ts] and won 1.68€ with Full of Queens and Tens
Seat 4: matmyl showed [Kd As] and lost with Trips of Queens


Winamax Poker - HOLD-UP "Colorado" - HandId: #19116069-208040-1701339823 - Holdem no limit (0.01€/0.02€) - 2023/11/30 10:23:43 UTC
Table: 'Colorado' 6-max (real money) Seat #6 is the button
Seat 1: grut28 (3.66€)
Seat 2: S-aaron24 (2€)
Seat 3: SUMO LARDON (2€)
Seat 4: Fried Berg (1.99€)
Seat 5: Aggro Loser (3.93€)
Seat 6: rick26 (2.82€)
*** ANTE/BLINDS ***
grut28 posts small blind 0.01€
S-aaron24 posts big blind 0.02€
Dealt to Fried Berg [9h Jh]
*** PRE-FLOP *** 
SUMO LARDON folds
Fried Berg raises 0.02€ to 0.04€
Aggro Loser folds
rick26 folds
grut28 folds
S-aaron24 folds
Fried Berg collected 0.07€ from pot
*** SUMMARY ***
Total pot 0.07€ | No rake
Seat 4: Fried Berg won 0.07€


Winamax Poker - HOLD-UP "Colorado" - HandId: #19116069-208050-1701339833 - Holdem no limit (0.01€/0.02€) - 2023/11/30 10:23:53 UTC
Table: 'Colorado' 6-max (real money) Seat #6 is the button
Seat 1: 1trospecti0n (6.09€)
Seat 2: Suaterna207 (2.24€)
Seat 3: rick26 (2.18€)
Seat 4: CB-Joker6274 (7.66€)
Seat 5: Nash123 (2.45€)
Seat 6: Fried Berg (2.02€)
*** ANTE/BLINDS ***
1trospecti0n posts small blind 0.01€
Suaterna207 posts big blind 0.02€
Dealt to Fried Berg [Qs 6d]
*** PRE-FLOP *** 
rick26 folds
CB-Joker6274 folds
Nash123 folds
Fried Berg folds
1trospecti0n folds
Suaterna207 collected 0.03€ from pot
*** SUMMARY ***
Total pot 0.03€ | No rake
Seat 2: Suaterna207 (big blind) won 0.03€


Winamax Poker - HOLD-UP "Colorado" - HandId: #19116069-208065-1701339842 - Holdem no limit (0.01€/0.02€) - 2023/11/30 10:24:02 UTC
Table: 'Colorado' 6-max (real money) Seat #6 is the button
Seat 1: Nash123 (2.90€)
Seat 2: Aggro Loser (3.89€)
Seat 3: crossRiver (2€)
Seat 4: Fried Berg (2.02€)
Seat 5: Hydramist (2.28€)
Seat 6: TimToBey (2.54€)
*** ANTE/BLINDS ***
Nash123 posts small blind 0.01€
Aggro Loser posts big blind 0.02€
Dealt to Fried Berg [Jd Ah]
*** PRE-FLOP *** 
crossRiver folds
Fried Berg raises 0.03€ to 0.05€
Hydramist folds
TimToBey folds
Nash123 folds
Aggro Loser folds
Fried Berg collected 0.08€ from pot
*** SUMMARY ***
Total pot 0.08€ | No rake
Seat 4: Fried Berg won 0.08€


Winamax Poker - HOLD-UP "Colorado" - HandId: #19116069-208122-1701339878 - Holdem no limit (0.01€/0.02€) - 2023/11/30 10:24:38 UTC
Table: 'Colorado' 6-max (real money) Seat #6 is the button
Seat 1: Fried Berg (2.05€)
Seat 2: SUMO LARDON (2.01€)
Seat 3: Nash123 (2.89€)
Seat 4: Ga31k (3.19€)
Seat 5: 1trospecti0n (3.29€)
Seat 6: Aggro Loser (3.90€)
*** ANTE/BLINDS ***
Fried Berg posts small blind 0.01€
SUMO LARDON posts big blind 0.02€
Dealt to Fried Berg [5s Ah]
*** PRE-FLOP *** 
Nash123 raises 0.03€ to 0.05€
Ga31k folds
1trospecti0n raises 0.16€ to 0.21€
Aggro Loser folds
Fried Berg folds
SUMO LARDON folds
Nash123 folds
1trospecti0n collected 0.29€ from pot
*** SUMMARY ***
Total pot 0.29€ | No rake
Seat 5: 1trospecti0n won 0.29€


Winamax Poker - HOLD-UP "Colorado" - HandId: #19116069-208156-1701339904 - Holdem no limit (0.01€/0.02€) - 2023/11/30 10:25:04 UTC
Table: 'Colorado' 6-max (real money) Seat #6 is the button
Seat 1: TimToBey (4.22€)
Seat 2: David Boring (2.11€)
Seat 3: Fried Berg (2.04€)
Seat 4: Ga31k (2.04€)
Seat 5: edfcain (2€)
Seat 6: Trevize (2.03€)
*** ANTE/BLINDS ***
TimToBey posts small blind 0.01€
David Boring posts big blind 0.02€
Dealt to Fried Berg [Qs Th]
*** PRE-FLOP *** 
Fried Berg folds
Ga31k folds
edfcain raises 0.03€ to 0.05€
Trevize folds
TimToBey folds
David Boring folds
edfcain collected 0.08€ from pot
*** SUMMARY ***
Total pot 0.08€ | No rake
Seat 5: edfcain won 0.08€


Winamax Poker - HOLD-UP "Colorado" - HandId: #19116069-208170-1701339915 - Holdem no limit (0.01€/0.02€) - 2023/11/30 10:25:15 UTC
Table: 'Colorado' 6-max (real money) Seat #6 is the button
Seat 1: DJlB (2.32€)
Seat 2: CHANGAS (2.64€)
Seat 3: Zaerts (4.36€)
Seat 4: grut28 (3.61€)
Seat 5: S-aaron24 (2.21€)
Seat 6: Fried Berg (2.04€)
*** ANTE/BLINDS ***
DJlB posts small blind 0.01€
CHANGAS posts big blind 0.02€
Dealt to Fried Berg [7h 5h]
*** PRE-FLOP *** 
Zaerts folds
grut28 folds
S-aaron24 folds
Fried Berg folds
DJlB raises 0.04€ to 0.06€
CHANGAS folds
DJlB collected 0.08€ from pot
*** SUMMARY ***
Total pot 0.08€ | No rake
Seat 1: DJlB (small blind) won 0.08€


Winamax Poker - HOLD-UP "Colorado" - HandId: #19116069-208184-1701339922 - Holdem no limit (0.01€/0.02€) - 2023/11/30 10:25:22 UTC
Table: 'Colorado' 6-max (real money) Seat #6 is the button
Seat 1: wAAlterrr (2.56€)
Seat 2: Frann3681 (0.50€)
Seat 3: colgate12 (1.66€)
Seat 4: Killim (2.16€)
Seat 5: 1trospecti0n (3.37€)
Seat 6: Fried Berg (2.04€)
*** ANTE/BLINDS ***
wAAlterrr posts small blind 0.01€
Frann3681 posts big blind 0.02€
Dealt to Fried Berg [Th 6h]
*** PRE-FLOP *** 
colgate12 folds
Killim folds
1trospecti0n folds
Fried Berg folds
wAAlterrr raises 0.05€ to 0.07€
Frann3681 folds
wAAlterrr collected 0.09€ from pot
*** SUMMARY ***
Total pot 0.09€ | No rake
Seat 1: wAAlterrr (small blind) won 0.09€


Winamax Poker - HOLD-UP "Colorado" - HandId: #19116069-208204-1701339934 - Holdem no limit (0.01€/0.02€) - 2023/11/30 10:25:34 UTC
Table: 'Colorado' 6-max (real money) Seat #6 is the button
Seat 1: rick26 (1.65€)
Seat 2: Fried Berg (2.04€)
Seat 3: LMG22_23 (2.01€)
Seat 4: lefraisier (5.19€)
Seat 5: DJlB (2.34€)
Seat 6: Perf-31 (3.27€)
*** ANTE/BLINDS ***
rick26 posts small blind 0.01€
Fried Berg posts big blind 0.02€
Dealt to Fried Berg [Js Qc]
*** PRE-FLOP *** 
LMG22_23 raises 0.03€ to 0.05€
lefraisier calls 0.05€
DJlB calls 0.05€
Perf-31 calls 0.05€
rick26 folds
Fried Berg calls 0.03€
*** FLOP *** [8h 2s 8d]
Fried Berg checks
LMG22_23 bets 0.17€
lefraisier calls 0.17€
DJlB calls 0.17€
Perf-31 folds
Fried Berg folds
*** TURN *** [8h 2s 8d][6d]
LMG22_23 checks
lefraisier checks
DJlB bets 0.39€
LMG22_23 raises 1.40€ to 1.79€ and is all-in
lefraisier folds
DJlB raises 0.33€ to 2.12€ and is all-in
*** RIVER *** [8h 2s 8d 6d][7s]
*** SHOW DOWN ***
LMG22_23 shows [Ah As] (Two pairs : Aces and 8)
DJlB shows [4c 4s] (Two pairs : 8 and 4)
DJlB collected 0.33€ from side pot 1
LMG22_23 collected 3.91€ from main pot
*** SUMMARY ***
Total pot 4.24€ | Rake 0.44€
Board: [8h 2s 8d 6d 7s]
Seat 3: LMG22_23 showed [Ah As] and won 3.91€ with Two pairs : Aces and 8
Seat 5: DJlB showed [4c 4s] and won 0.33€ with Two pairs : 8 and 4


Winamax Poker - HOLD-UP "Colorado" - HandId: #19116069-208291-1701339991 - Holdem no limit (0.01€/0.02€) - 2023/11/30 10:26:31 UTC
Table: 'Colorado' 6-max (real money) Seat #6 is the button
Seat 1: slowreplay (2€)
Seat 2: crossRiver (2.68€)
Seat 3: Suaterna207 (2.88€)
Seat 4: Fried Berg (1.99€)
Seat 5: lefraisier (4.97€)
Seat 6: Alyaah30 (0.66€)
*** ANTE/BLINDS ***
slowreplay posts small blind 0.01€
crossRiver posts big blind 0.02€
Dealt to Fried Berg [6d 5s]
*** PRE-FLOP *** 
Suaterna207 folds
Fried Berg folds
lefraisier folds
Alyaah30 calls 0.02€
slowreplay calls 0.01€
crossRiver checks
*** FLOP *** [Tc Qh Qd]
slowreplay checks
crossRiver checks
Alyaah30 bets 0.04€
slowreplay calls 0.04€
crossRiver folds
*** TURN *** [Tc Qh Qd][Kh]
slowreplay checks
Alyaah30 bets 0.14€
slowreplay calls 0.14€
*** RIVER *** [Tc Qh Qd Kh][8s]
slowreplay bets 0.12€
Alyaah30 raises 0.15€ to 0.27€
slowreplay calls 0.15€
*** SHOW DOWN ***
Alyaah30 shows [9c Qs] (Trips of Queens)
slowreplay shows [9s Jh] (Straight King high)
slowreplay collected 0.86€ from pot
*** SUMMARY ***
Total pot 0.86€ | Rake 0.10€
Board: [Tc Qh Qd Kh 8s]
Seat 1: slowreplay (small blind) showed [9s Jh] and won 0.86€ with Straight King high
Seat 6: Alyaah30 (button) showed [9c Qs] and lost with Trips of Queens


Winamax Poker - HOLD-UP "Colorado" - HandId: #19116069-208300-1701339995 - Holdem no limit (0.01€/0.02€) - 2023/11/30 10:26:35 UTC
Table: 'Colorado' 6-max (real money) Seat #6 is the button
Seat 1: Perf-31 (3.16€)
Seat 2: Ga31k (2€)
Seat 3: Fried Berg (1.99€)
Seat 4: PC_Mister (2.02€)
Seat 5: Suaterna207 (2.88€)
Seat 6: edfcain (2.11€)
*** ANTE/BLINDS ***
Perf-31 posts small blind 0.01€
Ga31k posts big blind 0.02€
Dealt to Fried Berg [Jc 4h]
*** PRE-FLOP *** 
Fried Berg folds
PC_Mister folds
Suaterna207 folds
edfcain raises 0.03€ to 0.05€
Perf-31 folds
Ga31k calls 0.03€
*** FLOP *** [2h Kd 5c]
Ga31k checks
edfcain bets 0.04€
Ga31k folds
edfcain collected 0.14€ from pot
*** SUMMARY ***
Total pot 0.14€ | Rake 0.01€
Board: [2h Kd 5c]
Seat 6: edfcain (button) won 0.14€


Winamax Poker - HOLD-UP "Colorado" - HandId: #19116069-208314-1701340006 - Holdem no limit (0.01€/0.02€) - 2023/11/30 10:26:46 UTC
Table: 'Colorado' 6-max (real money) Seat #6 is the button
Seat 1: l artiste ho (1.91€)
Seat 2: David Boring (9.59€)
Seat 3: ironman33 (0.64€)
Seat 4: rick26 (2.77€)
Seat 5: LMG22_23 (2.01€)
Seat 6: Fried Berg (1.99€)
*** ANTE/BLINDS ***
l artiste ho posts small blind 0.01€
David Boring posts big blind 0.02€
Dealt to Fried Berg [Qh 8c]
*** PRE-FLOP *** 
ironman33 folds
rick26 folds
LMG22_23 folds
Fried Berg raises 0.02€ to 0.04€
l artiste ho calls 0.03€
David Boring calls 0.02€
*** FLOP *** [Js Qc 4c]
l artiste ho checks
David Boring checks
Fried Berg bets 0.04€
l artiste ho folds
David Boring calls 0.04€
*** TURN *** [Js Qc 4c][3s]
David Boring checks
Fried Berg bets 0.05€
David Boring calls 0.05€
*** RIVER *** [Js Qc 4c 3s][7c]
David Boring bets 0.24€
Fried Berg calls 0.24€
*** SHOW DOWN ***
David Boring shows [Ts Ad] (High card : Ace)
Fried Berg shows [Qh 8c] (One pair : Queens)
Fried Berg collected 0.70€ from pot
*** SUMMARY ***
Total pot 0.70€ | Rake 0.08€
Board: [Js Qc 4c 3s 7c]
Seat 2: David Boring (big blind) showed [Ts Ad] and lost with High card : Ace
Seat 6: Fried Berg (button) showed [Qh 8c] and won 0.70€ with One pair : Queens


Winamax Poker - HOLD-UP "Colorado" - HandId: #19116069-208400-1701340069 - Holdem no limit (0.01€/0.02€) - 2023/11/30 10:27:49 UTC
Table: 'Colorado' 6-max (real money) Seat #6 is the button
Seat 1: Nash123 (2.80€)
Seat 2: Ga31k (3.37€)
Seat 3: David Boring (9.22€)
Seat 4: nico033 (2.05€)
Seat 5: Fried Berg (2.32€)
Seat 6: rick26 (2.74€)
*** ANTE/BLINDS ***
Nash123 posts small blind 0.01€
Ga31k posts big blind 0.02€
Dealt to Fried Berg [6s 7h]
*** PRE-FLOP *** 
David Boring folds
nico033 raises 0.03€ to 0.05€
Fried Berg folds
rick26 folds
Nash123 folds
Ga31k calls 0.03€
*** FLOP *** [4c 8d 4d]
Ga31k checks
nico033 checks
*** TURN *** [4c 8d 4d][6d]
Ga31k checks
nico033 bets 0.04€
Ga31k folds
nico033 collected 0.14€ from pot
*** SUMMARY ***
Total pot 0.14€ | Rake 0.01€
Board: [4c 8d 4d 6d]
Seat 4: nico033 won 0.14€


Winamax Poker - HOLD-UP "Colorado" - HandId: #19116069-208427-1701340092 - Holdem no limit (0.01€/0.02€) - 2023/11/30 10:28:12 UTC
Table: 'Colorado' 6-max (real money) Seat #6 is the button
Seat 1: Fried Berg (2.32€)
Seat 2: VH_GOAT40 (2.07€)
Seat 3: S-aaron24 (2.98€)
Seat 4: Vinclesu2 (0.66€)
Seat 5: TimToBey (2.62€)
Seat 6: kameleon73 (2.52€)
*** ANTE/BLINDS ***
Fried Berg posts small blind 0.01€
VH_GOAT40 posts big blind 0.02€
Dealt to Fried Berg [Qd 4h]
*** PRE-FLOP *** 
S-aaron24 folds
Vinclesu2 folds
TimToBey folds
kameleon73 folds
Fried Berg folds
VH_GOAT40 collected 0.03€ from pot
*** SUMMARY ***
Total pot 0.03€ | No rake
Seat 2: VH_GOAT40 (big blind) won 0.03€


Winamax Poker - HOLD-UP "Colorado" - HandId: #19116069-208444-1701340102 - Holdem no limit (0.01€/0.02€) - 2023/11/30 10:28:22 UTC
Table: 'Colorado' 6-max (real money) Seat #6 is the button
Seat 1: LA TOUR FL (7.44€)
Seat 2: Fried Berg (2.31€)
Seat 3: l artiste ho (2.95€)
Seat 4: AMORFOU (2.39€)
Seat 5: KKamarAAde (2.49€)
Seat 6: Aggro Loser (2€)
*** ANTE/BLINDS ***
LA TOUR FL posts small blind 0.01€
Fried Berg posts big blind 0.02€
Dealt to Fried Berg [8s As]
*** PRE-FLOP *** 
l artiste ho calls 0.02€
AMORFOU folds
KKamarAAde folds
Aggro Loser folds
LA TOUR FL calls 0.01€
Fried Berg checks
*** FLOP *** [Jh Qd Ad]
LA TOUR FL checks
Fried Berg bets 0.04€
l artiste ho calls 0.04€
LA TOUR FL calls 0.04€
*** TURN *** [Jh Qd Ad][2s]
LA TOUR FL checks
Fried Berg bets 0.06€
l artiste ho folds
LA TOUR FL calls 0.06€
*** RIVER *** [Jh Qd Ad 2s][6c]
LA TOUR FL checks
Fried Berg bets 0.15€
LA TOUR FL folds
Fried Berg collected 0.42€ from pot
*** SUMMARY ***
Total pot 0.42€ | Rake 0.03€
Board: [Jh Qd Ad 2s 6c]
Seat 2: Fried Berg (big blind) won 0.42€


Winamax Poker - HOLD-UP "Colorado" - HandId: #19116069-208564-1701340177 - Holdem no limit (0.01€/0.02€) - 2023/11/30 10:29:37 UTC
Table: 'Colorado' 6-max (real money) Seat #6 is the button
Seat 1: Trevize (1.99€)
Seat 2: Aggro Loser (4.82€)
Seat 3: curiouz dje (4.80€)
Seat 4: Fried Berg (2.46€)
Seat 5: ironman33 (0.65€)
Seat 6: VashtaNerada (4.29€)
*** ANTE/BLINDS ***
Trevize posts small blind 0.01€
Aggro Loser posts big blind 0.02€
Dealt to Fried Berg [As Jc]
*** PRE-FLOP *** 
curiouz dje folds
Fried Berg raises 0.02€ to 0.04€
ironman33 calls 0.04€
VashtaNerada folds
Trevize folds
Aggro Loser folds
*** FLOP *** [7h Ts Qc]
Fried Berg bets 0.02€
ironman33 calls 0.02€
*** TURN *** [7h Ts Qc][Tc]
Fried Berg checks
ironman33 checks
*** RIVER *** [7h Ts Qc Tc][8c]
Fried Berg checks
ironman33 checks
*** SHOW DOWN ***
ironman33 shows [9s Ks] (One pair : Tens)
Fried Berg shows [As Jc] (One pair : Tens)
Fried Berg collected 0.13€ from pot
*** SUMMARY ***
Total pot 0.13€ | Rake 0.02€
Board: [7h Ts Qc Tc 8c]
Seat 4: Fried Berg showed [As Jc] and won 0.13€ with One pair : Tens
Seat 5: ironman33 showed [9s Ks] and lost with One pair : Tens


Winamax Poker - HOLD-UP "Colorado" - HandId: #19116069-208640-1701340225 - Holdem no limit (0.01€/0.02€) - 2023/11/30 10:30:25 UTC
Table: 'Colorado' 6-max (real money) Seat #6 is the button
Seat 1: S-aaron24 (5.14€)
Seat 2: ironman33 (0.59€)
Seat 3: curiouz dje (5.12€)
Seat 4: Aggro Loser (2€)
Seat 5: Fried Berg (2.53€)
Seat 6: haouuum28 (5.67€)
Hold-up to Pot: total 0.10€
*** ANTE/BLINDS ***
S-aaron24 posts small blind 0.01€
ironman33 posts big blind 0.02€
Dealt to Fried Berg [Ts Th]
*** PRE-FLOP *** 
curiouz dje folds
Aggro Loser folds
Fried Berg raises 0.02€ to 0.04€
haouuum28 calls 0.04€
S-aaron24 folds
ironman33 calls 0.02€
*** FLOP *** [Ah 8h 3d]
ironman33 checks
Fried Berg bets 0.08€
haouuum28 folds
ironman33 folds
Fried Berg collected 0.30€ from pot
*** SUMMARY ***
Total pot 0.30€ | Rake 0.01€
Board: [Ah 8h 3d]
Seat 5: Fried Berg won 0.30€


Winamax Poker - HOLD-UP "Colorado" - HandId: #19116069-208683-1701340254 - Holdem no limit (0.01€/0.02€) - 2023/11/30 10:30:54 UTC
Table: 'Colorado' 6-max (real money) Seat #6 is the button
Seat 1: Nash123 (2€)
Seat 2: Perf-31 (3.39€)
Seat 3: rick26 (2.68€)
Seat 4: slowreplay (2.21€)
Seat 5: curiouz dje (4.84€)
Seat 6: Fried Berg (2.71€)
*** ANTE/BLINDS ***
Nash123 posts small blind 0.01€
Perf-31 posts big blind 0.02€
Dealt to Fried Berg [8d Kh]
*** PRE-FLOP *** 
rick26 folds
slowreplay folds
curiouz dje folds
Fried Berg raises 0.02€ to 0.04€
Nash123 folds
Perf-31 folds
Fried Berg collected 0.07€ from pot
*** SUMMARY ***
Total pot 0.07€ | No rake
Seat 6: Fried Berg (button) won 0.07€


Winamax Poker - HOLD-UP "Colorado" - HandId: #19116069-208749-1701340295 - Holdem no limit (0.01€/0.02€) - 2023/11/30 10:31:35 UTC
Table: 'Colorado' 6-max (real money) Seat #6 is the button
Seat 1: curiouz dje (4.15€)
Seat 2: Fried Berg (2.74€)
Seat 3: lefraisier (4.42€)
Seat 4: Killim (1.28€)
Seat 5: gitPush (2.95€)
Seat 6: Suaterna207 (2.03€)
*** ANTE/BLINDS ***
curiouz dje posts small blind 0.01€
Fried Berg posts big blind 0.02€
Dealt to Fried Berg [9c 6d]
*** PRE-FLOP *** 
lefraisier folds
Killim folds
gitPush folds
Suaterna207 raises 0.04€ to 0.06€
curiouz dje folds
Fried Berg folds
Suaterna207 collected 0.09€ from pot
*** SUMMARY ***
Total pot 0.09€ | No rake
Seat 6: Suaterna207 (button) won 0.09€


Winamax Poker - HOLD-UP "Colorado" - HandId: #19116069-208772-1701340309 - Holdem no limit (0.01€/0.02€) - 2023/11/30 10:31:49 UTC
Table: 'Colorado' 6-max (real money) Seat #6 is the button
Seat 1: gitPush (2.95€)
Seat 2: MaXKataleya (1.99€)
Seat 3: Fried Berg (2.72€)
Seat 4: wAAlterrr (2.67€)
Seat 5: Oxmau5 (2.21€)
Seat 6: Adame199623 (2€)
*** ANTE/BLINDS ***
gitPush posts small blind 0.01€
MaXKataleya posts big blind 0.02€
Dealt to Fried Berg [3h Jd]
*** PRE-FLOP *** 
Fried Berg folds
wAAlterrr folds
Oxmau5 raises 0.52€ to 0.54€
Adame199623 folds
gitPush folds
MaXKataleya calls 0.52€
*** FLOP *** [2d 4d 5d]
MaXKataleya checks
Oxmau5 bets 1.67€ and is all-in
MaXKataleya calls 1.45€ and is all-in
*** TURN *** [2d 4d 5d][Qs]
*** RIVER *** [2d 4d 5d Qs][Kc]
*** SHOW DOWN ***
MaXKataleya shows [Ad Kd] (Flush Ace high)
Oxmau5 shows [As Ah] (One pair : Aces)
Oxmau5 collected 0.22€ from side pot 1
MaXKataleya collected 3.59€ from main pot
*** SUMMARY ***
Total pot 3.81€ | Rake 0.40€
Board: [2d 4d 5d Qs Kc]
Seat 2: MaXKataleya (big blind) showed [Ad Kd] and won 3.59€ with Flush Ace high
Seat 5: Oxmau5 showed [As Ah] and won 0.22€ with One pair : Aces


Winamax Poker - HOLD-UP "Colorado" - HandId: #19116069-208775-1701340311 - Holdem no limit (0.01€/0.02€) - 2023/11/30 10:31:51 UTC
Table: 'Colorado' 6-max (real money) Seat #6 is the button
Seat 1: Fried Berg (2.72€)
Seat 2: ricki64 (1€)
Seat 3: David Boring (2€)
Seat 4: Treyar (2.15€)
Seat 5: kameleon73 (2.39€)
Seat 6: Aggro Loser (2.08€)
*** ANTE/BLINDS ***
Fried Berg posts small blind 0.01€
ricki64 posts big blind 0.02€
Dealt to Fried Berg [3c 8d]
*** PRE-FLOP *** 
David Boring folds
Treyar folds
kameleon73 raises 0.02€ to 0.04€
Aggro Loser folds
Fried Berg folds
ricki64 raises 0.96€ to 1€ and is all-in
kameleon73 folds
ricki64 collected 1.05€ from pot
*** SUMMARY ***
Total pot 1.05€ | No rake
Seat 2: ricki64 (big blind) won 1.05€


Winamax Poker - HOLD-UP "Colorado" - HandId: #19116069-208779-1701340313 - Holdem no limit (0.01€/0.02€) - 2023/11/30 10:31:53 UTC
Table: 'Colorado' 6-max (real money) Seat #6 is the button
Seat 1: Trevize (2.05€)
Seat 2: SUMO LARDON (3.07€)
Seat 3: JAWIKE1 (1.05€)
Seat 4: LMG22_23 (3.97€)
Seat 5: Fried Berg (2.71€)
Seat 6: Giucar (1.33€)
*** ANTE/BLINDS ***
Trevize posts small blind 0.01€
SUMO LARDON posts big blind 0.02€
Dealt to Fried Berg [Kd Tc]
*** PRE-FLOP *** 
JAWIKE1 folds
LMG22_23 folds
Fried Berg raises 0.02€ to 0.04€
Giucar calls 0.04€
Trevize calls 0.03€
SUMO LARDON folds
*** FLOP *** [Qs 6c 8c]
Trevize checks
Fried Berg checks
Giucar checks
*** TURN *** [Qs 6c 8c][Js]
Trevize bets 0.05€
Fried Berg calls 0.05€
Giucar calls 0.05€
*** RIVER *** [Qs 6c 8c Js][2h]
Trevize checks
Fried Berg checks
Giucar checks
*** SHOW DOWN ***
Trevize shows [2s As] (One pair : 2)
Fried Berg shows [Kd Tc] (High card : King)
Giucar shows [5d 5h] (One pair : 5)
Giucar collected 0.26€ from pot
*** SUMMARY ***
Total pot 0.26€ | Rake 0.03€
Board: [Qs 6c 8c Js 2h]
Seat 1: Trevize (small blind) showed [2s As] and lost with One pair : 2
Seat 5: Fried Berg showed [Kd Tc] and lost with High card : King
Seat 6: Giucar (button) showed [5d 5h] and won 0.26€ with One pair : 5


Winamax Poker - HOLD-UP "Colorado" - HandId: #19116069-208865-1701340369 - Holdem no limit (0.01€/0.02€) - 2023/11/30 10:32:49 UTC
Table: 'Colorado' 6-max (real money) Seat #6 is the button
Seat 1: Giucar (1.50€)
Seat 2: Trevize (1.96€)
Seat 3: ironman33 (0.53€)
Seat 4: Nash123 (3.68€)
Seat 5: Oxmau5 (2.06€)
Seat 6: Fried Berg (2.62€)
*** ANTE/BLINDS ***
Giucar posts small blind 0.01€
Trevize posts big blind 0.02€
Dealt to Fried Berg [3s 4h]
*** PRE-FLOP *** 
ironman33 folds
Nash123 folds
Oxmau5 folds
Fried Berg folds
Giucar calls 0.01€
Trevize checks
*** FLOP *** [5c Ts 6d]
Giucar checks
Trevize checks
*** TURN *** [5c Ts 6d][5s]
Giucar checks
Trevize bets 0.04€
Giucar folds
Trevize collected 0.08€ from pot
*** SUMMARY ***
Total pot 0.08€ | No rake
Board: [5c Ts 6d 5s]
Seat 2: Trevize (big blind) won 0.08€


Winamax Poker - HOLD-UP "Colorado" - HandId: #19116069-208884-1701340379 - Holdem no limit (0.01€/0.02€) - 2023/11/30 10:32:59 UTC
Table: 'Colorado' 6-max (real money) Seat #6 is the button
Seat 1: _Croute_ (4.64€)
Seat 2: Ga31k (3.16€)
Seat 3: KKamarAAde (2.48€)
Seat 4: Fried Berg (2.62€)
Seat 5: ganjabob (1.16€)
Seat 6: slowreplay (2.12€)
*** ANTE/BLINDS ***
_Croute_ posts small blind 0.01€
Ga31k posts big blind 0.02€
Dealt to Fried Berg [2h 5d]
*** PRE-FLOP *** 
KKamarAAde folds
Fried Berg folds
ganjabob raises 1.14€ to 1.16€ and is all-in
slowreplay folds
_Croute_ folds
Ga31k folds
ganjabob collected 1.19€ from pot
*** SUMMARY ***
Total pot 1.19€ | No rake
Seat 5: ganjabob won 1.19€


Winamax Poker - HOLD-UP "Colorado" - HandId: #19116069-208889-1701340381 - Holdem no limit (0.01€/0.02€) - 2023/11/30 10:33:01 UTC
Table: 'Colorado' 6-max (real money) Seat #6 is the button
Seat 1: CSWolf857287 (0.44€)
Seat 2: Fried Berg (2.62€)
Seat 3: Cedlebon (2.47€)
Seat 4: ironman33 (0.52€)
Seat 5: curiouz dje (5.01€)
Seat 6: Clemence75 (2.19€)
*** ANTE/BLINDS ***
CSWolf857287 posts small blind 0.01€
Fried Berg posts big blind 0.02€
Dealt to Fried Berg [7c 3d]
*** PRE-FLOP *** 
Cedlebon folds
ironman33 folds
curiouz dje folds
Clemence75 folds
CSWolf857287 calls 0.01€
Fried Berg checks
*** FLOP *** [6c 4d 8s]
CSWolf857287 checks
Fried Berg bets 0.02€
CSWolf857287 calls 0.02€
*** TURN *** [6c 4d 8s][6s]
CSWolf857287 checks
Fried Berg bets 0.04€
CSWolf857287 calls 0.04€
*** RIVER *** [6c 4d 8s 6s][Kc]
CSWolf857287 bets 0.36€ and is all-in
Fried Berg folds
CSWolf857287 collected 0.50€ from pot
*** SUMMARY ***
Total pot 0.50€ | Rake 0.02€
Board: [6c 4d 8s 6s Kc]
Seat 1: CSWolf857287 (small blind) won 0.50€


Winamax Poker - HOLD-UP "Colorado" - HandId: #19116069-209099-1701340503 - Holdem no limit (0.01€/0.02€) - 2023/11/30 10:35:03 UTC
Table: 'Colorado' 6-max (real money) Seat #6 is the button
Seat 1: Fried Berg (2.54€)
Seat 2: Champhype (2.02€)
Seat 3: slowreplay (2.53€)
Seat 4: Adame199623 (2€)
Seat 5: VH_GOAT40 (3.06€)
Seat 6: curiouz dje (4.87€)
*** ANTE/BLINDS ***
Fried Berg posts small blind 0.01€
Champhype posts big blind 0.02€
Dealt to Fried Berg [As 7c]
*** PRE-FLOP *** 
slowreplay folds
Adame199623 raises 0.06€ to 0.08€
VH_GOAT40 calls 0.08€
curiouz dje folds
Fried Berg calls 0.07€
Champhype folds
*** FLOP *** [3d Jd 2c]
Fried Berg checks
Adame199623 bets 0.09€
VH_GOAT40 folds
Fried Berg folds
Adame199623 collected 0.32€ from pot
*** SUMMARY ***
Total pot 0.32€ | Rake 0.03€
Board: [3d Jd 2c]
Seat 4: Adame199623 won 0.32€


Winamax Poker - HOLD-UP "Colorado" - HandId: #19116069-209148-1701340534 - Holdem no limit (0.01€/0.02€) - 2023/11/30 10:35:34 UTC
Table: 'Colorado' 6-max (real money) Seat #6 is the button
Seat 1: Hydramist (3.43€)
Seat 2: MaXKataleya (2.46€)
Seat 3: MFA_Mathis (3.39€)
Seat 4: Clemence75 (2.04€)
Seat 5: Fried Berg (2.46€)
Seat 6: tequilaaaa (2.12€)
*** ANTE/BLINDS ***
Hydramist posts small blind 0.01€
MaXKataleya posts big blind 0.02€
Dealt to Fried Berg [Tc Js]
*** PRE-FLOP *** 
MFA_Mathis folds
Clemence75 folds
Fried Berg raises 0.02€ to 0.04€
tequilaaaa folds
Hydramist folds
MaXKataleya raises 0.09€ to 0.13€
Fried Berg calls 0.09€
*** FLOP *** [Qs Jd Th]
MaXKataleya bets 0.18€
Fried Berg calls 0.18€
*** TURN *** [Qs Jd Th][3s]
MaXKataleya bets 0.22€
Fried Berg calls 0.22€
*** RIVER *** [Qs Jd Th 3s][8c]
MaXKataleya bets 0.37€
Fried Berg calls 0.37€
*** SHOW DOWN ***
Fried Berg shows [Tc Js] (Two pairs : Jacks and Tens)
MaXKataleya shows [8h 8s] (Trips of 8)
MaXKataleya collected 1.63€ from pot
*** SUMMARY ***
Total pot 1.63€ | Rake 0.18€
Board: [Qs Jd Th 3s 8c]
Seat 2: MaXKataleya (big blind) showed [8h 8s] and won 1.63€ with Trips of 8
Seat 5: Fried Berg showed [Tc Js] and lost with Two pairs : Jacks and Tens


Winamax Poker - HOLD-UP "Colorado" - HandId: #19116069-209245-1701340595 - Holdem no limit (0.01€/0.02€) - 2023/11/30 10:36:35 UTC
Table: 'Colorado' 6-max (real money) Seat #6 is the button
Seat 1: Chamois 2638 (2.62€)
Seat 2: GF Warrior82 (1.82€)
Seat 3: Fried Berg (1.56€)
Seat 4: _Croute_ (4.67€)
Seat 5: slowreplay (2.46€)
Seat 6: Clemence75 (2€)
*** ANTE/BLINDS ***
Chamois 2638 posts small blind 0.01€
GF Warrior82 posts big blind 0.02€
Dealt to Fried Berg [Ah 2s]
*** PRE-FLOP *** 
Fried Berg calls 0.02€
_Croute_ folds
slowreplay folds
Clemence75 folds
Chamois 2638 calls 0.01€
GF Warrior82 checks
*** FLOP *** [Jh Jd 5s]
Chamois 2638 checks
GF Warrior82 checks
Fried Berg checks
*** TURN *** [Jh Jd 5s][Td]
Chamois 2638 checks
GF Warrior82 bets 0.04€
Fried Berg calls 0.04€
Chamois 2638 folds
*** RIVER *** [Jh Jd 5s Td][Kh]
GF Warrior82 checks
Fried Berg checks
*** SHOW DOWN ***
GF Warrior82 shows [Qs 7h] (One pair : Jacks)
Fried Berg shows [Ah 2s] (One pair : Jacks)
Fried Berg collected 0.13€ from pot
*** SUMMARY ***
Total pot 0.13€ | Rake 0.01€
Board: [Jh Jd 5s Td Kh]
Seat 2: GF Warrior82 (big blind) showed [Qs 7h] and lost with One pair : Jacks
Seat 3: Fried Berg showed [Ah 2s] and won 0.13€ with One pair : Jacks


Winamax Poker - HOLD-UP "Colorado" - HandId: #19116069-209300-1701340638 - Holdem no limit (0.01€/0.02€) - 2023/11/30 10:37:18 UTC
Table: 'Colorado' 6-max (real money) Seat #6 is the button
Seat 1: curiouz dje (3.75€)
Seat 2: Siradella80 (2€)
Seat 3: Samapiker (1€)
Seat 4: Fried Berg (1.63€)
Seat 5: GF Warrior82 (1.76€)
Seat 6: Imramra95 (2€)
*** ANTE/BLINDS ***
curiouz dje posts small blind 0.01€
Siradella80 posts big blind 0.02€
Dealt to Fried Berg [Qs As]
*** PRE-FLOP *** 
Samapiker folds
Fried Berg raises 0.02€ to 0.04€
GF Warrior82 folds
Imramra95 folds
curiouz dje folds
Siradella80 calls 0.02€
*** FLOP *** [2d Kh 5d]
Siradella80 checks
Fried Berg bets 0.03€
Siradella80 calls 0.03€
*** TURN *** [2d Kh 5d][8d]
Siradella80 checks
Fried Berg checks
*** RIVER *** [2d Kh 5d 8d][8s]
Siradella80 bets 0.10€
Fried Berg calls 0.10€
*** SHOW DOWN ***
Fried Berg shows [Qs As] (One pair : 8)
Siradella80 shows [3d Jd] (Flush Jack high)
Siradella80 collected 0.31€ from pot
*** SUMMARY ***
Total pot 0.31€ | Rake 0.04€
Board: [2d Kh 5d 8d 8s]
Seat 2: Siradella80 (big blind) showed [3d Jd] and won 0.31€ with Flush Jack high
Seat 4: Fried Berg showed [Qs As] and lost with One pair : 8


Winamax Poker - HOLD-UP "Colorado" - HandId: #19116069-209357-1701340681 - Holdem no limit (0.01€/0.02€) - 2023/11/30 10:38:01 UTC
Table: 'Colorado' 6-max (real money) Seat #6 is the button
Seat 1: Siradella80 (2.14€)
Seat 2: Fried Berg (1.46€)
Seat 3: nonoleboucan (2€)
Seat 4: babe35 (2.13€)
Seat 5: JAWIKE1 (1.78€)
Seat 6: grut28 (5.87€)
*** ANTE/BLINDS ***
Siradella80 posts small blind 0.01€
Fried Berg posts big blind 0.02€
Dealt to Fried Berg [Th 8c]
*** PRE-FLOP *** 
nonoleboucan folds
babe35 folds
JAWIKE1 raises 0.03€ to 0.05€
grut28 folds
Siradella80 folds
Fried Berg folds
JAWIKE1 collected 0.08€ from pot
*** SUMMARY ***
Total pot 0.08€ | No rake
Seat 5: JAWIKE1 won 0.08€


Winamax Poker - HOLD-UP "Colorado" - HandId: #19116069-209377-1701340694 - Holdem no limit (0.01€/0.02€) - 2023/11/30 10:38:14 UTC
Table: 'Colorado' 6-max (real money) Seat #6 is the button
Seat 1: Nash123 (3.30€)
Seat 2: slowreplay (2.42€)
Seat 3: Hydramist (3.40€)
Seat 4: Clemence75 (3.33€)
Seat 5: VH_GOAT40 (2.80€)
Seat 6: Fried Berg (1.44€)
*** ANTE/BLINDS ***
Nash123 posts small blind 0.01€
slowreplay posts big blind 0.02€
Dealt to Fried Berg [2c 2d]
*** PRE-FLOP *** 
Hydramist folds
Clemence75 folds
VH_GOAT40 folds
Fried Berg raises 0.02€ to 0.04€
Nash123 folds
slowreplay calls 0.02€
*** FLOP *** [7d 4s Th]
slowreplay checks
Fried Berg bets 0.02€
slowreplay calls 0.02€
*** TURN *** [7d 4s Th][8d]
slowreplay checks
Fried Berg bets 0.05€
slowreplay calls 0.05€
*** RIVER *** [7d 4s Th 8d][9h]
slowreplay bets 0.15€
Fried Berg calls 0.15€
*** SHOW DOWN ***
Fried Berg shows [2c 2d] (One pair : 2)
slowreplay shows [7h Ac] (One pair : 7)
slowreplay collected 0.48€ from pot
*** SUMMARY ***
Total pot 0.48€ | Rake 0.05€
Board: [7d 4s Th 8d 9h]
Seat 2: slowreplay (big blind) showed [7h Ac] and won 0.48€ with One pair : 7
Seat 6: Fried Berg (button) showed [2c 2d] and lost with One pair : 2


Winamax Poker - HOLD-UP "Colorado" - HandId: #19116069-209482-1701340772 - Holdem no limit (0.01€/0.02€) - 2023/11/30 10:39:32 UTC
Table: 'Colorado' 6-max (real money) Seat #6 is the button
Seat 1: Fried Berg (1.18€)
Seat 2: curiouz dje (5.23€)
Seat 3: Ga31k (2€)
Seat 4: TTry-AgAin (5.49€)
Seat 5: CHANGAS (2.71€)
Seat 6: slowreplay (2.64€)
*** ANTE/BLINDS ***
Fried Berg posts small blind 0.01€
curiouz dje posts big blind 0.02€
Dealt to Fried Berg [6d Tc]
*** PRE-FLOP *** 
Ga31k folds
TTry-AgAin folds
CHANGAS folds
slowreplay folds
Fried Berg folds
curiouz dje collected 0.03€ from pot
*** SUMMARY ***
Total pot 0.03€ | No rake
Seat 2: curiouz dje (big blind) won 0.03€


Winamax Poker - HOLD-UP "Colorado" - HandId: #19116069-209506-1701340785 - Holdem no limit (0.01€/0.02€) - 2023/11/30 10:39:45 UTC
Table: 'Colorado' 6-max (real money) Seat #6 is the button
Seat 1: MFA_Mathis (3.67€)
Seat 2: Dim city (1.36€)
Seat 3: Fried Berg (1.17€)
Seat 4: AMORFOU (2.28€)
Seat 5: VH_GOAT40 (2.65€)
Seat 6: GTO-Mieko (2€)
*** ANTE/BLINDS ***
MFA_Mathis posts small blind 0.01€
Dim city posts big blind 0.02€
Dealt to Fried Berg [4c 2d]
*** PRE-FLOP *** 
Fried Berg folds
AMORFOU folds
VH_GOAT40 folds
GTO-Mieko folds
MFA_Mathis calls 0.01€
Dim city checks
*** FLOP *** [9d 3s Ad]
MFA_Mathis checks
Dim city checks
*** TURN *** [9d 3s Ad][8c]
MFA_Mathis checks
Dim city checks
*** RIVER *** [9d 3s Ad 8c][As]
MFA_Mathis bets 0.03€
Dim city folds
MFA_Mathis collected 0.07€ from pot
*** SUMMARY ***
Total pot 0.07€ | No rake
Board: [9d 3s Ad 8c As]
Seat 1: MFA_Mathis (small blind) won 0.07€


Winamax Poker - HOLD-UP "Colorado" - HandId: #19116069-209508-1701340786 - Holdem no limit (0.01€/0.02€) - 2023/11/30 10:39:46 UTC
Table: 'Colorado' 6-max (real money) Seat #6 is the button
Seat 1: Suaterna207 (2.23€)
Seat 2: PC_Mister (2.05€)
Seat 3: tequilaaaa (2€)
Seat 4: Ga31k (2€)
Seat 5: Fried Berg (1.17€)
Seat 6: GTO-Mieko (2€)
Hold-up to Pot: total 0.10€
*** ANTE/BLINDS ***
Suaterna207 posts small blind 0.01€
PC_Mister posts big blind 0.02€
Dealt to Fried Berg [3s 7h]
*** PRE-FLOP *** 
tequilaaaa folds
Ga31k raises 0.06€ to 0.08€
Fried Berg folds
GTO-Mieko folds
Suaterna207 calls 0.07€
PC_Mister calls 0.06€
*** FLOP *** [Js Td Jc]
Suaterna207 checks
PC_Mister checks
Ga31k bets 0.09€
Suaterna207 folds
PC_Mister calls 0.09€
*** TURN *** [Js Td Jc][2c]
PC_Mister checks
Ga31k checks
*** RIVER *** [Js Td Jc 2c][5h]
PC_Mister checks
Ga31k checks
*** SHOW DOWN ***
PC_Mister shows [9c Ad] (One pair : Jacks)
Ga31k shows [As Ts] (Two pairs : Jacks and Tens)
Ga31k collected 0.48€ from pot
*** SUMMARY ***
Total pot 0.48€ | Rake 0.04€
Board: [Js Td Jc 2c 5h]
Seat 2: PC_Mister (big blind) showed [9c Ad] and lost with One pair : Jacks
Seat 4: Ga31k showed [As Ts] and won 0.48€ with Two pairs : Jacks and Tens


Winamax Poker - HOLD-UP "Colorado" - HandId: #19116069-209539-1701340806 - Holdem no limit (0.01€/0.02€) - 2023/11/30 10:40:06 UTC
Table: 'Colorado' 6-max (real money) Seat #6 is the button
Seat 1: haouuum28 (3.15€)
Seat 2: bandarra8520 (2.70€)
Seat 3: Nash123 (2.95€)
Seat 4: Fried Berg (1.17€)
Seat 5: Zaerts (6.12€)
Seat 6: David Boring (11.86€)
*** ANTE/BLINDS ***
haouuum28 posts small blind 0.01€
bandarra8520 posts big blind 0.02€
Dealt to Fried Berg [5c 3c]
*** PRE-FLOP *** 
Nash123 raises 0.03€ to 0.05€
Fried Berg folds
Zaerts folds
David Boring folds
haouuum28 folds
bandarra8520 folds
Nash123 collected 0.08€ from pot
*** SUMMARY ***
Total pot 0.08€ | No rake
Seat 3: Nash123 won 0.08€


Winamax Poker - HOLD-UP "Colorado" - HandId: #19116069-209549-1701340812 - Holdem no limit (0.01€/0.02€) - 2023/11/30 10:40:12 UTC
Table: 'Colorado' 6-max (real money) Seat #6 is the button
Seat 1: David Boring (11.86€)
Seat 2: elsrab (1.99€)
Seat 3: Fried Berg (1.17€)
Seat 4: bandarra8520 (2.68€)
Seat 5: Hpet (2.39€)
Seat 6: VH_GOAT40 (2.19€)
*** ANTE/BLINDS ***
David Boring posts small blind 0.01€
elsrab posts big blind 0.02€
Dealt to Fried Berg [6d Kc]
*** PRE-FLOP *** 
Fried Berg folds
bandarra8520 folds
Hpet calls 0.02€
VH_GOAT40 folds
David Boring folds
elsrab checks
*** FLOP *** [Td 6c 4s]
elsrab bets 0.02€
Hpet calls 0.02€
*** TURN *** [Td 6c 4s][Kh]
elsrab bets 0.02€
Hpet calls 0.02€
*** RIVER *** [Td 6c 4s Kh][6h]
elsrab bets 0.13€
Hpet folds
elsrab collected 0.25€ from pot
*** SUMMARY ***
Total pot 0.25€ | Rake 0.01€
Board: [Td 6c 4s Kh 6h]
Seat 2: elsrab (big blind) won 0.25€


Winamax Poker - HOLD-UP "Colorado" - HandId: #19116069-209552-1701340814 - Holdem no limit (0.01€/0.02€) - 2023/11/30 10:40:14 UTC
Table: 'Colorado' 6-max (real money) Seat #6 is the button
Seat 1: Fried Berg (1.17€)
Seat 2: curiouz dje (5.23€)
Seat 3: CHANGAS (3.69€)
Seat 4: grut28 (5.75€)
Seat 5: Samapiker (1.35€)
Seat 6: Sebidu57 (2.56€)
*** ANTE/BLINDS ***
Fried Berg posts small blind 0.01€
curiouz dje posts big blind 0.02€
Dealt to Fried Berg [Ac 3d]
*** PRE-FLOP *** 
CHANGAS folds
grut28 folds
Samapiker folds
Sebidu57 folds
Fried Berg raises 0.02€ to 0.04€
curiouz dje folds
Fried Berg collected 0.06€ from pot
*** SUMMARY ***
Total pot 0.06€ | No rake
Seat 1: Fried Berg (small blind) won 0.06€


Winamax Poker - HOLD-UP "Colorado" - HandId: #19116069-209572-1701340827 - Holdem no limit (0.01€/0.02€) - 2023/11/30 10:40:27 UTC
Table: 'Colorado' 6-max (real money) Seat #6 is the button
Seat 1: Cl3mtar (4.67€)
Seat 2: Chamois 2638 (2.56€)
Seat 3: Siradella80 (2.01€)
Seat 4: curiouz dje (5.08€)
Seat 5: Fried Berg (1.19€)
Seat 6: TTry-AgAin (5.42€)
*** ANTE/BLINDS ***
Cl3mtar posts small blind 0.01€
Chamois 2638 posts big blind 0.02€
Dealt to Fried Berg [6c 9d]
*** PRE-FLOP *** 
Siradella80 raises 0.04€ to 0.06€
curiouz dje calls 0.06€
Fried Berg folds
TTry-AgAin folds
Cl3mtar calls 0.05€
Chamois 2638 folds
*** FLOP *** [8h 7h 3h]
Cl3mtar checks
Siradella80 bets 0.13€
curiouz dje folds
Cl3mtar calls 0.13€
*** TURN *** [8h 7h 3h][Ts]
Cl3mtar checks
Siradella80 bets 0.16€
Cl3mtar calls 0.16€
*** RIVER *** [8h 7h 3h Ts][5s]
Cl3mtar checks
Siradella80 checks
*** SHOW DOWN ***
Cl3mtar shows [Qd Kh] (High card : King)
Siradella80 shows [Qc Ah] (High card : Ace)
Siradella80 collected 0.70€ from pot
*** SUMMARY ***
Total pot 0.70€ | Rake 0.08€
Board: [8h 7h 3h Ts 5s]
Seat 1: Cl3mtar (small blind) showed [Qd Kh] and lost with High card : King
Seat 3: Siradella80 showed [Qc Ah] and won 0.70€ with High card : Ace


Winamax Poker - HOLD-UP "Colorado" - HandId: #19116069-209596-1701340844 - Holdem no limit (0.01€/0.02€) - 2023/11/30 10:40:44 UTC
Table: 'Colorado' 6-max (real money) Seat #6 is the button
Seat 1: Zaerts (6.10€)
Seat 2: Fried Berg (1.19€)
Seat 3: Giucar (1.12€)
Seat 4: KassKhrane76 (2€)
Seat 5: Samapiker (1.32€)
Seat 6: Sebidu57 (2.44€)
*** ANTE/BLINDS ***
Zaerts posts small blind 0.01€
Fried Berg posts big blind 0.02€
Dealt to Fried Berg [Qh 6d]
*** PRE-FLOP *** 
Giucar folds
KassKhrane76 folds
Samapiker folds
Sebidu57 folds
Zaerts folds
Fried Berg collected 0.03€ from pot
*** SUMMARY ***
Total pot 0.03€ | No rake
Seat 2: Fried Berg (big blind) won 0.03€


Winamax Poker - HOLD-UP "Colorado" - HandId: #19116069-209606-1701340849 - Holdem no limit (0.01€/0.02€) - 2023/11/30 10:40:49 UTC
Table: 'Colorado' 6-max (real money) Seat #6 is the button
Seat 1: GTO-Mieko (2€)
Seat 2: MFA_Mathis (3.69€)
Seat 3: babe35 (0.23€)
Seat 4: Fried Berg (1.20€)
Seat 5: PC_Mister (2€)
Seat 6: Perf-31 (4.12€)
*** ANTE/BLINDS ***
GTO-Mieko posts small blind 0.01€
MFA_Mathis posts big blind 0.02€
Dealt to Fried Berg [9h Ah]
*** PRE-FLOP *** 
babe35 folds
Fried Berg raises 0.02€ to 0.04€
PC_Mister folds
Perf-31 calls 0.04€
GTO-Mieko folds
MFA_Mathis calls 0.02€
*** FLOP *** [Js 6h 7s]
MFA_Mathis checks
Fried Berg checks
Perf-31 checks
*** TURN *** [Js 6h 7s][6d]
MFA_Mathis checks
Fried Berg checks
Perf-31 bets 0.08€
MFA_Mathis calls 0.08€
Fried Berg folds
*** RIVER *** [Js 6h 7s 6d][8h]
MFA_Mathis checks
Perf-31 checks
*** SHOW DOWN ***
Perf-31 shows [Th Kh] (One pair : 6)
MFA_Mathis shows [5h 5d] (Two pairs : 6 and 5)
MFA_Mathis collected 0.26€ from pot
*** SUMMARY ***
Total pot 0.26€ | Rake 0.03€
Board: [Js 6h 7s 6d 8h]
Seat 2: MFA_Mathis (big blind) showed [5h 5d] and won 0.26€ with Two pairs : 6 and 5
Seat 6: Perf-31 (button) showed [Th Kh] and lost with One pair : 6


Winamax Poker - HOLD-UP "Colorado" - HandId: #19116069-209701-1701340922 - Holdem no limit (0.01€/0.02€) - 2023/11/30 10:42:02 UTC
Table: 'Colorado' 6-max (real money) Seat #6 is the button
Seat 1: Charivari_ (0.94€)
Seat 2: CHANGAS (3.59€)
Seat 3: Adame199623 (2.04€)
Seat 4: curiouz dje (5.03€)
Seat 5: Fried Berg (1.16€)
Seat 6: PCB2401 (1.98€)
*** ANTE/BLINDS ***
Charivari_ posts small blind 0.01€
CHANGAS posts big blind 0.02€
Dealt to Fried Berg [4d Ts]
*** PRE-FLOP *** 
Adame199623 folds
curiouz dje folds
Fried Berg folds
PCB2401 raises 0.04€ to 0.06€
Charivari_ folds
CHANGAS calls 0.04€
*** FLOP *** [7h Qc 8s]
CHANGAS checks
PCB2401 checks
*** TURN *** [7h Qc 8s][Kc]
CHANGAS checks
PCB2401 bets 0.13€
CHANGAS folds
PCB2401 collected 0.25€ from pot
*** SUMMARY ***
Total pot 0.25€ | Rake 0.01€
Board: [7h Qc 8s Kc]
Seat 6: PCB2401 (button) won 0.25€


Winamax Poker - HOLD-UP "Colorado" - HandId: #19116069-209718-1701340936 - Holdem no limit (0.01€/0.02€) - 2023/11/30 10:42:16 UTC
Table: 'Colorado' 6-max (real money) Seat #6 is the button
Seat 1: Fried Berg (1.16€)
Seat 2: Pierrof24 (2.06€)
Seat 3: Jimmy91lenny (2.13€)
Seat 4: Retail Row (2.80€)
Seat 5: slowreplay (4.19€)
Seat 6: ricki64 (2.54€)
*** ANTE/BLINDS ***
Fried Berg posts small blind 0.01€
Pierrof24 posts big blind 0.02€
Dealt to Fried Berg [Jd 7c]
*** PRE-FLOP *** 
Jimmy91lenny folds
Retail Row folds
slowreplay folds
ricki64 calls 0.02€
Fried Berg folds
Pierrof24 checks
*** FLOP *** [Qs Ac Kc]
Pierrof24 checks
ricki64 bets 0.02€
Pierrof24 calls 0.02€
*** TURN *** [Qs Ac Kc][4d]
Pierrof24 checks
ricki64 bets 0.02€
Pierrof24 calls 0.02€
*** RIVER *** [Qs Ac Kc 4d][5c]
Pierrof24 checks
ricki64 checks
*** SHOW DOWN ***
Pierrof24 shows [Ts 9s] (High card : Ace)
ricki64 shows [2h Qh] (One pair : Queens)
ricki64 collected 0.12€ from pot
*** SUMMARY ***
Total pot 0.12€ | Rake 0.01€
Board: [Qs Ac Kc 4d 5c]
Seat 2: Pierrof24 (big blind) showed [Ts 9s] and lost with High card : Ace
Seat 6: ricki64 (button) showed [2h Qh] and won 0.12€ with One pair : Queens


Winamax Poker - HOLD-UP "Colorado" - HandId: #19116069-209724-1701340940 - Holdem no limit (0.01€/0.02€) - 2023/11/30 10:42:20 UTC
Table: 'Colorado' 6-max (real money) Seat #6 is the button
Seat 1: GTO-Mieko (2.15€)
Seat 2: vinzou050 (3.31€)
Seat 3: Fried Berg (1.15€)
Seat 4: Aggro Loser (5.82€)
Seat 5: Clemence75 (2.32€)
Seat 6: crabaudeur (1.72€)
*** ANTE/BLINDS ***
GTO-Mieko posts small blind 0.01€
vinzou050 posts big blind 0.02€
Dealt to Fried Berg [5c Js]
*** PRE-FLOP *** 
Fried Berg folds
Aggro Loser folds
Clemence75 folds
crabaudeur folds
GTO-Mieko folds
vinzou050 collected 0.03€ from pot
*** SUMMARY ***
Total pot 0.03€ | No rake
Seat 2: vinzou050 (big blind) won 0.03€


Winamax Poker - HOLD-UP "Colorado" - HandId: #19116069-209727-1701340943 - Holdem no limit (0.01€/0.02€) - 2023/11/30 10:42:23 UTC
Table: 'Colorado' 6-max (real money) Seat #6 is the button
Seat 1: nico033 (2.14€)
Seat 2: GTO-Mieko (2.14€)
Seat 3: Clemence75 (2.32€)
Seat 4: Flo83601 (1.80€)
Seat 5: VH_GOAT40 (2€)
Seat 6: Fried Berg (1.15€)
*** ANTE/BLINDS ***
nico033 posts small blind 0.01€
GTO-Mieko posts big blind 0.02€
Dealt to Fried Berg [2s Qh]
*** PRE-FLOP *** 
Clemence75 folds
Flo83601 folds
VH_GOAT40 folds
Fried Berg folds
nico033 folds
GTO-Mieko collected 0.03€ from pot
*** SUMMARY ***
Total pot 0.03€ | No rake
Seat 2: GTO-Mieko (big blind) won 0.03€


Winamax Poker - HOLD-UP "Colorado" - HandId: #19116069-209734-1701340950 - Holdem no limit (0.01€/0.02€) - 2023/11/30 10:42:30 UTC
Table: 'Colorado' 6-max (real money) Seat #6 is the button
Seat 1: vinzou050 (3.32€)
Seat 2: Fried Berg (1.15€)
Seat 3: Ottomann1453 (0.70€)
Seat 4: TTry-AgAin (5.45€)
Seat 5: Nash123 (2.95€)
Seat 6: Clemence75 (2€)
*** ANTE/BLINDS ***
vinzou050 posts small blind 0.01€
Fried Berg posts big blind 0.02€
Dealt to Fried Berg [7s 6h]
*** PRE-FLOP *** 
Ottomann1453 folds
TTry-AgAin folds
Nash123 raises 0.03€ to 0.05€
Clemence75 folds
vinzou050 folds
Fried Berg folds
Nash123 collected 0.08€ from pot
*** SUMMARY ***
Total pot 0.08€ | No rake
Seat 5: Nash123 won 0.08€


Winamax Poker - HOLD-UP "Colorado" - HandId: #19116069-209753-1701340969 - Holdem no limit (0.01€/0.02€) - 2023/11/30 10:42:49 UTC
Table: 'Colorado' 6-max (real money) Seat #6 is the button
Seat 1: Hydramist (5.86€)
Seat 2: AfgaBoBpoKer (1.83€)
Seat 3: TTry-AgAin (5.44€)
Seat 4: Giucar (1.19€)
Seat 5: Samapiker (1.03€)
Seat 6: Fried Berg (1.13€)
*** ANTE/BLINDS ***
Hydramist posts small blind 0.01€
AfgaBoBpoKer posts big blind 0.02€
Dealt to Fried Berg [Tc 7s]
*** PRE-FLOP *** 
TTry-AgAin folds
Giucar raises 0.03€ to 0.05€
Samapiker folds
Fried Berg folds
Hydramist folds
AfgaBoBpoKer folds
Giucar collected 0.08€ from pot
*** SUMMARY ***
Total pot 0.08€ | No rake
Seat 4: Giucar won 0.08€


Winamax Poker - HOLD-UP "Colorado" - HandId: #19116069-209758-1701340973 - Holdem no limit (0.01€/0.02€) - 2023/11/30 10:42:53 UTC
Table: 'Colorado' 6-max (real money) Seat #6 is the button
Seat 1: Daurade34 (2.10€)
Seat 2: Fried Berg (1.13€)
Seat 3: tequilaaaa (3.34€)
Seat 4: PC_Mister (2.92€)
Seat 5: Aggro Loser (2.30€)
Seat 6: slowreplay (2.15€)
*** ANTE/BLINDS ***
Daurade34 posts small blind 0.01€
Fried Berg posts big blind 0.02€
Dealt to Fried Berg [8h 8s]
*** PRE-FLOP *** 
tequilaaaa folds
PC_Mister folds
Aggro Loser folds
slowreplay folds
Daurade34 calls 0.01€
Fried Berg raises 0.02€ to 0.04€
Daurade34 calls 0.02€
*** FLOP *** [3s 3h Ts]
Daurade34 checks
Fried Berg bets 0.03€
Daurade34 calls 0.03€
*** TURN *** [3s 3h Ts][6s]
Daurade34 checks
Fried Berg bets 0.05€
Daurade34 folds
Fried Berg collected 0.18€ from pot
*** SUMMARY ***
Total pot 0.18€ | Rake 0.01€
Board: [3s 3h Ts 6s]
Seat 2: Fried Berg (big blind) won 0.18€


Winamax Poker - HOLD-UP "Colorado" - HandId: #19116069-209790-1701341002 - Holdem no limit (0.01€/0.02€) - 2023/11/30 10:43:22 UTC
Table: 'Colorado' 6-max (real money) Seat #6 is the button
Seat 1: Clemence75 (2.24€)
Seat 2: VH_GOAT40 (2.19€)
Seat 3: Fried Berg (1.19€)
Seat 4: samaris24 (1.90€)
Seat 5: Dim city (2.55€)
Seat 6: Daurade34 (2.03€)
*** ANTE/BLINDS ***
Clemence75 posts small blind 0.01€
VH_GOAT40 posts big blind 0.02€
Dealt to Fried Berg [7c 2h]
*** PRE-FLOP *** 
Fried Berg folds
samaris24 folds
Dim city folds
Daurade34 folds
Clemence75 folds
VH_GOAT40 collected 0.03€ from pot
*** SUMMARY ***
Total pot 0.03€ | No rake
Seat 2: VH_GOAT40 (big blind) won 0.03€


Winamax Poker - HOLD-UP "Colorado" - HandId: #19116069-209795-1701341006 - Holdem no limit (0.01€/0.02€) - 2023/11/30 10:43:26 UTC
Table: 'Colorado' 6-max (real money) Seat #6 is the button
Seat 1: Daurade34 (2.03€)
Seat 2: Zaerts (5.99€)
Seat 3: kameleon73 (2.86€)
Seat 4: Fried Berg (1.19€)
Seat 5: Charivari_ (1.81€)
Seat 6: Samapiker (1.20€)
*** ANTE/BLINDS ***
Daurade34 posts small blind 0.01€
Zaerts posts big blind 0.02€
Dealt to Fried Berg [2d 5s]
*** PRE-FLOP *** 
kameleon73 folds
Fried Berg folds
Charivari_ folds
Samapiker folds
Daurade34 calls 0.01€
Zaerts raises 0.04€ to 0.06€
Daurade34 calls 0.04€
*** FLOP *** [9c 8c As]
Daurade34 checks
Zaerts bets 0.08€
Daurade34 folds
Zaerts collected 0.19€ from pot
*** SUMMARY ***
Total pot 0.19€ | Rake 0.01€
Board: [9c 8c As]
Seat 2: Zaerts (big blind) won 0.19€


Winamax Poker - HOLD-UP "Colorado" - HandId: #19116069-209798-1701341009 - Holdem no limit (0.01€/0.02€) - 2023/11/30 10:43:29 UTC
Table: 'Colorado' 6-max (real money) Seat #6 is the button
Seat 1: Aggro Loser (2.28€)
Seat 2: wAAlterrr (2€)
Seat 3: Dim city (2.55€)
Seat 4: slowreplay (4.51€)
Seat 5: Fried Berg (1.19€)
Seat 6: Amnesis87 (1.22€)
*** ANTE/BLINDS ***
Aggro Loser posts small blind 0.01€
wAAlterrr posts big blind 0.02€
Dealt to Fried Berg [4h 5s]
*** PRE-FLOP *** 
Dim city calls 0.02€
slowreplay folds
Fried Berg calls 0.02€
Amnesis87 folds
Aggro Loser folds
wAAlterrr checks
*** FLOP *** [Kd 3d Ks]
wAAlterrr checks
Dim city checks
Fried Berg checks
*** TURN *** [Kd 3d Ks][5c]
wAAlterrr checks
Dim city checks
Fried Berg checks
*** RIVER *** [Kd 3d Ks 5c][9d]
wAAlterrr bets 0.07€
Dim city folds
Fried Berg calls 0.07€
*** SHOW DOWN ***
Fried Berg shows [4h 5s] (Two pairs : Kings and 5)
wAAlterrr shows [5d Kh] (Full of Kings and 5)
wAAlterrr collected 0.19€ from pot
*** SUMMARY ***
Total pot 0.19€ | Rake 0.02€
Board: [Kd 3d Ks 5c 9d]
Seat 2: wAAlterrr (big blind) showed [5d Kh] and won 0.19€ with Full of Kings and 5
Seat 5: Fried Berg showed [4h 5s] and lost with Two pairs : Kings and 5


Winamax Poker - HOLD-UP "Colorado" - HandId: #19116069-209893-1701341083 - Holdem no limit (0.01€/0.02€) - 2023/11/30 10:44:43 UTC
Table: 'Colorado' 6-max (real money) Seat #6 is the button
Seat 1: Aggro Loser (2€)
Seat 2: VashtaNerada (4.12€)
Seat 3: tequilaaaa (3.36€)
Seat 4: wAAlterrr (2.10€)
Seat 5: Thommynabo (4.23€)
Seat 6: Fried Berg (1.10€)
Hold-up to Pot: total 0.10€
*** ANTE/BLINDS ***
Aggro Loser posts small blind 0.01€
VashtaNerada posts big blind 0.02€
Dealt to Fried Berg [6h Qc]
*** PRE-FLOP *** 
tequilaaaa raises 0.04€ to 0.06€
wAAlterrr folds
Thommynabo calls 0.06€
Fried Berg folds
Aggro Loser calls 0.05€
VashtaNerada folds
*** FLOP *** [8h 3h 4c]
Aggro Loser checks
tequilaaaa checks
Thommynabo bets 0.10€
Aggro Loser folds
tequilaaaa calls 0.10€
*** TURN *** [8h 3h 4c][7c]
tequilaaaa checks
Thommynabo checks
*** RIVER *** [8h 3h 4c 7c][5c]
tequilaaaa bets 0.33€
Thommynabo calls 0.33€
*** SHOW DOWN ***
tequilaaaa shows [Ah 9d] (High card : Ace)
Thommynabo shows [4d Ad] (One pair : 4)
Thommynabo collected 1.05€ from pot
*** SUMMARY ***
Total pot 1.05€ | Rake 0.11€
Board: [8h 3h 4c 7c 5c]
Seat 3: tequilaaaa showed [Ah 9d] and lost with High card : Ace
Seat 5: Thommynabo showed [4d Ad] and won 1.05€ with One pair : 4


Winamax Poker - HOLD-UP "Colorado" - HandId: #19116069-209908-1701341095 - Holdem no limit (0.01€/0.02€) - 2023/11/30 10:44:55 UTC
Table: 'Colorado' 6-max (real money) Seat #6 is the button
Seat 1: Fried Berg (1.10€)
Seat 2: Clemence75 (2.32€)
Seat 3: Samapiker (1€)
Seat 4: VH_GOAT40 (2.19€)
Seat 5: Charivari_ (3.25€)
Seat 6: Martiwildest (3.31€)
*** ANTE/BLINDS ***
Fried Berg posts small blind 0.01€
Clemence75 posts big blind 0.02€
Dealt to Fried Berg [Ts 8h]
*** PRE-FLOP *** 
Samapiker folds
VH_GOAT40 folds
Charivari_ folds
Martiwildest folds
Fried Berg folds
Clemence75 collected 0.03€ from pot
*** SUMMARY ***
Total pot 0.03€ | No rake
Seat 2: Clemence75 (big blind) won 0.03€


Winamax Poker - HOLD-UP "Colorado" - HandId: #19116069-209914-1701341100 - Holdem no limit (0.01€/0.02€) - 2023/11/30 10:45:00 UTC
Table: 'Colorado' 6-max (real money) Seat #6 is the button
Seat 1: haouuum28 (3.19€)
Seat 2: Amnesis87 (1.28€)
Seat 3: Fried Berg (1.09€)
Seat 4: l artiste ho (3.28€)
Seat 5: VH_GOAT40 (3.83€)
Seat 6: Sebidu57 (1.96€)
*** ANTE/BLINDS ***
haouuum28 posts small blind 0.01€
Amnesis87 posts big blind 0.02€
Dealt to Fried Berg [6d As]
*** PRE-FLOP *** 
Fried Berg folds
l artiste ho folds
VH_GOAT40 folds
Sebidu57 calls 0.02€
haouuum28 calls 0.01€
Amnesis87 checks
*** FLOP *** [Qd 3d 2c]
haouuum28 checks
Amnesis87 checks
Sebidu57 bets 0.06€
haouuum28 folds
Amnesis87 folds
Sebidu57 collected 0.11€ from pot
*** SUMMARY ***
Total pot 0.11€ | Rake 0.01€
Board: [Qd 3d 2c]
Seat 6: Sebidu57 (button) won 0.11€


Winamax Poker - HOLD-UP "Colorado" - HandId: #19116069-209917-1701341104 - Holdem no limit (0.01€/0.02€) - 2023/11/30 10:45:04 UTC
Table: 'Colorado' 6-max (real money) Seat #6 is the button
Seat 1: Clemence75 (2.33€)
Seat 2: Fried Berg (1.09€)
Seat 3: Puma108 (0.81€)
Seat 4: Chamois 2638 (7.30€)
Seat 5: elsrab (2.70€)
Seat 6: Chinaski88 (2.05€)
*** ANTE/BLINDS ***
Clemence75 posts small blind 0.01€
Fried Berg posts big blind 0.02€
Dealt to Fried Berg [4d 8c]
*** PRE-FLOP *** 
Puma108 folds
Chamois 2638 calls 0.02€
elsrab folds
Chinaski88 folds
Clemence75 folds
Fried Berg checks
*** FLOP *** [Kc 6h 6d]
Fried Berg checks
Chamois 2638 checks
*** TURN *** [Kc 6h 6d][Kd]
Fried Berg checks
Chamois 2638 checks
*** RIVER *** [Kc 6h 6d Kd][4s]
Fried Berg bets 0.02€
Chamois 2638 calls 0.02€
*** SHOW DOWN ***
Fried Berg shows [4d 8c] (Two pairs : Kings and 6)
Chamois 2638 shows [Qc Ad] (Two pairs : Kings and 6)
Chamois 2638 collected 0.08€ from pot
*** SUMMARY ***
Total pot 0.08€ | Rake 0.01€
Board: [Kc 6h 6d Kd 4s]
Seat 2: Fried Berg (big blind) showed [4d 8c] and lost with Two pairs : Kings and 6
Seat 4: Chamois 2638 showed [Qc Ad] and won 0.08€ with Two pairs : Kings and 6


Winamax Poker - HOLD-UP "Colorado" - HandId: #19116069-209942-1701341128 - Holdem no limit (0.01€/0.02€) - 2023/11/30 10:45:28 UTC
Table: 'Colorado' 6-max (real money) Seat #6 is the button
Seat 1: Chamois 2638 (7.34€)
Seat 2: VH_GOAT40 (8.18€)
Seat 3: slowreplay (2.77€)
Seat 4: Fried Berg (1.05€)
Seat 5: Chinaski88 (2.02€)
Seat 6: Daurade34 (1.82€)
*** ANTE/BLINDS ***
Chamois 2638 posts small blind 0.01€
VH_GOAT40 posts big blind 0.02€
Dealt to Fried Berg [5c 5h]
*** PRE-FLOP *** 
slowreplay folds
Fried Berg raises 0.02€ to 0.04€
Chinaski88 folds
Daurade34 folds
Chamois 2638 folds
VH_GOAT40 folds
Fried Berg collected 0.07€ from pot
*** SUMMARY ***
Total pot 0.07€ | No rake
Seat 4: Fried Berg won 0.07€


Winamax Poker - HOLD-UP "Colorado" - HandId: #19116069-209957-1701341143 - Holdem no limit (0.01€/0.02€) - 2023/11/30 10:45:43 UTC
Table: 'Colorado' 6-max (real money) Seat #6 is the button
Seat 1: Tony2259 (2.76€)
Seat 2: KOKO K-Line (1.32€)
Seat 3: wAAlterrr (2.33€)
Seat 4: ricki64 (1€)
Seat 5: Fried Berg (1.08€)
Seat 6: nonoleboucan (2.47€)
*** ANTE/BLINDS ***
Tony2259 posts small blind 0.01€
KOKO K-Line posts big blind 0.02€
Dealt to Fried Berg [7d 9c]
*** PRE-FLOP *** 
wAAlterrr folds
ricki64 folds
Fried Berg folds
nonoleboucan raises 0.03€ to 0.05€
Tony2259 folds
KOKO K-Line folds
nonoleboucan collected 0.08€ from pot
*** SUMMARY ***
Total pot 0.08€ | No rake
Seat 6: nonoleboucan (button) won 0.08€


Winamax Poker - HOLD-UP "Colorado" - HandId: #19116069-209966-1701341150 - Holdem no limit (0.01€/0.02€) - 2023/11/30 10:45:50 UTC
Table: 'Colorado' 6-max (real money) Seat #6 is the button
Seat 1: Fried Berg (1.08€)
Seat 2: Chinaski88 (2.02€)
Seat 3: Pierrof24 (2€)
Seat 4: Clemence75 (2.39€)
Seat 5: Perf-31 (4.12€)
Seat 6: VashtaNerada (3.93€)
*** ANTE/BLINDS ***
Fried Berg posts small blind 0.01€
Chinaski88 posts big blind 0.02€
Dealt to Fried Berg [Kd 3h]
*** PRE-FLOP *** 
Pierrof24 folds
Clemence75 folds
Perf-31 raises 0.04€ to 0.06€
VashtaNerada folds
Fried Berg folds
Chinaski88 folds
Perf-31 collected 0.09€ from pot
*** SUMMARY ***
Total pot 0.09€ | No rake
Seat 5: Perf-31 won 0.09€


Winamax Poker - HOLD-UP "Colorado" - HandId: #19116069-209989-1701341168 - Holdem no limit (0.01€/0.02€) - 2023/11/30 10:46:08 UTC
Table: 'Colorado' 6-max (real money) Seat #6 is the button
Seat 1: kameleon73 (3.68€)
Seat 2: Fried Berg (1.07€)
Seat 3: wAAlterrr (2.21€)
Seat 4: PC_Mister (2€)
Seat 5: x spoony (2€)
Seat 6: SirX (6.98€)
*** ANTE/BLINDS ***
kameleon73 posts small blind 0.01€
Fried Berg posts big blind 0.02€
Dealt to Fried Berg [5c 5d]
*** PRE-FLOP *** 
wAAlterrr folds
PC_Mister folds
x spoony folds
SirX raises 0.04€ to 0.06€
kameleon73 folds
Fried Berg calls 0.04€
*** FLOP *** [Kh 6d 8h]
Fried Berg bets 0.05€
SirX calls 0.05€
*** TURN *** [Kh 6d 8h][2d]
Fried Berg checks
SirX bets 0.23€
Fried Berg folds
SirX collected 0.44€ from pot
*** SUMMARY ***
Total pot 0.44€ | Rake 0.02€
Board: [Kh 6d 8h 2d]
Seat 6: SirX (button) won 0.44€


Winamax Poker - HOLD-UP "Colorado" - HandId: #19116069-210022-1701341197 - Holdem no limit (0.01€/0.02€) - 2023/11/30 10:46:37 UTC
Table: 'Colorado' 6-max (real money) Seat #6 is the button
Seat 1: nico033 (2.12€)
Seat 2: tequilaaaa (2.87€)
Seat 3: Aggro Loser (3.84€)
Seat 4: Fried Berg (0.96€)
Seat 5: MaXKataleya (2.61€)
Seat 6: PC_Mister (2.98€)
*** ANTE/BLINDS ***
nico033 posts small blind 0.01€
tequilaaaa posts big blind 0.02€
Dealt to Fried Berg [Kh Jd]
*** PRE-FLOP *** 
Aggro Loser folds
Fried Berg raises 0.02€ to 0.04€
MaXKataleya calls 0.04€
PC_Mister folds
nico033 folds
tequilaaaa calls 0.02€
*** FLOP *** [2h Jh Ts]
tequilaaaa checks
Fried Berg bets 0.03€
MaXKataleya calls 0.03€
tequilaaaa raises 0.13€ to 0.16€
Fried Berg calls 0.13€
MaXKataleya folds
*** TURN *** [2h Jh Ts][8h]
tequilaaaa checks
Fried Berg checks
*** RIVER *** [2h Jh Ts 8h][Ks]
tequilaaaa checks
Fried Berg bets 0.12€
tequilaaaa calls 0.12€
*** SHOW DOWN ***
tequilaaaa shows [Jc 9d] (One pair : Jacks)
Fried Berg shows [Kh Jd] (Two pairs : Kings and Jacks)
Fried Berg collected 0.65€ from pot
*** SUMMARY ***
Total pot 0.65€ | Rake 0.07€
Board: [2h Jh Ts 8h Ks]
Seat 2: tequilaaaa (big blind) showed [Jc 9d] and lost with One pair : Jacks
Seat 4: Fried Berg showed [Kh Jd] and won 0.65€ with Two pairs : Kings and Jacks


Winamax Poker - HOLD-UP "Colorado" - HandId: #19116069-210151-1701341297 - Holdem no limit (0.01€/0.02€) - 2023/11/30 10:48:17 UTC
Table: 'Colorado' 6-max (real money) Seat #6 is the button
Seat 1: Imramra95 (3.58€)
Seat 2: x spoony (2€)
Seat 3: tequilaaaa (2.55€)
Seat 4: PC_Mister (2.02€)
Seat 5: Fried Berg (1.29€)
Seat 6: Aggro Loser (6.80€)
*** ANTE/BLINDS ***
Imramra95 posts small blind 0.01€
x spoony posts big blind 0.02€
Dealt to Fried Berg [Ac 2h]
*** PRE-FLOP *** 
tequilaaaa raises 0.04€ to 0.06€
PC_Mister folds
Fried Berg folds
Aggro Loser raises 0.12€ to 0.18€
Imramra95 folds
x spoony folds
tequilaaaa calls 0.12€
*** FLOP *** [7c 6d Td]
tequilaaaa checks
Aggro Loser checks
*** TURN *** [7c 6d Td][Qc]
tequilaaaa checks
Aggro Loser bets 0.26€
tequilaaaa calls 0.26€
*** RIVER *** [7c 6d Td Qc][Ks]
tequilaaaa checks
Aggro Loser checks
*** SHOW DOWN ***
tequilaaaa shows [8d 8s] (One pair : 8)
Aggro Loser shows [Qs Ah] (One pair : Queens)
Aggro Loser collected 0.82€ from pot
*** SUMMARY ***
Total pot 0.82€ | Rake 0.09€
Board: [7c 6d Td Qc Ks]
Seat 3: tequilaaaa showed [8d 8s] and lost with One pair : 8
Seat 6: Aggro Loser (button) showed [Qs Ah] and won 0.82€ with One pair : Queens


Winamax Poker - HOLD-UP "Colorado" - HandId: #19116069-210168-1701341315 - Holdem no limit (0.01€/0.02€) - 2023/11/30 10:48:35 UTC
Table: 'Colorado' 6-max (real money) Seat #6 is the button
Seat 1: NoStopLoss (1.98€)
Seat 2: vinzou050 (2.64€)
Seat 3: Fried Berg (1.29€)
Seat 4: PortRhu (1.67€)
Seat 5: bandarra8520 (5.48€)
Seat 6: Ragusnik00 (1.51€)
*** ANTE/BLINDS ***
NoStopLoss posts small blind 0.01€
vinzou050 posts big blind 0.02€
Dealt to Fried Berg [8d Tc]
*** PRE-FLOP *** 
Fried Berg folds
PortRhu folds
bandarra8520 folds
Ragusnik00 raises 0.04€ to 0.06€
NoStopLoss raises 0.18€ to 0.24€
vinzou050 folds
Ragusnik00 folds
NoStopLoss collected 0.32€ from pot
*** SUMMARY ***
Total pot 0.32€ | No rake
Seat 1: NoStopLoss (small blind) won 0.32€


Winamax Poker - HOLD-UP "Colorado" - HandId: #19116069-210172-1701341318 - Holdem no limit (0.01€/0.02€) - 2023/11/30 10:48:38 UTC
Table: 'Colorado' 6-max (real money) Seat #6 is the button
Seat 1: pamarmo79 (1.62€)
Seat 2: cmkiay (0.50€)
Seat 3: Pierrof24 (4€)
Seat 4: AfgaBoBpoKer (3.44€)
Seat 5: bandarra8520 (5.48€)
Seat 6: Fried Berg (1.29€)
*** ANTE/BLINDS ***
pamarmo79 posts small blind 0.01€
cmkiay posts big blind 0.02€
Dealt to Fried Berg [3h 3s]
*** PRE-FLOP *** 
Pierrof24 folds
AfgaBoBpoKer folds
bandarra8520 folds
Fried Berg raises 0.02€ to 0.04€
pamarmo79 folds
cmkiay folds
Fried Berg collected 0.07€ from pot
*** SUMMARY ***
Total pot 0.07€ | No rake
Seat 6: Fried Berg (button) won 0.07€


Winamax Poker - HOLD-UP "Colorado" - HandId: #19116069-210194-1701341334 - Holdem no limit (0.01€/0.02€) - 2023/11/30 10:48:54 UTC
Table: 'Colorado' 6-max (real money) Seat #6 is the button
Seat 1: Fried Berg (1.32€)
Seat 2: wAAlterrr (2.40€)
Seat 3: CB-Joker6274 (7.05€)
Seat 4: MisterZen (2.04€)
Seat 5: Yondaime M (2€)
Seat 6: Amazigh 78 (2.70€)
Hold-up to Pot: total 0.10€
*** ANTE/BLINDS ***
Fried Berg posts small blind 0.01€
wAAlterrr posts big blind 0.02€
Dealt to Fried Berg [Th As]
*** PRE-FLOP *** 
CB-Joker6274 folds
MisterZen calls 0.02€
Yondaime M folds
Amazigh 78 calls 0.02€
Fried Berg calls 0.01€
wAAlterrr checks
*** FLOP *** [8c 6s 3d]
Fried Berg bets 0.02€
wAAlterrr folds
MisterZen folds
Amazigh 78 calls 0.02€
*** TURN *** [8c 6s 3d][3h]
Fried Berg bets 0.02€
Amazigh 78 calls 0.02€
*** RIVER *** [8c 6s 3d 3h][9s]
Fried Berg bets 0.02€
Amazigh 78 raises 0.24€ to 0.26€
Fried Berg calls 0.24€
*** SHOW DOWN ***
Amazigh 78 shows [Jc 4c] (One pair : 3)
Fried Berg shows [Th As] (One pair : 3)
Fried Berg collected 0.71€ from pot
*** SUMMARY ***
Total pot 0.71€ | Rake 0.07€
Board: [8c 6s 3d 3h 9s]
Seat 1: Fried Berg (small blind) showed [Th As] and won 0.71€ with One pair : 3
Seat 6: Amazigh 78 (button) showed [Jc 4c] and lost with One pair : 3


Winamax Poker - HOLD-UP "Colorado" - HandId: #19116069-210292-1701341409 - Holdem no limit (0.01€/0.02€) - 2023/11/30 10:50:09 UTC
Table: 'Colorado' 6-max (real money) Seat #6 is the button
Seat 1: l artiste ho (2.26€)
Seat 2: VashtaNerada (4.05€)
Seat 3: Amazigh 78 (2.38€)
Seat 4: Imramra95 (3.79€)
Seat 5: JG813 (1.73€)
Seat 6: Fried Berg (1.71€)
*** ANTE/BLINDS ***
l artiste ho posts small blind 0.01€
VashtaNerada posts big blind 0.02€
Dealt to Fried Berg [6d Ad]
*** PRE-FLOP *** 
Amazigh 78 folds
Imramra95 folds
JG813 folds
Fried Berg raises 0.04€ to 0.06€
l artiste ho folds
VashtaNerada folds
Fried Berg collected 0.09€ from pot
*** SUMMARY ***
Total pot 0.09€ | No rake
Seat 6: Fried Berg (button) won 0.09€


Winamax Poker - HOLD-UP "Colorado" - HandId: #19116069-210328-1701341436 - Holdem no limit (0.01€/0.02€) - 2023/11/30 10:50:36 UTC
Table: 'Colorado' 6-max (real money) Seat #6 is the button
Seat 1: Aggro Loser (7.10€)
Seat 2: haouuum28 (4.15€)
Seat 3: SirX (6.31€)
Seat 4: Fried Berg (1.74€)
Seat 5: patrick19000 (1€)
Seat 6: nicky_poker (2.34€)
*** ANTE/BLINDS ***
Aggro Loser posts small blind 0.01€
haouuum28 posts big blind 0.02€
Dealt to Fried Berg [3s 2d]
*** PRE-FLOP *** 
SirX raises 0.04€ to 0.06€
Fried Berg folds
patrick19000 folds
nicky_poker folds
Aggro Loser folds
haouuum28 folds
SirX collected 0.09€ from pot
*** SUMMARY ***
Total pot 0.09€ | No rake
Seat 3: SirX won 0.09€


Winamax Poker - HOLD-UP "Colorado" - HandId: #19116069-210336-1701341441 - Holdem no limit (0.01€/0.02€) - 2023/11/30 10:50:41 UTC
Table: 'Colorado' 6-max (real money) Seat #6 is the button
Seat 1: Fried Berg (1.74€)
Seat 2: Jimmy91lenny (2.29€)
Seat 3: Erenox (1.76€)
Seat 4: PCB2401 (1.51€)
Seat 5: Charivari_ (0.91€)
Seat 6: Pierrof24 (2.03€)
*** ANTE/BLINDS ***
Fried Berg posts small blind 0.01€
Jimmy91lenny posts big blind 0.02€
Dealt to Fried Berg [Td 7d]
*** PRE-FLOP *** 
Erenox folds
PCB2401 raises 0.04€ to 0.06€
Charivari_ folds
Pierrof24 folds
Fried Berg folds
Jimmy91lenny calls 0.04€
*** FLOP *** [Qh 5s 7c]
Jimmy91lenny checks
PCB2401 checks
*** TURN *** [Qh 5s 7c][Kc]
Jimmy91lenny checks
PCB2401 bets 0.08€
Jimmy91lenny calls 0.08€
*** RIVER *** [Qh 5s 7c Kc][9h]
Jimmy91lenny checks
PCB2401 checks
*** SHOW DOWN ***
Jimmy91lenny shows [Qd Jd] (One pair : Queens)
PCB2401 shows [Kd Jc] (One pair : Kings)
PCB2401 collected 0.26€ from pot
*** SUMMARY ***
Total pot 0.26€ | Rake 0.03€
Board: [Qh 5s 7c Kc 9h]
Seat 2: Jimmy91lenny (big blind) showed [Qd Jd] and lost with One pair : Queens
Seat 4: PCB2401 showed [Kd Jc] and won 0.26€ with One pair : Kings


Winamax Poker - HOLD-UP "Colorado" - HandId: #19116069-210352-1701341456 - Holdem no limit (0.01€/0.02€) - 2023/11/30 10:50:56 UTC
Table: 'Colorado' 6-max (real money) Seat #6 is the button
Seat 1: vinzou050 (2.83€)
Seat 2: J.C Deuces.0 (1.77€)
Seat 3: Fried Berg (1.73€)
Seat 4: x spoony (2.05€)
Seat 5: Clemence75 (2.03€)
Seat 6: Imramra95 (3.87€)
*** ANTE/BLINDS ***
vinzou050 posts small blind 0.01€
J.C Deuces.0 posts big blind 0.02€
Dealt to Fried Berg [Kd Td]
*** PRE-FLOP *** 
Fried Berg raises 0.02€ to 0.04€
x spoony folds
Clemence75 folds
Imramra95 folds
vinzou050 folds
J.C Deuces.0 calls 0.02€
*** FLOP *** [Ac 6h Ts]
J.C Deuces.0 checks
Fried Berg bets 0.03€
J.C Deuces.0 calls 0.03€
*** TURN *** [Ac 6h Ts][7c]
J.C Deuces.0 checks
Fried Berg bets 0.05€
J.C Deuces.0 folds
Fried Berg collected 0.18€ from pot
*** SUMMARY ***
Total pot 0.18€ | Rake 0.02€
Board: [Ac 6h Ts 7c]
Seat 3: Fried Berg won 0.18€


Winamax Poker - HOLD-UP "Colorado" - HandId: #19116069-210404-1701341499 - Holdem no limit (0.01€/0.02€) - 2023/11/30 10:51:39 UTC
Table: 'Colorado' 6-max (real money) Seat #6 is the button
Seat 1: GTO-Mieko (4.42€)
Seat 2: Fried Berg (1.79€)
Seat 3: Aggro Loser (7.23€)
Seat 4: LeR6907 (2.24€)
Seat 5: PC_Mister (2€)
Seat 6: wAAlterrr (3€)
*** ANTE/BLINDS ***
GTO-Mieko posts small blind 0.01€
Fried Berg posts big blind 0.02€
Dealt to Fried Berg [Td 7s]
*** PRE-FLOP *** 
Aggro Loser folds
LeR6907 folds
PC_Mister folds
wAAlterrr raises 0.03€ to 0.05€
GTO-Mieko raises 0.10€ to 0.15€
Fried Berg folds
wAAlterrr folds
GTO-Mieko collected 0.22€ from pot
*** SUMMARY ***
Total pot 0.22€ | No rake
Seat 1: GTO-Mieko (small blind) won 0.22€


Winamax Poker - HOLD-UP "Colorado" - HandId: #19116069-210434-1701341523 - Holdem no limit (0.01€/0.02€) - 2023/11/30 10:52:03 UTC
Table: 'Colorado' 6-max (real money) Seat #6 is the button
Seat 1: Marto69 (3.68€)
Seat 2: PC_Mister (2€)
Seat 3: Adame199623 (2.37€)
Seat 4: slowreplay (2.16€)
Seat 5: x spoony (2.06€)
Seat 6: Fried Berg (1.77€)
*** ANTE/BLINDS ***
Marto69 posts small blind 0.01€
PC_Mister posts big blind 0.02€
Dealt to Fried Berg [Jh 8h]
*** PRE-FLOP *** 
Adame199623 raises 0.06€ to 0.08€
slowreplay folds
x spoony folds
Fried Berg calls 0.08€
Marto69 folds
PC_Mister folds
*** FLOP *** [6c 8s 2h]
Adame199623 checks
Fried Berg checks
*** TURN *** [6c 8s 2h][3d]
Adame199623 bets 0.14€
Fried Berg calls 0.14€
*** RIVER *** [6c 8s 2h 3d][2d]
Adame199623 checks
Fried Berg checks
*** SHOW DOWN ***
Adame199623 shows [Qh Ad] (One pair : 2)
Fried Berg shows [Jh 8h] (Two pairs : 8 and 2)
Fried Berg collected 0.42€ from pot
*** SUMMARY ***
Total pot 0.42€ | Rake 0.05€
Board: [6c 8s 2h 3d 2d]
Seat 3: Adame199623 showed [Qh Ad] and lost with One pair : 2
Seat 6: Fried Berg (button) showed [Jh 8h] and won 0.42€ with Two pairs : 8 and 2


Winamax Poker - HOLD-UP "Colorado" - HandId: #19116069-210495-1701341576 - Holdem no limit (0.01€/0.02€) - 2023/11/30 10:52:56 UTC
Table: 'Colorado' 6-max (real money) Seat #6 is the button
Seat 1: Aggro Loser (5.06€)
Seat 2: GF Warrior82 (1.06€)
Seat 3: wAAlterrr (2.39€)
Seat 4: Adame199623 (2.15€)
Seat 5: Fried Berg (1.97€)
Seat 6: x spoony (2.02€)
*** ANTE/BLINDS ***
Aggro Loser posts small blind 0.01€
GF Warrior82 posts big blind 0.02€
Dealt to Fried Berg [Jd 9s]
*** PRE-FLOP *** 
wAAlterrr folds
Adame199623 folds
Fried Berg folds
x spoony raises 0.04€ to 0.06€
Aggro Loser calls 0.05€
GF Warrior82 folds
*** FLOP *** [7c 4c 4d]
Aggro Loser checks
x spoony checks
*** TURN *** [7c 4c 4d][2d]
Aggro Loser checks
x spoony checks
*** RIVER *** [7c 4c 4d 2d][Jh]
Aggro Loser checks
x spoony checks
*** SHOW DOWN ***
x spoony shows [5h 5c] (Two pairs : 5 and 4)
Aggro Loser shows [Jc Qc] (Two pairs : Jacks and 4)
Aggro Loser collected 0.13€ from pot
*** SUMMARY ***
Total pot 0.13€ | Rake 0.01€
Board: [7c 4c 4d 2d Jh]
Seat 1: Aggro Loser (small blind) showed [Jc Qc] and won 0.13€ with Two pairs : Jacks and 4
Seat 6: x spoony (button) showed [5h 5c] and lost with Two pairs : 5 and 4


Winamax Poker - HOLD-UP "Colorado" - HandId: #19116069-210502-1701341581 - Holdem no limit (0.01€/0.02€) - 2023/11/30 10:53:01 UTC
Table: 'Colorado' 6-max (real money) Seat #6 is the button
Seat 1: Clemence75 (2€)
Seat 2: Fried Berg (1.97€)
Seat 3: XxTeamxX (2.48€)
Seat 4: PC_Mister (2.11€)
Seat 5: slowreplay (2.13€)
Seat 6: J.C Deuces.0 (1.89€)
Hold-up to Pot: total 0.10€
*** ANTE/BLINDS ***
Clemence75 posts small blind 0.01€
Fried Berg posts big blind 0.02€
Dealt to Fried Berg [4s 8s]
*** PRE-FLOP *** 
XxTeamxX folds
PC_Mister folds
slowreplay folds
J.C Deuces.0 raises 0.03€ to 0.05€
Clemence75 raises 0.15€ to 0.20€
Fried Berg folds
J.C Deuces.0 folds
Clemence75 collected 0.37€ from pot
*** SUMMARY ***
Total pot 0.37€ | No rake
Seat 1: Clemence75 (small blind) won 0.37€


Winamax Poker - HOLD-UP "Colorado" - HandId: #19116069-210530-1701341605 - Holdem no limit (0.01€/0.02€) - 2023/11/30 10:53:25 UTC
Table: 'Colorado' 6-max (real money) Seat #6 is the button
Seat 1: grut28 (5.26€)
Seat 2: Flo83601 (1.65€)
Seat 3: wAAlterrr (2.96€)
Seat 4: idem (1.97€)
Seat 5: PC_Mister (2.03€)
Seat 6: Fried Berg (1.95€)
*** ANTE/BLINDS ***
grut28 posts small blind 0.01€
Flo83601 posts big blind 0.02€
Dealt to Fried Berg [Jc Js]
*** PRE-FLOP *** 
wAAlterrr folds
idem folds
PC_Mister folds
Fried Berg raises 0.04€ to 0.06€
grut28 folds
Flo83601 calls 0.04€
*** FLOP *** [6d 9d 4c]
Flo83601 checks
Fried Berg bets 0.07€
Flo83601 calls 0.07€
*** TURN *** [6d 9d 4c][3s]
Flo83601 checks
Fried Berg bets 0.14€
Flo83601 calls 0.14€
*** RIVER *** [6d 9d 4c 3s][Td]
Flo83601 checks
Fried Berg checks
*** SHOW DOWN ***
Flo83601 shows [Ah 5s] (High card : Ace)
Fried Berg shows [Jc Js] (One pair : Jacks)
Fried Berg collected 0.49€ from pot
*** SUMMARY ***
Total pot 0.49€ | Rake 0.06€
Board: [6d 9d 4c 3s Td]
Seat 2: Flo83601 (big blind) showed [Ah 5s] and lost with High card : Ace
Seat 6: Fried Berg (button) showed [Jc Js] and won 0.49€ with One pair : Jacks


Winamax Poker - HOLD-UP "Colorado" - HandId: #19116069-210573-1701341643 - Holdem no limit (0.01€/0.02€) - 2023/11/30 10:54:03 UTC
Table: 'Colorado' 6-max (real money) Seat #6 is the button
Seat 1: Pierrof24 (1.49€)
Seat 2: pamarmo79 (5.09€)
Seat 3: Nash123 (2.73€)
Seat 4: Fried Berg (2.17€)
Seat 5: NoStopLoss (2€)
Seat 6: Martiwildest (3.92€)
*** ANTE/BLINDS ***
Pierrof24 posts small blind 0.01€
pamarmo79 posts big blind 0.02€
Dealt to Fried Berg [9c Ts]
*** PRE-FLOP *** 
Nash123 folds
Fried Berg folds
NoStopLoss folds
Martiwildest folds
Pierrof24 raises 0.02€ to 0.04€
pamarmo79 folds
Pierrof24 collected 0.06€ from pot
*** SUMMARY ***
Total pot 0.06€ | No rake
Seat 1: Pierrof24 (small blind) won 0.06€


Winamax Poker - HOLD-UP "Colorado" - HandId: #19116069-210582-1701341649 - Holdem no limit (0.01€/0.02€) - 2023/11/30 10:54:09 UTC
Table: 'Colorado' 6-max (real money) Seat #6 is the button
Seat 1: x spoony (2.15€)
Seat 2: J.C Deuces.0 (1.60€)
Seat 3: Fried Berg (2.17€)
Seat 4: PC_Mister (3.31€)
Seat 5: Samapiker (1€)
Seat 6: TTry-AgAin (6.86€)
*** ANTE/BLINDS ***
x spoony posts small blind 0.01€
J.C Deuces.0 posts big blind 0.02€
Dealt to Fried Berg [As Th]
*** PRE-FLOP *** 
Fried Berg raises 0.02€ to 0.04€
PC_Mister folds
Samapiker folds
TTry-AgAin folds
x spoony folds
J.C Deuces.0 calls 0.02€
*** FLOP *** [7d Kd 2h]
J.C Deuces.0 checks
Fried Berg checks
*** TURN *** [7d Kd 2h][6h]
J.C Deuces.0 bets 0.07€
Fried Berg folds
J.C Deuces.0 collected 0.15€ from pot
*** SUMMARY ***
Total pot 0.15€ | Rake 0.01€
Board: [7d Kd 2h 6h]
Seat 2: J.C Deuces.0 (big blind) won 0.15€


Winamax Poker - HOLD-UP "Colorado" - HandId: #19116069-210653-1701341698 - Holdem no limit (0.01€/0.02€) - 2023/11/30 10:54:58 UTC
Table: 'Colorado' 6-max (real money) Seat #6 is the button
Seat 1: Fried Berg (2.13€)
Seat 2: x spoony (2€)
Seat 3: Charivari_ (1.03€)
Seat 4: A. Baiunas (3.79€)
Seat 5: Sucre10 (4€)
Seat 6: Siradella80 (1.59€)
*** ANTE/BLINDS ***
Fried Berg posts small blind 0.01€
x spoony posts big blind 0.02€
Dealt to Fried Berg [8c 2d]
*** PRE-FLOP *** 
Charivari_ folds
A. Baiunas folds
Sucre10 folds
Siradella80 folds
Fried Berg folds
x spoony collected 0.03€ from pot
*** SUMMARY ***
Total pot 0.03€ | No rake
Seat 2: x spoony (big blind) won 0.03€


Winamax Poker - HOLD-UP "Colorado" - HandId: #19116069-210689-1701341725 - Holdem no limit (0.01€/0.02€) - 2023/11/30 10:55:25 UTC
Table: 'Colorado' 6-max (real money) Seat #6 is the button
Seat 1: slowreplay (2.37€)
Seat 2: grut28 (5.48€)
Seat 3: loreal78 (0.79€)
Seat 4: Nash123 (2.04€)
Seat 5: Charivari_ (1€)
Seat 6: Fried Berg (2.12€)
*** ANTE/BLINDS ***
slowreplay posts small blind 0.01€
grut28 posts big blind 0.02€
Dealt to Fried Berg [Jd 9c]
*** PRE-FLOP *** 
loreal78 raises 0.04€ to 0.06€
Nash123 folds
Charivari_ folds
Fried Berg folds
slowreplay folds
grut28 folds
loreal78 collected 0.09€ from pot
*** SUMMARY ***
Total pot 0.09€ | No rake
Seat 3: loreal78 won 0.09€


Winamax Poker - HOLD-UP "Colorado" - HandId: #19116069-210695-1701341731 - Holdem no limit (0.01€/0.02€) - 2023/11/30 10:55:31 UTC
Table: 'Colorado' 6-max (real money) Seat #6 is the button
Seat 1: tequilaaaa (2€)
Seat 2: Fried Berg (2.12€)
Seat 3: Adrianohhhh (2€)
Seat 4: VH_GOAT40 (7.38€)
Seat 5: haouuum28 (4.30€)
Seat 6: Hydramist (2€)
*** ANTE/BLINDS ***
tequilaaaa posts small blind 0.01€
Fried Berg posts big blind 0.02€
Dealt to Fried Berg [9s Ah]
*** PRE-FLOP *** 
Adrianohhhh folds
VH_GOAT40 folds
haouuum28 folds
Hydramist folds
tequilaaaa folds
Fried Berg collected 0.03€ from pot
*** SUMMARY ***
Total pot 0.03€ | No rake
Seat 2: Fried Berg (big blind) won 0.03€


Winamax Poker - HOLD-UP "Colorado" - HandId: #19116069-210726-1701341753 - Holdem no limit (0.01€/0.02€) - 2023/11/30 10:55:53 UTC
Table: 'Colorado' 6-max (real money) Seat #6 is the button
Seat 1: MCGHansen (2€)
Seat 2: Jneb34b (0.65€)
Seat 3: colgate12 (2.14€)
Seat 4: Fried Berg (2.13€)
Seat 5: PC_Mister (3.28€)
Seat 6: Samapiker (1.02€)
*** ANTE/BLINDS ***
MCGHansen posts small blind 0.01€
Jneb34b posts big blind 0.02€
Dealt to Fried Berg [8c 3c]
*** PRE-FLOP *** 
colgate12 folds
Fried Berg folds
PC_Mister raises 0.04€ to 0.06€
Samapiker folds
MCGHansen folds
Jneb34b folds
PC_Mister collected 0.09€ from pot
*** SUMMARY ***
Total pot 0.09€ | No rake
Seat 5: PC_Mister won 0.09€


Winamax Poker - HOLD-UP "Colorado" - HandId: #19116069-210732-1701341759 - Holdem no limit (0.01€/0.02€) - 2023/11/30 10:55:59 UTC
Table: 'Colorado' 6-max (real money) Seat #6 is the button
Seat 1: Fried Berg (2.13€)
Seat 2: Thommynabo (5.04€)
Seat 3: Aggro Loser (2.19€)
Seat 4: nicky_poker (3.31€)
Seat 5: loreal78 (0.82€)
Seat 6: Erenox (2.23€)
*** ANTE/BLINDS ***
Fried Berg posts small blind 0.01€
Thommynabo posts big blind 0.02€
Dealt to Fried Berg [4d 7s]
*** PRE-FLOP *** 
Aggro Loser folds
nicky_poker folds
loreal78 folds
Erenox raises 0.04€ to 0.06€
Fried Berg folds
Thommynabo folds
Erenox collected 0.09€ from pot
*** SUMMARY ***
Total pot 0.09€ | No rake
Seat 6: Erenox (button) won 0.09€


Winamax Poker - HOLD-UP "Colorado" - HandId: #19116069-210743-1701341766 - Holdem no limit (0.01€/0.02€) - 2023/11/30 10:56:06 UTC
Table: 'Colorado' 6-max (real money) Seat #6 is the button
Seat 1: Romoohlala (1.26€)
Seat 2: Aggro Loser (7.64€)
Seat 3: Fried Berg (2.12€)
Seat 4: Jneb34b (0.80€)
Seat 5: MCGHansen (2€)
Seat 6: Joan009 (2€)
*** ANTE/BLINDS ***
Romoohlala posts small blind 0.01€
Aggro Loser posts big blind 0.02€
Dealt to Fried Berg [2c Ac]
*** PRE-FLOP *** 
Fried Berg raises 0.02€ to 0.04€
Jneb34b folds
MCGHansen folds
Joan009 folds
Romoohlala folds
Aggro Loser folds
Fried Berg collected 0.07€ from pot
*** SUMMARY ***
Total pot 0.07€ | No rake
Seat 3: Fried Berg won 0.07€


Winamax Poker - HOLD-UP "Colorado" - HandId: #19116069-210804-1701341812 - Holdem no limit (0.01€/0.02€) - 2023/11/30 10:56:52 UTC
Table: 'Colorado' 6-max (real money) Seat #6 is the button
Seat 1: GF Warrior82 (1.25€)
Seat 2: haouuum28 (5.16€)
Seat 3: wAAlterrr (2.81€)
Seat 4: Daurade34 (1.31€)
Seat 5: Fried Berg (2.15€)
Seat 6: Killim (0.83€)
*** ANTE/BLINDS ***
GF Warrior82 posts small blind 0.01€
haouuum28 posts big blind 0.02€
Dealt to Fried Berg [3c 3h]
*** PRE-FLOP *** 
wAAlterrr folds
Daurade34 folds
Fried Berg raises 0.02€ to 0.04€
Killim calls 0.04€
GF Warrior82 calls 0.03€
haouuum28 folds
*** FLOP *** [7d Qh 6h]
GF Warrior82 bets 0.14€
Fried Berg folds
Killim folds
GF Warrior82 collected 0.27€ from pot
*** SUMMARY ***
Total pot 0.27€ | Rake 0.01€
Board: [7d Qh 6h]
Seat 1: GF Warrior82 (small blind) won 0.27€


Winamax Poker - HOLD-UP "Colorado" - HandId: #19116069-210858-1701341863 - Holdem no limit (0.01€/0.02€) - 2023/11/30 10:57:43 UTC
Table: 'Colorado' 6-max (real money) Seat #6 is the button
Seat 1: idem (2.13€)
Seat 2: Charivari_ (1.76€)
Seat 3: Fried Berg (2.11€)
Seat 4: nicky_poker (3.20€)
Seat 5: Aggro Loser (5.32€)
Seat 6: NoStopLoss (2.40€)
*** ANTE/BLINDS ***
idem posts small blind 0.01€
Charivari_ posts big blind 0.02€
Dealt to Fried Berg [4s 8h]
*** PRE-FLOP *** 
Fried Berg folds
nicky_poker folds
Aggro Loser folds
NoStopLoss folds
idem folds
Charivari_ collected 0.03€ from pot
*** SUMMARY ***
Total pot 0.03€ | No rake
Seat 2: Charivari_ (big blind) won 0.03€


Winamax Poker - HOLD-UP "Colorado" - HandId: #19116069-210860-1701341864 - Holdem no limit (0.01€/0.02€) - 2023/11/30 10:57:44 UTC
Table: 'Colorado' 6-max (real money) Seat #6 is the button
Seat 1: Tony2259 (2.50€)
Seat 2: Fried Berg (2.11€)
Seat 3: Joan009 (2€)
Seat 4: x spoony (2.16€)
Seat 5: idem (2.12€)
Seat 6: GF Warrior82 (1.34€)
*** ANTE/BLINDS ***
Tony2259 posts small blind 0.01€
Fried Berg posts big blind 0.02€
Dealt to Fried Berg [Td Ks]
*** PRE-FLOP *** 
Joan009 folds
x spoony folds
idem folds
GF Warrior82 raises 0.02€ to 0.04€
Tony2259 folds
Fried Berg calls 0.02€
*** FLOP *** [Jh 9s As]
Fried Berg bets 0.02€
GF Warrior82 calls 0.02€
*** TURN *** [Jh 9s As][6s]
Fried Berg checks
GF Warrior82 bets 0.08€
Fried Berg calls 0.08€
*** RIVER *** [Jh 9s As 6s][9d]
Fried Berg checks
GF Warrior82 checks
*** SHOW DOWN ***
Fried Berg shows [Td Ks] (One pair : 9)
GF Warrior82 shows [Jc Tc] (Two pairs : Jacks and 9)
GF Warrior82 collected 0.26€ from pot
*** SUMMARY ***
Total pot 0.26€ | Rake 0.03€
Board: [Jh 9s As 6s 9d]
Seat 2: Fried Berg (big blind) showed [Td Ks] and lost with One pair : 9
Seat 6: GF Warrior82 (button) showed [Jc Tc] and won 0.26€ with Two pairs : Jacks and 9


Winamax Poker - HOLD-UP "Colorado" - HandId: #19116069-210919-1701341908 - Holdem no limit (0.01€/0.02€) - 2023/11/30 10:58:28 UTC
Table: 'Colorado' 6-max (real money) Seat #6 is the button
Seat 1: Fried Berg (1.97€)
Seat 2: Nash123 (2.07€)
Seat 3: CB-Joker6274 (4.31€)
Seat 4: GF Warrior82 (1.46€)
Seat 5: ZenoidZ (1.94€)
Seat 6: tequilaaaa (2.67€)
*** ANTE/BLINDS ***
Fried Berg posts small blind 0.01€
Nash123 posts big blind 0.02€
Dealt to Fried Berg [Qs 2d]
*** PRE-FLOP *** 
CB-Joker6274 folds
GF Warrior82 folds
ZenoidZ folds
tequilaaaa folds
Fried Berg raises 0.02€ to 0.04€
Nash123 raises 0.14€ to 0.18€
Fried Berg folds
Nash123 collected 0.22€ from pot
*** SUMMARY ***
Total pot 0.22€ | No rake
Seat 2: Nash123 (big blind) won 0.22€


Winamax Poker - HOLD-UP "Colorado" - HandId: #19116069-210967-1701341946 - Holdem no limit (0.01€/0.02€) - 2023/11/30 10:59:06 UTC
Table: 'Colorado' 6-max (real money) Seat #6 is the button
Seat 1: x spoony (2.13€)
Seat 2: Killim (0.89€)
Seat 3: VashtaNerada (2.04€)
Seat 4: LeR6907 (2.39€)
Seat 5: Fried Berg (1.93€)
Seat 6: Pierrof24 (3.98€)
*** ANTE/BLINDS ***
x spoony posts small blind 0.01€
Killim posts big blind 0.02€
Dealt to Fried Berg [Ks 4c]
*** PRE-FLOP *** 
VashtaNerada folds
LeR6907 folds
Fried Berg folds
Pierrof24 raises 0.02€ to 0.04€
x spoony folds
Killim raises 0.14€ to 0.18€
Pierrof24 folds
Killim collected 0.23€ from pot
*** SUMMARY ***
Total pot 0.23€ | No rake
Seat 2: Killim (big blind) won 0.23€


Winamax Poker - HOLD-UP "Colorado" - HandId: #19116069-210975-1701341952 - Holdem no limit (0.01€/0.02€) - 2023/11/30 10:59:12 UTC
Table: 'Colorado' 6-max (real money) Seat #6 is the button
Seat 1: Fried Berg (1.93€)
Seat 2: GTO-Mieko (4.24€)
Seat 3: Adame199623 (2€)
Seat 4: VH_GOAT40 (5.94€)
Seat 5: crabaudeur (1.89€)
Seat 6: Astaril (2€)
*** ANTE/BLINDS ***
Fried Berg posts small blind 0.01€
GTO-Mieko posts big blind 0.02€
Dealt to Fried Berg [Ah As]
*** PRE-FLOP *** 
Adame199623 folds
VH_GOAT40 folds
crabaudeur folds
Astaril folds
Fried Berg raises 0.04€ to 0.06€
GTO-Mieko folds
Fried Berg collected 0.08€ from pot
*** SUMMARY ***
Total pot 0.08€ | No rake
Seat 1: Fried Berg (small blind) won 0.08€


Winamax Poker - HOLD-UP "Colorado" - HandId: #19116069-210987-1701341962 - Holdem no limit (0.01€/0.02€) - 2023/11/30 10:59:22 UTC
Table: 'Colorado' 6-max (real money) Seat #6 is the button
Seat 1: Samapiker (1€)
Seat 2: nicky_poker (3.08€)
Seat 3: Imramra95 (2.98€)
Seat 4: Jneb34b (0.57€)
Seat 5: Fried Berg (1.95€)
Seat 6: x spoony (2.25€)
*** ANTE/BLINDS ***
Samapiker posts small blind 0.01€
nicky_poker posts big blind 0.02€
Dealt to Fried Berg [Jc Tc]
*** PRE-FLOP *** 
Imramra95 folds
Jneb34b folds
Fried Berg raises 0.04€ to 0.06€
x spoony folds
Samapiker folds
nicky_poker folds
Fried Berg collected 0.09€ from pot
*** SUMMARY ***
Total pot 0.09€ | No rake
Seat 5: Fried Berg won 0.09€


Winamax Poker - HOLD-UP "Colorado" - HandId: #19116069-211004-1701341974 - Holdem no limit (0.01€/0.02€) - 2023/11/30 10:59:34 UTC
Table: 'Colorado' 6-max (real money) Seat #6 is the button
Seat 1: Adame199623 (2.03€)
Seat 2: - ONZE - (2€)
Seat 3: -pitch-TF- (2.18€)
Seat 4: LeR6907 (2.37€)
Seat 5: Fried Berg (1.98€)
Seat 6: Sebidu57 (1.69€)
*** ANTE/BLINDS ***
Adame199623 posts small blind 0.01€
- ONZE - posts big blind 0.02€
Dealt to Fried Berg [2s 6h]
*** PRE-FLOP *** 
-pitch-TF- folds
LeR6907 folds
Fried Berg folds
Sebidu57 folds
Adame199623 folds
- ONZE - collected 0.03€ from pot
*** SUMMARY ***
Total pot 0.03€ | No rake
Seat 2: - ONZE - (big blind) won 0.03€


Winamax Poker - HOLD-UP "Colorado" - HandId: #19116069-211011-1701341979 - Holdem no limit (0.01€/0.02€) - 2023/11/30 10:59:39 UTC
Table: 'Colorado' 6-max (real money) Seat #6 is the button
Seat 1: Astaril (2€)
Seat 2: NoStopLoss (3.77€)
Seat 3: Nash123 (3.33€)
Seat 4: Fried Berg (1.98€)
Seat 5: Aggro Loser (8.48€)
Seat 6: l artiste ho (2.15€)
*** ANTE/BLINDS ***
Astaril posts small blind 0.01€
NoStopLoss posts big blind 0.02€
Dealt to Fried Berg [Qc 2s]
*** PRE-FLOP *** 
Nash123 folds
Fried Berg folds
Aggro Loser folds
l artiste ho folds
Astaril folds
NoStopLoss collected 0.03€ from pot
*** SUMMARY ***
Total pot 0.03€ | No rake
Seat 2: NoStopLoss (big blind) won 0.03€


Winamax Poker - HOLD-UP "Colorado" - HandId: #19116069-211016-1701341982 - Holdem no limit (0.01€/0.02€) - 2023/11/30 10:59:42 UTC
Table: 'Colorado' 6-max (real money) Seat #6 is the button
Seat 1: Nash123 (2.04€)
Seat 2: Fried Berg (1.98€)
Seat 3: MCGHansen (2€)
Seat 4: haouuum28 (5.35€)
Seat 5: Astaril (2.03€)
Seat 6: -pitch-TF- (2.18€)
*** ANTE/BLINDS ***
Nash123 posts small blind 0.01€
Fried Berg posts big blind 0.02€
Dealt to Fried Berg [5c Ad]
*** PRE-FLOP *** 
MCGHansen folds
haouuum28 folds
Astaril raises 0.03€ to 0.05€
-pitch-TF- folds
Nash123 raises 0.19€ to 0.24€
Fried Berg folds
Astaril folds
Nash123 collected 0.31€ from pot
*** SUMMARY ***
Total pot 0.31€ | No rake
Seat 1: Nash123 (small blind) won 0.31€


Winamax Poker - HOLD-UP "Colorado" - HandId: #19116069-211030-1701341997 - Holdem no limit (0.01€/0.02€) - 2023/11/30 10:59:57 UTC
Table: 'Colorado' 6-max (real money) Seat #6 is the button
Seat 1: GTO-Mieko (4.66€)
Seat 2: Sucre10 (3.86€)
Seat 3: MaXKataleya (2.42€)
Seat 4: Fried Berg (1.96€)
Seat 5: morganeswolf (1.99€)
Seat 6: VH_GOAT40 (4.82€)
*** ANTE/BLINDS ***
GTO-Mieko posts small blind 0.01€
Sucre10 posts big blind 0.02€
Dealt to Fried Berg [2c 2h]
*** PRE-FLOP *** 
MaXKataleya folds
Fried Berg raises 0.02€ to 0.04€
morganeswolf folds
VH_GOAT40 folds
GTO-Mieko folds
Sucre10 folds
Fried Berg collected 0.07€ from pot
*** SUMMARY ***
Total pot 0.07€ | No rake
Seat 4: Fried Berg won 0.07€


Winamax Poker - HOLD-UP "Colorado" - HandId: #19116069-211044-1701342008 - Holdem no limit (0.01€/0.02€) - 2023/11/30 11:00:08 UTC
Table: 'Colorado' 6-max (real money) Seat #6 is the button
Seat 1: Fried Berg (1.99€)
Seat 2: Jneb34b (0.66€)
Seat 3: Sucre10 (3.84€)
Seat 4: OursDesMers (2.73€)
Seat 5: Pierrof24 (1.67€)
Seat 6: VashtaNerada (3.68€)
*** ANTE/BLINDS ***
Fried Berg posts small blind 0.01€
Jneb34b posts big blind 0.02€
Dealt to Fried Berg [2c 3c]
*** PRE-FLOP *** 
Sucre10 raises 0.03€ to 0.05€
OursDesMers folds
Pierrof24 folds
VashtaNerada calls 0.05€
Fried Berg folds
Jneb34b folds
*** FLOP *** [6c 9h Jc]
Sucre10 checks
VashtaNerada checks
*** TURN *** [6c 9h Jc][Ac]
Sucre10 checks
VashtaNerada bets 0.07€
Sucre10 folds
VashtaNerada collected 0.19€ from pot
*** SUMMARY ***
Total pot 0.19€ | Rake 0.01€
Board: [6c 9h Jc Ac]
Seat 6: VashtaNerada (button) won 0.19€


Winamax Poker - HOLD-UP "Colorado" - HandId: #19116069-211068-1701342037 - Holdem no limit (0.01€/0.02€) - 2023/11/30 11:00:37 UTC
Table: 'Colorado' 6-max (real money) Seat #6 is the button
Seat 1: Samapiker (1€)
Seat 2: PC_Mister (4.89€)
Seat 3: Fried Berg (1.98€)
Seat 4: x spoony (2.05€)
Seat 5: Champhype (2.01€)
Seat 6: Jneb34b (0.63€)
Hold-up to Pot: total 0.10€
*** ANTE/BLINDS ***
Samapiker posts small blind 0.01€
PC_Mister posts big blind 0.02€
Dealt to Fried Berg [8s 2c]
*** PRE-FLOP *** 
Fried Berg folds
x spoony folds
Champhype folds
Jneb34b raises 0.61€ to 0.63€ and is all-in
Samapiker folds
PC_Mister folds
Jneb34b collected 0.76€ from pot
*** SUMMARY ***
Total pot 0.76€ | No rake
Seat 6: Jneb34b (button) won 0.76€


Winamax Poker - HOLD-UP "Colorado" - HandId: #19116069-211072-1701342043 - Holdem no limit (0.01€/0.02€) - 2023/11/30 11:00:43 UTC
Table: 'Colorado' 6-max (real money) Seat #6 is the button
Seat 1: Hydramist (2.26€)
Seat 2: Samapiker (1€)
Seat 3: Nash123 (2.07€)
Seat 4: _Croute_ (3.91€)
Seat 5: Fried Berg (1.98€)
Seat 6: Aggro Loser (5.23€)
*** ANTE/BLINDS ***
Hydramist posts small blind 0.01€
Samapiker posts big blind 0.02€
Dealt to Fried Berg [Ts 9h]
*** PRE-FLOP *** 
Nash123 folds
_Croute_ folds
Fried Berg folds
Aggro Loser raises 0.03€ to 0.05€
Hydramist raises 0.15€ to 0.20€
Samapiker folds
Aggro Loser calls 0.15€
*** FLOP *** [8s Jc 8h]
Hydramist bets 0.11€
Aggro Loser calls 0.11€
*** TURN *** [8s Jc 8h][4s]
Hydramist bets 0.40€
Aggro Loser folds
Hydramist collected 0.98€ from pot
*** SUMMARY ***
Total pot 0.98€ | Rake 0.06€
Board: [8s Jc 8h 4s]
Seat 1: Hydramist (small blind) won 0.98€


Winamax Poker - HOLD-UP "Colorado" - HandId: #19116069-211090-1701342055 - Holdem no limit (0.01€/0.02€) - 2023/11/30 11:00:55 UTC
Table: 'Colorado' 6-max (real money) Seat #6 is the button
Seat 1: Amazigh 78 (4.69€)
Seat 2: LeR6907 (2.87€)
Seat 3: PC_Mister (3.46€)
Seat 4: A. Baiunas (3.54€)
Seat 5: Sucre10 (3.79€)
Seat 6: Fried Berg (1.98€)
*** ANTE/BLINDS ***
Amazigh 78 posts small blind 0.01€
LeR6907 posts big blind 0.02€
Dealt to Fried Berg [Tc 3s]
*** PRE-FLOP *** 
PC_Mister folds
A. Baiunas folds
Sucre10 folds
Fried Berg folds
Amazigh 78 folds
LeR6907 collected 0.03€ from pot
*** SUMMARY ***
Total pot 0.03€ | No rake
Seat 2: LeR6907 (big blind) won 0.03€


Winamax Poker - HOLD-UP "Colorado" - HandId: #19116069-211099-1701342063 - Holdem no limit (0.01€/0.02€) - 2023/11/30 11:01:03 UTC
Table: 'Colorado' 6-max (real money) Seat #6 is the button
Seat 1: _Croute_ (3.91€)
Seat 2: A.soto5 (0.55€)
Seat 3: NoStopLoss (3.88€)
Seat 4: Fried Berg (1.98€)
Seat 5: Samapiker (1€)
Seat 6: Nash123 (2.06€)
*** ANTE/BLINDS ***
_Croute_ posts small blind 0.01€
A.soto5 posts big blind 0.02€
Dealt to Fried Berg [Ac Qc]
*** PRE-FLOP *** 
NoStopLoss folds
Fried Berg raises 0.03€ to 0.05€
Samapiker folds
Nash123 raises 0.13€ to 0.18€
_Croute_ folds
A.soto5 folds
Fried Berg calls 0.13€
*** FLOP *** [Jd Kd 7d]
Fried Berg checks
Nash123 bets 0.13€
Fried Berg calls 0.13€
*** TURN *** [Jd Kd 7d][3c]
Fried Berg checks
Nash123 checks
*** RIVER *** [Jd Kd 7d 3c][Tc]
Fried Berg bets 0.23€
Nash123 calls 0.23€
*** SHOW DOWN ***
Fried Berg shows [Ac Qc] (Straight Ace high)
Nash123 shows [Ah Qd] (Straight Ace high)
Nash123 collected 0.50€ from pot
Fried Berg collected 0.50€ from pot
*** SUMMARY ***
Total pot 1€ | Rake 0.11€
Board: [Jd Kd 7d 3c Tc]
Seat 4: Fried Berg showed [Ac Qc] and won 0.50€ with Straight Ace high
Seat 6: Nash123 (button) showed [Ah Qd] and won 0.50€ with Straight Ace high


Winamax Poker - HOLD-UP "Colorado" - HandId: #19116069-211150-1701342117 - Holdem no limit (0.01€/0.02€) - 2023/11/30 11:01:57 UTC
Table: 'Colorado' 6-max (real money) Seat #6 is the button
Seat 1: Jneb34b (0.26€)
Seat 2: TTry-AgAin (7.66€)
Seat 3: Fried Berg (1.94€)
Seat 4: Nash123 (2.02€)
Seat 5: tequilaaaa (2.44€)
Seat 6: x spoony (3.19€)
*** ANTE/BLINDS ***
Jneb34b posts small blind 0.01€
TTry-AgAin posts big blind 0.02€
Dealt to Fried Berg [Jd Kd]
*** PRE-FLOP *** 
Fried Berg raises 0.02€ to 0.04€
Nash123 folds
tequilaaaa folds
x spoony folds
Jneb34b calls 0.03€
TTry-AgAin raises 7.62€ to 7.66€ and is all-in
Fried Berg folds
Jneb34b calls 0.22€ and is all-in
*** FLOP *** [Ts 4s 7s]
*** TURN *** [Ts 4s 7s][5c]
*** RIVER *** [Ts 4s 7s 5c][Ks]
*** SHOW DOWN ***
Jneb34b shows [Qh Kh] (One pair : Kings)
TTry-AgAin shows [Qc Qs] (Flush King high)
TTry-AgAin collected 7.90€ from pot
*** SUMMARY ***
Total pot 7.90€ | Rake 0.06€
Board: [Ts 4s 7s 5c Ks]
Seat 1: Jneb34b (small blind) showed [Qh Kh] and lost with One pair : Kings
Seat 2: TTry-AgAin (big blind) showed [Qc Qs] and won 7.90€ with Flush King high


Winamax Poker - HOLD-UP "Colorado" - HandId: #19116069-211172-1701342143 - Holdem no limit (0.01€/0.02€) - 2023/11/30 11:02:23 UTC
Table: 'Colorado' 6-max (real money) Seat #6 is the button
Seat 1: crabaudeur (0.95€)
Seat 2: Fried Berg (1.90€)
Seat 3: _LeMessi_ (0.47€)
Seat 4: tequilaaaa (2.42€)
Seat 5: Hydramist (2€)
Seat 6: Joan009 (2.01€)
*** ANTE/BLINDS ***
crabaudeur posts small blind 0.01€
Fried Berg posts big blind 0.02€
Dealt to Fried Berg [Ad 4c]
*** PRE-FLOP *** 
_LeMessi_ folds
tequilaaaa raises 0.04€ to 0.06€
Hydramist folds
Joan009 folds
crabaudeur folds
Fried Berg folds
tequilaaaa collected 0.09€ from pot
*** SUMMARY ***
Total pot 0.09€ | No rake
Seat 4: tequilaaaa won 0.09€


Winamax Poker - HOLD-UP "Colorado" - HandId: #19116069-211196-1701342167 - Holdem no limit (0.01€/0.02€) - 2023/11/30 11:02:47 UTC
Table: 'Colorado' 6-max (real money) Seat #6 is the button
Seat 1: Hydramist (2€)
Seat 2: Joan009 (2€)
Seat 3: AfgaBoBpoKer (2.48€)
Seat 4: Fried Berg (1.88€)
Seat 5: _LeMessi_ (0.47€)
Seat 6: VH_GOAT40 (2.30€)
*** ANTE/BLINDS ***
Hydramist posts small blind 0.01€
Joan009 posts big blind 0.02€
Dealt to Fried Berg [Tc 7c]
*** PRE-FLOP *** 
AfgaBoBpoKer raises 0.05€ to 0.07€
Fried Berg folds
_LeMessi_ folds
VH_GOAT40 calls 0.07€
Hydramist folds
Joan009 folds
*** FLOP *** [Kd 2d 7d]
AfgaBoBpoKer checks
VH_GOAT40 bets 0.17€
AfgaBoBpoKer folds
VH_GOAT40 collected 0.32€ from pot
*** SUMMARY ***
Total pot 0.32€ | Rake 0.02€
Board: [Kd 2d 7d]
Seat 6: VH_GOAT40 (button) won 0.32€


Winamax Poker - HOLD-UP "Colorado" - HandId: #19116069-211203-1701342172 - Holdem no limit (0.01€/0.02€) - 2023/11/30 11:02:52 UTC
Table: 'Colorado' 6-max (real money) Seat #6 is the button
Seat 1: PC_Mister (3.64€)
Seat 2: x spoony (2.11€)
Seat 3: franco100 (0.50€)
Seat 4: Champhype (2.19€)
Seat 5: Fried Berg (1.88€)
Seat 6: A. Baiunas (3.30€)
*** ANTE/BLINDS ***
PC_Mister posts small blind 0.01€
x spoony posts big blind 0.02€
Dealt to Fried Berg [Kc 2d]
*** PRE-FLOP *** 
franco100 calls 0.02€
Champhype raises 0.03€ to 0.05€
Fried Berg folds
A. Baiunas folds
PC_Mister folds
x spoony folds
franco100 calls 0.03€
*** FLOP *** [2s Qd 5s]
franco100 bets 0.02€
Champhype raises 0.06€ to 0.08€
franco100 calls 0.06€
*** TURN *** [2s Qd 5s][3s]
franco100 bets 0.02€
Champhype calls 0.02€
*** RIVER *** [2s Qd 5s 3s][7d]
franco100 bets 0.02€
Champhype calls 0.02€
*** SHOW DOWN ***
Champhype shows [Kd 9d] (High card : King)
franco100 shows [9h 9c] (One pair : 9)
franco100 collected 0.33€ from pot
*** SUMMARY ***
Total pot 0.33€ | Rake 0.04€
Board: [2s Qd 5s 3s 7d]
Seat 3: franco100 showed [9h 9c] and won 0.33€ with One pair : 9
Seat 4: Champhype showed [Kd 9d] and lost with High card : King


Winamax Poker - HOLD-UP "Colorado" - HandId: #19116069-211223-1701342191 - Holdem no limit (0.01€/0.02€) - 2023/11/30 11:03:11 UTC
Table: 'Colorado' 6-max (real money) Seat #6 is the button
Seat 1: Thommynabo (4.12€)
Seat 2: Marto69 (3.14€)
Seat 3: x spoony (3.16€)
Seat 4: A. Baiunas (3.30€)
Seat 5: OursDesMers (2.01€)
Seat 6: Fried Berg (1.88€)
*** ANTE/BLINDS ***
Thommynabo posts small blind 0.01€
Marto69 posts big blind 0.02€
Dealt to Fried Berg [5s 3s]
*** PRE-FLOP *** 
x spoony folds
A. Baiunas folds
OursDesMers folds
Fried Berg folds
Thommynabo raises 0.04€ to 0.06€
Marto69 calls 0.04€
*** FLOP *** [3h Jc 2h]
Thommynabo checks
Marto69 bets 0.05€
Thommynabo calls 0.05€
*** TURN *** [3h Jc 2h][Th]
Thommynabo checks
Marto69 checks
*** RIVER *** [3h Jc 2h Th][7s]
Thommynabo checks
Marto69 bets 0.08€
Thommynabo folds
Marto69 collected 0.28€ from pot
*** SUMMARY ***
Total pot 0.28€ | Rake 0.02€
Board: [3h Jc 2h Th 7s]
Seat 2: Marto69 (big blind) won 0.28€


Winamax Poker - HOLD-UP "Colorado" - HandId: #19116069-211227-1701342196 - Holdem no limit (0.01€/0.02€) - 2023/11/30 11:03:16 UTC
Table: 'Colorado' 6-max (real money) Seat #6 is the button
Seat 1: Fried Berg (1.88€)
Seat 2: ricki64 (1€)
Seat 3: x spoony (2€)
Seat 4: TTry-AgAin (8.30€)
Seat 5: NoStopLoss (2.84€)
Seat 6: Aggro Loser (2.42€)
*** ANTE/BLINDS ***
Fried Berg posts small blind 0.01€
ricki64 posts big blind 0.02€
Dealt to Fried Berg [6s 4s]
*** PRE-FLOP *** 
x spoony raises 0.04€ to 0.06€
TTry-AgAin folds
NoStopLoss folds
Aggro Loser folds
Fried Berg calls 0.05€
ricki64 folds
*** FLOP *** [7d As 4h]
Fried Berg checks
x spoony bets 0.09€
Fried Berg calls 0.09€
*** TURN *** [7d As 4h][4d]
Fried Berg checks
x spoony checks
*** RIVER *** [7d As 4h 4d][Qc]
Fried Berg bets 0.11€
x spoony calls 0.11€
*** SHOW DOWN ***
x spoony shows [Kh Ad] (Two pairs : Aces and 4)
Fried Berg shows [6s 4s] (Trips of 4)
Fried Berg collected 0.49€ from pot
*** SUMMARY ***
Total pot 0.49€ | Rake 0.05€
Board: [7d As 4h 4d Qc]
Seat 1: Fried Berg (small blind) showed [6s 4s] and won 0.49€ with Trips of 4
Seat 3: x spoony showed [Kh Ad] and lost with Two pairs : Aces and 4


Winamax Poker - HOLD-UP "Colorado" - HandId: #19116069-211278-1701342245 - Holdem no limit (0.01€/0.02€) - 2023/11/30 11:04:05 UTC
Table: 'Colorado' 6-max (real money) Seat #6 is the button
Seat 1: Pierrof24 (3.98€)
Seat 2: Fried Berg (2.11€)
Seat 3: x spoony (2€)
Seat 4: Marto69 (3.23€)
Seat 5: Joan009 (2€)
Seat 6: Sebidu57 (1.68€)
*** ANTE/BLINDS ***
Pierrof24 posts small blind 0.01€
Fried Berg posts big blind 0.02€
Dealt to Fried Berg [Ts 9c]
*** PRE-FLOP *** 
x spoony folds
Marto69 folds
Joan009 folds
Sebidu57 folds
Pierrof24 raises 0.02€ to 0.04€
Fried Berg calls 0.02€
*** FLOP *** [4h As Td]
Pierrof24 checks
Fried Berg checks
*** TURN *** [4h As Td][Kh]
Pierrof24 checks
Fried Berg checks
*** RIVER *** [4h As Td Kh][3h]
Pierrof24 checks
Fried Berg bets 0.03€
Pierrof24 folds
Fried Berg collected 0.10€ from pot
*** SUMMARY ***
Total pot 0.10€ | Rake 0.01€
Board: [4h As Td Kh 3h]
Seat 2: Fried Berg (big blind) won 0.10€


Winamax Poker - HOLD-UP "Colorado" - HandId: #19116069-211344-1701342304 - Holdem no limit (0.01€/0.02€) - 2023/11/30 11:05:04 UTC
Table: 'Colorado' 6-max (real money) Seat #6 is the button
Seat 1: Bilderbet (2€)
Seat 2: haouuum28 (5.70€)
Seat 3: MaXKataleya (2.19€)
Seat 4: Jneb34b (0.84€)
Seat 5: Fried Berg (2.14€)
Seat 6: timePLZ (2€)
*** ANTE/BLINDS ***
Bilderbet posts small blind 0.01€
haouuum28 posts big blind 0.02€
Dealt to Fried Berg [4d 6d]
*** PRE-FLOP *** 
MaXKataleya folds
Jneb34b folds
Fried Berg raises 0.02€ to 0.04€
timePLZ folds
Bilderbet folds
haouuum28 raises 0.13€ to 0.17€
Fried Berg calls 0.13€
*** FLOP *** [8s 3d 5s]
haouuum28 bets 0.28€
Fried Berg calls 0.28€
*** TURN *** [8s 3d 5s][7s]
haouuum28 bets 0.32€
Fried Berg calls 0.32€
*** RIVER *** [8s 3d 5s 7s][8c]
haouuum28 bets 1.55€
Fried Berg calls 1.37€ and is all-in
*** SHOW DOWN ***
haouuum28 shows [Ks Kc] (Two pairs : Kings and 8)
Fried Berg shows [4d 6d] (Straight 8 high)
Fried Berg collected 3.86€ from main pot
haouuum28 collected 0.18€ from side pot 1
*** SUMMARY ***
Total pot 4.04€ | Rake 0.43€
Board: [8s 3d 5s 7s 8c]
Seat 2: haouuum28 (big blind) showed [Ks Kc] and won 0.18€ with Two pairs : Kings and 8
Seat 5: Fried Berg showed [4d 6d] and won 3.86€ with Straight 8 high


Winamax Poker - HOLD-UP "Colorado" - HandId: #19116069-211450-1701342404 - Holdem no limit (0.01€/0.02€) - 2023/11/30 11:06:44 UTC
Table: 'Colorado' 6-max (real money) Seat #6 is the button
Seat 1: _LeMessi_ (0.37€)
Seat 2: Aggro Loser (2€)
Seat 3: Fried Berg (3.86€)
Seat 4: A. Baiunas (2.02€)
Seat 5: haouuum28 (3.56€)
Seat 6: Hydramist (2€)
*** ANTE/BLINDS ***
_LeMessi_ posts small blind 0.01€
Aggro Loser posts big blind 0.02€
Dealt to Fried Berg [2d Js]
*** PRE-FLOP *** 
Fried Berg folds
A. Baiunas folds
haouuum28 folds
Hydramist folds
_LeMessi_ folds
Aggro Loser collected 0.03€ from pot
*** SUMMARY ***
Total pot 0.03€ | No rake
Seat 2: Aggro Loser (big blind) won 0.03€


Winamax Poker - HOLD-UP "Colorado" - HandId: #19116069-211461-1701342413 - Holdem no limit (0.01€/0.02€) - 2023/11/30 11:06:53 UTC
Table: 'Colorado' 6-max (real money) Seat #6 is the button
Seat 1: Flo83601 (0.36€)
Seat 2: NoStopLoss (2.09€)
Seat 3: Joan009 (2€)
Seat 4: timePLZ (2.04€)
Seat 5: Fried Berg (3.86€)
Seat 6: JG813 (2.06€)
*** ANTE/BLINDS ***
Flo83601 posts small blind 0.01€
NoStopLoss posts big blind 0.02€
Dealt to Fried Berg [Qh 2d]
*** PRE-FLOP *** 
Joan009 raises 0.03€ to 0.05€
timePLZ folds
Fried Berg folds
JG813 calls 0.05€
Flo83601 folds
NoStopLoss calls 0.03€
*** FLOP *** [8c 2h 4s]
NoStopLoss checks
Joan009 checks
JG813 bets 0.02€
NoStopLoss calls 0.02€
Joan009 calls 0.02€
*** TURN *** [8c 2h 4s][9c]
NoStopLoss bets 0.04€
Joan009 folds
JG813 calls 0.04€
*** RIVER *** [8c 2h 4s 9c][7s]
NoStopLoss checks
JG813 checks
*** SHOW DOWN ***
NoStopLoss shows [Ac 6c] (High card : Ace)
JG813 shows [Ts Th] (One pair : Tens)
JG813 collected 0.27€ from pot
*** SUMMARY ***
Total pot 0.27€ | Rake 0.03€
Board: [8c 2h 4s 9c 7s]
Seat 2: NoStopLoss (big blind) showed [Ac 6c] and lost with High card : Ace
Seat 6: JG813 (button) showed [Ts Th] and won 0.27€ with One pair : Tens


Winamax Poker - HOLD-UP "Colorado" - HandId: #19116069-211472-1701342423 - Holdem no limit (0.01€/0.02€) - 2023/11/30 11:07:03 UTC
Table: 'Colorado' 6-max (real money) Seat #6 is the button
Seat 1: l artiste ho (2.13€)
Seat 2: efficace.921 (0.50€)
Seat 3: Fried Berg (3.86€)
Seat 4: KON-2-PEUTE (2.14€)
Seat 5: Mouaxx (2.28€)
Seat 6: Siradella80 (1.30€)
*** ANTE/BLINDS ***
l artiste ho posts small blind 0.01€
efficace.921 posts big blind 0.02€
Dealt to Fried Berg [Jc 7s]
*** PRE-FLOP *** 
Fried Berg folds
KON-2-PEUTE folds
Mouaxx folds
Siradella80 folds
l artiste ho calls 0.01€
efficace.921 raises 0.02€ to 0.04€
l artiste ho calls 0.02€
*** FLOP *** [8h Ts 7d]
l artiste ho checks
efficace.921 bets 0.08€
l artiste ho folds
efficace.921 collected 0.15€ from pot
*** SUMMARY ***
Total pot 0.15€ | Rake 0.01€
Board: [8h Ts 7d]
Seat 2: efficace.921 (big blind) won 0.15€


Winamax Poker - HOLD-UP "Colorado" - HandId: #19116069-211481-1701342430 - Holdem no limit (0.01€/0.02€) - 2023/11/30 11:07:10 UTC
Table: 'Colorado' 6-max (real money) Seat #6 is the button
Seat 1: Fried Berg (3.86€)
Seat 2: Filet-O-fils (2€)
Seat 3: x spoony (2.04€)
Seat 4: sportsmax006 (1.97€)
Seat 5: MCGHansen (2.03€)
Seat 6: JissEl1te (2€)
*** ANTE/BLINDS ***
Fried Berg posts small blind 0.01€
Filet-O-fils posts big blind 0.02€
Dealt to Fried Berg [7d Jc]
*** PRE-FLOP *** 
x spoony folds
sportsmax006 folds
MCGHansen folds
JissEl1te raises 0.03€ to 0.05€
Fried Berg folds
Filet-O-fils calls 0.03€
*** FLOP *** [Qh 3d 4c]
Filet-O-fils checks
JissEl1te bets 0.06€
Filet-O-fils folds
JissEl1te collected 0.16€ from pot
*** SUMMARY ***
Total pot 0.16€ | Rake 0.01€
Board: [Qh 3d 4c]
Seat 6: JissEl1te (button) won 0.16€


Winamax Poker - HOLD-UP "Colorado" - HandId: #19116069-211503-1701342443 - Holdem no limit (0.01€/0.02€) - 2023/11/30 11:07:23 UTC
Table: 'Colorado' 6-max (real money) Seat #6 is the button
Seat 1: Bilderbet (2€)
Seat 2: Erenox (2.96€)
Seat 3: bipbip2a (1.94€)
Seat 4: grut28 (1.98€)
Seat 5: -Y4V- (3.07€)
Seat 6: Fried Berg (3.85€)
Hold-up to Pot: total 0.10€
*** ANTE/BLINDS ***
Bilderbet posts small blind 0.01€
Erenox posts big blind 0.02€
Dealt to Fried Berg [7c 8s]
*** PRE-FLOP *** 
bipbip2a folds
grut28 folds
-Y4V- folds
Fried Berg raises 0.02€ to 0.04€
Bilderbet folds
Erenox raises 0.08€ to 0.12€
Fried Berg calls 0.08€
*** FLOP *** [Ad 6d Qd]
Erenox checks
Fried Berg bets 0.18€
Erenox calls 0.18€
*** TURN *** [Ad 6d Qd][7h]
Erenox checks
Fried Berg checks
*** RIVER *** [Ad 6d Qd 7h][Jd]
Erenox bets 0.36€
Fried Berg folds
Erenox collected 1.01€ from pot
*** SUMMARY ***
Total pot 1.01€ | Rake 0.06€
Board: [Ad 6d Qd 7h Jd]
Seat 2: Erenox (big blind) won 1.01€


Winamax Poker - HOLD-UP "Colorado" - HandId: #19116069-211562-1701342484 - Holdem no limit (0.01€/0.02€) - 2023/11/30 11:08:04 UTC
Table: 'Colorado' 6-max (real money) Seat #6 is the button
Seat 1: x spoony (2.01€)
Seat 2: sportsmax006 (2.20€)
Seat 3: Yakari raise (2€)
Seat 4: Fried Berg (3.55€)
Seat 5: bandarra8520 (6€)
Seat 6: haouuum28 (3.51€)
*** ANTE/BLINDS ***
x spoony posts small blind 0.01€
sportsmax006 posts big blind 0.02€
Dealt to Fried Berg [5s 7d]
*** PRE-FLOP *** 
Yakari raise folds
Fried Berg folds
bandarra8520 folds
haouuum28 folds
x spoony raises 0.04€ to 0.06€
sportsmax006 calls 0.04€
*** FLOP *** [Ad 7c Js]
x spoony bets 0.10€
sportsmax006 folds
x spoony collected 0.21€ from pot
*** SUMMARY ***
Total pot 0.21€ | Rake 0.01€
Board: [Ad 7c Js]
Seat 1: x spoony (small blind) won 0.21€


Winamax Poker - HOLD-UP "Colorado" - HandId: #19116069-211568-1701342490 - Holdem no limit (0.01€/0.02€) - 2023/11/30 11:08:10 UTC
Table: 'Colorado' 6-max (real money) Seat #6 is the button
Seat 1: Donky Shot (1.05€)
Seat 2: Fried Berg (3.55€)
Seat 3: nicky_poker (2.15€)
Seat 4: Kira17 (3.58€)
Seat 5: Antho-B-69 (3.76€)
Seat 6: Joan009 (2.06€)
*** ANTE/BLINDS ***
Donky Shot posts small blind 0.01€
Fried Berg posts big blind 0.02€
Dealt to Fried Berg [Qs As]
*** PRE-FLOP *** 
nicky_poker raises 0.03€ to 0.05€
Kira17 folds
Antho-B-69 folds
Joan009 folds
Donky Shot folds
Fried Berg raises 0.03€ to 0.08€
nicky_poker calls 0.03€
*** FLOP *** [Qd Kd 4d]
Fried Berg bets 0.06€
nicky_poker calls 0.06€
*** TURN *** [Qd Kd 4d][3s]
Fried Berg bets 0.10€
nicky_poker calls 0.10€
*** RIVER *** [Qd Kd 4d 3s][9s]
Fried Berg checks
nicky_poker bets 0.30€
Fried Berg calls 0.30€
*** SHOW DOWN ***
Fried Berg shows [Qs As] (One pair : Queens)
nicky_poker shows [8d 7d] (Flush King high)
nicky_poker collected 0.98€ from pot
*** SUMMARY ***
Total pot 0.98€ | Rake 0.11€
Board: [Qd Kd 4d 3s 9s]
Seat 2: Fried Berg (big blind) showed [Qs As] and lost with One pair : Queens
Seat 3: nicky_poker showed [8d 7d] and won 0.98€ with Flush King high


Winamax Poker - HOLD-UP "Colorado" - HandId: #19116069-211630-1701342544 - Holdem no limit (0.01€/0.02€) - 2023/11/30 11:09:04 UTC
Table: 'Colorado' 6-max (real money) Seat #6 is the button
Seat 1: Mouaxx (3.48€)
Seat 2: _LeMessi_ (0.33€)
Seat 3: Pierrof24 (1.86€)
Seat 4: nicky_poker (2.59€)
Seat 5: l artiste ho (2.57€)
Seat 6: Fried Berg (3.01€)
*** ANTE/BLINDS ***
Mouaxx posts small blind 0.01€
_LeMessi_ posts big blind 0.02€
Dealt to Fried Berg [7s Kc]
*** PRE-FLOP *** 
Pierrof24 folds
nicky_poker folds
l artiste ho folds
Fried Berg folds
Mouaxx folds
_LeMessi_ collected 0.03€ from pot
*** SUMMARY ***
Total pot 0.03€ | No rake
Seat 2: _LeMessi_ (big blind) won 0.03€


Winamax Poker - HOLD-UP "Colorado" - HandId: #19116069-211640-1701342553 - Holdem no limit (0.01€/0.02€) - 2023/11/30 11:09:13 UTC
Table: 'Colorado' 6-max (real money) Seat #6 is the button
Seat 1: Pierrof24 (2.13€)
Seat 2: Fried Berg (3.01€)
Seat 3: Flo83601 (2.84€)
Seat 4: KingSoto (2.56€)
Seat 5: Antho-B-69 (3.79€)
Seat 6: JFSredbaron (2.38€)
*** ANTE/BLINDS ***
Pierrof24 posts small blind 0.01€
Fried Berg posts big blind 0.02€
Dealt to Fried Berg [4d 7d]
*** PRE-FLOP *** 
Flo83601 folds
KingSoto folds
Antho-B-69 folds
JFSredbaron folds
Pierrof24 raises 0.02€ to 0.04€
Fried Berg folds
Pierrof24 collected 0.06€ from pot
*** SUMMARY ***
Total pot 0.06€ | No rake
Seat 1: Pierrof24 (small blind) won 0.06€


Winamax Poker - HOLD-UP "Colorado" - HandId: #19116069-211661-1701342570 - Holdem no limit (0.01€/0.02€) - 2023/11/30 11:09:30 UTC
Table: 'Colorado' 6-max (real money) Seat #6 is the button
Seat 1: Killim (1.31€)
Seat 2: x spoony (2€)
Seat 3: l artiste ho (2.55€)
Seat 4: tequilaaaa (2€)
Seat 5: Fried Berg (2.99€)
Seat 6: fifou22980 (0.41€)
Hold-up to Pot: total 0.10€
*** ANTE/BLINDS ***
Killim posts small blind 0.01€
x spoony posts big blind 0.02€
Dealt to Fried Berg [8c 7h]
*** PRE-FLOP *** 
l artiste ho folds
tequilaaaa folds
Fried Berg raises 0.03€ to 0.05€
fifou22980 folds
Killim calls 0.04€
x spoony folds
*** FLOP *** [4c 8d 4h]
Killim checks
Fried Berg checks
*** TURN *** [4c 8d 4h][7c]
Killim bets 0.06€
Fried Berg raises 0.14€ to 0.20€
Killim raises 0.31€ to 0.51€
Fried Berg calls 0.31€
*** RIVER *** [4c 8d 4h 7c][Ad]
Killim bets 0.75€ and is all-in
Fried Berg calls 0.75€
*** SHOW DOWN ***
Fried Berg shows [8c 7h] (Two pairs : 8 and 7)
Killim shows [4s 9s] (Trips of 4)
Killim collected 2.48€ from pot
*** SUMMARY ***
Total pot 2.48€ | Rake 0.26€
Board: [4c 8d 4h 7c Ad]
Seat 1: Killim (small blind) showed [4s 9s] and won 2.48€ with Trips of 4
Seat 5: Fried Berg showed [8c 7h] and lost with Two pairs : 8 and 7


Winamax Poker - HOLD-UP "Colorado" - HandId: #19116069-211715-1701342617 - Holdem no limit (0.01€/0.02€) - 2023/11/30 11:10:17 UTC
Table: 'Colorado' 6-max (real money) Seat #6 is the button
Seat 1: AlphaBlue (0.51€)
Seat 2: KON-2-PEUTE (3.91€)
Seat 3: Killim (2.48€)
Seat 4: KKamarAAde (1.81€)
Seat 5: bandarra8520 (6.02€)
Seat 6: Fried Berg (1.68€)
*** ANTE/BLINDS ***
AlphaBlue posts small blind 0.01€
KON-2-PEUTE posts big blind 0.02€
Dealt to Fried Berg [Kh 5h]
*** PRE-FLOP *** 
Killim folds
KKamarAAde folds
bandarra8520 raises 0.04€ to 0.06€
Fried Berg calls 0.06€
AlphaBlue calls 0.05€
KON-2-PEUTE folds
*** FLOP *** [Qh Ah 7c]
AlphaBlue checks
bandarra8520 checks
Fried Berg checks
*** TURN *** [Qh Ah 7c][8s]
AlphaBlue checks
bandarra8520 bets 0.13€
Fried Berg calls 0.13€
AlphaBlue folds
*** RIVER *** [Qh Ah 7c 8s][Kd]
bandarra8520 bets 0.23€
Fried Berg calls 0.23€
*** SHOW DOWN ***
Fried Berg shows [Kh 5h] (One pair : Kings)
bandarra8520 shows [As Qd] (Two pairs : Aces and Queens)
bandarra8520 collected 0.83€ from pot
*** SUMMARY ***
Total pot 0.83€ | Rake 0.09€
Board: [Qh Ah 7c 8s Kd]
Seat 5: bandarra8520 showed [As Qd] and won 0.83€ with Two pairs : Aces and Queens
Seat 6: Fried Berg (button) showed [Kh 5h] and lost with One pair : Kings


Winamax Poker - HOLD-UP "Colorado" - HandId: #19116069-211799-1701342684 - Holdem no limit (0.01€/0.02€) - 2023/11/30 11:11:24 UTC
Table: 'Colorado' 6-max (real money) Seat #6 is the button
Seat 1: SirX (2.34€)
Seat 2: bandarra8520 (6.43€)
Seat 3: Fried Berg (1.26€)
Seat 4: Hydramist (2.12€)
Seat 5: Jneb34b (0.83€)
Seat 6: Nikthefish (2€)
*** ANTE/BLINDS ***
SirX posts small blind 0.01€
bandarra8520 posts big blind 0.02€
Dealt to Fried Berg [7d Ah]
*** PRE-FLOP *** 
Fried Berg raises 0.02€ to 0.04€
Hydramist folds
Jneb34b folds
Nikthefish folds
SirX calls 0.03€
bandarra8520 folds
*** FLOP *** [4d 7s 4h]
SirX checks
Fried Berg bets 0.04€
SirX calls 0.04€
*** TURN *** [4d 7s 4h][Ks]
SirX checks
Fried Berg checks
*** RIVER *** [4d 7s 4h Ks][Jh]
SirX bets 0.18€
Fried Berg folds
SirX collected 0.34€ from pot
*** SUMMARY ***
Total pot 0.34€ | Rake 0.02€
Board: [4d 7s 4h Ks Jh]
Seat 1: SirX (small blind) won 0.34€


Winamax Poker - HOLD-UP "Colorado" - HandId: #19116069-211849-1701342715 - Holdem no limit (0.01€/0.02€) - 2023/11/30 11:11:55 UTC
Table: 'Colorado' 6-max (real money) Seat #6 is the button
Seat 1: -Y4V- (3.23€)
Seat 2: fifi2308 (2.09€)
Seat 3: NoStopLoss (2.90€)
Seat 4: Clemence75 (2.05€)
Seat 5: rogabi (2.05€)
Seat 6: Fried Berg (1.18€)
*** ANTE/BLINDS ***
-Y4V- posts small blind 0.01€
fifi2308 posts big blind 0.02€
Dealt to Fried Berg [Tc 3h]
*** PRE-FLOP *** 
NoStopLoss raises 0.04€ to 0.06€
Clemence75 folds
rogabi folds
Fried Berg folds
-Y4V- folds
fifi2308 folds
NoStopLoss collected 0.09€ from pot
*** SUMMARY ***
Total pot 0.09€ | No rake
Seat 3: NoStopLoss won 0.09€


Winamax Poker - HOLD-UP "Colorado" - HandId: #19116069-211887-1701342740 - Holdem no limit (0.01€/0.02€) - 2023/11/30 11:12:20 UTC
Table: 'Colorado' 6-max (real money) Seat #6 is the button
Seat 1: Fried Berg (1.18€)
Seat 2: -Y4V- (3.19€)
Seat 3: tequilaaaa (2.02€)
Seat 4: fab19641964 (0.34€)
Seat 5: Erenox (2.79€)
Seat 6: x spoony (2€)
Hold-up to Pot: total 0.10€
*** ANTE/BLINDS ***
Fried Berg posts small blind 0.01€
-Y4V- posts big blind 0.02€
Dealt to Fried Berg [Qd 6d]
*** PRE-FLOP *** 
tequilaaaa folds
fab19641964 folds
Erenox folds
x spoony raises 0.04€ to 0.06€
Fried Berg calls 0.05€
-Y4V- calls 0.04€
*** FLOP *** [3d Tc Js]
Fried Berg checks
-Y4V- checks
x spoony checks
*** TURN *** [3d Tc Js][4s]
Fried Berg checks
-Y4V- checks
x spoony checks
*** RIVER *** [3d Tc Js 4s][5d]
Fried Berg checks
-Y4V- bets 0.04€
x spoony folds
Fried Berg calls 0.04€
*** SHOW DOWN ***
Fried Berg shows [Qd 6d] (High card : Queen)
-Y4V- shows [As 2s] (Straight 5 high)
-Y4V- collected 0.33€ from pot
*** SUMMARY ***
Total pot 0.33€ | Rake 0.03€
Board: [3d Tc Js 4s 5d]
Seat 1: Fried Berg (small blind) showed [Qd 6d] and lost with High card : Queen
Seat 2: -Y4V- (big blind) showed [As 2s] and won 0.33€ with Straight 5 high


Winamax Poker - HOLD-UP "Colorado" - HandId: #19116069-211958-1701342790 - Holdem no limit (0.01€/0.02€) - 2023/11/30 11:13:10 UTC
Table: 'Colorado' 6-max (real money) Seat #6 is the button
Seat 1: Flakitoxd (2.09€)
Seat 2: Fried Berg (1.08€)
Seat 3: Clemence75 (2€)
Seat 4: -Y4V- (3.42€)
Seat 5: SUERTE CC (1.86€)
Seat 6: Yakari raise (2.15€)
*** ANTE/BLINDS ***
Flakitoxd posts small blind 0.01€
Fried Berg posts big blind 0.02€
Dealt to Fried Berg [9d 6h]
*** PRE-FLOP *** 
Clemence75 folds
-Y4V- folds
SUERTE CC folds
Yakari raise folds
Flakitoxd raises 0.04€ to 0.06€
Fried Berg folds
Flakitoxd collected 0.08€ from pot
*** SUMMARY ***
Total pot 0.08€ | No rake
Seat 1: Flakitoxd (small blind) won 0.08€


Winamax Poker - HOLD-UP "Colorado" - HandId: #19116069-211971-1701342798 - Holdem no limit (0.01€/0.02€) - 2023/11/30 11:13:18 UTC
Table: 'Colorado' 6-max (real money) Seat #6 is the button
Seat 1: Mouaxx (1.36€)
Seat 2: Hydramist (3.72€)
Seat 3: Lunau (2.44€)
Seat 4: fifi2308 (2.01€)
Seat 5: Raging.Full (1.84€)
Seat 6: Fried Berg (1.06€)
*** ANTE/BLINDS ***
Mouaxx posts small blind 0.01€
Hydramist posts big blind 0.02€
Dealt to Fried Berg [2c 3s]
*** PRE-FLOP *** 
Lunau folds
fifi2308 folds
Raging.Full calls 0.02€
Fried Berg folds
Mouaxx folds
Hydramist checks
*** FLOP *** [2s 4s 4d]
Hydramist checks
Raging.Full bets 0.05€
Hydramist folds
Raging.Full collected 0.09€ from pot
*** SUMMARY ***
Total pot 0.09€ | Rake 0.01€
Board: [2s 4s 4d]
Seat 5: Raging.Full won 0.09€


Winamax Poker - HOLD-UP "Colorado" - HandId: #19116069-211992-1701342813 - Holdem no limit (0.01€/0.02€) - 2023/11/30 11:13:33 UTC
Table: 'Colorado' 6-max (real money) Seat #6 is the button
Seat 1: tequilaaaa (2.02€)
Seat 2: Lunau (2.02€)
Seat 3: x spoony (2€)
Seat 4: -pitch-TF- (2.22€)
Seat 5: KON-2-PEUTE (4.08€)
Seat 6: Fried Berg (1.06€)
*** ANTE/BLINDS ***
tequilaaaa posts small blind 0.01€
Lunau posts big blind 0.02€
Dealt to Fried Berg [4c 6c]
*** PRE-FLOP *** 
x spoony folds
-pitch-TF- folds
KON-2-PEUTE folds
Fried Berg raises 0.02€ to 0.04€
tequilaaaa folds
Lunau calls 0.02€
*** FLOP *** [7h Th 2s]
Lunau checks
Fried Berg checks
*** TURN *** [7h Th 2s][9c]
Lunau bets 0.06€
Fried Berg folds
Lunau collected 0.14€ from pot
*** SUMMARY ***
Total pot 0.14€ | Rake 0.01€
Board: [7h Th 2s 9c]
Seat 2: Lunau (big blind) won 0.14€


Winamax Poker - HOLD-UP "Colorado" - HandId: #19116069-212034-1701342842 - Holdem no limit (0.01€/0.02€) - 2023/11/30 11:14:02 UTC
Table: 'Colorado' 6-max (real money) Seat #6 is the button
Seat 1: A. Baiunas (2.25€)
Seat 2: Cedlebon (6.62€)
Seat 3: Fried Berg (1.02€)
Seat 4: JG813 (2.10€)
Seat 5: Erenox (2.02€)
Seat 6: El Paellas (0.66€)
*** ANTE/BLINDS ***
A. Baiunas posts small blind 0.01€
Cedlebon posts big blind 0.02€
Dealt to Fried Berg [6s Td]
*** PRE-FLOP *** 
Fried Berg folds
JG813 folds
Erenox folds
El Paellas raises 0.03€ to 0.05€
A. Baiunas folds
Cedlebon calls 0.03€
*** FLOP *** [7c Qd 2c]
Cedlebon checks
El Paellas bets 0.04€
Cedlebon calls 0.04€
*** TURN *** [7c Qd 2c][8d]
Cedlebon checks
El Paellas bets 0.12€
Cedlebon folds
El Paellas collected 0.29€ from pot
*** SUMMARY ***
Total pot 0.29€ | Rake 0.02€
Board: [7c Qd 2c 8d]
Seat 6: El Paellas (button) won 0.29€


Winamax Poker - HOLD-UP "Colorado" - HandId: #19116069-212039-1701342844 - Holdem no limit (0.01€/0.02€) - 2023/11/30 11:14:04 UTC
Table: 'Colorado' 6-max (real money) Seat #6 is the button
Seat 1: Lunau (2.06€)
Seat 2: Nikthefish (2.10€)
Seat 3: Yakari raise (2.12€)
Seat 4: Fried Berg (1.02€)
Seat 5: MagicBast 1 (0.71€)
Seat 6: .PROMETHEUS. (1.56€)
*** ANTE/BLINDS ***
Lunau posts small blind 0.01€
Nikthefish posts big blind 0.02€
Dealt to Fried Berg [Jh 9s]
*** PRE-FLOP *** 
Yakari raise folds
Fried Berg folds
MagicBast 1 folds
.PROMETHEUS. folds
Lunau raises 0.04€ to 0.06€
Nikthefish folds
Lunau collected 0.08€ from pot
*** SUMMARY ***
Total pot 0.08€ | No rake
Seat 1: Lunau (small blind) won 0.08€


Winamax Poker - HOLD-UP "Colorado" - HandId: #19116069-212047-1701342848 - Holdem no limit (0.01€/0.02€) - 2023/11/30 11:14:08 UTC
Table: 'Colorado' 6-max (real money) Seat #6 is the button
Seat 1: pamarmo79 (4.92€)
Seat 2: JissEl1te (3.29€)
Seat 3: crabaudeur (2.55€)
Seat 4: Yakari raise (2.12€)
Seat 5: Fried Berg (1.02€)
Seat 6: PC_Mister (2.03€)
*** ANTE/BLINDS ***
pamarmo79 posts small blind 0.01€
JissEl1te posts big blind 0.02€
Dealt to Fried Berg [6h 8d]
*** PRE-FLOP *** 
crabaudeur folds
Yakari raise folds
Fried Berg folds
PC_Mister folds
pamarmo79 folds
JissEl1te collected 0.03€ from pot
*** SUMMARY ***
Total pot 0.03€ | No rake
Seat 2: JissEl1te (big blind) won 0.03€


Winamax Poker - HOLD-UP "Colorado" - HandId: #19116069-212050-1701342850 - Holdem no limit (0.01€/0.02€) - 2023/11/30 11:14:10 UTC
Table: 'Colorado' 6-max (real money) Seat #6 is the button
Seat 1: JFSredbaron (2.05€)
Seat 2: NoStopLoss (2€)
Seat 3: CB-Joker6274 (2.77€)
Seat 4: Fried Berg (1.02€)
Seat 5: bipbip2a (1.89€)
Seat 6: crabaudeur (2.55€)
*** ANTE/BLINDS ***
JFSredbaron posts small blind 0.01€
NoStopLoss posts big blind 0.02€
Dealt to Fried Berg [Qs 8d]
*** PRE-FLOP *** 
CB-Joker6274 folds
Fried Berg folds
bipbip2a folds
crabaudeur raises 0.04€ to 0.06€
JFSredbaron folds
NoStopLoss folds
crabaudeur collected 0.09€ from pot
*** SUMMARY ***
Total pot 0.09€ | No rake
Seat 6: crabaudeur (button) won 0.09€


Winamax Poker - HOLD-UP "Colorado" - HandId: #19116069-212054-1701342853 - Holdem no limit (0.01€/0.02€) - 2023/11/30 11:14:13 UTC
Table: 'Colorado' 6-max (real money) Seat #6 is the button
Seat 1: x spoony (2.02€)
Seat 2: tequilaaaa (2.07€)
Seat 3: rogabi (2€)
Seat 4: Fried Berg (1.02€)
Seat 5: Yakari raise (2.12€)
Seat 6: JFSredbaron (2.55€)
*** ANTE/BLINDS ***
x spoony posts small blind 0.01€
tequilaaaa posts big blind 0.02€
Dealt to Fried Berg [Ad 3d]
*** PRE-FLOP *** 
rogabi raises 0.04€ to 0.06€
Fried Berg calls 0.06€
Yakari raise folds
JFSredbaron folds
x spoony folds
tequilaaaa folds
*** FLOP *** [3s 3c Qs]
rogabi checks
Fried Berg bets 0.05€
rogabi calls 0.05€
*** TURN *** [3s 3c Qs][5c]
rogabi checks
Fried Berg bets 0.09€
rogabi calls 0.09€
*** RIVER *** [3s 3c Qs 5c][2h]
rogabi checks
Fried Berg bets 0.15€
rogabi calls 0.15€
*** SHOW DOWN ***
rogabi shows [4d 4s] (Two pairs : 4 and 3)
Fried Berg shows [Ad 3d] (Trips of 3)
Fried Berg collected 0.66€ from pot
*** SUMMARY ***
Total pot 0.66€ | Rake 0.07€
Board: [3s 3c Qs 5c 2h]
Seat 3: rogabi showed [4d 4s] and lost with Two pairs : 4 and 3
Seat 4: Fried Berg showed [Ad 3d] and won 0.66€ with Trips of 3


Winamax Poker - HOLD-UP "Colorado" - HandId: #19116069-212116-1701342897 - Holdem no limit (0.01€/0.02€) - 2023/11/30 11:14:57 UTC
Table: 'Colorado' 6-max (real money) Seat #6 is the button
Seat 1: Never_Giv_UP (2.01€)
Seat 2: Fried Berg (1.33€)
Seat 3: El Paellas (0.74€)
Seat 4: sportsmax006 (1.46€)
Seat 5: Erenox (1.96€)
Seat 6: Astaril (3.47€)
*** ANTE/BLINDS ***
Never_Giv_UP posts small blind 0.01€
Fried Berg posts big blind 0.02€
Dealt to Fried Berg [Td 8c]
*** PRE-FLOP *** 
El Paellas folds
sportsmax006 folds
Erenox folds
Astaril folds
Never_Giv_UP folds
Fried Berg collected 0.03€ from pot
*** SUMMARY ***
Total pot 0.03€ | No rake
Seat 2: Fried Berg (big blind) won 0.03€


Winamax Poker - HOLD-UP "Colorado" - HandId: #19116069-212127-1701342906 - Holdem no limit (0.01€/0.02€) - 2023/11/30 11:15:06 UTC
Table: 'Colorado' 6-max (real money) Seat #6 is the button
Seat 1: Fried Berg (1.34€)
Seat 2: Solda14 (2.15€)
Seat 3: Lunau (2.61€)
Seat 4: AlphaBlue (0.46€)
Seat 5: Siradella80 (1.03€)
Seat 6: timePLZ (2.59€)
*** ANTE/BLINDS ***
Fried Berg posts small blind 0.01€
Solda14 posts big blind 0.02€
Dealt to Fried Berg [4s 6d]
*** PRE-FLOP *** 
Lunau folds
AlphaBlue folds
Siradella80 folds
timePLZ folds
Fried Berg folds
Solda14 collected 0.03€ from pot
*** SUMMARY ***
Total pot 0.03€ | No rake
Seat 2: Solda14 (big blind) won 0.03€


Winamax Poker - HOLD-UP "Colorado" - HandId: #19116069-212147-1701342919 - Holdem no limit (0.01€/0.02€) - 2023/11/30 11:15:19 UTC
Table: 'Colorado' 6-max (real money) Seat #6 is the button
Seat 1: A. Baiunas (2.14€)
Seat 2: Fried Berg (1.33€)
Seat 3: _Croute_ (3.86€)
Seat 4: Raging.Full (1.78€)
Seat 5: JFSredbaron (2.52€)
Seat 6: Bouddhabouda (0.72€)
*** ANTE/BLINDS ***
A. Baiunas posts small blind 0.01€
Fried Berg posts big blind 0.02€
Dealt to Fried Berg [9h Qh]
*** PRE-FLOP *** 
_Croute_ folds
Raging.Full folds
JFSredbaron folds
Bouddhabouda folds
A. Baiunas folds
Fried Berg collected 0.03€ from pot
*** SUMMARY ***
Total pot 0.03€ | No rake
Seat 2: Fried Berg (big blind) won 0.03€


Winamax Poker - HOLD-UP "Colorado" - HandId: #19116069-212162-1701342927 - Holdem no limit (0.01€/0.02€) - 2023/11/30 11:15:27 UTC
Table: 'Colorado' 6-max (real money) Seat #6 is the button
Seat 1: timePLZ (2€)
Seat 2: JFSredbaron (2.04€)
Seat 3: charlotte35. (0.26€)
Seat 4: bandarra8520 (6.63€)
Seat 5: KON-2-PEUTE (3.62€)
Seat 6: Fried Berg (1.34€)
*** ANTE/BLINDS ***
timePLZ posts small blind 0.01€
JFSredbaron posts big blind 0.02€
Dealt to Fried Berg [3h Th]
*** PRE-FLOP *** 
charlotte35. calls 0.02€
bandarra8520 folds
KON-2-PEUTE folds
Fried Berg folds
timePLZ folds
JFSredbaron checks
*** FLOP *** [8s Jc 9s]
JFSredbaron checks
charlotte35. bets 0.24€ and is all-in
JFSredbaron folds
charlotte35. collected 0.28€ from pot
*** SUMMARY ***
Total pot 0.28€ | Rake 0.01€
Board: [8s Jc 9s]
Seat 3: charlotte35. won 0.28€


Winamax Poker - HOLD-UP "Colorado" - HandId: #19116069-212187-1701342941 - Holdem no limit (0.01€/0.02€) - 2023/11/30 11:15:41 UTC
Table: 'Colorado' 6-max (real money) Seat #6 is the button
Seat 1: fab19641964 (0.51€)
Seat 2: Yakari raise (2€)
Seat 3: Mouaxx (3.12€)
Seat 4: Fried Berg (1.34€)
Seat 5: PC_Mister (2.65€)
Seat 6: Nikthefish (2.10€)
*** ANTE/BLINDS ***
fab19641964 posts small blind 0.01€
Yakari raise posts big blind 0.02€
Dealt to Fried Berg [9s 6s]
*** PRE-FLOP *** 
Mouaxx folds
Fried Berg calls 0.02€
PC_Mister raises 0.06€ to 0.08€
Nikthefish folds
fab19641964 folds
Yakari raise folds
Fried Berg calls 0.06€
*** FLOP *** [Ks 4h Ah]
Fried Berg checks
PC_Mister bets 0.05€
Fried Berg folds
PC_Mister collected 0.22€ from pot
*** SUMMARY ***
Total pot 0.22€ | Rake 0.02€
Board: [Ks 4h Ah]
Seat 5: PC_Mister won 0.22€


Winamax Poker - HOLD-UP "Colorado" - HandId: #19116069-212252-1701342979 - Holdem no limit (0.01€/0.02€) - 2023/11/30 11:16:19 UTC
Table: 'Colorado' 6-max (real money) Seat #6 is the button
Seat 1: Antho-B-69 (3.98€)
Seat 2: zozo6750 (1.36€)
Seat 3: rogabi (2€)
Seat 4: JFSredbaron (2.36€)
Seat 5: Fried Berg (1.26€)
Seat 6: El Paellas (0.50€)
*** ANTE/BLINDS ***
Antho-B-69 posts small blind 0.01€
zozo6750 posts big blind 0.02€
Dealt to Fried Berg [6d Ks]
*** PRE-FLOP *** 
rogabi folds
JFSredbaron folds
Fried Berg folds
El Paellas folds
Antho-B-69 folds
zozo6750 collected 0.03€ from pot
*** SUMMARY ***
Total pot 0.03€ | No rake
Seat 2: zozo6750 (big blind) won 0.03€


Winamax Poker - HOLD-UP "Colorado" - HandId: #19116069-212272-1701342991 - Holdem no limit (0.01€/0.02€) - 2023/11/30 11:16:31 UTC
Table: 'Colorado' 6-max (real money) Seat #6 is the button
Seat 1: Fried Berg (1.26€)
Seat 2: Joan009 (2.80€)
Seat 3: Bouddhabouda (0.72€)
Seat 4: totomax22 (2€)
Seat 5: OuchSteve (2€)
Seat 6: Jneb34b (0.84€)
*** ANTE/BLINDS ***
Fried Berg posts small blind 0.01€
Joan009 posts big blind 0.02€
Dealt to Fried Berg [Tc Kh]
*** PRE-FLOP *** 
Bouddhabouda folds
totomax22 folds
OuchSteve folds
Jneb34b folds
Fried Berg raises 0.02€ to 0.04€
Joan009 folds
Fried Berg collected 0.06€ from pot
*** SUMMARY ***
Total pot 0.06€ | No rake
Seat 1: Fried Berg (small blind) won 0.06€


Winamax Poker - HOLD-UP "Colorado" - HandId: #19116069-212305-1701343012 - Holdem no limit (0.01€/0.02€) - 2023/11/30 11:16:52 UTC
Table: 'Colorado' 6-max (real money) Seat #6 is the button
Seat 1: Nikthefish (2.01€)
Seat 2: Joan009 (2.87€)
Seat 3: Berig (1.94€)
Seat 4: haouuum28 (2.43€)
Seat 5: timePLZ (2.03€)
Seat 6: Fried Berg (1.28€)
*** ANTE/BLINDS ***
Nikthefish posts small blind 0.01€
Joan009 posts big blind 0.02€
Dealt to Fried Berg [5s 5c]
*** PRE-FLOP *** 
Berig folds
haouuum28 folds
timePLZ raises 0.03€ to 0.05€
Fried Berg calls 0.05€
Nikthefish calls 0.04€
Joan009 calls 0.03€
*** FLOP *** [Ts 8d Qs]
Nikthefish checks
Joan009 checks
timePLZ bets 0.07€
Fried Berg folds
Nikthefish folds
Joan009 calls 0.07€
*** TURN *** [Ts 8d Qs][2h]
Joan009 checks
timePLZ bets 0.34€
Joan009 folds
timePLZ collected 0.65€ from pot
*** SUMMARY ***
Total pot 0.65€ | Rake 0.03€
Board: [Ts 8d Qs 2h]
Seat 5: timePLZ won 0.65€


Winamax Poker - HOLD-UP "Colorado" - HandId: #19116069-212358-1701343058 - Holdem no limit (0.01€/0.02€) - 2023/11/30 11:17:38 UTC
Table: 'Colorado' 6-max (real money) Seat #6 is the button
Seat 1: Fried Berg (1.23€)
Seat 2: Keossko (2.33€)
Seat 3: Pierrof24 (4.04€)
Seat 4: CB-Joker6274 (3.63€)
Seat 5: KingSoto (1.97€)
Seat 6: rogabi (2.19€)
*** ANTE/BLINDS ***
Fried Berg posts small blind 0.01€
Keossko posts big blind 0.02€
Dealt to Fried Berg [Qs 4s]
*** PRE-FLOP *** 
Pierrof24 folds
CB-Joker6274 folds
KingSoto folds
rogabi raises 0.03€ to 0.05€
Fried Berg calls 0.04€
Keossko folds
*** FLOP *** [8h 9c 3d]
Fried Berg checks
rogabi checks
*** TURN *** [8h 9c 3d][Jd]
Fried Berg checks
rogabi checks
*** RIVER *** [8h 9c 3d Jd][4c]
Fried Berg bets 0.04€
rogabi folds
Fried Berg collected 0.15€ from pot
*** SUMMARY ***
Total pot 0.15€ | Rake 0.01€
Board: [8h 9c 3d Jd 4c]
Seat 1: Fried Berg (small blind) won 0.15€


Winamax Poker - HOLD-UP "Colorado" - HandId: #19116069-212420-1701343104 - Holdem no limit (0.01€/0.02€) - 2023/11/30 11:18:24 UTC
Table: 'Colorado' 6-max (real money) Seat #6 is the button
Seat 1: Joan009 (2.74€)
Seat 2: sportsmax006 (1.40€)
Seat 3: Fried Berg (1.29€)
Seat 4: ninoujacou (0.63€)
Seat 5: Jneb34b (0.77€)
Seat 6: Pierrof24 (4.46€)
*** ANTE/BLINDS ***
Joan009 posts small blind 0.01€
sportsmax006 posts big blind 0.02€
Dealt to Fried Berg [Qh 3h]
*** PRE-FLOP *** 
Fried Berg folds
ninoujacou folds
Jneb34b folds
Pierrof24 raises 0.02€ to 0.04€
Joan009 folds
sportsmax006 folds
Pierrof24 collected 0.07€ from pot
*** SUMMARY ***
Total pot 0.07€ | No rake
Seat 6: Pierrof24 (button) won 0.07€


Winamax Poker - HOLD-UP "Colorado" - HandId: #19116069-212430-1701343111 - Holdem no limit (0.01€/0.02€) - 2023/11/30 11:18:31 UTC
Table: 'Colorado' 6-max (real money) Seat #6 is the button
Seat 1: ricki64 (1.80€)
Seat 2: rogabi (2.69€)
Seat 3: Keossko (1.31€)
Seat 4: Mouaxx (2.52€)
Seat 5: Fried Berg (1.29€)
Seat 6: Nikthefish (2.06€)
Hold-up to Pot: total 0.10€
*** ANTE/BLINDS ***
ricki64 posts small blind 0.01€
rogabi posts big blind 0.02€
Dealt to Fried Berg [Ts 2d]
*** PRE-FLOP *** 
Keossko raises 1.29€ to 1.31€ and is all-in
Mouaxx calls 1.31€
Fried Berg folds
Nikthefish folds
ricki64 raises 0.49€ to 1.80€ and is all-in
rogabi folds
Mouaxx calls 0.49€
*** FLOP *** [As 6d 8d]
*** TURN *** [As 6d 8d][Qs]
*** RIVER *** [As 6d 8d Qs][4c]
*** SHOW DOWN ***
ricki64 shows [3h 3c] (One pair : 3)
Keossko shows [9s Qc] (One pair : Queens)
Mouaxx shows [Ac Kc] (One pair : Aces)
Mouaxx collected 4.54€ from pot
*** SUMMARY ***
Total pot 4.54€ | Rake 0.49€
Board: [As 6d 8d Qs 4c]
Seat 1: ricki64 (small blind) showed [3h 3c] and lost with One pair : 3
Seat 3: Keossko showed [9s Qc] and lost with One pair : Queens
Seat 4: Mouaxx showed [Ac Kc] and won 4.54€ with One pair : Aces


Winamax Poker - HOLD-UP "Colorado" - HandId: #19116069-212443-1701343121 - Holdem no limit (0.01€/0.02€) - 2023/11/30 11:18:41 UTC
Table: 'Colorado' 6-max (real money) Seat #6 is the button
Seat 1: Fried Berg (1.29€)
Seat 2: Joan009 (2.73€)
Seat 3: Berig (2.12€)
Seat 4: KON-2-PEUTE (3.52€)
Seat 5: haouuum28 (2.19€)
Seat 6: cybok20001 (1.02€)
Hold-up to Pot: total 0.20€
*** ANTE/BLINDS ***
Fried Berg posts small blind 0.01€
Joan009 posts big blind 0.02€
Dealt to Fried Berg [Tc 8d]
*** PRE-FLOP *** 
Berig calls 0.02€
KON-2-PEUTE calls 0.02€
haouuum28 calls 0.02€
cybok20001 raises 0.06€ to 0.08€
Fried Berg folds
Joan009 calls 0.06€
Berig calls 0.06€
KON-2-PEUTE calls 0.06€
haouuum28 folds
*** FLOP *** [4d 9c 6c]
Joan009 checks
Berig checks
KON-2-PEUTE checks
cybok20001 checks
*** TURN *** [4d 9c 6c][8h]
Joan009 checks
Berig checks
KON-2-PEUTE checks
cybok20001 checks
*** RIVER *** [4d 9c 6c 8h][Kh]
Joan009 checks
Berig checks
KON-2-PEUTE checks
cybok20001 checks
*** SHOW DOWN ***
Berig shows [Jd 2d] (High card : King)
KON-2-PEUTE shows [Th Ad] (High card : Ace)
cybok20001 shows [Ah Qc] (High card : Ace)
Joan009 shows [7d Kd] (One pair : Kings)
Joan009 collected 0.51€ from pot
*** SUMMARY ***
Total pot 0.51€ | Rake 0.04€
Board: [4d 9c 6c 8h Kh]
Seat 2: Joan009 (big blind) showed [7d Kd] and won 0.51€ with One pair : Kings
Seat 3: Berig showed [Jd 2d] and lost with High card : King
Seat 4: KON-2-PEUTE showed [Th Ad] and lost with High card : Ace
Seat 6: cybok20001 (button) showed [Ah Qc] and lost with High card : Ace


Winamax Poker - HOLD-UP "Colorado" - HandId: #19116069-212471-1701343146 - Holdem no limit (0.01€/0.02€) - 2023/11/30 11:19:06 UTC
Table: 'Colorado' 6-max (real money) Seat #6 is the button
Seat 1: Champhype (2.10€)
Seat 2: Fried Berg (1.28€)
Seat 3: Hug2579 (0.50€)
Seat 4: toka30 (2.27€)
Seat 5: fifi2308 (2.22€)
Seat 6: timePLZ (2.61€)
*** ANTE/BLINDS ***
Champhype posts small blind 0.01€
Fried Berg posts big blind 0.02€
Dealt to Fried Berg [Jd 4c]
*** PRE-FLOP *** 
Hug2579 folds
toka30 raises 0.04€ to 0.06€
fifi2308 calls 0.06€
timePLZ folds
Champhype folds
Fried Berg folds
*** FLOP *** [7c 2h 8d]
toka30 checks
fifi2308 bets 0.15€
toka30 calls 0.15€
*** TURN *** [7c 2h 8d][9c]
toka30 checks
fifi2308 bets 0.61€
toka30 raises 1.45€ to 2.06€ and is all-in
fifi2308 calls 1.40€ and is all-in
*** RIVER *** [7c 2h 8d 9c][6d]
*** SHOW DOWN ***
toka30 shows [Kh Kd] (One pair : Kings)
fifi2308 shows [8s 8h] (Trips of 8)
fifi2308 collected 4.02€ from main pot
toka30 collected 0.05€ from side pot 1
*** SUMMARY ***
Total pot 4.07€ | Rake 0.45€
Board: [7c 2h 8d 9c 6d]
Seat 4: toka30 showed [Kh Kd] and won 0.05€ with One pair : Kings
Seat 5: fifi2308 showed [8s 8h] and won 4.02€ with Trips of 8


Winamax Poker - HOLD-UP "Colorado" - HandId: #19116069-212477-1701343150 - Holdem no limit (0.01€/0.02€) - 2023/11/30 11:19:10 UTC
Table: 'Colorado' 6-max (real money) Seat #6 is the button
Seat 1: Jimmy91lenny (2€)
Seat 2: _Croute_ (3.68€)
Seat 3: Fried Berg (1.26€)
Seat 4: txalintxo (1.81€)
Seat 5: Astaril (3.62€)
Seat 6: KingSoto (1.92€)
*** ANTE/BLINDS ***
Jimmy91lenny posts small blind 0.01€
_Croute_ posts big blind 0.02€
Dealt to Fried Berg [5d Kh]
*** PRE-FLOP *** 
Fried Berg folds
txalintxo folds
Astaril raises 0.03€ to 0.05€
KingSoto folds
Jimmy91lenny calls 0.04€
_Croute_ folds
*** FLOP *** [5h 2c 2d]
Jimmy91lenny checks
Astaril bets 0.06€
Jimmy91lenny folds
Astaril collected 0.17€ from pot
*** SUMMARY ***
Total pot 0.17€ | Rake 0.01€
Board: [5h 2c 2d]
Seat 5: Astaril won 0.17€


Winamax Poker - HOLD-UP "Colorado" - HandId: #19116069-212482-1701343153 - Holdem no limit (0.01€/0.02€) - 2023/11/30 11:19:13 UTC
Table: 'Colorado' 6-max (real money) Seat #6 is the button
Seat 1: _Croute_ (3.66€)
Seat 2: Pierrof24 (3.66€)
Seat 3: Bilderbet (2.23€)
Seat 4: X3a26J23i54 (1.83€)
Seat 5: Fried Berg (1.26€)
Seat 6: txalintxo (1.81€)
Hold-up to Pot: total 0.20€
*** ANTE/BLINDS ***
_Croute_ posts small blind 0.01€
Pierrof24 posts big blind 0.02€
Dealt to Fried Berg [Th Ac]
*** PRE-FLOP *** 
Bilderbet folds
X3a26J23i54 folds
Fried Berg raises 0.08€ to 0.10€
txalintxo folds
_Croute_ folds
Pierrof24 folds
Fried Berg collected 0.33€ from pot
*** SUMMARY ***
Total pot 0.33€ | No rake
Seat 5: Fried Berg won 0.33€


Winamax Poker - HOLD-UP "Colorado" - HandId: #19116069-212515-1701343178 - Holdem no limit (0.01€/0.02€) - 2023/11/30 11:19:38 UTC
Table: 'Colorado' 6-max (real money) Seat #6 is the button
Seat 1: Fried Berg (1.49€)
Seat 2: SirX (0.76€)
Seat 3: haouuum28 (2.17€)
Seat 4: Yakari raise (2.05€)
Seat 5: Pierrof24 (4.52€)
Seat 6: .PROMETHEUS. (1.50€)
*** ANTE/BLINDS ***
Fried Berg posts small blind 0.01€
SirX posts big blind 0.02€
Dealt to Fried Berg [9c 8d]
*** PRE-FLOP *** 
haouuum28 folds
Yakari raise raises 0.03€ to 0.05€
Pierrof24 folds
.PROMETHEUS. folds
Fried Berg calls 0.04€
SirX calls 0.03€
*** FLOP *** [8s 3d Kc]
Fried Berg checks
SirX checks
Yakari raise bets 0.07€
Fried Berg calls 0.07€
SirX calls 0.07€
*** TURN *** [8s 3d Kc][4c]
Fried Berg checks
SirX checks
Yakari raise bets 0.22€
Fried Berg folds
SirX calls 0.22€
*** RIVER *** [8s 3d Kc 4c][Ah]
SirX checks
Yakari raise checks
*** SHOW DOWN ***
SirX shows [Th 3h] (One pair : 3)
Yakari raise shows [Kh Jh] (One pair : Kings)
Yakari raise collected 0.72€ from pot
*** SUMMARY ***
Total pot 0.72€ | Rake 0.08€
Board: [8s 3d Kc 4c Ah]
Seat 2: SirX (big blind) showed [Th 3h] and lost with One pair : 3
Seat 4: Yakari raise showed [Kh Jh] and won 0.72€ with One pair : Kings


Winamax Poker - HOLD-UP "Colorado" - HandId: #19116069-212632-1701343264 - Holdem no limit (0.01€/0.02€) - 2023/11/30 11:21:04 UTC
Table: 'Colorado' 6-max (real money) Seat #6 is the button
Seat 1: SirX (0.42€)
Seat 2: AlphaBlue (0.44€)
Seat 3: Solda14 (2.16€)
Seat 4: haouuum28 (2.26€)
Seat 5: timePLZ (2.54€)
Seat 6: Fried Berg (1.37€)
*** ANTE/BLINDS ***
SirX posts small blind 0.01€
AlphaBlue posts big blind 0.02€
Dealt to Fried Berg [Ac As]
*** PRE-FLOP *** 
Solda14 raises 0.04€ to 0.06€
haouuum28 folds
timePLZ folds
Fried Berg raises 0.12€ to 0.18€
SirX folds
AlphaBlue folds
Solda14 folds
Fried Berg collected 0.27€ from pot
*** SUMMARY ***
Total pot 0.27€ | No rake
Seat 6: Fried Berg (button) won 0.27€


Winamax Poker - HOLD-UP "Colorado" - HandId: #19116069-212668-1701343291 - Holdem no limit (0.01€/0.02€) - 2023/11/30 11:21:31 UTC
Table: 'Colorado' 6-max (real money) Seat #6 is the button
Seat 1: Solda14 (2.10€)
Seat 2: NoStopLoss (2.43€)
Seat 3: Fried Berg (1.46€)
Seat 4: Hug2579 (0.50€)
Seat 5: txalintxo (1.70€)
Seat 6: haouuum28 (2.45€)
*** ANTE/BLINDS ***
Solda14 posts small blind 0.01€
NoStopLoss posts big blind 0.02€
Dealt to Fried Berg [9c 2s]
*** PRE-FLOP *** 
Fried Berg folds
Hug2579 folds
txalintxo folds
haouuum28 folds
Solda14 calls 0.01€
NoStopLoss checks
*** FLOP *** [5s Th Ac]
Solda14 bets 0.07€
NoStopLoss folds
Solda14 collected 0.11€ from pot
*** SUMMARY ***
Total pot 0.11€ | No rake
Board: [5s Th Ac]
Seat 1: Solda14 (small blind) won 0.11€


Winamax Poker - HOLD-UP "Colorado" - HandId: #19116069-212673-1701343294 - Holdem no limit (0.01€/0.02€) - 2023/11/30 11:21:34 UTC
Table: 'Colorado' 6-max (real money) Seat #6 is the button
Seat 1: PEPEKA (3.93€)
Seat 2: Yakari raise (2.46€)
Seat 3: Boman16 (2.26€)
Seat 4: Fried Berg (1.46€)
Seat 5: Raging.Full (1.90€)
Seat 6: KON-2-PEUTE (3.20€)
*** ANTE/BLINDS ***
PEPEKA posts small blind 0.01€
Yakari raise posts big blind 0.02€
Dealt to Fried Berg [9s 8d]
*** PRE-FLOP *** 
Boman16 raises 0.04€ to 0.06€
Fried Berg folds
Raging.Full folds
KON-2-PEUTE folds
PEPEKA calls 0.05€
Yakari raise folds
*** FLOP *** [3d Qc 7h]
PEPEKA checks
Boman16 checks
*** TURN *** [3d Qc 7h][Ac]
PEPEKA bets 0.06€
Boman16 calls 0.06€
*** RIVER *** [3d Qc 7h Ac][2d]
PEPEKA bets 0.21€
Boman16 calls 0.21€
*** SHOW DOWN ***
PEPEKA shows [Ad Ts] (One pair : Aces)
Boman16 shows [As Js] (One pair : Aces)
Boman16 collected 0.61€ from pot
*** SUMMARY ***
Total pot 0.61€ | Rake 0.07€
Board: [3d Qc 7h Ac 2d]
Seat 1: PEPEKA (small blind) showed [Ad Ts] and lost with One pair : Aces
Seat 3: Boman16 showed [As Js] and won 0.61€ with One pair : Aces


Winamax Poker - HOLD-UP "Colorado" - HandId: #19116069-212683-1701343300 - Holdem no limit (0.01€/0.02€) - 2023/11/30 11:21:40 UTC
Table: 'Colorado' 6-max (real money) Seat #6 is the button
Seat 1: Brut2pok (2.01€)
Seat 2: Fried Berg (1.46€)
Seat 3: Filet-O-fils (2.75€)
Seat 4: zozo6750 (1.14€)
Seat 5: JFSredbaron (2€)
Seat 6: Jneb34b (0.79€)
*** ANTE/BLINDS ***
Brut2pok posts small blind 0.01€
Fried Berg posts big blind 0.02€
Dealt to Fried Berg [6c 3s]
*** PRE-FLOP *** 
Filet-O-fils folds
zozo6750 folds
JFSredbaron folds
Jneb34b folds
Brut2pok folds
Fried Berg collected 0.03€ from pot
*** SUMMARY ***
Total pot 0.03€ | No rake
Seat 2: Fried Berg (big blind) won 0.03€


Winamax Poker - HOLD-UP "Colorado" - HandId: #19116069-212699-1701343312 - Holdem no limit (0.01€/0.02€) - 2023/11/30 11:21:52 UTC
Table: 'Colorado' 6-max (real money) Seat #6 is the button
Seat 1: Brut2pok (2€)
Seat 2: JFSredbaron (2€)
Seat 3: Fried Berg (1.47€)
Seat 4: Hydramist (2.03€)
Seat 5: ZenoidZ (3.69€)
Seat 6: Amazigh 78 (0.93€)
*** ANTE/BLINDS ***
Brut2pok posts small blind 0.01€
JFSredbaron posts big blind 0.02€
Dealt to Fried Berg [6c 9c]
*** PRE-FLOP *** 
Fried Berg calls 0.02€
Hydramist folds
ZenoidZ folds
Amazigh 78 folds
Brut2pok folds
JFSredbaron checks
*** FLOP *** [8c 2d 2s]
JFSredbaron checks
Fried Berg checks
*** TURN *** [8c 2d 2s][2c]
JFSredbaron checks
Fried Berg checks
*** RIVER *** [8c 2d 2s 2c][As]
JFSredbaron checks
Fried Berg bets 0.04€
JFSredbaron folds
Fried Berg collected 0.08€ from pot
*** SUMMARY ***
Total pot 0.08€ | Rake 0.01€
Board: [8c 2d 2s 2c As]
Seat 3: Fried Berg won 0.08€


Winamax Poker - HOLD-UP "Colorado" - HandId: #19116069-212758-1701343357 - Holdem no limit (0.01€/0.02€) - 2023/11/30 11:22:37 UTC
Table: 'Colorado' 6-max (real money) Seat #6 is the button
Seat 1: crabaudeur (1.75€)
Seat 2: KON-2-PEUTE (5.88€)
Seat 3: JissEl1te (3.07€)
Seat 4: Fried Berg (1.49€)
Seat 5: X3a26J23i54 (1.59€)
Seat 6: Boman16 (2.51€)
*** ANTE/BLINDS ***
crabaudeur posts small blind 0.01€
KON-2-PEUTE posts big blind 0.02€
Dealt to Fried Berg [5d Qh]
*** PRE-FLOP *** 
JissEl1te folds
Fried Berg folds
X3a26J23i54 folds
Boman16 raises 0.03€ to 0.05€
crabaudeur calls 0.04€
KON-2-PEUTE folds
*** FLOP *** [Jd 5s 4c]
crabaudeur checks
Boman16 bets 0.04€
crabaudeur calls 0.04€
*** TURN *** [Jd 5s 4c][Qc]
crabaudeur checks
Boman16 bets 0.13€
crabaudeur folds
Boman16 collected 0.31€ from pot
*** SUMMARY ***
Total pot 0.31€ | Rake 0.02€
Board: [Jd 5s 4c Qc]
Seat 6: Boman16 (button) won 0.31€


Winamax Poker - HOLD-UP "Colorado" - HandId: #19116069-212766-1701343362 - Holdem no limit (0.01€/0.02€) - 2023/11/30 11:22:42 UTC
Table: 'Colorado' 6-max (real money) Seat #6 is the button
Seat 1: Fried Berg (1.49€)
Seat 2: zozo6750 (0.35€)
Seat 3: g8o8k8u (2.87€)
Seat 4: grut28 (3.59€)
Seat 5: Pierrof24 (3.58€)
Seat 6: rogabi (2.25€)
*** ANTE/BLINDS ***
Fried Berg posts small blind 0.01€
zozo6750 posts big blind 0.02€
Dealt to Fried Berg [3d 5s]
*** PRE-FLOP *** 
g8o8k8u folds
grut28 folds
Pierrof24 folds
rogabi folds
Fried Berg folds
zozo6750 collected 0.03€ from pot
*** SUMMARY ***
Total pot 0.03€ | No rake
Seat 2: zozo6750 (big blind) won 0.03€


Winamax Poker - HOLD-UP "Colorado" - HandId: #19116069-212774-1701343370 - Holdem no limit (0.01€/0.02€) - 2023/11/30 11:22:50 UTC
Table: 'Colorado' 6-max (real money) Seat #6 is the button
Seat 1: Kira17 (3.22€)
Seat 2: Bilderbet (2.05€)
Seat 3: Yakari raise (2€)
Seat 4: AfgaBoBpoKer (1.59€)
Seat 5: Fried Berg (1.48€)
Seat 6: Mouaxx (1.21€)
*** ANTE/BLINDS ***
Kira17 posts small blind 0.01€
Bilderbet posts big blind 0.02€
Dealt to Fried Berg [7c 6c]
*** PRE-FLOP *** 
Yakari raise raises 0.03€ to 0.05€
AfgaBoBpoKer folds
Fried Berg calls 0.05€
Mouaxx folds
Kira17 folds
Bilderbet folds
*** FLOP *** [3s 6h 4s]
Yakari raise bets 0.05€
Fried Berg calls 0.05€
*** TURN *** [3s 6h 4s][6s]
Yakari raise bets 0.13€
Fried Berg calls 0.13€
*** RIVER *** [3s 6h 4s 6s][4h]
Yakari raise bets 0.37€
Fried Berg calls 0.37€
*** SHOW DOWN ***
Yakari raise shows [Qs Js] (Flush Queen high)
Fried Berg shows [7c 6c] (Full of 6 and 4)
Fried Berg collected 1.11€ from pot
*** SUMMARY ***
Total pot 1.11€ | Rake 0.12€
Board: [3s 6h 4s 6s 4h]
Seat 3: Yakari raise showed [Qs Js] and lost with Flush Queen high
Seat 5: Fried Berg showed [7c 6c] and won 1.11€ with Full of 6 and 4


Winamax Poker - HOLD-UP "Colorado" - HandId: #19116069-212830-1701343417 - Holdem no limit (0.01€/0.02€) - 2023/11/30 11:23:37 UTC
Table: 'Colorado' 6-max (real money) Seat #6 is the button
Seat 1: NoStopLoss (3.80€)
Seat 2: emojipok (0.50€)
Seat 3: Blurran (0.33€)
Seat 4: Holiap (2€)
Seat 5: Astaril (3.44€)
Seat 6: Fried Berg (1.99€)
*** ANTE/BLINDS ***
NoStopLoss posts small blind 0.01€
emojipok posts big blind 0.02€
Dealt to Fried Berg [Tc Kd]
*** PRE-FLOP *** 
Blurran folds
Holiap folds
Astaril folds
Fried Berg raises 0.02€ to 0.04€
NoStopLoss raises 0.12€ to 0.16€
emojipok folds
Fried Berg calls 0.12€
*** FLOP *** [7d 8s 5s]
NoStopLoss checks
Fried Berg checks
*** TURN *** [7d 8s 5s][Jh]
NoStopLoss bets 0.06€
Fried Berg calls 0.06€
*** RIVER *** [7d 8s 5s Jh][3d]
NoStopLoss checks
Fried Berg checks
*** SHOW DOWN ***
Fried Berg shows [Tc Kd] (High card : King)
NoStopLoss shows [Qd Ad] (High card : Ace)
NoStopLoss collected 0.41€ from pot
*** SUMMARY ***
Total pot 0.41€ | Rake 0.05€
Board: [7d 8s 5s Jh 3d]
Seat 1: NoStopLoss (small blind) showed [Qd Ad] and won 0.41€ with High card : Ace
Seat 6: Fried Berg (button) showed [Tc Kd] and lost with High card : King


Winamax Poker - HOLD-UP "Colorado" - HandId: #19116069-212875-1701343456 - Holdem no limit (0.01€/0.02€) - 2023/11/30 11:24:16 UTC
Table: 'Colorado' 6-max (real money) Seat #6 is the button
Seat 1: Jimmy91lenny (1.86€)
Seat 2: Fried Berg (1.77€)
Seat 3: Berig (1.94€)
Seat 4: NoStopLoss (3.99€)
Seat 5: KON-2-PEUTE (5.82€)
Seat 6: sportsmax006 (1.71€)
Hold-up to Pot: total 0.20€
*** ANTE/BLINDS ***
Jimmy91lenny posts small blind 0.01€
Fried Berg posts big blind 0.02€
Dealt to Fried Berg [Kd Ad]
*** PRE-FLOP *** 
Berig calls 0.02€
NoStopLoss folds
KON-2-PEUTE calls 0.02€
sportsmax006 folds
Jimmy91lenny raises 0.28€ to 0.30€
Fried Berg calls 0.28€
Berig folds
KON-2-PEUTE folds
*** FLOP *** [3s 4s 6c]
Jimmy91lenny checks
Fried Berg checks
*** TURN *** [3s 4s 6c][4h]
Jimmy91lenny checks
Fried Berg checks
*** RIVER *** [3s 4s 6c 4h][9h]
Jimmy91lenny checks
Fried Berg checks
*** SHOW DOWN ***
Jimmy91lenny shows [Kc Jc] (One pair : 4)
Fried Berg shows [Kd Ad] (One pair : 4)
Fried Berg collected 0.78€ from pot
*** SUMMARY ***
Total pot 0.78€ | Rake 0.06€
Board: [3s 4s 6c 4h 9h]
Seat 1: Jimmy91lenny (small blind) showed [Kc Jc] and lost with One pair : 4
Seat 2: Fried Berg (big blind) showed [Kd Ad] and won 0.78€ with One pair : 4


Winamax Poker - HOLD-UP "Colorado" - HandId: #19116069-212918-1701343491 - Holdem no limit (0.01€/0.02€) - 2023/11/30 11:24:51 UTC
Table: 'Colorado' 6-max (real money) Seat #6 is the button
Seat 1: NoStopLoss (2.26€)
Seat 2: Holiap (2.09€)
Seat 3: Fried Berg (2.25€)
Seat 4: Jimmy91lenny (1.56€)
Seat 5: KON-2-PEUTE (5.80€)
Seat 6: Champhype (3.78€)
Hold-up to Pot: total 0.10€
*** ANTE/BLINDS ***
NoStopLoss posts small blind 0.01€
Holiap posts big blind 0.02€
Dealt to Fried Berg [5d 5s]
*** PRE-FLOP *** 
Fried Berg calls 0.02€
Jimmy91lenny folds
KON-2-PEUTE calls 0.02€
Champhype folds
NoStopLoss raises 0.04€ to 0.06€
Holiap folds
Fried Berg calls 0.04€
KON-2-PEUTE calls 0.04€
*** FLOP *** [4s 5c 8s]
NoStopLoss bets 0.06€
Fried Berg calls 0.06€
KON-2-PEUTE folds
*** TURN *** [4s 5c 8s][8c]
NoStopLoss checks
Fried Berg checks
*** RIVER *** [4s 5c 8s 8c][Kc]
NoStopLoss checks
Fried Berg bets 0.15€
NoStopLoss folds
Fried Berg collected 0.54€ from pot
*** SUMMARY ***
Total pot 0.54€ | Rake 0.03€
Board: [4s 5c 8s 8c Kc]
Seat 3: Fried Berg won 0.54€


Winamax Poker - HOLD-UP "Colorado" - HandId: #19116069-212978-1701343541 - Holdem no limit (0.01€/0.02€) - 2023/11/30 11:25:41 UTC
Table: 'Colorado' 6-max (real money) Seat #6 is the button
Seat 1: KOMParHASARD (2€)
Seat 2: MCGHansen (2.80€)
Seat 3: J.C Deuces.0 (2.78€)
Seat 4: Fried Berg (2.52€)
Seat 5: rogabi (2.31€)
Seat 6: Pierrof24 (4.04€)
*** ANTE/BLINDS ***
KOMParHASARD posts small blind 0.01€
MCGHansen posts big blind 0.02€
Dealt to Fried Berg [5h 7s]
*** PRE-FLOP *** 
J.C Deuces.0 folds
Fried Berg folds
rogabi raises 0.04€ to 0.06€
Pierrof24 calls 0.06€
KOMParHASARD folds
MCGHansen raises 0.16€ to 0.22€
rogabi calls 0.16€
Pierrof24 folds
*** FLOP *** [Qh Ks Kd]
MCGHansen bets 0.07€
rogabi calls 0.07€
*** TURN *** [Qh Ks Kd][8s]
MCGHansen checks
rogabi bets 0.52€
MCGHansen folds
rogabi collected 1.10€ from pot
*** SUMMARY ***
Total pot 1.10€ | Rake 0.07€
Board: [Qh Ks Kd 8s]
Seat 5: rogabi won 1.10€


