Winamax Poker - HOLD-UP "Colorado" - HandId: #19116069-775374-1701768777 - Holdem no limit (0.01€/0.02€) - 2023/12/05 09:32:57 UTC
Table: 'Colorado' 6-max (real money) Seat #6 is the button
Seat 1: HOTGAME (1.20€)
Seat 2: Fried Berg (0.50€)
Seat 3: AdiTheKing (1.86€)
Seat 4: Neferusobek (2.28€)
Seat 5: D_A_R_K_ (2.85€)
Seat 6: Pierrof24 (2€)
*** ANTE/BLINDS ***
HOTGAME posts small blind 0.01€
Fried Berg posts big blind 0.02€
Dealt to Fried Berg [6d 3h]
*** PRE-FLOP *** 
AdiTheKing folds
Neferusobek folds
D_A_R_K_ folds
Pierrof24 folds
HOTGAME calls 0.01€
Fried Berg checks
*** FLOP *** [5s 9c 4h]
HOTGAME checks
Fried Berg checks
*** TURN *** [5s 9c 4h][Tc]
HOTGAME checks
Fried Berg checks
*** RIVER *** [5s 9c 4h Tc][Qs]
HOTGAME bets 0.04€
Fried Berg folds
HOTGAME collected 0.08€ from pot
*** SUMMARY ***
Total pot 0.08€ | No rake
Board: [5s 9c 4h Tc Qs]
Seat 1: HOTGAME (small blind) won 0.08€


Winamax Poker - HOLD-UP "Colorado" - HandId: #19116069-775482-1701768865 - Holdem no limit (0.01€/0.02€) - 2023/12/05 09:34:25 UTC
Table: 'Colorado' 6-max (real money) Seat #6 is the button
Seat 1: Fried Berg (0.48€)
Seat 2: Tompahmax (2.40€)
Seat 3: slowreplay (2.06€)
Seat 4: Richard Reuk (2.27€)
Seat 5: PIQSOU (2.11€)
Seat 6: nemo5 (3.28€)
*** ANTE/BLINDS ***
Fried Berg posts small blind 0.01€
Tompahmax posts big blind 0.02€
Dealt to Fried Berg [2s Qh]
*** PRE-FLOP *** 
slowreplay raises 0.03€ to 0.05€
Richard Reuk folds
PIQSOU folds
nemo5 folds
Fried Berg folds
Tompahmax folds
slowreplay collected 0.08€ from pot
*** SUMMARY ***
Total pot 0.08€ | No rake
Seat 3: slowreplay won 0.08€


Winamax Poker - HOLD-UP "Colorado" - HandId: #19116069-775503-1701768884 - Holdem no limit (0.01€/0.02€) - 2023/12/05 09:34:44 UTC
Table: 'Colorado' 6-max (real money) Seat #6 is the button
Seat 1: Tompahmax (2.41€)
Seat 2: Totolebarj (1.82€)
Seat 3: BrokBroken (2€)
Seat 4: Fried Berg (0.47€)
Seat 5: Aggro Loser (3.55€)
Seat 6: HOTGAME (1.22€)
*** ANTE/BLINDS ***
Tompahmax posts small blind 0.01€
Totolebarj posts big blind 0.02€
Dealt to Fried Berg [As 5d]
*** PRE-FLOP *** 
BrokBroken folds
Fried Berg raises 0.02€ to 0.04€
Aggro Loser raises 0.12€ to 0.16€
HOTGAME calls 0.16€
Tompahmax folds
Totolebarj folds
Fried Berg folds
*** FLOP *** [7s 5h Tc]
Aggro Loser bets 0.34€
HOTGAME raises 0.72€ to 1.06€ and is all-in
Aggro Loser calls 0.72€
*** TURN *** [7s 5h Tc][Ah]
*** RIVER *** [7s 5h Tc Ah][3s]
*** SHOW DOWN ***
HOTGAME shows [Qd Qs] (One pair : Queens)
Aggro Loser shows [Kc Kh] (One pair : Kings)
Aggro Loser collected 2.26€ from pot
*** SUMMARY ***
Total pot 2.26€ | Rake 0.25€
Board: [7s 5h Tc Ah 3s]
Seat 5: Aggro Loser showed [Kc Kh] and won 2.26€ with One pair : Kings
Seat 6: HOTGAME (button) showed [Qd Qs] and lost with One pair : Queens


Winamax Poker - HOLD-UP "Colorado" - HandId: #19116069-775536-1701768913 - Holdem no limit (0.01€/0.02€) - 2023/12/05 09:35:13 UTC
Table: 'Colorado' 6-max (real money) Seat #6 is the button
Seat 1: Ga31k (2.10€)
Seat 2: A1pha_B1oCkk (1.13€)
Seat 3: Fried Berg (0.43€)
Seat 4: biquet77 (1.97€)
Seat 5: PIQSOU (2€)
Seat 6: S-aaron24 (2€)
*** ANTE/BLINDS ***
Ga31k posts small blind 0.01€
A1pha_B1oCkk posts big blind 0.02€
Dealt to Fried Berg [Qd Qs]
*** PRE-FLOP *** 
Fried Berg raises 0.04€ to 0.06€
biquet77 folds
PIQSOU folds
S-aaron24 folds
Ga31k folds
A1pha_B1oCkk folds
Fried Berg collected 0.09€ from pot
*** SUMMARY ***
Total pot 0.09€ | No rake
Seat 3: Fried Berg won 0.09€


Winamax Poker - HOLD-UP "Colorado" - HandId: #19116069-775563-1701768939 - Holdem no limit (0.01€/0.02€) - 2023/12/05 09:35:39 UTC
Table: 'Colorado' 6-max (real money) Seat #6 is the button
Seat 1: biquet77 (1.98€)
Seat 2: PIQSOU (2.37€)
Seat 3: A1pha_B1oCkk (1.10€)
Seat 4: Ga31k (2.09€)
Seat 5: Fried Berg (0.46€)
Seat 6: MoneyGrowing (2€)
*** ANTE/BLINDS ***
biquet77 posts small blind 0.01€
PIQSOU posts big blind 0.02€
Dealt to Fried Berg [Td Ac]
*** PRE-FLOP *** 
A1pha_B1oCkk folds
Ga31k folds
Fried Berg raises 0.02€ to 0.04€
MoneyGrowing folds
biquet77 calls 0.03€
PIQSOU folds
*** FLOP *** [Jh Jc 4d]
biquet77 checks
Fried Berg bets 0.06€
biquet77 folds
Fried Berg collected 0.15€ from pot
*** SUMMARY ***
Total pot 0.15€ | Rake 0.01€
Board: [Jh Jc 4d]
Seat 5: Fried Berg won 0.15€


Winamax Poker - HOLD-UP "Colorado" - HandId: #19116069-775609-1701768981 - Holdem no limit (0.01€/0.02€) - 2023/12/05 09:36:21 UTC
Table: 'Colorado' 6-max (real money) Seat #6 is the button
Seat 1: PIQSOU (2.21€)
Seat 2: TheRealWill (3.88€)
Seat 3: Ga31k (2.03€)
Seat 4: VanDolar (2.11€)
Seat 5: -genzo- (2.46€)
Seat 6: Fried Berg (0.51€)
*** ANTE/BLINDS ***
PIQSOU posts small blind 0.01€
TheRealWill posts big blind 0.02€
Dealt to Fried Berg [8d Th]
*** PRE-FLOP *** 
Ga31k folds
VanDolar raises 0.03€ to 0.05€
-genzo- raises 0.15€ to 0.20€
Fried Berg folds
PIQSOU folds
TheRealWill folds
VanDolar calls 0.15€
*** FLOP *** [Ah 6s Kd]
VanDolar bets 0.22€
-genzo- folds
VanDolar collected 0.61€ from pot
*** SUMMARY ***
Total pot 0.61€ | Rake 0.04€
Board: [Ah 6s Kd]
Seat 4: VanDolar won 0.61€


Winamax Poker - HOLD-UP "Colorado" - HandId: #19116069-775637-1701769007 - Holdem no limit (0.01€/0.02€) - 2023/12/05 09:36:47 UTC
Table: 'Colorado' 6-max (real money) Seat #6 is the button
Seat 1: Tina117 (0.51€)
Seat 2: el_menestrel (1.91€)
Seat 3: biquet77 (1.92€)
Seat 4: Aggro Loser (4.47€)
Seat 5: Fried Berg (0.51€)
Seat 6: MoneyGrowing (2€)
Hold-up to Pot: total 0.20€
*** ANTE/BLINDS ***
Tina117 posts small blind 0.01€
el_menestrel posts big blind 0.02€
Dealt to Fried Berg [4d Jd]
*** PRE-FLOP *** 
biquet77 folds
Aggro Loser raises 0.25€ to 0.27€
Fried Berg folds
MoneyGrowing folds
Tina117 raises 0.24€ to 0.51€ and is all-in
el_menestrel raises 1.40€ to 1.91€ and is all-in
Aggro Loser folds
*** FLOP *** [2c 6c 3c]
*** TURN *** [2c 6c 3c][5s]
*** RIVER *** [2c 6c 3c 5s][7h]
*** SHOW DOWN ***
Tina117 shows [As Jh] (High card : Ace)
el_menestrel shows [Qs 9s] (High card : Queen)
el_menestrel collected 1.40€ from side pot 1
Tina117 collected 1.36€ from main pot
*** SUMMARY ***
Total pot 2.76€ | Rake 0.13€
Board: [2c 6c 3c 5s 7h]
Seat 1: Tina117 (small blind) showed [As Jh] and won 1.36€ with High card : Ace
Seat 2: el_menestrel (big blind) showed [Qs 9s] and won 1.40€ with High card : Queen


Winamax Poker - HOLD-UP "Colorado" - HandId: #19116069-775659-1701769030 - Holdem no limit (0.01€/0.02€) - 2023/12/05 09:37:10 UTC
Table: 'Colorado' 6-max (real money) Seat #6 is the button
Seat 1: Fred_FFE (0.55€)
Seat 2: Fried Berg (0.51€)
Seat 3: -genzo- (2.72€)
Seat 4: nemo5 (2.62€)
Seat 5: VanDolar (2.29€)
Seat 6: AdiTheKing (1.67€)
*** ANTE/BLINDS ***
Fred_FFE posts small blind 0.01€
Fried Berg posts big blind 0.02€
Dealt to Fried Berg [9c Kh]
*** PRE-FLOP *** 
-genzo- raises 0.04€ to 0.06€
nemo5 folds
VanDolar folds
AdiTheKing folds
Fred_FFE folds
Fried Berg folds
-genzo- collected 0.09€ from pot
*** SUMMARY ***
Total pot 0.09€ | No rake
Seat 3: -genzo- won 0.09€


Winamax Poker - HOLD-UP "Colorado" - HandId: #19116069-775683-1701769057 - Holdem no limit (0.01€/0.02€) - 2023/12/05 09:37:37 UTC
Table: 'Colorado' 6-max (real money) Seat #6 is the button
Seat 1: Fried Berg (0.49€)
Seat 2: Fred_FFE (0.42€)
Seat 3: MoneyGrowing (2€)
Seat 4: Ga31k (2.28€)
Seat 5: ischia (0.76€)
Seat 6: slowreplay (2.11€)
*** ANTE/BLINDS ***
Fried Berg posts small blind 0.01€
Fred_FFE posts big blind 0.02€
Dealt to Fried Berg [8s Ks]
*** PRE-FLOP *** 
MoneyGrowing folds
Ga31k folds
ischia folds
slowreplay folds
Fried Berg raises 0.02€ to 0.04€
Fred_FFE raises 0.38€ to 0.42€ and is all-in
Fried Berg folds
Fred_FFE collected 0.46€ from pot
*** SUMMARY ***
Total pot 0.46€ | No rake
Seat 2: Fred_FFE (big blind) won 0.46€


Winamax Poker - HOLD-UP "Colorado" - HandId: #19116069-775720-1701769099 - Holdem no limit (0.01€/0.02€) - 2023/12/05 09:38:19 UTC
Table: 'Colorado' 6-max (real money) Seat #6 is the button
Seat 1: Simba_Roi (0.87€)
Seat 2: Ertorko (2€)
Seat 3: Fried Berg (0.45€)
Seat 4: TheRealWill (2.89€)
Seat 5: VanDolar (2€)
Seat 6: trikar xx (2.06€)
*** ANTE/BLINDS ***
Simba_Roi posts small blind 0.01€
Ertorko posts big blind 0.02€
Dealt to Fried Berg [5c Td]
*** PRE-FLOP *** 
Fried Berg folds
TheRealWill folds
VanDolar raises 0.04€ to 0.06€
trikar xx folds
Simba_Roi folds
Ertorko folds
VanDolar collected 0.09€ from pot
*** SUMMARY ***
Total pot 0.09€ | No rake
Seat 5: VanDolar won 0.09€


Winamax Poker - HOLD-UP "Colorado" - HandId: #19116069-775723-1701769101 - Holdem no limit (0.01€/0.02€) - 2023/12/05 09:38:21 UTC
Table: 'Colorado' 6-max (real money) Seat #6 is the button
Seat 1: nemo5 (3.54€)
Seat 2: trikar xx (2.06€)
Seat 3: slowreplay (2.88€)
Seat 4: Pierrof24 (2.02€)
Seat 5: PIQSOU (2.45€)
Seat 6: Fried Berg (0.45€)
*** ANTE/BLINDS ***
nemo5 posts small blind 0.01€
trikar xx posts big blind 0.02€
Dealt to Fried Berg [Qs 6d]
*** PRE-FLOP *** 
slowreplay folds
Pierrof24 folds
PIQSOU raises 0.03€ to 0.05€
Fried Berg folds
nemo5 folds
trikar xx folds
PIQSOU collected 0.08€ from pot
*** SUMMARY ***
Total pot 0.08€ | No rake
Seat 5: PIQSOU won 0.08€


Winamax Poker - HOLD-UP "Colorado" - HandId: #19116069-775738-1701769113 - Holdem no limit (0.01€/0.02€) - 2023/12/05 09:38:33 UTC
Table: 'Colorado' 6-max (real money) Seat #6 is the button
Seat 1: trikar xx (2.03€)
Seat 2: Tina117 (1.59€)
Seat 3: LMG22_23 (1.85€)
Seat 4: Fried Berg (0.45€)
Seat 5: Karinecokine (0.44€)
Seat 6: SirX (9.23€)
*** ANTE/BLINDS ***
trikar xx posts small blind 0.01€
Tina117 posts big blind 0.02€
Dealt to Fried Berg [Qh 7c]
*** PRE-FLOP *** 
LMG22_23 folds
Fried Berg folds
Karinecokine folds
SirX raises 0.05€ to 0.07€
trikar xx calls 0.06€
Tina117 folds
*** FLOP *** [Jc 3c 4h]
trikar xx checks
SirX bets 0.10€
trikar xx calls 0.10€
*** TURN *** [Jc 3c 4h][4c]
trikar xx checks
SirX checks
*** RIVER *** [Jc 3c 4h 4c][Qd]
trikar xx bets 0.27€
SirX folds
trikar xx collected 0.59€ from pot
*** SUMMARY ***
Total pot 0.59€ | Rake 0.04€
Board: [Jc 3c 4h 4c Qd]
Seat 1: trikar xx (small blind) won 0.59€


Winamax Poker - HOLD-UP "Colorado" - HandId: #19116069-775763-1701769143 - Holdem no limit (0.01€/0.02€) - 2023/12/05 09:39:03 UTC
Table: 'Colorado' 6-max (real money) Seat #6 is the button
Seat 1: yep80 (1.98€)
Seat 2: Fried Berg (0.45€)
Seat 3: swag-Morue73 (1.97€)
Seat 4: nemo5 (2.21€)
Seat 5: Tooto1808 (3.47€)
Seat 6: 48centaure (1.92€)
*** ANTE/BLINDS ***
yep80 posts small blind 0.01€
Fried Berg posts big blind 0.02€
Dealt to Fried Berg [7d 2c]
*** PRE-FLOP *** 
swag-Morue73 folds
nemo5 folds
Tooto1808 raises 0.03€ to 0.05€
48centaure folds
yep80 calls 0.04€
Fried Berg folds
*** FLOP *** [4c 3h 6d]
yep80 checks
Tooto1808 checks
*** TURN *** [4c 3h 6d][Jc]
yep80 checks
Tooto1808 checks
*** RIVER *** [4c 3h 6d Jc][8c]
yep80 checks
Tooto1808 checks
*** SHOW DOWN ***
yep80 shows [Kc Td] (High card : King)
Tooto1808 shows [7s 8s] (One pair : 8)
Tooto1808 collected 0.11€ from pot
*** SUMMARY ***
Total pot 0.11€ | Rake 0.01€
Board: [4c 3h 6d Jc 8c]
Seat 1: yep80 (small blind) showed [Kc Td] and lost with High card : King
Seat 5: Tooto1808 showed [7s 8s] and won 0.11€ with One pair : 8


Winamax Poker - HOLD-UP "Colorado" - HandId: #19116069-775778-1701769155 - Holdem no limit (0.01€/0.02€) - 2023/12/05 09:39:15 UTC
Table: 'Colorado' 6-max (real money) Seat #6 is the button
Seat 1: Fried Berg (0.43€)
Seat 2: AdiTheKing (3.63€)
Seat 3: DeX70 (1.73€)
Seat 4: MoneyGrowing (2.01€)
Seat 5: Neferusobek (2.48€)
Seat 6: Simba_Roi (0.61€)
*** ANTE/BLINDS ***
Fried Berg posts small blind 0.01€
AdiTheKing posts big blind 0.02€
Dealt to Fried Berg [3d Ts]
*** PRE-FLOP *** 
DeX70 folds
MoneyGrowing folds
Neferusobek raises 0.04€ to 0.06€
Simba_Roi folds
Fried Berg folds
AdiTheKing folds
Neferusobek collected 0.09€ from pot
*** SUMMARY ***
Total pot 0.09€ | No rake
Seat 5: Neferusobek won 0.09€


Winamax Poker - HOLD-UP "Colorado" - HandId: #19116069-775791-1701769166 - Holdem no limit (0.01€/0.02€) - 2023/12/05 09:39:26 UTC
Table: 'Colorado' 6-max (real money) Seat #6 is the button
Seat 1: Zebulon_66 (0.99€)
Seat 2: MoneyGrowing (2.01€)
Seat 3: Fried Berg (0.42€)
Seat 4: tprosper (3.51€)
Seat 5: -genzo- (2.14€)
Seat 6: PIQSOU (2.03€)
*** ANTE/BLINDS ***
Zebulon_66 posts small blind 0.01€
MoneyGrowing posts big blind 0.02€
Dealt to Fried Berg [4h Kh]
*** PRE-FLOP *** 
Fried Berg raises 0.02€ to 0.04€
tprosper calls 0.04€
-genzo- folds
PIQSOU folds
Zebulon_66 folds
MoneyGrowing folds
*** FLOP *** [Ad 7h Ks]
Fried Berg bets 0.04€
tprosper calls 0.04€
*** TURN *** [Ad 7h Ks][Ah]
Fried Berg bets 0.08€
tprosper folds
Fried Berg collected 0.25€ from pot
*** SUMMARY ***
Total pot 0.25€ | Rake 0.02€
Board: [Ad 7h Ks Ah]
Seat 3: Fried Berg won 0.25€


Winamax Poker - HOLD-UP "Colorado" - HandId: #19116069-775832-1701769202 - Holdem no limit (0.01€/0.02€) - 2023/12/05 09:40:02 UTC
Table: 'Colorado' 6-max (real money) Seat #6 is the button
Seat 1: slowreplay (2.49€)
Seat 2: VanDolar (2.20€)
Seat 3: nemo5 (3.50€)
Seat 4: Fried Berg (0.51€)
Seat 5: AdiTheKing (1.25€)
Seat 6: Neferusobek (3.38€)
*** ANTE/BLINDS ***
slowreplay posts small blind 0.01€
VanDolar posts big blind 0.02€
Dealt to Fried Berg [7s 4s]
*** PRE-FLOP *** 
nemo5 folds
Fried Berg folds
AdiTheKing raises 0.03€ to 0.05€
Neferusobek folds
slowreplay folds
VanDolar folds
AdiTheKing collected 0.08€ from pot
*** SUMMARY ***
Total pot 0.08€ | No rake
Seat 5: AdiTheKing won 0.08€


Winamax Poker - HOLD-UP "Colorado" - HandId: #19116069-775839-1701769209 - Holdem no limit (0.01€/0.02€) - 2023/12/05 09:40:09 UTC
Table: 'Colorado' 6-max (real money) Seat #6 is the button
Seat 1: nemo5 (2.16€)
Seat 2: Pierrof24 (2.44€)
Seat 3: g8o8k8u (2.05€)
Seat 4: biquet77 (1.95€)
Seat 5: Fried Berg (0.51€)
Seat 6: stevebalboni (2.03€)
*** ANTE/BLINDS ***
nemo5 posts small blind 0.01€
Pierrof24 posts big blind 0.02€
Dealt to Fried Berg [Tc Jc]
*** PRE-FLOP *** 
g8o8k8u folds
biquet77 raises 0.02€ to 0.04€
Fried Berg calls 0.04€
stevebalboni folds
nemo5 folds
Pierrof24 folds
*** FLOP *** [As Js 3d]
biquet77 bets 0.02€
Fried Berg raises 0.04€ to 0.06€
biquet77 folds
Fried Berg collected 0.17€ from pot
*** SUMMARY ***
Total pot 0.17€ | Rake 0.02€
Board: [As Js 3d]
Seat 5: Fried Berg won 0.17€


Winamax Poker - HOLD-UP "Colorado" - HandId: #19116069-775872-1701769239 - Holdem no limit (0.01€/0.02€) - 2023/12/05 09:40:39 UTC
Table: 'Colorado' 6-max (real money) Seat #6 is the button
Seat 1: yep80 (1.99€)
Seat 2: g8o8k8u (2.07€)
Seat 3: biquet77 (1.89€)
Seat 4: AdiTheKing (1.31€)
Seat 5: Ertorko (4.01€)
Seat 6: Fried Berg (0.58€)
*** ANTE/BLINDS ***
yep80 posts small blind 0.01€
g8o8k8u posts big blind 0.02€
Dealt to Fried Berg [Js Ts]
*** PRE-FLOP *** 
biquet77 calls 0.02€
AdiTheKing folds
Ertorko folds
Fried Berg raises 0.02€ to 0.04€
yep80 calls 0.03€
g8o8k8u folds
biquet77 calls 0.02€
*** FLOP *** [Qc 8d Jh]
yep80 checks
biquet77 checks
Fried Berg bets 0.06€
yep80 calls 0.06€
biquet77 calls 0.06€
*** TURN *** [Qc 8d Jh][Qd]
yep80 checks
biquet77 checks
Fried Berg checks
*** RIVER *** [Qc 8d Jh Qd][5s]
yep80 checks
biquet77 checks
Fried Berg checks
*** SHOW DOWN ***
yep80 shows [Ah Kd] (One pair : Queens)
biquet77 shows [Th Kh] (One pair : Queens)
Fried Berg shows [Js Ts] (Two pairs : Queens and Jacks)
Fried Berg collected 0.29€ from pot
*** SUMMARY ***
Total pot 0.29€ | Rake 0.03€
Board: [Qc 8d Jh Qd 5s]
Seat 1: yep80 (small blind) showed [Ah Kd] and lost with One pair : Queens
Seat 3: biquet77 showed [Th Kh] and lost with One pair : Queens
Seat 6: Fried Berg (button) showed [Js Ts] and won 0.29€ with Two pairs : Queens and Jacks


Winamax Poker - HOLD-UP "Colorado" - HandId: #19116069-775921-1701769284 - Holdem no limit (0.01€/0.02€) - 2023/12/05 09:41:24 UTC
Table: 'Colorado' 6-max (real money) Seat #6 is the button
Seat 1: S-aaron24 (2€)
Seat 2: LeJouer666 (1.70€)
Seat 3: Beso1Dartich (1.76€)
Seat 4: tprosper (3.74€)
Seat 5: Fried Berg (0.77€)
Seat 6: trikar xx (2.15€)
*** ANTE/BLINDS ***
S-aaron24 posts small blind 0.01€
LeJouer666 posts big blind 0.02€
Dealt to Fried Berg [4s Th]
*** PRE-FLOP *** 
Beso1Dartich folds
tprosper calls 0.02€
Fried Berg folds
trikar xx raises 0.07€ to 0.09€
S-aaron24 calls 0.08€
LeJouer666 calls 0.07€
tprosper calls 0.07€
*** FLOP *** [Tc Ac Ks]
S-aaron24 checks
LeJouer666 checks
tprosper bets 0.05€
trikar xx raises 0.13€ to 0.18€
S-aaron24 folds
LeJouer666 calls 0.18€
tprosper calls 0.13€
*** TURN *** [Tc Ac Ks][7c]
LeJouer666 bets 1.43€ and is all-in
tprosper folds
trikar xx folds
LeJouer666 collected 2.24€ from pot
*** SUMMARY ***
Total pot 2.24€ | Rake 0.09€
Board: [Tc Ac Ks 7c]
Seat 2: LeJouer666 (big blind) won 2.24€


Winamax Poker - HOLD-UP "Colorado" - HandId: #19116069-775927-1701769289 - Holdem no limit (0.01€/0.02€) - 2023/12/05 09:41:29 UTC
Table: 'Colorado' 6-max (real money) Seat #6 is the button
Seat 1: EA_Stinger (0.77€)
Seat 2: Fried Berg (0.77€)
Seat 3: Beso1Dartich (1.76€)
Seat 4: Richard Reuk (2.01€)
Seat 5: yep80 (1.89€)
Seat 6: Tribuna38 (2.04€)
*** ANTE/BLINDS ***
EA_Stinger posts small blind 0.01€
Fried Berg posts big blind 0.02€
Dealt to Fried Berg [Qd Th]
*** PRE-FLOP *** 
Beso1Dartich folds
Richard Reuk raises 0.04€ to 0.06€
yep80 calls 0.06€
Tribuna38 folds
EA_Stinger folds
Fried Berg calls 0.04€
*** FLOP *** [4h 4s As]
Fried Berg checks
Richard Reuk bets 0.10€
yep80 calls 0.10€
Fried Berg folds
*** TURN *** [4h 4s As][8s]
Richard Reuk bets 0.25€
yep80 calls 0.25€
*** RIVER *** [4h 4s As 8s][4c]
Richard Reuk bets 0.58€
yep80 calls 0.58€
*** SHOW DOWN ***
Richard Reuk shows [Ah Ks] (Full of 4 and Aces)
yep80 shows [Ac 8d] (Full of 4 and Aces)
yep80 collected 0.92€ from pot
Richard Reuk collected 0.92€ from pot
*** SUMMARY ***
Total pot 1.84€ | Rake 0.21€
Board: [4h 4s As 8s 4c]
Seat 4: Richard Reuk showed [Ah Ks] and won 0.92€ with Full of 4 and Aces
Seat 5: yep80 showed [Ac 8d] and won 0.92€ with Full of 4 and Aces


Winamax Poker - HOLD-UP "Colorado" - HandId: #19116069-775954-1701769319 - Holdem no limit (0.01€/0.02€) - 2023/12/05 09:41:59 UTC
Table: 'Colorado' 6-max (real money) Seat #6 is the button
Seat 1: Fried Berg (0.71€)
Seat 2: AdiTheKing (1.30€)
Seat 3: Zebulon_66 (1.42€)
Seat 4: RaseOnYou (2.60€)
Seat 5: PIQSOU (2.35€)
Seat 6: TheRealWill (4.19€)
*** ANTE/BLINDS ***
Fried Berg posts small blind 0.01€
AdiTheKing posts big blind 0.02€
Dealt to Fried Berg [6d Js]
*** PRE-FLOP *** 
Zebulon_66 folds
RaseOnYou calls 0.02€
PIQSOU folds
TheRealWill folds
Fried Berg folds
AdiTheKing checks
*** FLOP *** [As Ac 7c]
AdiTheKing checks
RaseOnYou checks
*** TURN *** [As Ac 7c][6h]
AdiTheKing checks
RaseOnYou checks
*** RIVER *** [As Ac 7c 6h][9c]
AdiTheKing checks
RaseOnYou checks
*** SHOW DOWN ***
AdiTheKing shows [Qc 8s] (One pair : Aces)
RaseOnYou shows [Jh Qs] (One pair : Aces)
RaseOnYou collected 0.04€ from pot
*** SUMMARY ***
Total pot 0.04€ | Rake 0.01€
Board: [As Ac 7c 6h 9c]
Seat 2: AdiTheKing (big blind) showed [Qc 8s] and lost with One pair : Aces
Seat 4: RaseOnYou showed [Jh Qs] and won 0.04€ with One pair : Aces


Winamax Poker - HOLD-UP "Colorado" - HandId: #19116069-775967-1701769337 - Holdem no limit (0.01€/0.02€) - 2023/12/05 09:42:17 UTC
Table: 'Colorado' 6-max (real money) Seat #6 is the button
Seat 1: NeNerf (1.34€)
Seat 2: yep80 (1.82€)
Seat 3: nodi69 (1.62€)
Seat 4: Fried Berg (0.70€)
Seat 5: Beso1Dartich (1.61€)
Seat 6: Zard.Oz (1.91€)
*** ANTE/BLINDS ***
NeNerf posts small blind 0.01€
yep80 posts big blind 0.02€
Dealt to Fried Berg [Qd 7h]
*** PRE-FLOP *** 
nodi69 folds
Fried Berg folds
Beso1Dartich folds
Zard.Oz raises 0.03€ to 0.05€
NeNerf calls 0.04€
yep80 calls 0.03€
*** FLOP *** [9d 3h 9s]
NeNerf checks
yep80 checks
Zard.Oz checks
*** TURN *** [9d 3h 9s][2s]
NeNerf bets 0.05€
yep80 calls 0.05€
Zard.Oz calls 0.05€
*** RIVER *** [9d 3h 9s 2s][8c]
NeNerf checks
yep80 checks
Zard.Oz checks
*** SHOW DOWN ***
yep80 shows [Js 5s] (One pair : 9)
Zard.Oz shows [Ks Qc] (One pair : 9)
NeNerf shows [As 3c] (Two pairs : 9 and 3)
NeNerf collected 0.27€ from pot
*** SUMMARY ***
Total pot 0.27€ | Rake 0.03€
Board: [9d 3h 9s 2s 8c]
Seat 1: NeNerf (small blind) showed [As 3c] and won 0.27€ with Two pairs : 9 and 3
Seat 2: yep80 (big blind) showed [Js 5s] and lost with One pair : 9
Seat 6: Zard.Oz (button) showed [Ks Qc] and lost with One pair : 9


Winamax Poker - HOLD-UP "Colorado" - HandId: #19116069-775980-1701769347 - Holdem no limit (0.01€/0.02€) - 2023/12/05 09:42:27 UTC
Table: 'Colorado' 6-max (real money) Seat #6 is the button
Seat 1: koshikosha (2.13€)
Seat 2: nodi69 (1.62€)
Seat 3: Fried Berg (0.70€)
Seat 4: julieninaval (2.02€)
Seat 5: tprosper (3.47€)
Seat 6: liseau5312 (1.98€)
Hold-up to Pot: total 0.20€
*** ANTE/BLINDS ***
koshikosha posts small blind 0.01€
nodi69 posts big blind 0.02€
Dealt to Fried Berg [Jh 7s]
*** PRE-FLOP *** 
Fried Berg folds
julieninaval folds
tprosper calls 0.02€
liseau5312 calls 0.02€
koshikosha raises 0.18€ to 0.20€
nodi69 folds
tprosper calls 0.18€
liseau5312 folds
*** FLOP *** [Ts 8c 5h]
koshikosha bets 0.64€
tprosper calls 0.64€
*** TURN *** [Ts 8c 5h][Th]
koshikosha bets 1.29€ and is all-in
tprosper folds
koshikosha collected 3.04€ from pot
*** SUMMARY ***
Total pot 3.04€ | Rake 0.17€
Board: [Ts 8c 5h Th]
Seat 1: koshikosha (small blind) won 3.04€


Winamax Poker - HOLD-UP "Colorado" - HandId: #19116069-775986-1701769354 - Holdem no limit (0.01€/0.02€) - 2023/12/05 09:42:34 UTC
Table: 'Colorado' 6-max (real money) Seat #6 is the button
Seat 1: PIQSOU (2€)
Seat 2: julieninaval (2.02€)
Seat 3: Karinecokine (0.26€)
Seat 4: slowreplay (2.14€)
Seat 5: trikar xx (2.21€)
Seat 6: Fried Berg (0.70€)
*** ANTE/BLINDS ***
PIQSOU posts small blind 0.01€
julieninaval posts big blind 0.02€
Dealt to Fried Berg [9h Qc]
*** PRE-FLOP *** 
Karinecokine folds
slowreplay folds
trikar xx raises 0.04€ to 0.06€
Fried Berg folds
PIQSOU folds
julieninaval folds
trikar xx collected 0.09€ from pot
*** SUMMARY ***
Total pot 0.09€ | No rake
Seat 5: trikar xx won 0.09€


Winamax Poker - HOLD-UP "Colorado" - HandId: #19116069-776006-1701769372 - Holdem no limit (0.01€/0.02€) - 2023/12/05 09:42:52 UTC
Table: 'Colorado' 6-max (real money) Seat #6 is the button
Seat 1: -genzo- (2.64€)
Seat 2: Fried Berg (0.70€)
Seat 3: PIQSOU (2.09€)
Seat 4: Neferusobek (2.03€)
Seat 5: Ertorko (2.39€)
Seat 6: g8o8k8u (2€)
*** ANTE/BLINDS ***
-genzo- posts small blind 0.01€
Fried Berg posts big blind 0.02€
Dealt to Fried Berg [Jc 7c]
*** PRE-FLOP *** 
PIQSOU folds
Neferusobek folds
Ertorko folds
g8o8k8u folds
-genzo- folds
Fried Berg collected 0.03€ from pot
*** SUMMARY ***
Total pot 0.03€ | No rake
Seat 2: Fried Berg (big blind) won 0.03€


Winamax Poker - HOLD-UP "Colorado" - HandId: #19116069-776024-1701769388 - Holdem no limit (0.01€/0.02€) - 2023/12/05 09:43:08 UTC
Table: 'Colorado' 6-max (real money) Seat #6 is the button
Seat 1: Fried Berg (0.71€)
Seat 2: ALLIN_OLI (2.94€)
Seat 3: nemo5 (3.28€)
Seat 4: liseau5312 (1.93€)
Seat 5: koshikosha (3.04€)
Seat 6: kameleon73 (2.23€)
*** ANTE/BLINDS ***
Fried Berg posts small blind 0.01€
ALLIN_OLI posts big blind 0.02€
Dealt to Fried Berg [5s Kd]
*** PRE-FLOP *** 
nemo5 folds
liseau5312 folds
koshikosha folds
kameleon73 raises 0.02€ to 0.04€
Fried Berg folds
ALLIN_OLI folds
kameleon73 collected 0.07€ from pot
*** SUMMARY ***
Total pot 0.07€ | No rake
Seat 6: kameleon73 (button) won 0.07€


Winamax Poker - HOLD-UP "Colorado" - HandId: #19116069-776040-1701769403 - Holdem no limit (0.01€/0.02€) - 2023/12/05 09:43:23 UTC
Table: 'Colorado' 6-max (real money) Seat #6 is the button
Seat 1: el_menestrel (1.41€)
Seat 2: Beso1Dartich (1.61€)
Seat 3: Fried Berg (0.70€)
Seat 4: slowreplay (2.11€)
Seat 5: Neferusobek (3.55€)
Seat 6: -genzo- (2.81€)
*** ANTE/BLINDS ***
el_menestrel posts small blind 0.01€
Beso1Dartich posts big blind 0.02€
Dealt to Fried Berg [5h 7d]
*** PRE-FLOP *** 
Fried Berg folds
slowreplay folds
Neferusobek folds
-genzo- folds
el_menestrel folds
Beso1Dartich collected 0.03€ from pot
*** SUMMARY ***
Total pot 0.03€ | No rake
Seat 2: Beso1Dartich (big blind) won 0.03€


Winamax Poker - HOLD-UP "Colorado" - HandId: #19116069-776044-1701769405 - Holdem no limit (0.01€/0.02€) - 2023/12/05 09:43:25 UTC
Table: 'Colorado' 6-max (real money) Seat #6 is the button
Seat 1: AdiTheKing (1.50€)
Seat 2: stevebalboni (4.46€)
Seat 3: slowreplay (2.11€)
Seat 4: Fried Berg (0.70€)
Seat 5: el_menestrel (1.40€)
Seat 6: MoneyGrowing (2.34€)
*** ANTE/BLINDS ***
AdiTheKing posts small blind 0.01€
stevebalboni posts big blind 0.02€
Dealt to Fried Berg [4c As]
*** PRE-FLOP *** 
slowreplay folds
Fried Berg raises 0.02€ to 0.04€
el_menestrel folds
MoneyGrowing folds
AdiTheKing calls 0.03€
stevebalboni folds
*** FLOP *** [5s Jh 3h]
AdiTheKing bets 0.04€
Fried Berg folds
AdiTheKing collected 0.13€ from pot
*** SUMMARY ***
Total pot 0.13€ | Rake 0.01€
Board: [5s Jh 3h]
Seat 1: AdiTheKing (small blind) won 0.13€


Winamax Poker - HOLD-UP "Colorado" - HandId: #19116069-776082-1701769438 - Holdem no limit (0.01€/0.02€) - 2023/12/05 09:43:58 UTC
Table: 'Colorado' 6-max (real money) Seat #6 is the button
Seat 1: Ertorko (4.45€)
Seat 2: nemo5 (3.26€)
Seat 3: ALLIN_OLI (2.21€)
Seat 4: RaseOnYou (2.70€)
Seat 5: Fried Berg (0.66€)
Seat 6: slowreplay (2.27€)
Hold-up to Pot: total 0.20€
*** ANTE/BLINDS ***
Ertorko posts small blind 0.01€
nemo5 posts big blind 0.02€
Dealt to Fried Berg [Ac Tc]
*** PRE-FLOP *** 
ALLIN_OLI raises 0.05€ to 0.07€
RaseOnYou folds
Fried Berg raises 0.05€ to 0.12€
slowreplay folds
Ertorko folds
nemo5 folds
ALLIN_OLI raises 0.60€ to 0.72€
Fried Berg calls 0.54€ and is all-in
*** FLOP *** [2c Js 3h]
*** TURN *** [2c Js 3h][Th]
*** RIVER *** [2c Js 3h Th][2d]
*** SHOW DOWN ***
Fried Berg shows [Ac Tc] (Two pairs : Tens and 2)
ALLIN_OLI shows [Qd Qs] (Two pairs : Queens and 2)
ALLIN_OLI collected 1.47€ from pot
*** SUMMARY ***
Total pot 1.47€ | Rake 0.14€
Board: [2c Js 3h Th 2d]
Seat 3: ALLIN_OLI showed [Qd Qs] and won 1.47€ with Two pairs : Queens and 2
Seat 5: Fried Berg showed [Ac Tc] and lost with Two pairs : Tens and 2


Winamax Poker - HOLD-UP "Colorado" - HandId: #19116069-775376-1701768778 - Holdem no limit (0.01€/0.02€) - 2023/12/05 09:32:58 UTC
Table: 'Colorado' 6-max (real money) Seat #6 is the button
Seat 1: -genzo- (2.20€)
Seat 2: Fried Berg (0.50€)
Seat 3: AdiTheKing (1.37€)
Seat 4: Ga31k (2.24€)
Seat 5: Pierrof24 (1.97€)
Seat 6: LMG22_23 (1.82€)
*** ANTE/BLINDS ***
-genzo- posts small blind 0.01€
Fried Berg posts big blind 0.02€
Dealt to Fried Berg [3s 4d]
*** PRE-FLOP *** 
AdiTheKing folds
Ga31k folds
Pierrof24 folds
LMG22_23 folds
-genzo- raises 0.04€ to 0.06€
Fried Berg folds
-genzo- collected 0.08€ from pot
*** SUMMARY ***
Total pot 0.08€ | No rake
Seat 1: -genzo- (small blind) won 0.08€


Winamax Poker - HOLD-UP "Colorado" - HandId: #19116069-775446-1701768839 - Holdem no limit (0.01€/0.02€) - 2023/12/05 09:33:59 UTC
Table: 'Colorado' 6-max (real money) Seat #6 is the button
Seat 1: Fried Berg (0.48€)
Seat 2: Tompahmax (1.90€)
Seat 3: LMG22_23 (1.82€)
Seat 4: trikar xx (2.01€)
Seat 5: g8o8k8u (3.03€)
Seat 6: slowreplay (2.07€)
*** ANTE/BLINDS ***
Fried Berg posts small blind 0.01€
Tompahmax posts big blind 0.02€
Dealt to Fried Berg [Ah 7c]
*** PRE-FLOP *** 
LMG22_23 folds
trikar xx folds
g8o8k8u folds
slowreplay folds
Fried Berg raises 0.02€ to 0.04€
Tompahmax calls 0.02€
*** FLOP *** [Tc 4h Ac]
Fried Berg bets 0.04€
Tompahmax folds
Fried Berg collected 0.11€ from pot
*** SUMMARY ***
Total pot 0.11€ | Rake 0.01€
Board: [Tc 4h Ac]
Seat 1: Fried Berg (small blind) won 0.11€


Winamax Poker - HOLD-UP "Colorado" - HandId: #19116069-775492-1701768875 - Holdem no limit (0.01€/0.02€) - 2023/12/05 09:34:35 UTC
Table: 'Colorado' 6-max (real money) Seat #6 is the button
Seat 1: MoneyGrowing (2.04€)
Seat 2: DeX70 (2.28€)
Seat 3: Fried Berg (0.51€)
Seat 4: Fred_FFE (0.50€)
Seat 5: Ertorko (2.14€)
Seat 6: Sebidu57 (1.02€)
Hold-up to Pot: total 0.10€
*** ANTE/BLINDS ***
MoneyGrowing posts small blind 0.01€
DeX70 posts big blind 0.02€
Dealt to Fried Berg [9d 7h]
*** PRE-FLOP *** 
Fried Berg folds
Fred_FFE folds
Ertorko folds
Sebidu57 calls 0.02€
MoneyGrowing folds
DeX70 raises 0.03€ to 0.05€
Sebidu57 calls 0.03€
*** FLOP *** [8s 2s 4s]
DeX70 checks
Sebidu57 bets 0.97€ and is all-in
DeX70 folds
Sebidu57 collected 1.17€ from pot
*** SUMMARY ***
Total pot 1.17€ | Rake 0.01€
Board: [8s 2s 4s]
Seat 6: Sebidu57 (button) won 1.17€


Winamax Poker - HOLD-UP "Colorado" - HandId: #19116069-775499-1701768882 - Holdem no limit (0.01€/0.02€) - 2023/12/05 09:34:42 UTC
Table: 'Colorado' 6-max (real money) Seat #6 is the button
Seat 1: nemo5 (2€)
Seat 2: Ga31k (2.01€)
Seat 3: TheRealWill (2€)
Seat 4: Fried Berg (0.51€)
Seat 5: S-aaron24 (2€)
Seat 6: tprosper (3.52€)
*** ANTE/BLINDS ***
nemo5 posts small blind 0.01€
Ga31k posts big blind 0.02€
Dealt to Fried Berg [4d Jh]
*** PRE-FLOP *** 
TheRealWill folds
Fried Berg folds
S-aaron24 folds
tprosper raises 0.48€ to 0.50€
nemo5 folds
Ga31k folds
tprosper collected 0.53€ from pot
*** SUMMARY ***
Total pot 0.53€ | No rake
Seat 6: tprosper (button) won 0.53€


Winamax Poker - HOLD-UP "Colorado" - HandId: #19116069-775509-1701768889 - Holdem no limit (0.01€/0.02€) - 2023/12/05 09:34:49 UTC
Table: 'Colorado' 6-max (real money) Seat #6 is the button
Seat 1: MoneyGrowing (2.04€)
Seat 2: TheRealWill (3.95€)
Seat 3: trikar xx (2€)
Seat 4: Meg a lodon (0.49€)
Seat 5: Fried Berg (0.51€)
Seat 6: Ertorko (2.14€)
*** ANTE/BLINDS ***
MoneyGrowing posts small blind 0.01€
TheRealWill posts big blind 0.02€
Dealt to Fried Berg [7s 4h]
*** PRE-FLOP *** 
trikar xx raises 0.04€ to 0.06€
Meg a lodon folds
Fried Berg folds
Ertorko folds
MoneyGrowing folds
TheRealWill calls 0.04€
*** FLOP *** [Qs 3s Kh]
TheRealWill checks
trikar xx checks
*** TURN *** [Qs 3s Kh][5d]
TheRealWill checks
trikar xx checks
*** RIVER *** [Qs 3s Kh 5d][Ah]
TheRealWill checks
trikar xx checks
*** SHOW DOWN ***
TheRealWill shows [8h Th] (High card : Ace)
trikar xx shows [9s 9d] (One pair : 9)
trikar xx collected 0.12€ from pot
*** SUMMARY ***
Total pot 0.12€ | Rake 0.01€
Board: [Qs 3s Kh 5d Ah]
Seat 2: TheRealWill (big blind) showed [8h Th] and lost with High card : Ace
Seat 3: trikar xx showed [9s 9d] and won 0.12€ with One pair : 9


Winamax Poker - HOLD-UP "Colorado" - HandId: #19116069-775526-1701768904 - Holdem no limit (0.01€/0.02€) - 2023/12/05 09:35:04 UTC
Table: 'Colorado' 6-max (real money) Seat #6 is the button
Seat 1: Flazzer17 (1.79€)
Seat 2: -genzo- (2€)
Seat 3: Aggro Loser (4.95€)
Seat 4: Frankyonki2 (1.97€)
Seat 5: Fred_FFE (0.58€)
Seat 6: Fried Berg (0.51€)
*** ANTE/BLINDS ***
Flazzer17 posts small blind 0.01€
-genzo- posts big blind 0.02€
Dealt to Fried Berg [6h 4s]
*** PRE-FLOP *** 
Aggro Loser folds
Frankyonki2 folds
Fred_FFE folds
Fried Berg folds
Flazzer17 calls 0.01€
-genzo- raises 0.04€ to 0.06€
Flazzer17 calls 0.04€
*** FLOP *** [Ts 9c Qs]
Flazzer17 checks
-genzo- bets 0.06€
Flazzer17 calls 0.06€
*** TURN *** [Ts 9c Qs][7h]
Flazzer17 checks
-genzo- bets 0.18€
Flazzer17 calls 0.18€
*** RIVER *** [Ts 9c Qs 7h][2c]
Flazzer17 checks
-genzo- bets 0.60€
Flazzer17 calls 0.60€
*** SHOW DOWN ***
Flazzer17 shows [8h 8c] (One pair : 8)
-genzo- shows [Jd Kd] (Straight King high)
-genzo- collected 1.62€ from pot
*** SUMMARY ***
Total pot 1.62€ | Rake 0.18€
Board: [Ts 9c Qs 7h 2c]
Seat 1: Flazzer17 (small blind) showed [8h 8c] and lost with One pair : 8
Seat 2: -genzo- (big blind) showed [Jd Kd] and won 1.62€ with Straight King high


Winamax Poker - HOLD-UP "Colorado" - HandId: #19116069-775542-1701768917 - Holdem no limit (0.01€/0.02€) - 2023/12/05 09:35:17 UTC
Table: 'Colorado' 6-max (real money) Seat #6 is the button
Seat 1: slowreplay (2.26€)
Seat 2: Richard Reuk (2€)
Seat 3: Fried Berg (0.51€)
Seat 4: Aggro Loser (4.95€)
Seat 5: LMG22_23 (2.19€)
Seat 6: Fred_FFE (0.58€)
*** ANTE/BLINDS ***
slowreplay posts small blind 0.01€
Richard Reuk posts big blind 0.02€
Dealt to Fried Berg [2c 9d]
*** PRE-FLOP *** 
Fried Berg folds
Aggro Loser folds
LMG22_23 raises 0.03€ to 0.05€
Fred_FFE folds
slowreplay calls 0.04€
Richard Reuk folds
*** FLOP *** [Kh Td Jh]
slowreplay checks
LMG22_23 checks
*** TURN *** [Kh Td Jh][7c]
slowreplay checks
LMG22_23 checks
*** RIVER *** [Kh Td Jh 7c][5s]
slowreplay bets 0.10€
LMG22_23 folds
slowreplay collected 0.21€ from pot
*** SUMMARY ***
Total pot 0.21€ | Rake 0.01€
Board: [Kh Td Jh 7c 5s]
Seat 1: slowreplay (small blind) won 0.21€


Winamax Poker - HOLD-UP "Colorado" - HandId: #19116069-775545-1701768921 - Holdem no limit (0.01€/0.02€) - 2023/12/05 09:35:21 UTC
Table: 'Colorado' 6-max (real money) Seat #6 is the button
Seat 1: Ga31k (2.24€)
Seat 2: Fried Berg (0.51€)
Seat 3: Halmosthard (3.39€)
Seat 4: VanDolar (2€)
Seat 5: Tompahmax (2.37€)
Seat 6: AdiTheKing (1.53€)
*** ANTE/BLINDS ***
Ga31k posts small blind 0.01€
Fried Berg posts big blind 0.02€
Dealt to Fried Berg [Qh 5h]
*** PRE-FLOP *** 
Halmosthard folds
VanDolar folds
Tompahmax folds
AdiTheKing folds
Ga31k raises 0.04€ to 0.06€
Fried Berg calls 0.04€
*** FLOP *** [Tc 9c 7s]
Ga31k bets 0.06€
Fried Berg folds
Ga31k collected 0.17€ from pot
*** SUMMARY ***
Total pot 0.17€ | Rake 0.01€
Board: [Tc 9c 7s]
Seat 1: Ga31k (small blind) won 0.17€


Winamax Poker - HOLD-UP "Colorado" - HandId: #19116069-775611-1701768983 - Holdem no limit (0.01€/0.02€) - 2023/12/05 09:36:23 UTC
Table: 'Colorado' 6-max (real money) Seat #6 is the button
Seat 1: Fried Berg (0.45€)
Seat 2: S-aaron24 (2.91€)
Seat 3: swag-Morue73 (1.97€)
Seat 4: Fred_FFE (0.77€)
Seat 5: nemo5 (2.14€)
Seat 6: EA_Stinger (0.70€)
*** ANTE/BLINDS ***
Fried Berg posts small blind 0.01€
S-aaron24 posts big blind 0.02€
Dealt to Fried Berg [2c 3c]
*** PRE-FLOP *** 
swag-Morue73 calls 0.02€
Fred_FFE folds
nemo5 folds
EA_Stinger folds
Fried Berg calls 0.01€
S-aaron24 checks
*** FLOP *** [Jc Js Kh]
Fried Berg bets 0.04€
S-aaron24 calls 0.04€
swag-Morue73 folds
*** TURN *** [Jc Js Kh][6d]
Fried Berg bets 0.12€
S-aaron24 calls 0.12€
*** RIVER *** [Jc Js Kh 6d][Jh]
Fried Berg checks
S-aaron24 bets 0.29€
Fried Berg folds
S-aaron24 collected 0.63€ from pot
*** SUMMARY ***
Total pot 0.63€ | Rake 0.04€
Board: [Jc Js Kh 6d Jh]
Seat 2: S-aaron24 (big blind) won 0.63€


Winamax Poker - HOLD-UP "Colorado" - HandId: #19116069-775686-1701769059 - Holdem no limit (0.01€/0.02€) - 2023/12/05 09:37:39 UTC
Table: 'Colorado' 6-max (real money) Seat #6 is the button
Seat 1: -genzo- (2.75€)
Seat 2: ALLIN_OLI (9.03€)
Seat 3: Ga31k (2.06€)
Seat 4: Zebulon_66 (0.94€)
Seat 5: Fried Berg (0.27€)
Seat 6: AdiTheKing (3.63€)
*** ANTE/BLINDS ***
-genzo- posts small blind 0.01€
ALLIN_OLI posts big blind 0.02€
Dealt to Fried Berg [2s Jd]
*** PRE-FLOP *** 
Ga31k folds
Zebulon_66 raises 0.03€ to 0.05€
Fried Berg folds
AdiTheKing folds
-genzo- folds
ALLIN_OLI folds
Zebulon_66 collected 0.08€ from pot
*** SUMMARY ***
Total pot 0.08€ | No rake
Seat 4: Zebulon_66 won 0.08€


Winamax Poker - HOLD-UP "Colorado" - HandId: #19116069-775693-1701769067 - Holdem no limit (0.01€/0.02€) - 2023/12/05 09:37:47 UTC
Table: 'Colorado' 6-max (real money) Seat #6 is the button
Seat 1: BrokBroken (2.04€)
Seat 2: 48centaure (2€)
Seat 3: Totolebarj (1.79€)
Seat 4: crepu-bzh (0.42€)
Seat 5: S-aaron24 (2.03€)
Seat 6: Fried Berg (0.27€)
*** ANTE/BLINDS ***
BrokBroken posts small blind 0.01€
48centaure posts big blind 0.02€
Dealt to Fried Berg [Kc Ah]
*** PRE-FLOP *** 
Totolebarj folds
crepu-bzh calls 0.02€
S-aaron24 folds
Fried Berg raises 0.02€ to 0.04€
BrokBroken raises 0.08€ to 0.12€
48centaure folds
crepu-bzh calls 0.10€
Fried Berg raises 0.15€ to 0.27€ and is all-in
BrokBroken calls 0.15€
crepu-bzh calls 0.15€
*** FLOP *** [5c 2d Ad]
BrokBroken checks
crepu-bzh checks
*** TURN *** [5c 2d Ad][4d]
BrokBroken bets 0.29€
crepu-bzh calls 0.15€ and is all-in
*** RIVER *** [5c 2d Ad 4d][9h]
*** SHOW DOWN ***
crepu-bzh shows [Qh 5h] (One pair : 5)
BrokBroken shows [Ac Tc] (One pair : Aces)
Fried Berg shows [Kc Ah] (One pair : Aces)
Fried Berg collected 0.75€ from main pot
BrokBroken collected 0.41€ from side pot 1
*** SUMMARY ***
Total pot 1.16€ | Rake 0.11€
Board: [5c 2d Ad 4d 9h]
Seat 1: BrokBroken (small blind) showed [Ac Tc] and won 0.41€ with One pair : Aces
Seat 4: crepu-bzh showed [Qh 5h] and lost with One pair : 5
Seat 6: Fried Berg (button) showed [Kc Ah] and won 0.75€ with One pair : Aces


Winamax Poker - HOLD-UP "Colorado" - HandId: #19116069-775761-1701769141 - Holdem no limit (0.01€/0.02€) - 2023/12/05 09:39:01 UTC
Table: 'Colorado' 6-max (real money) Seat #6 is the button
Seat 1: Ertorko (2€)
Seat 2: HOTGAME (0.78€)
Seat 3: nemo5 (3.50€)
Seat 4: Fried Berg (0.75€)
Seat 5: Fred_FFE (0.41€)
Seat 6: Aggro Loser (5.77€)
*** ANTE/BLINDS ***
Ertorko posts small blind 0.01€
HOTGAME posts big blind 0.02€
Dealt to Fried Berg [5h 5s]
*** PRE-FLOP *** 
nemo5 folds
Fried Berg raises 0.02€ to 0.04€
Fred_FFE folds
Aggro Loser folds
Ertorko folds
HOTGAME folds
Fried Berg collected 0.07€ from pot
*** SUMMARY ***
Total pot 0.07€ | No rake
Seat 4: Fried Berg won 0.07€


Winamax Poker - HOLD-UP "Colorado" - HandId: #19116069-775782-1701769158 - Holdem no limit (0.01€/0.02€) - 2023/12/05 09:39:18 UTC
Table: 'Colorado' 6-max (real money) Seat #6 is the button
Seat 1: Tina117 (1.57€)
Seat 2: nemo5 (2.21€)
Seat 3: Fried Berg (0.78€)
Seat 4: Karinecokine (0.39€)
Seat 5: Johnytop (4.96€)
Seat 6: Halmosthard (5.53€)
*** ANTE/BLINDS ***
Tina117 posts small blind 0.01€
nemo5 posts big blind 0.02€
Dealt to Fried Berg [9c As]
*** PRE-FLOP *** 
Fried Berg raises 0.02€ to 0.04€
Karinecokine folds
Johnytop folds
Halmosthard calls 0.04€
Tina117 folds
nemo5 folds
*** FLOP *** [3c Jd Ad]
Fried Berg bets 0.06€
Halmosthard folds
Fried Berg collected 0.16€ from pot
*** SUMMARY ***
Total pot 0.16€ | Rake 0.01€
Board: [3c Jd Ad]
Seat 3: Fried Berg won 0.16€


Winamax Poker - HOLD-UP "Colorado" - HandId: #19116069-775819-1701769189 - Holdem no limit (0.01€/0.02€) - 2023/12/05 09:39:49 UTC
Table: 'Colorado' 6-max (real money) Seat #6 is the button
Seat 1: BrokBroken (2.01€)
Seat 2: Fried Berg (0.84€)
Seat 3: Udrab (2.02€)
Seat 4: g8o8k8u (2€)
Seat 5: LeJouer666 (1.92€)
Seat 6: TheRealWill (2.98€)
*** ANTE/BLINDS ***
BrokBroken posts small blind 0.01€
Fried Berg posts big blind 0.02€
Dealt to Fried Berg [3h 2c]
*** PRE-FLOP *** 
Udrab folds
g8o8k8u folds
LeJouer666 calls 0.02€
TheRealWill folds
BrokBroken calls 0.01€
Fried Berg checks
*** FLOP *** [9h 5c 8c]
BrokBroken bets 0.04€
Fried Berg folds
LeJouer666 folds
BrokBroken collected 0.09€ from pot
*** SUMMARY ***
Total pot 0.09€ | Rake 0.01€
Board: [9h 5c 8c]
Seat 1: BrokBroken (small blind) won 0.09€


Winamax Poker - HOLD-UP "Colorado" - HandId: #19116069-775844-1701769214 - Holdem no limit (0.01€/0.02€) - 2023/12/05 09:40:14 UTC
Table: 'Colorado' 6-max (real money) Seat #6 is the button
Seat 1: Fried Berg (0.82€)
Seat 2: Ertorko (2.16€)
Seat 3: Neferusobek (2.45€)
Seat 4: trikar xx (2.24€)
Seat 5: EA_Stinger (0.74€)
Seat 6: nemo5 (3.54€)
*** ANTE/BLINDS ***
Fried Berg posts small blind 0.01€
Ertorko posts big blind 0.02€
Dealt to Fried Berg [2s Kh]
*** PRE-FLOP *** 
Neferusobek folds
trikar xx folds
EA_Stinger raises 0.02€ to 0.04€
nemo5 folds
Fried Berg folds
Ertorko folds
EA_Stinger collected 0.07€ from pot
*** SUMMARY ***
Total pot 0.07€ | No rake
Seat 5: EA_Stinger won 0.07€


Winamax Poker - HOLD-UP "Colorado" - HandId: #19116069-775866-1701769236 - Holdem no limit (0.01€/0.02€) - 2023/12/05 09:40:36 UTC
Table: 'Colorado' 6-max (real money) Seat #6 is the button
Seat 1: TheRealWill (2.96€)
Seat 2: trikar xx (2.24€)
Seat 3: -genzo- (2.05€)
Seat 4: Fried Berg (0.81€)
Seat 5: Richard Reuk (2.21€)
Seat 6: slowreplay (2.30€)
*** ANTE/BLINDS ***
TheRealWill posts small blind 0.01€
trikar xx posts big blind 0.02€
Dealt to Fried Berg [Tc 6h]
*** PRE-FLOP *** 
-genzo- folds
Fried Berg folds
Richard Reuk folds
slowreplay raises 0.04€ to 0.06€
TheRealWill folds
trikar xx calls 0.04€
*** FLOP *** [9s 4h 4c]
trikar xx checks
slowreplay checks
*** TURN *** [9s 4h 4c][Qc]
trikar xx checks
slowreplay checks
*** RIVER *** [9s 4h 4c Qc][7s]
trikar xx checks
slowreplay checks
*** SHOW DOWN ***
trikar xx shows [Ad 5d] (One pair : 4)
slowreplay shows [8h Ah] (One pair : 4)
slowreplay collected 0.06€ from pot
trikar xx collected 0.06€ from pot
*** SUMMARY ***
Total pot 0.12€ | Rake 0.01€
Board: [9s 4h 4c Qc 7s]
Seat 2: trikar xx (big blind) showed [Ad 5d] and won 0.06€ with One pair : 4
Seat 6: slowreplay (button) showed [8h Ah] and won 0.06€ with One pair : 4


Winamax Poker - HOLD-UP "Colorado" - HandId: #19116069-775877-1701769246 - Holdem no limit (0.01€/0.02€) - 2023/12/05 09:40:46 UTC
Table: 'Colorado' 6-max (real money) Seat #6 is the button
Seat 1: Zard.Oz (4.71€)
Seat 2: kameleon73 (2€)
Seat 3: Halmosthard (5.48€)
Seat 4: Richard Reuk (2.21€)
Seat 5: Fried Berg (0.81€)
Seat 6: PIQSOU (2.39€)
*** ANTE/BLINDS ***
Zard.Oz posts small blind 0.01€
kameleon73 posts big blind 0.02€
Dealt to Fried Berg [Js 8h]
*** PRE-FLOP *** 
Halmosthard folds
Richard Reuk folds
Fried Berg folds
PIQSOU folds
Zard.Oz calls 0.01€
kameleon73 checks
*** FLOP *** [Ah 4h 9s]
Zard.Oz checks
kameleon73 checks
*** TURN *** [Ah 4h 9s][Jc]
Zard.Oz checks
kameleon73 bets 0.07€
Zard.Oz folds
kameleon73 collected 0.11€ from pot
*** SUMMARY ***
Total pot 0.11€ | No rake
Board: [Ah 4h 9s Jc]
Seat 2: kameleon73 (big blind) won 0.11€


Winamax Poker - HOLD-UP "Colorado" - HandId: #19116069-775920-1701769283 - Holdem no limit (0.01€/0.02€) - 2023/12/05 09:41:23 UTC
Table: 'Colorado' 6-max (real money) Seat #6 is the button
Seat 1: ischia (0.42€)
Seat 2: AdiTheKing (3.43€)
Seat 3: Karinecokine (0.33€)
Seat 4: BrokBroken (2.11€)
Seat 5: Neferusobek (2.02€)
Seat 6: Fried Berg (0.81€)
*** ANTE/BLINDS ***
ischia posts small blind 0.01€
AdiTheKing posts big blind 0.02€
Dealt to Fried Berg [4s 2s]
*** PRE-FLOP *** 
Karinecokine folds
BrokBroken folds
Neferusobek raises 0.04€ to 0.06€
Fried Berg folds
ischia folds
AdiTheKing folds
Neferusobek collected 0.09€ from pot
*** SUMMARY ***
Total pot 0.09€ | No rake
Seat 5: Neferusobek won 0.09€


Winamax Poker - HOLD-UP "Colorado" - HandId: #19116069-775930-1701769293 - Holdem no limit (0.01€/0.02€) - 2023/12/05 09:41:33 UTC
Table: 'Colorado' 6-max (real money) Seat #6 is the button
Seat 1: Halmosthard (5.46€)
Seat 2: S-aaron24 (3.15€)
Seat 3: el_menestrel (1.33€)
Seat 4: Fried Berg (0.81€)
Seat 5: TheRealWill (4.09€)
Seat 6: slowreplay (4€)
*** ANTE/BLINDS ***
Halmosthard posts small blind 0.01€
S-aaron24 posts big blind 0.02€
Dealt to Fried Berg [7d 3s]
*** PRE-FLOP *** 
el_menestrel folds
Fried Berg folds
TheRealWill raises 0.04€ to 0.06€
slowreplay folds
Halmosthard folds
S-aaron24 calls 0.04€
*** FLOP *** [8h Js 7h]
S-aaron24 checks
TheRealWill bets 0.07€
S-aaron24 calls 0.07€
*** TURN *** [8h Js 7h][2s]
S-aaron24 checks
TheRealWill checks
*** RIVER *** [8h Js 7h 2s][Jc]
S-aaron24 checks
TheRealWill checks
*** SHOW DOWN ***
S-aaron24 shows [Kh Qh] (One pair : Jacks)
TheRealWill shows [As 9c] (One pair : Jacks)
TheRealWill collected 0.24€ from pot
*** SUMMARY ***
Total pot 0.24€ | Rake 0.03€
Board: [8h Js 7h 2s Jc]
Seat 2: S-aaron24 (big blind) showed [Kh Qh] and lost with One pair : Jacks
Seat 5: TheRealWill showed [As 9c] and won 0.24€ with One pair : Jacks


Winamax Poker - HOLD-UP "Colorado" - HandId: #19116069-775932-1701769297 - Holdem no limit (0.01€/0.02€) - 2023/12/05 09:41:37 UTC
Table: 'Colorado' 6-max (real money) Seat #6 is the button
Seat 1: AdiTheKing (3.41€)
Seat 2: Fried Berg (0.81€)
Seat 3: Frankyonki2 (2.54€)
Seat 4: el_menestrel (1.33€)
Seat 5: koshikosha (2.19€)
Seat 6: Karinecokine (0.32€)
*** ANTE/BLINDS ***
AdiTheKing posts small blind 0.01€
Fried Berg posts big blind 0.02€
Dealt to Fried Berg [6c 3s]
*** PRE-FLOP *** 
Frankyonki2 folds
el_menestrel folds
koshikosha calls 0.02€
Karinecokine folds
AdiTheKing folds
Fried Berg checks
*** FLOP *** [4h 2c 6h]
Fried Berg bets 0.04€
koshikosha folds
Fried Berg collected 0.08€ from pot
*** SUMMARY ***
Total pot 0.08€ | Rake 0.01€
Board: [4h 2c 6h]
Seat 2: Fried Berg (big blind) won 0.08€


Winamax Poker - HOLD-UP "Colorado" - HandId: #19116069-775955-1701769321 - Holdem no limit (0.01€/0.02€) - 2023/12/05 09:42:01 UTC
Table: 'Colorado' 6-max (real money) Seat #6 is the button
Seat 1: Fried Berg (0.83€)
Seat 2: ALLIN_OLI (9.33€)
Seat 3: Ertorko (2.26€)
Seat 4: el_menestrel (1.31€)
Seat 5: slowreplay (2.30€)
Seat 6: -genzo- (2.70€)
*** ANTE/BLINDS ***
Fried Berg posts small blind 0.01€
ALLIN_OLI posts big blind 0.02€
Dealt to Fried Berg [5c Jc]
*** PRE-FLOP *** 
Ertorko folds
el_menestrel raises 0.04€ to 0.06€
slowreplay folds
-genzo- calls 0.06€
Fried Berg folds
ALLIN_OLI folds
*** FLOP *** [5s Tc 7h]
el_menestrel checks
-genzo- checks
*** TURN *** [5s Tc 7h][8s]
el_menestrel bets 0.15€
-genzo- folds
el_menestrel collected 0.28€ from pot
*** SUMMARY ***
Total pot 0.28€ | Rake 0.02€
Board: [5s Tc 7h 8s]
Seat 4: el_menestrel won 0.28€


Winamax Poker - HOLD-UP "Colorado" - HandId: #19116069-775979-1701769346 - Holdem no limit (0.01€/0.02€) - 2023/12/05 09:42:26 UTC
Table: 'Colorado' 6-max (real money) Seat #6 is the button
Seat 1: nemo5 (3.32€)
Seat 2: Alexluka (2.40€)
Seat 3: Fried Berg (0.82€)
Seat 4: Neferusobek (2.12€)
Seat 5: MoneyGrowing (2.30€)
Seat 6: nico033 (5.91€)
*** ANTE/BLINDS ***
nemo5 posts small blind 0.01€
Alexluka posts big blind 0.02€
Dealt to Fried Berg [4h Ad]
*** PRE-FLOP *** 
Fried Berg raises 0.02€ to 0.04€
Neferusobek folds
MoneyGrowing folds
nico033 folds
nemo5 calls 0.03€
Alexluka calls 0.02€
*** FLOP *** [8c Js 3c]
nemo5 checks
Alexluka checks
Fried Berg bets 0.06€
nemo5 folds
Alexluka folds
Fried Berg collected 0.17€ from pot
*** SUMMARY ***
Total pot 0.17€ | Rake 0.01€
Board: [8c Js 3c]
Seat 3: Fried Berg won 0.17€


Winamax Poker - HOLD-UP "Colorado" - HandId: #19116069-776016-1701769381 - Holdem no limit (0.01€/0.02€) - 2023/12/05 09:43:01 UTC
Table: 'Colorado' 6-max (real money) Seat #6 is the button
Seat 1: PIQSOU (2.33€)
Seat 2: nemo5 (3.37€)
Seat 3: slowreplay (4.06€)
Seat 4: -genzo- (3.08€)
Seat 5: Fried Berg (0.89€)
Seat 6: Zard.Oz (4.71€)
*** ANTE/BLINDS ***
PIQSOU posts small blind 0.01€
nemo5 posts big blind 0.02€
Dealt to Fried Berg [3c Qh]
*** PRE-FLOP *** 
slowreplay folds
-genzo- folds
Fried Berg folds
Zard.Oz folds
PIQSOU raises 0.03€ to 0.05€
nemo5 folds
PIQSOU collected 0.07€ from pot
*** SUMMARY ***
Total pot 0.07€ | No rake
Seat 1: PIQSOU (small blind) won 0.07€


Winamax Poker - HOLD-UP "Colorado" - HandId: #19116069-776030-1701769393 - Holdem no limit (0.01€/0.02€) - 2023/12/05 09:43:13 UTC
Table: 'Colorado' 6-max (real money) Seat #6 is the button
Seat 1: sAArtouKK (2.20€)
Seat 2: el_menestrel (1.40€)
Seat 3: slowreplay (2.30€)
Seat 4: VanDolar (2.18€)
Seat 5: Fried Berg (0.89€)
Seat 6: g8o8k8u (2.03€)
*** ANTE/BLINDS ***
sAArtouKK posts small blind 0.01€
el_menestrel posts big blind 0.02€
Dealt to Fried Berg [4d Qh]
*** PRE-FLOP *** 
slowreplay folds
VanDolar folds
Fried Berg folds
g8o8k8u folds
sAArtouKK folds
el_menestrel collected 0.03€ from pot
*** SUMMARY ***
Total pot 0.03€ | No rake
Seat 2: el_menestrel (big blind) won 0.03€


Winamax Poker - HOLD-UP "Colorado" - HandId: #19116069-776036-1701769399 - Holdem no limit (0.01€/0.02€) - 2023/12/05 09:43:19 UTC
Table: 'Colorado' 6-max (real money) Seat #6 is the button
Seat 1: Velvet420 (0.64€)
Seat 2: Fried Berg (0.89€)
Seat 3: TheRealWill (4.04€)
Seat 4: Masterab (1.79€)
Seat 5: nodi69 (1.69€)
Seat 6: sAArtouKK (2.19€)
*** ANTE/BLINDS ***
Velvet420 posts small blind 0.01€
Fried Berg posts big blind 0.02€
Dealt to Fried Berg [Ac 8d]
*** PRE-FLOP *** 
TheRealWill raises 0.04€ to 0.06€
Masterab calls 0.06€
nodi69 folds
sAArtouKK folds
Velvet420 calls 0.05€
Fried Berg calls 0.04€
*** FLOP *** [4s 2c 8c]
Velvet420 bets 0.08€
Fried Berg calls 0.08€
TheRealWill calls 0.08€
Masterab folds
*** TURN *** [4s 2c 8c][As]
Velvet420 checks
Fried Berg bets 0.16€
TheRealWill raises 0.32€ to 0.48€
Velvet420 folds
Fried Berg calls 0.32€
*** RIVER *** [4s 2c 8c As][Qd]
Fried Berg checks
TheRealWill bets 0.36€
Fried Berg calls 0.27€ and is all-in
*** SHOW DOWN ***
Fried Berg shows [Ac 8d] (Two pairs : Aces and 8)
TheRealWill shows [Ah Qs] (Two pairs : Aces and Queens)
TheRealWill collected 1.87€ from pot
*** SUMMARY ***
Total pot 1.87€ | Rake 0.20€
Board: [4s 2c 8c As Qd]
Seat 2: Fried Berg (big blind) showed [Ac 8d] and lost with Two pairs : Aces and 8
Seat 3: TheRealWill showed [Ah Qs] and won 1.87€ with Two pairs : Aces and Queens


Winamax Poker - HOLD-UP "Colorado" - HandId: #19116069-776162-1701769504 - Holdem no limit (0.01€/0.02€) - 2023/12/05 09:45:04 UTC
Table: 'Colorado' 6-max (real money) Seat #6 is the button
Seat 1: _AKKA_ (2.70€)
Seat 2: Fried Berg (0.50€)
Seat 3: prudence34 (2€)
Seat 4: TheRealWill (3.08€)
Seat 5: Richard Reuk (4.20€)
Seat 6: luffy43770 (1.49€)
*** ANTE/BLINDS ***
_AKKA_ posts small blind 0.01€
Fried Berg posts big blind 0.02€
Dealt to Fried Berg [7s 8d]
*** PRE-FLOP *** 
prudence34 folds
TheRealWill raises 0.04€ to 0.06€
Richard Reuk raises 0.12€ to 0.18€
luffy43770 folds
_AKKA_ folds
Fried Berg folds
TheRealWill folds
Richard Reuk collected 0.27€ from pot
*** SUMMARY ***
Total pot 0.27€ | No rake
Seat 5: Richard Reuk won 0.27€


Winamax Poker - HOLD-UP "Colorado" - HandId: #19116069-776181-1701769521 - Holdem no limit (0.01€/0.02€) - 2023/12/05 09:45:21 UTC
Table: 'Colorado' 6-max (real money) Seat #6 is the button
Seat 1: Fried Berg (0.48€)
Seat 2: nodi69 (1.15€)
Seat 3: stevebalboni (4.25€)
Seat 4: Ertorko (2.53€)
Seat 5: Velvet420 (0.18€)
Seat 6: -genzo- (2.88€)
*** ANTE/BLINDS ***
Fried Berg posts small blind 0.01€
nodi69 posts big blind 0.02€
Dealt to Fried Berg [Ks Kc]
*** PRE-FLOP *** 
stevebalboni folds
Ertorko folds
Velvet420 raises 0.03€ to 0.05€
-genzo- folds
Fried Berg raises 0.10€ to 0.15€
nodi69 folds
Velvet420 calls 0.10€
*** FLOP *** [Qs 5c Qd]
Fried Berg bets 0.03€
Velvet420 calls 0.03€ and is all-in
*** TURN *** [Qs 5c Qd][5d]
*** RIVER *** [Qs 5c Qd 5d][8c]
*** SHOW DOWN ***
Velvet420 shows [Jd Ad] (Two pairs : Queens and 5)
Fried Berg shows [Ks Kc] (Two pairs : Kings and Queens)
Fried Berg collected 0.34€ from pot
*** SUMMARY ***
Total pot 0.34€ | Rake 0.04€
Board: [Qs 5c Qd 5d 8c]
Seat 1: Fried Berg (small blind) showed [Ks Kc] and won 0.34€ with Two pairs : Kings and Queens
Seat 5: Velvet420 showed [Jd Ad] and lost with Two pairs : Queens and 5


Winamax Poker - HOLD-UP "Colorado" - HandId: #19116069-776218-1701769551 - Holdem no limit (0.01€/0.02€) - 2023/12/05 09:45:51 UTC
Table: 'Colorado' 6-max (real money) Seat #6 is the button
Seat 1: stevebalboni (4.25€)
Seat 2: Karinecokine (0.41€)
Seat 3: Fried Berg (0.64€)
Seat 4: magnumbenji (0.44€)
Seat 5: liseau5312 (2.14€)
Seat 6: prudence34 (2€)
*** ANTE/BLINDS ***
stevebalboni posts small blind 0.01€
Karinecokine posts big blind 0.02€
Dealt to Fried Berg [8d Tc]
*** PRE-FLOP *** 
Fried Berg folds
magnumbenji folds
liseau5312 folds
prudence34 raises 0.04€ to 0.06€
stevebalboni folds
Karinecokine folds
prudence34 collected 0.09€ from pot
*** SUMMARY ***
Total pot 0.09€ | No rake
Seat 6: prudence34 (button) won 0.09€


Winamax Poker - HOLD-UP "Colorado" - HandId: #19116069-776226-1701769556 - Holdem no limit (0.01€/0.02€) - 2023/12/05 09:45:56 UTC
Table: 'Colorado' 6-max (real money) Seat #6 is the button
Seat 1: julieninaval (2.19€)
Seat 2: BrokBroken (2.52€)
Seat 3: yep80 (1.75€)
Seat 4: Fried Berg (0.64€)
Seat 5: g8o8k8u (2.73€)
Seat 6: AdiTheKing (1.43€)
*** ANTE/BLINDS ***
julieninaval posts small blind 0.01€
BrokBroken posts big blind 0.02€
Dealt to Fried Berg [Ah 8c]
*** PRE-FLOP *** 
yep80 folds
Fried Berg raises 0.02€ to 0.04€
g8o8k8u folds
AdiTheKing raises 0.08€ to 0.12€
julieninaval folds
BrokBroken calls 0.10€
Fried Berg calls 0.08€
*** FLOP *** [5h 6c 9c]
BrokBroken checks
Fried Berg checks
AdiTheKing checks
*** TURN *** [5h 6c 9c][5d]
BrokBroken checks
Fried Berg checks
AdiTheKing bets 0.13€
BrokBroken folds
Fried Berg folds
AdiTheKing collected 0.46€ from pot
*** SUMMARY ***
Total pot 0.46€ | Rake 0.04€
Board: [5h 6c 9c 5d]
Seat 6: AdiTheKing (button) won 0.46€


Winamax Poker - HOLD-UP "Colorado" - HandId: #19116069-776265-1701769592 - Holdem no limit (0.01€/0.02€) - 2023/12/05 09:46:32 UTC
Table: 'Colorado' 6-max (real money) Seat #6 is the button
Seat 1: DosdeBras (1.06€)
Seat 2: Polanskii (2.03€)
Seat 3: BrokBroken (2.39€)
Seat 4: Pierrof24 (2.33€)
Seat 5: Fried Berg (0.52€)
Seat 6: VanDolar (2.54€)
*** ANTE/BLINDS ***
DosdeBras posts small blind 0.01€
Polanskii posts big blind 0.02€
Dealt to Fried Berg [Tc 2s]
*** PRE-FLOP *** 
BrokBroken folds
Pierrof24 folds
Fried Berg folds
VanDolar folds
DosdeBras folds
Polanskii collected 0.03€ from pot
*** SUMMARY ***
Total pot 0.03€ | No rake
Seat 2: Polanskii (big blind) won 0.03€


Winamax Poker - HOLD-UP "Colorado" - HandId: #19116069-776267-1701769594 - Holdem no limit (0.01€/0.02€) - 2023/12/05 09:46:34 UTC
Table: 'Colorado' 6-max (real money) Seat #6 is the button
Seat 1: AdiTheKing (1.64€)
Seat 2: PANDIKORNIO (2.02€)
Seat 3: TheRealWill (5.25€)
Seat 4: BrokBroken (2.39€)
Seat 5: Aggro Loser (2€)
Seat 6: Fried Berg (0.52€)
*** ANTE/BLINDS ***
AdiTheKing posts small blind 0.01€
PANDIKORNIO posts big blind 0.02€
Dealt to Fried Berg [2s 6h]
*** PRE-FLOP *** 
TheRealWill folds
BrokBroken raises 0.04€ to 0.06€
Aggro Loser folds
Fried Berg folds
AdiTheKing folds
PANDIKORNIO folds
BrokBroken collected 0.09€ from pot
*** SUMMARY ***
Total pot 0.09€ | No rake
Seat 4: BrokBroken won 0.09€


Winamax Poker - HOLD-UP "Colorado" - HandId: #19116069-776269-1701769597 - Holdem no limit (0.01€/0.02€) - 2023/12/05 09:46:37 UTC
Table: 'Colorado' 6-max (real money) Seat #6 is the button
Seat 1: MoneyGrowing (2€)
Seat 2: slowreplay (2.63€)
Seat 3: -genzo- (2.85€)
Seat 4: TheRealWill (5.25€)
Seat 5: Fried Berg (0.52€)
Seat 6: nemo5 (4.79€)
*** ANTE/BLINDS ***
MoneyGrowing posts small blind 0.01€
slowreplay posts big blind 0.02€
Dealt to Fried Berg [7d 2h]
*** PRE-FLOP *** 
-genzo- raises 0.04€ to 0.06€
TheRealWill folds
Fried Berg folds
nemo5 folds
MoneyGrowing folds
slowreplay folds
-genzo- collected 0.09€ from pot
*** SUMMARY ***
Total pot 0.09€ | No rake
Seat 3: -genzo- won 0.09€


Winamax Poker - HOLD-UP "Colorado" - HandId: #19116069-776272-1701769599 - Holdem no limit (0.01€/0.02€) - 2023/12/05 09:46:39 UTC
Table: 'Colorado' 6-max (real money) Seat #6 is the button
Seat 1: livthe34 (1.98€)
Seat 2: Fried Berg (0.52€)
Seat 3: Aggro Loser (2€)
Seat 4: g8o8k8u (2.06€)
Seat 5: Pierrof24 (2.33€)
Seat 6: S-aaron24 (2.31€)
*** ANTE/BLINDS ***
livthe34 posts small blind 0.01€
Fried Berg posts big blind 0.02€
Dealt to Fried Berg [Qc 3c]
*** PRE-FLOP *** 
Aggro Loser raises 0.03€ to 0.05€
g8o8k8u folds
Pierrof24 folds
S-aaron24 folds
livthe34 folds
Fried Berg folds
Aggro Loser collected 0.08€ from pot
*** SUMMARY ***
Total pot 0.08€ | No rake
Seat 3: Aggro Loser won 0.08€


Winamax Poker - HOLD-UP "Colorado" - HandId: #19116069-776277-1701769603 - Holdem no limit (0.01€/0.02€) - 2023/12/05 09:46:43 UTC
Table: 'Colorado' 6-max (real money) Seat #6 is the button
Seat 1: Dexter1971 (1.98€)
Seat 2: TheRealWill (4.08€)
Seat 3: Fried Berg (0.50€)
Seat 4: loox7 (1.12€)
Seat 5: PIQSOU (4.13€)
Seat 6: HOTGAME (0.44€)
*** ANTE/BLINDS ***
Dexter1971 posts small blind 0.01€
TheRealWill posts big blind 0.02€
Dealt to Fried Berg [3d Qd]
*** PRE-FLOP *** 
Fried Berg folds
loox7 folds
PIQSOU folds
HOTGAME folds
Dexter1971 folds
TheRealWill collected 0.03€ from pot
*** SUMMARY ***
Total pot 0.03€ | No rake
Seat 2: TheRealWill (big blind) won 0.03€


Winamax Poker - HOLD-UP "Colorado" - HandId: #19116069-776281-1701769606 - Holdem no limit (0.01€/0.02€) - 2023/12/05 09:46:46 UTC
Table: 'Colorado' 6-max (real money) Seat #6 is the button
Seat 1: Fried Berg (0.50€)
Seat 2: nodi69 (2.26€)
Seat 3: loox7 (1.12€)
Seat 4: Dexter1971 (1.97€)
Seat 5: P.BaIkany (2€)
Seat 6: Stackbystack (2€)
*** ANTE/BLINDS ***
Fried Berg posts small blind 0.01€
nodi69 posts big blind 0.02€
Dealt to Fried Berg [5h 4h]
*** PRE-FLOP *** 
loox7 folds
Dexter1971 folds
P.BaIkany folds
Stackbystack calls 0.02€
Fried Berg folds
nodi69 checks
*** FLOP *** [2d Kd Kc]
nodi69 checks
Stackbystack checks
*** TURN *** [2d Kd Kc][6d]
nodi69 checks
Stackbystack checks
*** RIVER *** [2d Kd Kc 6d][6s]
nodi69 checks
Stackbystack checks
*** SHOW DOWN ***
nodi69 shows [4d Ah] (Two pairs : Kings and 6)
Stackbystack shows [Ac Jd] (Two pairs : Kings and 6)
Stackbystack collected 0.02€ from pot
nodi69 collected 0.02€ from pot
*** SUMMARY ***
Total pot 0.04€ | Rake 0.01€
Board: [2d Kd Kc 6d 6s]
Seat 2: nodi69 (big blind) showed [4d Ah] and won 0.02€ with Two pairs : Kings and 6
Seat 6: Stackbystack (button) showed [Ac Jd] and won 0.02€ with Two pairs : Kings and 6


Winamax Poker - HOLD-UP "Colorado" - HandId: #19116069-776283-1701769607 - Holdem no limit (0.01€/0.02€) - 2023/12/05 09:46:47 UTC
Table: 'Colorado' 6-max (real money) Seat #6 is the button
Seat 1: slowreplay (2.61€)
Seat 2: ALLIN_OLI (2.73€)
Seat 3: prudence34 (2€)
Seat 4: Fried Berg (0.49€)
Seat 5: MoneyGrowing (2€)
Seat 6: Dexter1971 (1.97€)
*** ANTE/BLINDS ***
slowreplay posts small blind 0.01€
ALLIN_OLI posts big blind 0.02€
Dealt to Fried Berg [Qd 3c]
*** PRE-FLOP *** 
prudence34 folds
Fried Berg folds
MoneyGrowing folds
Dexter1971 calls 0.02€
slowreplay folds
ALLIN_OLI raises 0.10€ to 0.12€
Dexter1971 folds
ALLIN_OLI collected 0.15€ from pot
*** SUMMARY ***
Total pot 0.15€ | No rake
Seat 2: ALLIN_OLI (big blind) won 0.15€


Winamax Poker - HOLD-UP "Colorado" - HandId: #19116069-776287-1701769609 - Holdem no limit (0.01€/0.02€) - 2023/12/05 09:46:49 UTC
Table: 'Colorado' 6-max (real money) Seat #6 is the button
Seat 1: nemo5 (3.08€)
Seat 2: AAdellKK (1.94€)
Seat 3: stevebalboni (4.21€)
Seat 4: livthe34 (1.97€)
Seat 5: MoneyGrowing (2€)
Seat 6: Fried Berg (0.49€)
*** ANTE/BLINDS ***
nemo5 posts small blind 0.01€
AAdellKK posts big blind 0.02€
Dealt to Fried Berg [Tc 4h]
*** PRE-FLOP *** 
stevebalboni folds
livthe34 folds
MoneyGrowing folds
Fried Berg folds
nemo5 raises 0.05€ to 0.07€
AAdellKK folds
nemo5 collected 0.09€ from pot
*** SUMMARY ***
Total pot 0.09€ | No rake
Seat 1: nemo5 (small blind) won 0.09€


Winamax Poker - HOLD-UP "Colorado" - HandId: #19116069-776291-1701769613 - Holdem no limit (0.01€/0.02€) - 2023/12/05 09:46:53 UTC
Table: 'Colorado' 6-max (real money) Seat #6 is the button
Seat 1: PIQSOU (2.07€)
Seat 2: Aggro Loser (2.03€)
Seat 3: _AKKA_ (2.84€)
Seat 4: Fried Berg (0.49€)
Seat 5: Neferusobek (3.27€)
Seat 6: Richard Reuk (3.68€)
*** ANTE/BLINDS ***
PIQSOU posts small blind 0.01€
Aggro Loser posts big blind 0.02€
Dealt to Fried Berg [5d 4c]
*** PRE-FLOP *** 
_AKKA_ raises 0.04€ to 0.06€
Fried Berg folds
Neferusobek folds
Richard Reuk folds
PIQSOU folds
Aggro Loser raises 0.18€ to 0.24€
_AKKA_ folds
Aggro Loser collected 0.31€ from pot
*** SUMMARY ***
Total pot 0.31€ | No rake
Seat 2: Aggro Loser (big blind) won 0.31€


Winamax Poker - HOLD-UP "Colorado" - HandId: #19116069-776294-1701769615 - Holdem no limit (0.01€/0.02€) - 2023/12/05 09:46:55 UTC
Table: 'Colorado' 6-max (real money) Seat #6 is the button
Seat 1: PANDIKORNIO (2.03€)
Seat 2: Fried Berg (0.49€)
Seat 3: slowreplay (2.23€)
Seat 4: prudence34 (2€)
Seat 5: liseau5312 (1.06€)
Seat 6: TheRealWill (4.09€)
*** ANTE/BLINDS ***
PANDIKORNIO posts small blind 0.01€
Fried Berg posts big blind 0.02€
Dealt to Fried Berg [Jh 9d]
*** PRE-FLOP *** 
slowreplay folds
prudence34 folds
liseau5312 raises 0.03€ to 0.05€
TheRealWill folds
PANDIKORNIO calls 0.04€
Fried Berg folds
*** FLOP *** [7s Ts 3d]
PANDIKORNIO bets 0.04€
liseau5312 raises 0.04€ to 0.08€
PANDIKORNIO calls 0.04€
*** TURN *** [7s Ts 3d][As]
PANDIKORNIO checks
liseau5312 bets 0.10€
PANDIKORNIO folds
liseau5312 collected 0.35€ from pot
*** SUMMARY ***
Total pot 0.35€ | Rake 0.03€
Board: [7s Ts 3d As]
Seat 5: liseau5312 won 0.35€


Winamax Poker - HOLD-UP "Colorado" - HandId: #19116069-776308-1701769625 - Holdem no limit (0.01€/0.02€) - 2023/12/05 09:47:05 UTC
Table: 'Colorado' 6-max (real money) Seat #6 is the button
Seat 1: Fried Berg (0.47€)
Seat 2: -genzo- (3.20€)
Seat 3: DeX70 (3.36€)
Seat 4: Karinecokine (0.04€)
Seat 5: P.BaIkany (2.05€)
Seat 6: grut28 (1.97€)
*** ANTE/BLINDS ***
Fried Berg posts small blind 0.01€
-genzo- posts big blind 0.02€
Dealt to Fried Berg [3c 7c]
*** PRE-FLOP *** 
DeX70 folds
Karinecokine raises 0.02€ to 0.04€ and is all-in
P.BaIkany folds
grut28 folds
Fried Berg folds
-genzo- calls 0.02€
*** FLOP *** [4h Ks 4c]
*** TURN *** [4h Ks 4c][3d]
*** RIVER *** [4h Ks 4c 3d][Qs]
*** SHOW DOWN ***
-genzo- shows [Jc Ac] (One pair : 4)
Karinecokine shows [Kc Qc] (Two pairs : Kings and Queens)
Karinecokine collected 0.08€ from pot
*** SUMMARY ***
Total pot 0.08€ | Rake 0.01€
Board: [4h Ks 4c 3d Qs]
Seat 2: -genzo- (big blind) showed [Jc Ac] and lost with One pair : 4
Seat 4: Karinecokine showed [Kc Qc] and won 0.08€ with Two pairs : Kings and Queens


Winamax Poker - HOLD-UP "Colorado" - HandId: #19116069-776319-1701769637 - Holdem no limit (0.01€/0.02€) - 2023/12/05 09:47:17 UTC
Table: 'Colorado' 6-max (real money) Seat #6 is the button
Seat 1: AdiTheKing (1€)
Seat 2: g8o8k8u (2€)
Seat 3: Fried Berg (0.46€)
Seat 4: PIQSOU (2€)
Seat 5: Halmosthard (2.45€)
Seat 6: stevebalboni (4.16€)
*** ANTE/BLINDS ***
AdiTheKing posts small blind 0.01€
g8o8k8u posts big blind 0.02€
Dealt to Fried Berg [3s Ts]
*** PRE-FLOP *** 
Fried Berg folds
PIQSOU folds
Halmosthard folds
stevebalboni raises 0.04€ to 0.06€
AdiTheKing folds
g8o8k8u folds
stevebalboni collected 0.09€ from pot
*** SUMMARY ***
Total pot 0.09€ | No rake
Seat 6: stevebalboni (button) won 0.09€


Winamax Poker - HOLD-UP "Colorado" - HandId: #19116069-776322-1701769638 - Holdem no limit (0.01€/0.02€) - 2023/12/05 09:47:18 UTC
Table: 'Colorado' 6-max (real money) Seat #6 is the button
Seat 1: grut28 (1.95€)
Seat 2: MoneyGrowing (2€)
Seat 3: Halmosthard (2.45€)
Seat 4: Neferusobek (3.29€)
Seat 5: Fried Berg (0.46€)
Seat 6: Tooto1808 (2.19€)
*** ANTE/BLINDS ***
grut28 posts small blind 0.01€
MoneyGrowing posts big blind 0.02€
Dealt to Fried Berg [6s 9h]
*** PRE-FLOP *** 
Halmosthard folds
Neferusobek folds
Fried Berg folds
Tooto1808 raises 0.03€ to 0.05€
grut28 folds
MoneyGrowing folds
Tooto1808 collected 0.08€ from pot
*** SUMMARY ***
Total pot 0.08€ | No rake
Seat 6: Tooto1808 (button) won 0.08€


Winamax Poker - HOLD-UP "Colorado" - HandId: #19116069-776328-1701769643 - Holdem no limit (0.01€/0.02€) - 2023/12/05 09:47:23 UTC
Table: 'Colorado' 6-max (real money) Seat #6 is the button
Seat 1: g8o8k8u (2€)
Seat 2: VanDolar (2.11€)
Seat 3: slowreplay (2.96€)
Seat 4: -genzo- (3.16€)
Seat 5: Fried Berg (0.46€)
Seat 6: P.BaIkany (2€)
*** ANTE/BLINDS ***
g8o8k8u posts small blind 0.01€
VanDolar posts big blind 0.02€
Dealt to Fried Berg [Qc 6h]
*** PRE-FLOP *** 
slowreplay folds
-genzo- folds
Fried Berg folds
P.BaIkany raises 0.06€ to 0.08€
g8o8k8u folds
VanDolar folds
P.BaIkany collected 0.11€ from pot
*** SUMMARY ***
Total pot 0.11€ | No rake
Seat 6: P.BaIkany (button) won 0.11€


Winamax Poker - HOLD-UP "Colorado" - HandId: #19116069-776331-1701769645 - Holdem no limit (0.01€/0.02€) - 2023/12/05 09:47:25 UTC
Table: 'Colorado' 6-max (real money) Seat #6 is the button
Seat 1: Fried Berg (0.46€)
Seat 2: Richard Reuk (4.23€)
Seat 3: prudence34 (2.29€)
Seat 4: AdiTheKing (0.99€)
Seat 5: PIQSOU (2.04€)
Seat 6: g8o8k8u (2€)
*** ANTE/BLINDS ***
Fried Berg posts small blind 0.01€
Richard Reuk posts big blind 0.02€
Dealt to Fried Berg [2d Ts]
*** PRE-FLOP *** 
prudence34 folds
AdiTheKing raises 0.03€ to 0.05€
PIQSOU folds
g8o8k8u folds
Fried Berg folds
Richard Reuk folds
AdiTheKing collected 0.08€ from pot
*** SUMMARY ***
Total pot 0.08€ | No rake
Seat 4: AdiTheKing won 0.08€


Winamax Poker - HOLD-UP "Colorado" - HandId: #19116069-776334-1701769647 - Holdem no limit (0.01€/0.02€) - 2023/12/05 09:47:27 UTC
Table: 'Colorado' 6-max (real money) Seat #6 is the button
Seat 1: ALLIN_OLI (2.76€)
Seat 2: Fried Berg (0.45€)
Seat 3: stevebalboni (4.19€)
Seat 4: Frankyonki2 (2.96€)
Seat 5: Dexter1971 (1.95€)
Seat 6: grut28 (1.94€)
*** ANTE/BLINDS ***
ALLIN_OLI posts small blind 0.01€
Fried Berg posts big blind 0.02€
Dealt to Fried Berg [6h 9c]
*** PRE-FLOP *** 
stevebalboni raises 0.04€ to 0.06€
Frankyonki2 folds
Dexter1971 folds
grut28 calls 0.06€
ALLIN_OLI calls 0.05€
Fried Berg folds
*** FLOP *** [Ac Jh 5d]
ALLIN_OLI bets 0.15€
stevebalboni raises 0.50€ to 0.65€
grut28 folds
ALLIN_OLI folds
stevebalboni collected 0.95€ from pot
*** SUMMARY ***
Total pot 0.95€ | Rake 0.05€
Board: [Ac Jh 5d]
Seat 3: stevebalboni won 0.95€


Winamax Poker - HOLD-UP "Colorado" - HandId: #19116069-776337-1701769650 - Holdem no limit (0.01€/0.02€) - 2023/12/05 09:47:30 UTC
Table: 'Colorado' 6-max (real money) Seat #6 is the button
Seat 1: MIKATRANKIL (2.12€)
Seat 2: Halmosthard (2.45€)
Seat 3: Fried Berg (0.43€)
Seat 4: nemo5 (2.48€)
Seat 5: prudence34 (2.29€)
Seat 6: S-aaron24 (2.31€)
*** ANTE/BLINDS ***
MIKATRANKIL posts small blind 0.01€
Halmosthard posts big blind 0.02€
Dealt to Fried Berg [Jd Ac]
*** PRE-FLOP *** 
Fried Berg raises 0.02€ to 0.04€
nemo5 folds
prudence34 folds
S-aaron24 folds
MIKATRANKIL folds
Halmosthard folds
Fried Berg collected 0.07€ from pot
*** SUMMARY ***
Total pot 0.07€ | No rake
Seat 3: Fried Berg won 0.07€


Winamax Poker - HOLD-UP "Colorado" - HandId: #19116069-776354-1701769663 - Holdem no limit (0.01€/0.02€) - 2023/12/05 09:47:43 UTC
Table: 'Colorado' 6-max (real money) Seat #6 is the button
Seat 1: livthe34 (2.16€)
Seat 2: AdiTheKing (1.02€)
Seat 3: g8o8k8u (2.65€)
Seat 4: prudence34 (2€)
Seat 5: grut28 (1.88€)
Seat 6: Fried Berg (0.46€)
*** ANTE/BLINDS ***
livthe34 posts small blind 0.01€
AdiTheKing posts big blind 0.02€
Dealt to Fried Berg [4c 5c]
*** PRE-FLOP *** 
g8o8k8u folds
prudence34 folds
grut28 calls 0.02€
Fried Berg calls 0.02€
livthe34 calls 0.01€
AdiTheKing checks
*** FLOP *** [3s 5s 3d]
livthe34 checks
AdiTheKing bets 0.02€
grut28 folds
Fried Berg raises 0.02€ to 0.04€
livthe34 calls 0.04€
AdiTheKing calls 0.02€
*** TURN *** [3s 5s 3d][Kd]
livthe34 checks
AdiTheKing checks
Fried Berg checks
*** RIVER *** [3s 5s 3d Kd][8s]
livthe34 checks
AdiTheKing bets 0.15€
Fried Berg folds
livthe34 folds
AdiTheKing collected 0.33€ from pot
*** SUMMARY ***
Total pot 0.33€ | Rake 0.02€
Board: [3s 5s 3d Kd 8s]
Seat 2: AdiTheKing (big blind) won 0.33€


Winamax Poker - HOLD-UP "Colorado" - HandId: #19116069-776450-1701769739 - Holdem no limit (0.01€/0.02€) - 2023/12/05 09:48:59 UTC
Table: 'Colorado' 6-max (real money) Seat #6 is the button
Seat 1: julieninaval (2.05€)
Seat 2: nico033 (5.67€)
Seat 3: Ertorko (3.55€)
Seat 4: ntr92_ (0.47€)
Seat 5: -genzo- (2.92€)
Seat 6: Fried Berg (0.40€)
*** ANTE/BLINDS ***
julieninaval posts small blind 0.01€
nico033 posts big blind 0.02€
Dealt to Fried Berg [Jc 8c]
*** PRE-FLOP *** 
Ertorko folds
ntr92_ folds
-genzo- folds
Fried Berg raises 0.02€ to 0.04€
julieninaval folds
nico033 folds
Fried Berg collected 0.07€ from pot
*** SUMMARY ***
Total pot 0.07€ | No rake
Seat 6: Fried Berg (button) won 0.07€


Winamax Poker - HOLD-UP "Colorado" - HandId: #19116069-776467-1701769751 - Holdem no limit (0.01€/0.02€) - 2023/12/05 09:49:11 UTC
Table: 'Colorado' 6-max (real money) Seat #6 is the button
Seat 1: prudence34 (2.22€)
Seat 2: trikar xx (2.23€)
Seat 3: S-aaron24 (2.17€)
Seat 4: Fried Berg (0.43€)
Seat 5: Zard.Oz (1.42€)
Seat 6: -genzo- (3.07€)
*** ANTE/BLINDS ***
prudence34 posts small blind 0.01€
trikar xx posts big blind 0.02€
Dealt to Fried Berg [5d Qs]
*** PRE-FLOP *** 
S-aaron24 folds
Fried Berg folds
Zard.Oz folds
-genzo- folds
prudence34 raises 0.04€ to 0.06€
trikar xx calls 0.04€
*** FLOP *** [Ts Kc 6s]
prudence34 checks
trikar xx bets 0.04€
prudence34 folds
trikar xx collected 0.15€ from pot
*** SUMMARY ***
Total pot 0.15€ | Rake 0.01€
Board: [Ts Kc 6s]
Seat 2: trikar xx (big blind) won 0.15€


Winamax Poker - HOLD-UP "Colorado" - HandId: #19116069-776472-1701769756 - Holdem no limit (0.01€/0.02€) - 2023/12/05 09:49:16 UTC
Table: 'Colorado' 6-max (real money) Seat #6 is the button
Seat 1: Pierrof24 (2.49€)
Seat 2: -genzo- (2.92€)
Seat 3: g8o8k8u (2.31€)
Seat 4: Alexluka (1.97€)
Seat 5: Fried Berg (0.43€)
Seat 6: Halmosthard (2.36€)
*** ANTE/BLINDS ***
Pierrof24 posts small blind 0.01€
-genzo- posts big blind 0.02€
Dealt to Fried Berg [3s Ts]
*** PRE-FLOP *** 
g8o8k8u folds
Alexluka folds
Fried Berg folds
Halmosthard folds
Pierrof24 raises 0.02€ to 0.04€
-genzo- calls 0.02€
*** FLOP *** [6h 6d 9s]
Pierrof24 checks
-genzo- checks
*** TURN *** [6h 6d 9s][Js]
Pierrof24 checks
-genzo- checks
*** RIVER *** [6h 6d 9s Js][2d]
Pierrof24 checks
-genzo- checks
*** SHOW DOWN ***
-genzo- shows [Tc Qc] (One pair : 6)
Pierrof24 shows [5d Ks] (One pair : 6)
Pierrof24 collected 0.07€ from pot
*** SUMMARY ***
Total pot 0.07€ | Rake 0.01€
Board: [6h 6d 9s Js 2d]
Seat 1: Pierrof24 (small blind) showed [5d Ks] and won 0.07€ with One pair : 6
Seat 2: -genzo- (big blind) showed [Tc Qc] and lost with One pair : 6


Winamax Poker - HOLD-UP "Colorado" - HandId: #19116069-776475-1701769758 - Holdem no limit (0.01€/0.02€) - 2023/12/05 09:49:18 UTC
Table: 'Colorado' 6-max (real money) Seat #6 is the button
Seat 1: Stackbystack (2.01€)
Seat 2: Fried Berg (0.43€)
Seat 3: nemo5 (5.47€)
Seat 4: Richard Reuk (3.96€)
Seat 5: g8o8k8u (2.31€)
Seat 6: Beso1Dartich (1.60€)
*** ANTE/BLINDS ***
Stackbystack posts small blind 0.01€
Fried Berg posts big blind 0.02€
Dealt to Fried Berg [3c Kd]
*** PRE-FLOP *** 
nemo5 folds
Richard Reuk folds
g8o8k8u folds
Beso1Dartich raises 0.02€ to 0.04€
Stackbystack folds
Fried Berg folds
Beso1Dartich collected 0.07€ from pot
*** SUMMARY ***
Total pot 0.07€ | No rake
Seat 6: Beso1Dartich (button) won 0.07€


Winamax Poker - HOLD-UP "Colorado" - HandId: #19116069-776480-1701769766 - Holdem no limit (0.01€/0.02€) - 2023/12/05 09:49:26 UTC
Table: 'Colorado' 6-max (real money) Seat #6 is the button
Seat 1: Fried Berg (0.41€)
Seat 2: LeJouer666 (2.04€)
Seat 3: Ertorko (3.52€)
Seat 4: RaseOnYou (3.85€)
Seat 5: nico033 (5.65€)
Seat 6: Tooto1808 (2.07€)
*** ANTE/BLINDS ***
Fried Berg posts small blind 0.01€
LeJouer666 posts big blind 0.02€
Dealt to Fried Berg [Kc 3c]
*** PRE-FLOP *** 
Ertorko folds
RaseOnYou raises 0.02€ to 0.04€
nico033 folds
Tooto1808 calls 0.04€
Fried Berg folds
LeJouer666 folds
*** FLOP *** [7d Qc 5c]
RaseOnYou bets 0.04€
Tooto1808 folds
RaseOnYou collected 0.14€ from pot
*** SUMMARY ***
Total pot 0.14€ | Rake 0.01€
Board: [7d Qc 5c]
Seat 4: RaseOnYou won 0.14€


Winamax Poker - HOLD-UP "Colorado" - HandId: #19116069-776505-1701769788 - Holdem no limit (0.01€/0.02€) - 2023/12/05 09:49:48 UTC
Table: 'Colorado' 6-max (real money) Seat #6 is the button
Seat 1: PIQSOU (4.14€)
Seat 2: Zard.Oz (1.42€)
Seat 3: VanDolar (3.80€)
Seat 4: Stackbystack (2€)
Seat 5: SIMLcocotier (3.16€)
Seat 6: Fried Berg (0.40€)
*** ANTE/BLINDS ***
PIQSOU posts small blind 0.01€
Zard.Oz posts big blind 0.02€
Dealt to Fried Berg [9d 3h]
*** PRE-FLOP *** 
VanDolar raises 0.03€ to 0.05€
Stackbystack raises 0.13€ to 0.18€
SIMLcocotier folds
Fried Berg folds
PIQSOU folds
Zard.Oz folds
VanDolar calls 0.13€
*** FLOP *** [4h Kd Jh]
VanDolar checks
Stackbystack bets 1.82€ and is all-in
VanDolar calls 1.82€
*** TURN *** [4h Kd Jh][Qc]
*** RIVER *** [4h Kd Jh Qc][Ac]
*** SHOW DOWN ***
Stackbystack shows [As Ks] (Two pairs : Aces and Kings)
VanDolar shows [Kh Kc] (Trips of Kings)
VanDolar collected 3.63€ from pot
*** SUMMARY ***
Total pot 3.63€ | Rake 0.40€
Board: [4h Kd Jh Qc Ac]
Seat 3: VanDolar showed [Kh Kc] and won 3.63€ with Trips of Kings
Seat 4: Stackbystack showed [As Ks] and lost with Two pairs : Aces and Kings


Winamax Poker - HOLD-UP "Colorado" - HandId: #19116069-776507-1701769790 - Holdem no limit (0.01€/0.02€) - 2023/12/05 09:49:50 UTC
Table: 'Colorado' 6-max (real money) Seat #6 is the button
Seat 1: MIKATRANKIL (2.40€)
Seat 2: nemo5 (5.45€)
Seat 3: Fried Berg (0.40€)
Seat 4: julieninaval (2.35€)
Seat 5: TheRealWill (4.02€)
Seat 6: slowreplay (3.09€)
*** ANTE/BLINDS ***
MIKATRANKIL posts small blind 0.01€
nemo5 posts big blind 0.02€
Dealt to Fried Berg [8h Ac]
*** PRE-FLOP *** 
Fried Berg raises 0.02€ to 0.04€
julieninaval folds
TheRealWill folds
slowreplay folds
MIKATRANKIL folds
nemo5 folds
Fried Berg collected 0.07€ from pot
*** SUMMARY ***
Total pot 0.07€ | No rake
Seat 3: Fried Berg won 0.07€


Winamax Poker - HOLD-UP "Colorado" - HandId: #19116069-776521-1701769802 - Holdem no limit (0.01€/0.02€) - 2023/12/05 09:50:02 UTC
Table: 'Colorado' 6-max (real money) Seat #6 is the button
Seat 1: -genzo- (2.88€)
Seat 2: mika9080 (3.88€)
Seat 3: Pierrof24 (2.52€)
Seat 4: prudence34 (2.16€)
Seat 5: Fried Berg (0.43€)
Seat 6: P.BaIkany (2€)
*** ANTE/BLINDS ***
-genzo- posts small blind 0.01€
mika9080 posts big blind 0.02€
Dealt to Fried Berg [3s 6c]
*** PRE-FLOP *** 
Pierrof24 folds
prudence34 folds
Fried Berg folds
P.BaIkany folds
-genzo- folds
mika9080 collected 0.03€ from pot
*** SUMMARY ***
Total pot 0.03€ | No rake
Seat 2: mika9080 (big blind) won 0.03€


Winamax Poker - HOLD-UP "Colorado" - HandId: #19116069-776525-1701769806 - Holdem no limit (0.01€/0.02€) - 2023/12/05 09:50:06 UTC
Table: 'Colorado' 6-max (real money) Seat #6 is the button
Seat 1: PIQSOU (2.53€)
Seat 2: Richard Reuk (4.06€)
Seat 3: Fried Berg (0.43€)
Seat 4: sacerx (2.32€)
Seat 5: BrokBroken (3.93€)
Seat 6: el_menestrel (1.69€)
*** ANTE/BLINDS ***
PIQSOU posts small blind 0.01€
Richard Reuk posts big blind 0.02€
Dealt to Fried Berg [Ah 6c]
*** PRE-FLOP *** 
Fried Berg raises 0.02€ to 0.04€
sacerx folds
BrokBroken folds
el_menestrel folds
PIQSOU folds
Richard Reuk folds
Fried Berg collected 0.07€ from pot
*** SUMMARY ***
Total pot 0.07€ | No rake
Seat 3: Fried Berg won 0.07€


Winamax Poker - HOLD-UP "Colorado" - HandId: #19116069-776567-1701769843 - Holdem no limit (0.01€/0.02€) - 2023/12/05 09:50:43 UTC
Table: 'Colorado' 6-max (real money) Seat #6 is the button
Seat 1: -genzo- (2.87€)
Seat 2: Fried Berg (0.46€)
Seat 3: Tooto1808 (2.06€)
Seat 4: Ertorko (3.96€)
Seat 5: VanDolar (2.02€)
Seat 6: PIQSOU (2.52€)
*** ANTE/BLINDS ***
-genzo- posts small blind 0.01€
Fried Berg posts big blind 0.02€
Dealt to Fried Berg [3c Qs]
*** PRE-FLOP *** 
Tooto1808 folds
Ertorko folds
VanDolar raises 0.03€ to 0.05€
PIQSOU folds
-genzo- folds
Fried Berg folds
VanDolar collected 0.08€ from pot
*** SUMMARY ***
Total pot 0.08€ | No rake
Seat 5: VanDolar won 0.08€


Winamax Poker - HOLD-UP "Colorado" - HandId: #19116069-776572-1701769848 - Holdem no limit (0.01€/0.02€) - 2023/12/05 09:50:48 UTC
Table: 'Colorado' 6-max (real money) Seat #6 is the button
Seat 1: AdiTheKing (0.98€)
Seat 2: koshikosha (3.15€)
Seat 3: S-aaron24 (2€)
Seat 4: Fried Berg (0.44€)
Seat 5: Halmosthard (2.17€)
Seat 6: AAdellKK (2.64€)
*** ANTE/BLINDS ***
AdiTheKing posts small blind 0.01€
koshikosha posts big blind 0.02€
Dealt to Fried Berg [2d 4c]
*** PRE-FLOP *** 
S-aaron24 raises 0.03€ to 0.05€
Fried Berg folds
Halmosthard folds
AAdellKK calls 0.05€
AdiTheKing folds
koshikosha folds
*** FLOP *** [6s Js 2h]
S-aaron24 checks
AAdellKK checks
*** TURN *** [6s Js 2h][5c]
S-aaron24 checks
AAdellKK checks
*** RIVER *** [6s Js 2h 5c][2s]
S-aaron24 checks
AAdellKK checks
*** SHOW DOWN ***
S-aaron24 shows [Qc Kd] (One pair : 2)
AAdellKK shows [8h Ah] (One pair : 2)
AAdellKK collected 0.12€ from pot
*** SUMMARY ***
Total pot 0.12€ | Rake 0.01€
Board: [6s Js 2h 5c 2s]
Seat 3: S-aaron24 showed [Qc Kd] and lost with One pair : 2
Seat 6: AAdellKK (button) showed [8h Ah] and won 0.12€ with One pair : 2


Winamax Poker - HOLD-UP "Colorado" - HandId: #19116069-776573-1701769849 - Holdem no limit (0.01€/0.02€) - 2023/12/05 09:50:49 UTC
Table: 'Colorado' 6-max (real money) Seat #6 is the button
Seat 1: Fried Berg (0.44€)
Seat 2: Pierrof24 (3.20€)
Seat 3: PIQSOU (2.52€)
Seat 4: TheRealWill (5.30€)
Seat 5: RaseOnYou (3.85€)
Seat 6: loreal78 (0.86€)
*** ANTE/BLINDS ***
Fried Berg posts small blind 0.01€
Pierrof24 posts big blind 0.02€
Dealt to Fried Berg [2c Ad]
*** PRE-FLOP *** 
PIQSOU folds
TheRealWill raises 0.04€ to 0.06€
RaseOnYou folds
loreal78 folds
Fried Berg folds
Pierrof24 folds
TheRealWill collected 0.09€ from pot
*** SUMMARY ***
Total pot 0.09€ | No rake
Seat 4: TheRealWill won 0.09€


Winamax Poker - HOLD-UP "Colorado" - HandId: #19116069-776588-1701769864 - Holdem no limit (0.01€/0.02€) - 2023/12/05 09:51:04 UTC
Table: 'Colorado' 6-max (real money) Seat #6 is the button
Seat 1: fcmess (0.81€)
Seat 2: el_menestrel (2.08€)
Seat 3: Ertorko (3.96€)
Seat 4: Fried Berg (0.43€)
Seat 5: BrokBroken (3.90€)
Seat 6: mika9080 (4.03€)
Hold-up to Pot: total 0.10€
*** ANTE/BLINDS ***
fcmess posts small blind 0.01€
el_menestrel posts big blind 0.02€
Dealt to Fried Berg [5h 4c]
*** PRE-FLOP *** 
Ertorko raises 0.04€ to 0.06€
Fried Berg folds
BrokBroken raises 0.25€ to 0.31€
mika9080 folds
fcmess folds
el_menestrel folds
Ertorko calls 0.25€
*** FLOP *** [3h 5d Qs]
Ertorko checks
BrokBroken bets 0.49€
Ertorko calls 0.49€
*** TURN *** [3h 5d Qs][3c]
Ertorko checks
BrokBroken bets 3.10€ and is all-in
Ertorko calls 3.10€
*** RIVER *** [3h 5d Qs 3c][7c]
*** SHOW DOWN ***
BrokBroken shows [9c Jh] (One pair : 3)
Ertorko shows [Td Qd] (Two pairs : Queens and 3)
Ertorko collected 7.23€ from pot
*** SUMMARY ***
Total pot 7.23€ | Rake 0.70€
Board: [3h 5d Qs 3c 7c]
Seat 3: Ertorko showed [Td Qd] and won 7.23€ with Two pairs : Queens and 3
Seat 5: BrokBroken showed [9c Jh] and lost with One pair : 3


Winamax Poker - HOLD-UP "Colorado" - HandId: #19116069-776595-1701769872 - Holdem no limit (0.01€/0.02€) - 2023/12/05 09:51:12 UTC
Table: 'Colorado' 6-max (real money) Seat #6 is the button
Seat 1: Fried Berg (0.43€)
Seat 2: nemo5 (3.46€)
Seat 3: AdiTheKing (0.97€)
Seat 4: Richard Reuk (2€)
Seat 5: SIMLcocotier (2.02€)
Seat 6: Aggro Loser (2.25€)
*** ANTE/BLINDS ***
Fried Berg posts small blind 0.01€
nemo5 posts big blind 0.02€
Dealt to Fried Berg [2c 7s]
*** PRE-FLOP *** 
AdiTheKing folds
Richard Reuk folds
SIMLcocotier folds
Aggro Loser raises 0.03€ to 0.05€
Fried Berg folds
nemo5 folds
Aggro Loser collected 0.08€ from pot
*** SUMMARY ***
Total pot 0.08€ | No rake
Seat 6: Aggro Loser (button) won 0.08€


Winamax Poker - HOLD-UP "Colorado" - HandId: #19116069-776601-1701769877 - Holdem no limit (0.01€/0.02€) - 2023/12/05 09:51:17 UTC
Table: 'Colorado' 6-max (real money) Seat #6 is the button
Seat 1: el_menestrel (2.05€)
Seat 2: -genzo- (2.81€)
Seat 3: Alexluka (1.49€)
Seat 4: slowreplay (2€)
Seat 5: Fried Berg (0.42€)
Seat 6: grut28 (3.07€)
*** ANTE/BLINDS ***
el_menestrel posts small blind 0.01€
-genzo- posts big blind 0.02€
Dealt to Fried Berg [As 5h]
*** PRE-FLOP *** 
Alexluka folds
slowreplay folds
Fried Berg raises 0.02€ to 0.04€
grut28 calls 0.04€
el_menestrel folds
-genzo- calls 0.02€
*** FLOP *** [5s 8s Kd]
-genzo- checks
Fried Berg bets 0.04€
grut28 calls 0.04€
-genzo- folds
*** TURN *** [5s 8s Kd][Qc]
Fried Berg checks
grut28 bets 2.99€ and is all-in
Fried Berg folds
grut28 collected 3.18€ from pot
*** SUMMARY ***
Total pot 3.18€ | Rake 0.02€
Board: [5s 8s Kd Qc]
Seat 6: grut28 (button) won 3.18€


Winamax Poker - HOLD-UP "Colorado" - HandId: #19116069-776720-1701770014 - Holdem no limit (0.01€/0.02€) - 2023/12/05 09:53:34 UTC
Table: 'Colorado' 6-max (real money) Seat #6 is the button
Seat 1: Meryl Streep (1.94€)
Seat 2: Fried Berg (0.34€)
Seat 3: stevebalboni (4.11€)
Seat 4: Halmosthard (1.97€)
Seat 5: trikar xx (2.49€)
Seat 6: Zard.Oz (1.27€)
*** ANTE/BLINDS ***
Meryl Streep posts small blind 0.01€
Fried Berg posts big blind 0.02€
Dealt to Fried Berg [Tc Qh]
*** PRE-FLOP *** 
stevebalboni folds
Halmosthard raises 0.03€ to 0.05€
trikar xx folds
Zard.Oz folds
Meryl Streep folds
Fried Berg folds
Halmosthard collected 0.08€ from pot
*** SUMMARY ***
Total pot 0.08€ | No rake
Seat 4: Halmosthard won 0.08€


Winamax Poker - HOLD-UP "Colorado" - HandId: #19116069-776725-1701770018 - Holdem no limit (0.01€/0.02€) - 2023/12/05 09:53:38 UTC
Table: 'Colorado' 6-max (real money) Seat #6 is the button
Seat 1: P.BaIkany (2.40€)
Seat 2: nemo5 (2.83€)
Seat 3: Fried Berg (0.32€)
Seat 4: slowreplay (2.07€)
Seat 5: TheRealWill (3.50€)
Seat 6: Medoc94 (0.91€)
*** ANTE/BLINDS ***
P.BaIkany posts small blind 0.01€
nemo5 posts big blind 0.02€
Dealt to Fried Berg [Js 4c]
*** PRE-FLOP *** 
Fried Berg folds
slowreplay raises 0.03€ to 0.05€
TheRealWill folds
Medoc94 folds
P.BaIkany folds
nemo5 folds
slowreplay collected 0.08€ from pot
*** SUMMARY ***
Total pot 0.08€ | No rake
Seat 4: slowreplay won 0.08€


Winamax Poker - HOLD-UP "Colorado" - HandId: #19116069-776731-1701770023 - Holdem no limit (0.01€/0.02€) - 2023/12/05 09:53:43 UTC
Table: 'Colorado' 6-max (real money) Seat #6 is the button
Seat 1: Richard Reuk (2€)
Seat 2: MoneyGrowing (2€)
Seat 3: Meryl Streep (1.93€)
Seat 4: Fried Berg (0.32€)
Seat 5: -genzo- (2.70€)
Seat 6: AdiTheKing (1.56€)
*** ANTE/BLINDS ***
Richard Reuk posts small blind 0.01€
MoneyGrowing posts big blind 0.02€
Dealt to Fried Berg [8s 4s]
*** PRE-FLOP *** 
Meryl Streep calls 0.02€
Fried Berg folds
-genzo- raises 0.04€ to 0.06€
AdiTheKing folds
Richard Reuk raises 0.18€ to 0.24€
MoneyGrowing folds
Meryl Streep folds
-genzo- raises 0.26€ to 0.50€
Richard Reuk folds
-genzo- collected 0.78€ from pot
*** SUMMARY ***
Total pot 0.78€ | No rake
Seat 5: -genzo- won 0.78€


Winamax Poker - HOLD-UP "Colorado" - HandId: #19116069-776734-1701770029 - Holdem no limit (0.01€/0.02€) - 2023/12/05 09:53:49 UTC
Table: 'Colorado' 6-max (real money) Seat #6 is the button
Seat 1: prudence34 (2.20€)
Seat 2: trikar xx (2.52€)
Seat 3: nemo5 (2.81€)
Seat 4: Halmosthard (2.09€)
Seat 5: PIQSOU (3.79€)
Seat 6: Fried Berg (0.32€)
*** ANTE/BLINDS ***
prudence34 posts small blind 0.01€
trikar xx posts big blind 0.02€
Dealt to Fried Berg [7d 5d]
*** PRE-FLOP *** 
nemo5 folds
Halmosthard calls 0.02€
PIQSOU folds
Fried Berg folds
prudence34 folds
trikar xx checks
*** FLOP *** [6s 5s 2s]
trikar xx checks
Halmosthard bets 0.03€
trikar xx calls 0.03€
*** TURN *** [6s 5s 2s][Jh]
trikar xx checks
Halmosthard bets 0.07€
trikar xx calls 0.07€
*** RIVER *** [6s 5s 2s Jh][3s]
trikar xx checks
Halmosthard checks
*** SHOW DOWN ***
Halmosthard shows [Js 9s] (Flush Jack high)
trikar xx shows [As 9c] (Flush Ace high)
trikar xx collected 0.22€ from pot
*** SUMMARY ***
Total pot 0.22€ | Rake 0.03€
Board: [6s 5s 2s Jh 3s]
Seat 2: trikar xx (big blind) showed [As 9c] and won 0.22€ with Flush Ace high
Seat 4: Halmosthard showed [Js 9s] and lost with Flush Jack high


Winamax Poker - HOLD-UP "Colorado" - HandId: #19116069-776758-1701770049 - Holdem no limit (0.01€/0.02€) - 2023/12/05 09:54:09 UTC
Table: 'Colorado' 6-max (real money) Seat #6 is the button
Seat 1: slowreplay (3.11€)
Seat 2: nemo5 (2.78€)
Seat 3: Medoc94 (0.91€)
Seat 4: prudence34 (2.22€)
Seat 5: grut28 (3.15€)
Seat 6: Fried Berg (0.32€)
*** ANTE/BLINDS ***
slowreplay posts small blind 0.01€
nemo5 posts big blind 0.02€
Dealt to Fried Berg [Td 2c]
*** PRE-FLOP *** 
Medoc94 folds
prudence34 folds
grut28 calls 0.02€
Fried Berg folds
slowreplay folds
nemo5 checks
*** FLOP *** [Kh Jd 8d]
nemo5 checks
grut28 checks
*** TURN *** [Kh Jd 8d][Jh]
nemo5 checks
grut28 checks
*** RIVER *** [Kh Jd 8d Jh][2s]
nemo5 checks
grut28 checks
*** SHOW DOWN ***
nemo5 shows [3c 5s] (One pair : Jacks)
grut28 shows [Qd Qs] (Two pairs : Queens and Jacks)
grut28 collected 0.04€ from pot
*** SUMMARY ***
Total pot 0.04€ | Rake 0.01€
Board: [Kh Jd 8d Jh 2s]
Seat 2: nemo5 (big blind) showed [3c 5s] and lost with One pair : Jacks
Seat 5: grut28 showed [Qd Qs] and won 0.04€ with Two pairs : Queens and Jacks


Winamax Poker - HOLD-UP "Colorado" - HandId: #19116069-776762-1701770052 - Holdem no limit (0.01€/0.02€) - 2023/12/05 09:54:12 UTC
Table: 'Colorado' 6-max (real money) Seat #6 is the button
Seat 1: Anty-dot (2€)
Seat 2: Fried Berg (0.32€)
Seat 3: slowreplay (3.10€)
Seat 4: SIMLcocotier (2€)
Seat 5: el_menestrel (1.94€)
Seat 6: AdiTheKing (0.92€)
*** ANTE/BLINDS ***
Anty-dot posts small blind 0.01€
Fried Berg posts big blind 0.02€
Dealt to Fried Berg [Qc 9c]
*** PRE-FLOP *** 
slowreplay folds
SIMLcocotier folds
el_menestrel folds
AdiTheKing raises 0.03€ to 0.05€
Anty-dot folds
Fried Berg raises 0.10€ to 0.15€
AdiTheKing folds
Fried Berg collected 0.21€ from pot
*** SUMMARY ***
Total pot 0.21€ | No rake
Seat 2: Fried Berg (big blind) won 0.21€


Winamax Poker - HOLD-UP "Colorado" - HandId: #19116069-776800-1701770090 - Holdem no limit (0.01€/0.02€) - 2023/12/05 09:54:50 UTC
Table: 'Colorado' 6-max (real money) Seat #6 is the button
Seat 1: trikar xx (2.62€)
Seat 2: Meryl Streep (1.94€)
Seat 3: tottimarley5 (0.22€)
Seat 4: Pierrof24 (3.11€)
Seat 5: Fried Berg (0.38€)
Seat 6: Halmosthard (1.97€)
*** ANTE/BLINDS ***
trikar xx posts small blind 0.01€
Meryl Streep posts big blind 0.02€
Dealt to Fried Berg [Th 2h]
*** PRE-FLOP *** 
tottimarley5 raises 0.20€ to 0.22€ and is all-in
Pierrof24 folds
Fried Berg folds
Halmosthard calls 0.22€
trikar xx folds
Meryl Streep folds
*** FLOP *** [4d 9c Jd]
*** TURN *** [4d 9c Jd][Jc]
*** RIVER *** [4d 9c Jd Jc][5d]
*** SHOW DOWN ***
tottimarley5 shows [6s 6c] (Two pairs : Jacks and 6)
Halmosthard shows [Qd Jh] (Trips of Jacks)
Halmosthard collected 0.42€ from pot
*** SUMMARY ***
Total pot 0.42€ | Rake 0.05€
Board: [4d 9c Jd Jc 5d]
Seat 3: tottimarley5 showed [6s 6c] and lost with Two pairs : Jacks and 6
Seat 6: Halmosthard (button) showed [Qd Jh] and won 0.42€ with Trips of Jacks


Winamax Poker - HOLD-UP "Colorado" - HandId: #19116069-776804-1701770096 - Holdem no limit (0.01€/0.02€) - 2023/12/05 09:54:56 UTC
Table: 'Colorado' 6-max (real money) Seat #6 is the button
Seat 1: Medoc94 (0.99€)
Seat 2: ALLIN_OLI (9.38€)
Seat 3: Fried Berg (0.38€)
Seat 4: mika9080 (4.16€)
Seat 5: Pintxili (2.08€)
Seat 6: PIQSOU (2.46€)
*** ANTE/BLINDS ***
Medoc94 posts small blind 0.01€
ALLIN_OLI posts big blind 0.02€
Dealt to Fried Berg [5h Ac]
*** PRE-FLOP *** 
Fried Berg folds
mika9080 raises 0.05€ to 0.07€
Pintxili folds
PIQSOU folds
Medoc94 folds
ALLIN_OLI calls 0.05€
*** FLOP *** [Kc 5s Qs]
ALLIN_OLI checks
mika9080 bets 0.15€
ALLIN_OLI folds
mika9080 collected 0.28€ from pot
*** SUMMARY ***
Total pot 0.28€ | Rake 0.02€
Board: [Kc 5s Qs]
Seat 4: mika9080 won 0.28€


Winamax Poker - HOLD-UP "Colorado" - HandId: #19116069-776813-1701770102 - Holdem no limit (0.01€/0.02€) - 2023/12/05 09:55:02 UTC
Table: 'Colorado' 6-max (real money) Seat #6 is the button
Seat 1: Fried Berg (0.38€)
Seat 2: DosdeBras (0.83€)
Seat 3: Zard.Oz (1.31€)
Seat 4: PIQSOU (2.11€)
Seat 5: Pierrof24 (2.16€)
Seat 6: -genzo- (2.70€)
*** ANTE/BLINDS ***
Fried Berg posts small blind 0.01€
DosdeBras posts big blind 0.02€
Dealt to Fried Berg [5h As]
*** PRE-FLOP *** 
Zard.Oz folds
PIQSOU folds
Pierrof24 folds
-genzo- folds
Fried Berg raises 0.02€ to 0.04€
DosdeBras folds
Fried Berg collected 0.06€ from pot
*** SUMMARY ***
Total pot 0.06€ | No rake
Seat 1: Fried Berg (small blind) won 0.06€


Winamax Poker - HOLD-UP "Colorado" - HandId: #19116069-776837-1701770126 - Holdem no limit (0.01€/0.02€) - 2023/12/05 09:55:26 UTC
Table: 'Colorado' 6-max (real money) Seat #6 is the button
Seat 1: DosdeBras (0.81€)
Seat 2: SIMLcocotier (2.05€)
Seat 3: prudence34 (2€)
Seat 4: Fried Berg (0.40€)
Seat 5: PIQSOU (4.11€)
Seat 6: nemo5 (5.65€)
*** ANTE/BLINDS ***
DosdeBras posts small blind 0.01€
SIMLcocotier posts big blind 0.02€
Dealt to Fried Berg [3d Ah]
*** PRE-FLOP *** 
prudence34 folds
Fried Berg folds
PIQSOU folds
nemo5 folds
DosdeBras folds
SIMLcocotier collected 0.03€ from pot
*** SUMMARY ***
Total pot 0.03€ | No rake
Seat 2: SIMLcocotier (big blind) won 0.03€


Winamax Poker - HOLD-UP "Colorado" - HandId: #19116069-776844-1701770135 - Holdem no limit (0.01€/0.02€) - 2023/12/05 09:55:35 UTC
Table: 'Colorado' 6-max (real money) Seat #6 is the button
Seat 1: prudence34 (2.04€)
Seat 2: nemo5 (5.65€)
Seat 3: dallo974 (1.93€)
Seat 4: Richard Reuk (2.09€)
Seat 5: P.BaIkany (3.22€)
Seat 6: Fried Berg (0.40€)
*** ANTE/BLINDS ***
prudence34 posts small blind 0.01€
nemo5 posts big blind 0.02€
Dealt to Fried Berg [Th Js]
*** PRE-FLOP *** 
dallo974 calls 0.02€
Richard Reuk calls 0.02€
P.BaIkany folds
Fried Berg calls 0.02€
prudence34 folds
nemo5 checks
*** FLOP *** [8s 5c Qs]
nemo5 checks
dallo974 checks
Richard Reuk checks
Fried Berg bets 0.04€
nemo5 folds
dallo974 folds
Richard Reuk folds
Fried Berg collected 0.12€ from pot
*** SUMMARY ***
Total pot 0.12€ | Rake 0.01€
Board: [8s 5c Qs]
Seat 6: Fried Berg (button) won 0.12€


Winamax Poker - HOLD-UP "Colorado" - HandId: #19116069-776873-1701770164 - Holdem no limit (0.01€/0.02€) - 2023/12/05 09:56:04 UTC
Table: 'Colorado' 6-max (real money) Seat #6 is the button
Seat 1: Fried Berg (0.46€)
Seat 2: AAdellKK (2.24€)
Seat 3: AdiTheKing (0.90€)
Seat 4: Dexter1971 (1.52€)
Seat 5: sacerx (2.29€)
Seat 6: PIQSOU (2.05€)
*** ANTE/BLINDS ***
Fried Berg posts small blind 0.01€
AAdellKK posts big blind 0.02€
Dealt to Fried Berg [Jh Js]
*** PRE-FLOP *** 
AdiTheKing folds
Dexter1971 folds
sacerx folds
PIQSOU raises 0.03€ to 0.05€
Fried Berg raises 0.10€ to 0.15€
AAdellKK calls 0.13€
PIQSOU calls 0.10€
*** FLOP *** [Kd Ks 3h]
Fried Berg bets 0.31€ and is all-in
AAdellKK calls 0.31€
PIQSOU raises 1.59€ to 1.90€ and is all-in
AAdellKK calls 1.59€
*** TURN *** [Kd Ks 3h][As]
*** RIVER *** [Kd Ks 3h As][6c]
*** SHOW DOWN ***
Fried Berg shows [Jh Js] (Two pairs : Kings and Jacks)
AAdellKK shows [8d Kh] (Trips of Kings)
PIQSOU shows [Kc Qc] (Trips of Kings)
PIQSOU collected 4.10€ from pot
*** SUMMARY ***
Total pot 4.10€ | Rake 0.46€
Board: [Kd Ks 3h As 6c]
Seat 1: Fried Berg (small blind) showed [Jh Js] and lost with Two pairs : Kings and Jacks
Seat 2: AAdellKK (big blind) showed [8d Kh] and lost with Trips of Kings
Seat 6: PIQSOU (button) showed [Kc Qc] and won 4.10€ with Trips of Kings


Winamax Poker - HOLD-UP "Colorado" - HandId: #19116069-777137-1701770428 - Holdem no limit (0.01€/0.02€) - 2023/12/05 10:00:28 UTC
Table: 'Colorado' 6-max (real money) Seat #6 is the button
Seat 1: AdiTheKing (1.34€)
Seat 2: Fried Berg (0.50€)
Seat 3: guevarache (2.21€)
Seat 4: prudence34 (3.03€)
Seat 5: PIQSOU (4.11€)
Seat 6: Anty-dot (2.32€)
*** ANTE/BLINDS ***
AdiTheKing posts small blind 0.01€
Fried Berg posts big blind 0.02€
Dealt to Fried Berg [9s 7c]
*** PRE-FLOP *** 
guevarache folds
prudence34 raises 0.04€ to 0.06€
PIQSOU folds
Anty-dot folds
AdiTheKing folds
Fried Berg folds
prudence34 collected 0.09€ from pot
*** SUMMARY ***
Total pot 0.09€ | No rake
Seat 4: prudence34 won 0.09€


Winamax Poker - HOLD-UP "Colorado" - HandId: #19116069-777142-1701770434 - Holdem no limit (0.01€/0.02€) - 2023/12/05 10:00:34 UTC
Table: 'Colorado' 6-max (real money) Seat #6 is the button
Seat 1: Ertorko (4.32€)
Seat 2: trikar xx (2.31€)
Seat 3: Fried Berg (0.48€)
Seat 4: Tooto1808 (2.66€)
Seat 5: fesacar (2.03€)
Seat 6: AdiTheKing (1.33€)
*** ANTE/BLINDS ***
Ertorko posts small blind 0.01€
trikar xx posts big blind 0.02€
Dealt to Fried Berg [Ah Qd]
*** PRE-FLOP *** 
Fried Berg raises 0.02€ to 0.04€
Tooto1808 calls 0.04€
fesacar folds
AdiTheKing folds
Ertorko raises 0.20€ to 0.24€
trikar xx folds
Fried Berg calls 0.20€
Tooto1808 calls 0.20€
*** FLOP *** [Td 5s Qs]
Ertorko checks
Fried Berg bets 0.24€ and is all-in
Tooto1808 calls 0.24€
Ertorko raises 0.60€ to 0.84€
Tooto1808 raises 1.58€ to 2.42€ and is all-in
Ertorko calls 1.58€
*** TURN *** [Td 5s Qs][4c]
*** RIVER *** [Td 5s Qs 4c][Qh]
*** SHOW DOWN ***
Fried Berg shows [Ah Qd] (Trips of Queens)
Tooto1808 shows [9s Ks] (One pair : Queens)
Ertorko shows [Th Tc] (Full of Tens and Queens)
Ertorko collected 5.24€ from pot
*** SUMMARY ***
Total pot 5.24€ | Rake 0.58€
Board: [Td 5s Qs 4c Qh]
Seat 1: Ertorko (small blind) showed [Th Tc] and won 5.24€ with Full of Tens and Queens
Seat 3: Fried Berg showed [Ah Qd] and lost with Trips of Queens
Seat 4: Tooto1808 showed [9s Ks] and lost with One pair : Queens


Winamax Poker - HOLD-UP "Colorado" - HandId: #19116069-777213-1701770511 - Holdem no limit (0.01€/0.02€) - 2023/12/05 10:01:51 UTC
Table: 'Colorado' 6-max (real money) Seat #6 is the button
Seat 1: Halmosthard (1.95€)
Seat 2: S-aaron24 (2.28€)
Seat 3: P.BaIkany (2.22€)
Seat 4: Fried Berg (0.50€)
Seat 5: swag-Morue73 (1.85€)
Seat 6: Ertorko (6.93€)
*** ANTE/BLINDS ***
Halmosthard posts small blind 0.01€
S-aaron24 posts big blind 0.02€
Dealt to Fried Berg [9c 8d]
*** PRE-FLOP *** 
P.BaIkany folds
Fried Berg folds
swag-Morue73 folds
Ertorko folds
Halmosthard raises 0.02€ to 0.04€
S-aaron24 calls 0.02€
*** FLOP *** [2h As 8h]
Halmosthard checks
S-aaron24 checks
*** TURN *** [2h As 8h][Th]
Halmosthard bets 0.03€
S-aaron24 calls 0.03€
*** RIVER *** [2h As 8h Th][4d]
Halmosthard checks
S-aaron24 checks
*** SHOW DOWN ***
S-aaron24 shows [Jd Qd] (High card : Ace)
Halmosthard shows [6d 6s] (One pair : 6)
Halmosthard collected 0.13€ from pot
*** SUMMARY ***
Total pot 0.13€ | Rake 0.01€
Board: [2h As 8h Th 4d]
Seat 1: Halmosthard (small blind) showed [6d 6s] and won 0.13€ with One pair : 6
Seat 2: S-aaron24 (big blind) showed [Jd Qd] and lost with High card : Ace


Winamax Poker - HOLD-UP "Colorado" - HandId: #19116069-777221-1701770518 - Holdem no limit (0.01€/0.02€) - 2023/12/05 10:01:58 UTC
Table: 'Colorado' 6-max (real money) Seat #6 is the button
Seat 1: Pierrof24 (2.35€)
Seat 2: slowreplay (2.42€)
Seat 3: Richard Reuk (4.45€)
Seat 4: kameleon73 (2.90€)
Seat 5: Fried Berg (0.50€)
Seat 6: -genzo- (5.29€)
*** ANTE/BLINDS ***
Pierrof24 posts small blind 0.01€
slowreplay posts big blind 0.02€
Dealt to Fried Berg [Js Kh]
*** PRE-FLOP *** 
Richard Reuk folds
kameleon73 raises 0.05€ to 0.07€
Fried Berg calls 0.07€
-genzo- folds
Pierrof24 folds
slowreplay folds
*** FLOP *** [4h 7c 5h]
kameleon73 checks
Fried Berg checks
*** TURN *** [4h 7c 5h][4c]
kameleon73 checks
Fried Berg checks
*** RIVER *** [4h 7c 5h 4c][Kc]
kameleon73 checks
Fried Berg bets 0.04€
kameleon73 folds
Fried Berg collected 0.19€ from pot
*** SUMMARY ***
Total pot 0.19€ | Rake 0.02€
Board: [4h 7c 5h 4c Kc]
Seat 5: Fried Berg won 0.19€


Winamax Poker - HOLD-UP "Colorado" - HandId: #19116069-777279-1701770572 - Holdem no limit (0.01€/0.02€) - 2023/12/05 10:02:52 UTC
Table: 'Colorado' 6-max (real money) Seat #6 is the button
Seat 1: guevarache (1.69€)
Seat 2: EA_Stinger (0.96€)
Seat 3: -genzo- (2.97€)
Seat 4: Ertorko (7.95€)
Seat 5: Ifshetan (0.50€)
Seat 6: Fried Berg (0.58€)
*** ANTE/BLINDS ***
guevarache posts small blind 0.01€
EA_Stinger posts big blind 0.02€
Dealt to Fried Berg [6h 8s]
*** PRE-FLOP *** 
-genzo- raises 0.04€ to 0.06€
Ertorko folds
Ifshetan raises 0.44€ to 0.50€ and is all-in
Fried Berg folds
guevarache folds
EA_Stinger folds
-genzo- calls 0.44€
*** FLOP *** [Kd 2c 6d]
*** TURN *** [Kd 2c 6d][3d]
*** RIVER *** [Kd 2c 6d 3d][3c]
*** SHOW DOWN ***
Ifshetan shows [Ac Qs] (One pair : 3)
-genzo- shows [Td Ts] (Two pairs : Tens and 3)
-genzo- collected 0.93€ from pot
*** SUMMARY ***
Total pot 0.93€ | Rake 0.10€
Board: [Kd 2c 6d 3d 3c]
Seat 3: -genzo- showed [Td Ts] and won 0.93€ with Two pairs : Tens and 3
Seat 5: Ifshetan showed [Ac Qs] and lost with One pair : 3


Winamax Poker - HOLD-UP "Colorado" - HandId: #19116069-777288-1701770582 - Holdem no limit (0.01€/0.02€) - 2023/12/05 10:03:02 UTC
Table: 'Colorado' 6-max (real money) Seat #6 is the button
Seat 1: sacerx (2.33€)
Seat 2: trikar xx (2.49€)
Seat 3: Anty-dot (2€)
Seat 4: Pintxili (2.20€)
Seat 5: le brakeur (2.31€)
Seat 6: Fried Berg (0.58€)
*** ANTE/BLINDS ***
sacerx posts small blind 0.01€
trikar xx posts big blind 0.02€
Dealt to Fried Berg [4c 6d]
*** PRE-FLOP *** 
Anty-dot folds
Pintxili raises 0.04€ to 0.06€
le brakeur folds
Fried Berg folds
sacerx calls 0.05€
trikar xx folds
*** FLOP *** [Jc 6c 4d]
sacerx checks
Pintxili checks
*** TURN *** [Jc 6c 4d][Qc]
sacerx checks
Pintxili bets 0.09€
sacerx calls 0.09€
*** RIVER *** [Jc 6c 4d Qc][3s]
sacerx checks
Pintxili checks
*** SHOW DOWN ***
Pintxili shows [2h 2s] (One pair : 2)
sacerx shows [8d 8c] (One pair : 8)
sacerx collected 0.29€ from pot
*** SUMMARY ***
Total pot 0.29€ | Rake 0.03€
Board: [Jc 6c 4d Qc 3s]
Seat 1: sacerx (small blind) showed [8d 8c] and won 0.29€ with One pair : 8
Seat 4: Pintxili showed [2h 2s] and lost with One pair : 2


Winamax Poker - HOLD-UP "Colorado" - HandId: #19116069-777291-1701770586 - Holdem no limit (0.01€/0.02€) - 2023/12/05 10:03:06 UTC
Table: 'Colorado' 6-max (real money) Seat #6 is the button
Seat 1: PIQSOU (2.11€)
Seat 2: Fried Berg (0.58€)
Seat 3: slowreplay (4.43€)
Seat 4: Anty-dot (2€)
Seat 5: stevebalboni (2.57€)
Seat 6: AdiTheKing (0.97€)
*** ANTE/BLINDS ***
PIQSOU posts small blind 0.01€
Fried Berg posts big blind 0.02€
Dealt to Fried Berg [5d Qs]
*** PRE-FLOP *** 
slowreplay folds
Anty-dot raises 0.03€ to 0.05€
stevebalboni folds
AdiTheKing folds
PIQSOU folds
Fried Berg folds
Anty-dot collected 0.08€ from pot
*** SUMMARY ***
Total pot 0.08€ | No rake
Seat 4: Anty-dot won 0.08€


Winamax Poker - HOLD-UP "Colorado" - HandId: #19116069-777307-1701770601 - Holdem no limit (0.01€/0.02€) - 2023/12/05 10:03:21 UTC
Table: 'Colorado' 6-max (real money) Seat #6 is the button
Seat 1: Fried Berg (0.56€)
Seat 2: Meryl Streep (2.09€)
Seat 3: -genzo- (5.31€)
Seat 4: LM231620 (0.33€)
Seat 5: DosdeBras (0.81€)
Seat 6: lematk31 (1.09€)
*** ANTE/BLINDS ***
Fried Berg posts small blind 0.01€
Meryl Streep posts big blind 0.02€
Dealt to Fried Berg [6d 8h]
*** PRE-FLOP *** 
-genzo- folds
LM231620 folds
DosdeBras folds
lematk31 raises 0.03€ to 0.05€
Fried Berg folds
Meryl Streep folds
lematk31 collected 0.08€ from pot
*** SUMMARY ***
Total pot 0.08€ | No rake
Seat 6: lematk31 (button) won 0.08€


Winamax Poker - HOLD-UP "Colorado" - HandId: #19116069-777318-1701770612 - Holdem no limit (0.01€/0.02€) - 2023/12/05 10:03:32 UTC
Table: 'Colorado' 6-max (real money) Seat #6 is the button
Seat 1: mIcHoCcO (1.35€)
Seat 2: LM231620 (0.33€)
Seat 3: G0R0N11 (2.13€)
Seat 4: Fried Berg (0.55€)
Seat 5: fesacar (3€)
Seat 6: AdiTheKing (0.97€)
*** ANTE/BLINDS ***
mIcHoCcO posts small blind 0.01€
LM231620 posts big blind 0.02€
Dealt to Fried Berg [4s 2c]
*** PRE-FLOP *** 
G0R0N11 folds
Fried Berg folds
fesacar raises 0.03€ to 0.05€
AdiTheKing folds
mIcHoCcO folds
LM231620 folds
fesacar collected 0.08€ from pot
*** SUMMARY ***
Total pot 0.08€ | No rake
Seat 5: fesacar won 0.08€


Winamax Poker - HOLD-UP "Colorado" - HandId: #19116069-777330-1701770623 - Holdem no limit (0.01€/0.02€) - 2023/12/05 10:03:43 UTC
Table: 'Colorado' 6-max (real money) Seat #6 is the button
Seat 1: -genzo- (2.71€)
Seat 2: trikar xx (2.10€)
Seat 3: Fried Berg (0.55€)
Seat 4: Ertorko (6.93€)
Seat 5: MoneyGrowing (2.07€)
Seat 6: Beso1Dartich (1€)
*** ANTE/BLINDS ***
-genzo- posts small blind 0.01€
trikar xx posts big blind 0.02€
Dealt to Fried Berg [6d Js]
*** PRE-FLOP *** 
Fried Berg folds
Ertorko raises 0.03€ to 0.05€
MoneyGrowing folds
Beso1Dartich folds
-genzo- folds
trikar xx folds
Ertorko collected 0.08€ from pot
*** SUMMARY ***
Total pot 0.08€ | No rake
Seat 4: Ertorko won 0.08€


Winamax Poker - HOLD-UP "Colorado" - HandId: #19116069-777332-1701770625 - Holdem no limit (0.01€/0.02€) - 2023/12/05 10:03:45 UTC
Table: 'Colorado' 6-max (real money) Seat #6 is the button
Seat 1: novembre04 (1.96€)
Seat 2: G0R0N11 (2.13€)
Seat 3: Zard.Oz (2.38€)
Seat 4: Pierrof24 (2.93€)
Seat 5: Fried Berg (0.55€)
Seat 6: prudence34 (2.70€)
Hold-up to Pot: total 0.10€
*** ANTE/BLINDS ***
novembre04 posts small blind 0.01€
G0R0N11 posts big blind 0.02€
Dealt to Fried Berg [3d 5h]
*** PRE-FLOP *** 
Zard.Oz raises 0.04€ to 0.06€
Pierrof24 raises 0.25€ to 0.31€
Fried Berg folds
prudence34 folds
novembre04 folds
G0R0N11 folds
Zard.Oz calls 0.25€
*** FLOP *** [6c 7h 3c]
Zard.Oz checks
Pierrof24 bets 0.38€
Zard.Oz folds
Pierrof24 collected 1.06€ from pot
*** SUMMARY ***
Total pot 1.06€ | Rake 0.07€
Board: [6c 7h 3c]
Seat 4: Pierrof24 won 1.06€


Winamax Poker - HOLD-UP "Colorado" - HandId: #19116069-777338-1701770629 - Holdem no limit (0.01€/0.02€) - 2023/12/05 10:03:49 UTC
Table: 'Colorado' 6-max (real money) Seat #6 is the button
Seat 1: livthe34 (3.12€)
Seat 2: Anty-dot (2.03€)
Seat 3: S-aaron24 (2.19€)
Seat 4: DosdeBras (0.78€)
Seat 5: SIMLcocotier (2.15€)
Seat 6: Fried Berg (0.55€)
*** ANTE/BLINDS ***
livthe34 posts small blind 0.01€
Anty-dot posts big blind 0.02€
Dealt to Fried Berg [4d As]
*** PRE-FLOP *** 
S-aaron24 folds
DosdeBras folds
SIMLcocotier folds
Fried Berg raises 0.02€ to 0.04€
livthe34 folds
Anty-dot folds
Fried Berg collected 0.07€ from pot
*** SUMMARY ***
Total pot 0.07€ | No rake
Seat 6: Fried Berg (button) won 0.07€


Winamax Poker - HOLD-UP "Colorado" - HandId: #19116069-777360-1701770649 - Holdem no limit (0.01€/0.02€) - 2023/12/05 10:04:09 UTC
Table: 'Colorado' 6-max (real money) Seat #6 is the button
Seat 1: Noka1320 (0.33€)
Seat 2: Fried Berg (0.58€)
Seat 3: slowreplay (2.02€)
Seat 4: DosdeBras (0.75€)
Seat 5: AdiTheKing (1.29€)
Seat 6: G0R0N11 (2.10€)
*** ANTE/BLINDS ***
Noka1320 posts small blind 0.01€
Fried Berg posts big blind 0.02€
Dealt to Fried Berg [8s 2s]
*** PRE-FLOP *** 
slowreplay folds
DosdeBras folds
AdiTheKing raises 0.03€ to 0.05€
G0R0N11 calls 0.05€
Noka1320 folds
Fried Berg folds
*** FLOP *** [8h 9d Kh]
AdiTheKing checks
G0R0N11 checks
*** TURN *** [8h 9d Kh][4d]
AdiTheKing bets 0.02€
G0R0N11 calls 0.02€
*** RIVER *** [8h 9d Kh 4d][As]
AdiTheKing checks
G0R0N11 checks
*** SHOW DOWN ***
G0R0N11 shows [7d 7c] (One pair : 7)
AdiTheKing shows [9s Qs] (One pair : 9)
AdiTheKing collected 0.15€ from pot
*** SUMMARY ***
Total pot 0.15€ | Rake 0.02€
Board: [8h 9d Kh 4d As]
Seat 5: AdiTheKing showed [9s Qs] and won 0.15€ with One pair : 9
Seat 6: G0R0N11 (button) showed [7d 7c] and lost with One pair : 7


Winamax Poker - HOLD-UP "Colorado" - HandId: #19116069-777368-1701770655 - Holdem no limit (0.01€/0.02€) - 2023/12/05 10:04:15 UTC
Table: 'Colorado' 6-max (real money) Seat #6 is the button
Seat 1: Fried Berg (0.56€)
Seat 2: LGK.NC (2.20€)
Seat 3: SIMLcocotier (2.74€)
Seat 4: ThePryce (3.11€)
Seat 5: Bb68 (2.02€)
Seat 6: magnumbenji (0.29€)
*** ANTE/BLINDS ***
Fried Berg posts small blind 0.01€
LGK.NC posts big blind 0.02€
Dealt to Fried Berg [7c 7s]
*** PRE-FLOP *** 
SIMLcocotier folds
ThePryce folds
Bb68 folds
magnumbenji folds
Fried Berg raises 0.02€ to 0.04€
LGK.NC calls 0.02€
*** FLOP *** [Kc Kh Qh]
Fried Berg checks
LGK.NC checks
*** TURN *** [Kc Kh Qh][5s]
Fried Berg checks
LGK.NC checks
*** RIVER *** [Kc Kh Qh 5s][Kd]
Fried Berg bets 0.06€
LGK.NC raises 0.11€ to 0.17€
Fried Berg calls 0.11€
*** SHOW DOWN ***
Fried Berg shows [7c 7s] (Full of Kings and 7)
LGK.NC shows [Qs 2s] (Full of Kings and Queens)
LGK.NC collected 0.38€ from pot
*** SUMMARY ***
Total pot 0.38€ | Rake 0.04€
Board: [Kc Kh Qh 5s Kd]
Seat 1: Fried Berg (small blind) showed [7c 7s] and lost with Full of Kings and 7
Seat 2: LGK.NC (big blind) showed [Qs 2s] and won 0.38€ with Full of Kings and Queens


Winamax Poker - HOLD-UP "Colorado" - HandId: #19116069-777396-1701770689 - Holdem no limit (0.01€/0.02€) - 2023/12/05 10:04:49 UTC
Table: 'Colorado' 6-max (real money) Seat #6 is the button
Seat 1: prudence34 (2.87€)
Seat 2: Medoc94 (1€)
Seat 3: Fried Berg (0.35€)
Seat 4: livthe34 (3€)
Seat 5: Beso1Dartich (0.84€)
Seat 6: grut28 (3€)
*** ANTE/BLINDS ***
prudence34 posts small blind 0.01€
Medoc94 posts big blind 0.02€
Dealt to Fried Berg [Jd 5d]
*** PRE-FLOP *** 
Fried Berg raises 0.02€ to 0.04€
livthe34 calls 0.04€
Beso1Dartich folds
grut28 folds
prudence34 folds
Medoc94 calls 0.02€
*** FLOP *** [4h 3s 2d]
Medoc94 checks
Fried Berg checks
livthe34 checks
*** TURN *** [4h 3s 2d][Kh]
Medoc94 checks
Fried Berg checks
livthe34 bets 0.05€
Medoc94 calls 0.05€
Fried Berg folds
*** RIVER *** [4h 3s 2d Kh][7c]
Medoc94 checks
livthe34 bets 0.15€
Medoc94 folds
livthe34 collected 0.36€ from pot
*** SUMMARY ***
Total pot 0.36€ | Rake 0.02€
Board: [4h 3s 2d Kh 7c]
Seat 4: livthe34 won 0.36€


Winamax Poker - HOLD-UP "Colorado" - HandId: #19116069-777438-1701770734 - Holdem no limit (0.01€/0.02€) - 2023/12/05 10:05:34 UTC
Table: 'Colorado' 6-max (real money) Seat #6 is the button
Seat 1: P.BaIkany (2.32€)
Seat 2: DosdeBras (0.77€)
Seat 3: LGK.NC (2.29€)
Seat 4: LM231620 (0.31€)
Seat 5: mika9080 (4.52€)
Seat 6: Fried Berg (0.31€)
*** ANTE/BLINDS ***
P.BaIkany posts small blind 0.01€
DosdeBras posts big blind 0.02€
Dealt to Fried Berg [2c Th]
*** PRE-FLOP *** 
LGK.NC folds
LM231620 raises 0.04€ to 0.06€
mika9080 calls 0.06€
Fried Berg folds
P.BaIkany folds
DosdeBras folds
*** FLOP *** [2s 9s 7d]
LM231620 bets 0.25€ and is all-in
mika9080 folds
LM231620 collected 0.38€ from pot
*** SUMMARY ***
Total pot 0.38€ | Rake 0.02€
Board: [2s 9s 7d]
Seat 4: LM231620 won 0.38€


Winamax Poker - HOLD-UP "Colorado" - HandId: #19116069-777441-1701770737 - Holdem no limit (0.01€/0.02€) - 2023/12/05 10:05:37 UTC
Table: 'Colorado' 6-max (real money) Seat #6 is the button
Seat 1: Jesperord98 (2€)
Seat 2: -genzo- (3.07€)
Seat 3: G0R0N11 (2€)
Seat 4: dallo974 (4.61€)
Seat 5: fesacar (3€)
Seat 6: Fried Berg (0.31€)
*** ANTE/BLINDS ***
Jesperord98 posts small blind 0.01€
-genzo- posts big blind 0.02€
Dealt to Fried Berg [6s Jc]
*** PRE-FLOP *** 
G0R0N11 folds
dallo974 calls 0.02€
fesacar calls 0.02€
Fried Berg folds
Jesperord98 folds
-genzo- checks
*** FLOP *** [2s Qd 3h]
-genzo- checks
dallo974 checks
fesacar bets 0.02€
-genzo- folds
dallo974 calls 0.02€
*** TURN *** [2s Qd 3h][6d]
dallo974 checks
fesacar checks
*** RIVER *** [2s Qd 3h 6d][9h]
dallo974 checks
fesacar checks
*** SHOW DOWN ***
dallo974 shows [Kc 2c] (One pair : 2)
fesacar shows [8c 8s] (One pair : 8)
fesacar collected 0.10€ from pot
*** SUMMARY ***
Total pot 0.10€ | Rake 0.01€
Board: [2s Qd 3h 6d 9h]
Seat 4: dallo974 showed [Kc 2c] and lost with One pair : 2
Seat 5: fesacar showed [8c 8s] and won 0.10€ with One pair : 8


Winamax Poker - HOLD-UP "Colorado" - HandId: #19116069-777443-1701770739 - Holdem no limit (0.01€/0.02€) - 2023/12/05 10:05:39 UTC
Table: 'Colorado' 6-max (real money) Seat #6 is the button
Seat 1: magnumbenji (0.69€)
Seat 2: Alexisdpp (2.60€)
Seat 3: Fried Berg (0.31€)
Seat 4: Jesperord98 (2€)
Seat 5: prudence34 (2.17€)
Seat 6: G0R0N11 (2€)
*** ANTE/BLINDS ***
magnumbenji posts small blind 0.01€
Alexisdpp posts big blind 0.02€
Dealt to Fried Berg [Td 8h]
*** PRE-FLOP *** 
Fried Berg folds
Jesperord98 folds
prudence34 folds
G0R0N11 folds
magnumbenji folds
Alexisdpp collected 0.03€ from pot
*** SUMMARY ***
Total pot 0.03€ | No rake
Seat 2: Alexisdpp (big blind) won 0.03€


Winamax Poker - HOLD-UP "Colorado" - HandId: #19116069-777447-1701770742 - Holdem no limit (0.01€/0.02€) - 2023/12/05 10:05:42 UTC
Table: 'Colorado' 6-max (real money) Seat #6 is the button
Seat 1: Okapi_Poli29 (3.64€)
Seat 2: S-aaron24 (2.25€)
Seat 3: prudence34 (2.74€)
Seat 4: Anty-dot (2€)
Seat 5: kameleon73 (2.82€)
Seat 6: Fried Berg (0.31€)
*** ANTE/BLINDS ***
Okapi_Poli29 posts small blind 0.01€
S-aaron24 posts big blind 0.02€
Dealt to Fried Berg [Ac 6s]
*** PRE-FLOP *** 
prudence34 folds
Anty-dot folds
kameleon73 folds
Fried Berg raises 0.02€ to 0.04€
Okapi_Poli29 folds
S-aaron24 folds
Fried Berg collected 0.07€ from pot
*** SUMMARY ***
Total pot 0.07€ | No rake
Seat 6: Fried Berg (button) won 0.07€


Winamax Poker - HOLD-UP "Colorado" - HandId: #19116069-777470-1701770765 - Holdem no limit (0.01€/0.02€) - 2023/12/05 10:06:05 UTC
Table: 'Colorado' 6-max (real money) Seat #6 is the button
Seat 1: kameleon73 (2.26€)
Seat 2: Fried Berg (0.34€)
Seat 3: slowreplay (4.35€)
Seat 4: AdiTheKing (1.34€)
Seat 5: LM231620 (0.38€)
Seat 6: mika9080 (4.46€)
*** ANTE/BLINDS ***
kameleon73 posts small blind 0.01€
Fried Berg posts big blind 0.02€
Dealt to Fried Berg [9d 3c]
*** PRE-FLOP *** 
slowreplay folds
AdiTheKing folds
LM231620 folds
mika9080 folds
kameleon73 raises 0.02€ to 0.04€
Fried Berg folds
kameleon73 collected 0.06€ from pot
*** SUMMARY ***
Total pot 0.06€ | No rake
Seat 1: kameleon73 (small blind) won 0.06€


Winamax Poker - HOLD-UP "Colorado" - HandId: #19116069-777479-1701770774 - Holdem no limit (0.01€/0.02€) - 2023/12/05 10:06:14 UTC
Table: 'Colorado' 6-max (real money) Seat #6 is the button
Seat 1: G0R0N11 (2€)
Seat 2: slowreplay (3.35€)
Seat 3: P.BaIkany (2.29€)
Seat 4: Fried Berg (0.32€)
Seat 5: AdiTheKing (1.34€)
Seat 6: Ertorko (7.12€)
*** ANTE/BLINDS ***
G0R0N11 posts small blind 0.01€
slowreplay posts big blind 0.02€
Dealt to Fried Berg [8h 7d]
*** PRE-FLOP *** 
P.BaIkany folds
Fried Berg folds
AdiTheKing raises 0.03€ to 0.05€
Ertorko calls 0.05€
G0R0N11 folds
slowreplay folds
*** FLOP *** [Kc Qc Js]
AdiTheKing checks
Ertorko bets 0.05€
AdiTheKing calls 0.05€
*** TURN *** [Kc Qc Js][9c]
AdiTheKing checks
Ertorko bets 0.16€
AdiTheKing raises 0.41€ to 0.57€
Ertorko calls 0.41€
*** RIVER *** [Kc Qc Js 9c][Tc]
AdiTheKing bets 0.67€ and is all-in
Ertorko folds
AdiTheKing collected 1.90€ from pot
*** SUMMARY ***
Total pot 1.90€ | Rake 0.14€
Board: [Kc Qc Js 9c Tc]
Seat 5: AdiTheKing won 1.90€


Winamax Poker - HOLD-UP "Colorado" - HandId: #19116069-777481-1701770776 - Holdem no limit (0.01€/0.02€) - 2023/12/05 10:06:16 UTC
Table: 'Colorado' 6-max (real money) Seat #6 is the button
Seat 1: SIMLcocotier (2.73€)
Seat 2: LGK.NC (2.26€)
Seat 3: Richard Reuk (4.85€)
Seat 4: Fried Berg (0.32€)
Seat 5: kameleon73 (2.28€)
Seat 6: -genzo- (6.09€)
*** ANTE/BLINDS ***
SIMLcocotier posts small blind 0.01€
LGK.NC posts big blind 0.02€
Dealt to Fried Berg [7c 8s]
*** PRE-FLOP *** 
Richard Reuk folds
Fried Berg folds
kameleon73 folds
-genzo- folds
SIMLcocotier folds
LGK.NC collected 0.03€ from pot
*** SUMMARY ***
Total pot 0.03€ | No rake
Seat 2: LGK.NC (big blind) won 0.03€


Winamax Poker - HOLD-UP "Colorado" - HandId: #19116069-777487-1701770783 - Holdem no limit (0.01€/0.02€) - 2023/12/05 10:06:23 UTC
Table: 'Colorado' 6-max (real money) Seat #6 is the button
Seat 1: Fried Berg (0.32€)
Seat 2: Anty-dot (2.28€)
Seat 3: G0R0N11 (2€)
Seat 4: le brakeur (1.63€)
Seat 5: trikar xx (2.44€)
Seat 6: kameleon73 (2.28€)
*** ANTE/BLINDS ***
Fried Berg posts small blind 0.01€
Anty-dot posts big blind 0.02€
Dealt to Fried Berg [8d 3s]
*** PRE-FLOP *** 
G0R0N11 folds
le brakeur folds
trikar xx folds
kameleon73 raises 0.04€ to 0.06€
Fried Berg folds
Anty-dot folds
kameleon73 collected 0.09€ from pot
*** SUMMARY ***
Total pot 0.09€ | No rake
Seat 6: kameleon73 (button) won 0.09€


Winamax Poker - HOLD-UP "Colorado" - HandId: #19116069-777488-1701770784 - Holdem no limit (0.01€/0.02€) - 2023/12/05 10:06:24 UTC
Table: 'Colorado' 6-max (real money) Seat #6 is the button
Seat 1: slowreplay (3.33€)
Seat 2: Jesperord98 (2€)
Seat 3: DosdeBras (1€)
Seat 4: -genzo- (6.08€)
Seat 5: Fried Berg (0.31€)
Seat 6: SIMLcocotier (2.72€)
*** ANTE/BLINDS ***
slowreplay posts small blind 0.01€
Jesperord98 posts big blind 0.02€
Dealt to Fried Berg [Jc 3s]
*** PRE-FLOP *** 
DosdeBras raises 0.03€ to 0.05€
-genzo- folds
Fried Berg folds
SIMLcocotier folds
slowreplay folds
Jesperord98 calls 0.03€
*** FLOP *** [6c 6d 9s]
Jesperord98 checks
DosdeBras bets 0.05€
Jesperord98 calls 0.05€
*** TURN *** [6c 6d 9s][6h]
Jesperord98 checks
DosdeBras checks
*** RIVER *** [6c 6d 9s 6h][Kc]
Jesperord98 bets 0.08€
DosdeBras calls 0.08€
*** SHOW DOWN ***
Jesperord98 shows [3c Ac] (Trips of 6)
DosdeBras shows [Ts As] (Trips of 6)
DosdeBras collected 0.17€ from pot
Jesperord98 collected 0.16€ from pot
*** SUMMARY ***
Total pot 0.33€ | Rake 0.04€
Board: [6c 6d 9s 6h Kc]
Seat 2: Jesperord98 (big blind) showed [3c Ac] and won 0.16€ with Trips of 6
Seat 3: DosdeBras showed [Ts As] and won 0.17€ with Trips of 6


Winamax Poker - HOLD-UP "Colorado" - HandId: #19116069-777490-1701770787 - Holdem no limit (0.01€/0.02€) - 2023/12/05 10:06:27 UTC
Table: 'Colorado' 6-max (real money) Seat #6 is the button
Seat 1: Fried Berg (0.31€)
Seat 2: Richard Reuk (4.59€)
Seat 3: le brakeur (1.63€)
Seat 4: G0R0N11 (2€)
Seat 5: ThePryce (2.27€)
Seat 6: prudence34 (2.78€)
*** ANTE/BLINDS ***
Fried Berg posts small blind 0.01€
Richard Reuk posts big blind 0.02€
Dealt to Fried Berg [7h Kd]
*** PRE-FLOP *** 
le brakeur raises 0.04€ to 0.06€
G0R0N11 folds
ThePryce folds
prudence34 folds
Fried Berg folds
Richard Reuk folds
le brakeur collected 0.09€ from pot
*** SUMMARY ***
Total pot 0.09€ | No rake
Seat 3: le brakeur won 0.09€


Winamax Poker - HOLD-UP "Colorado" - HandId: #19116069-777496-1701770793 - Holdem no limit (0.01€/0.02€) - 2023/12/05 10:06:33 UTC
Table: 'Colorado' 6-max (real money) Seat #6 is the button
Seat 1: fesacar (2.04€)
Seat 2: Fried Berg (0.30€)
Seat 3: S-aaron24 (2.23€)
Seat 4: sacerx (2.26€)
Seat 5: guevarache (3.74€)
Seat 6: luffy43770 (2.64€)
*** ANTE/BLINDS ***
fesacar posts small blind 0.01€
Fried Berg posts big blind 0.02€
Dealt to Fried Berg [6d Ah]
*** PRE-FLOP *** 
S-aaron24 folds
sacerx folds
guevarache folds
luffy43770 calls 0.02€
fesacar folds
Fried Berg checks
*** FLOP *** [Ts 9c 7s]
Fried Berg checks
luffy43770 checks
*** TURN *** [Ts 9c 7s][4h]
Fried Berg checks
luffy43770 checks
*** RIVER *** [Ts 9c 7s 4h][4c]
Fried Berg checks
luffy43770 checks
*** SHOW DOWN ***
Fried Berg shows [6d Ah] (One pair : 4)
luffy43770 shows [5d As] (One pair : 4)
luffy43770 collected 0.02€ from pot
Fried Berg collected 0.02€ from pot
*** SUMMARY ***
Total pot 0.04€ | Rake 0.01€
Board: [Ts 9c 7s 4h 4c]
Seat 2: Fried Berg (big blind) showed [6d Ah] and won 0.02€ with One pair : 4
Seat 6: luffy43770 (button) showed [5d As] and won 0.02€ with One pair : 4


Winamax Poker - HOLD-UP "Colorado" - HandId: #19116069-777545-1701770836 - Holdem no limit (0.01€/0.02€) - 2023/12/05 10:07:16 UTC
Table: 'Colorado' 6-max (real money) Seat #6 is the button
Seat 1: livthe34 (2.81€)
Seat 2: MoneyGrowing (2.93€)
Seat 3: Fried Berg (0.30€)
Seat 4: luffy43770 (2.64€)
Seat 5: Anty-dot (2€)
Seat 6: SirX (5.44€)
Hold-up to Pot: total 0.10€
*** ANTE/BLINDS ***
livthe34 posts small blind 0.01€
MoneyGrowing posts big blind 0.02€
Dealt to Fried Berg [2c Kh]
*** PRE-FLOP *** 
Fried Berg folds
luffy43770 calls 0.02€
Anty-dot folds
SirX folds
livthe34 calls 0.01€
MoneyGrowing checks
*** FLOP *** [8d 3c Ks]
livthe34 checks
MoneyGrowing checks
luffy43770 checks
*** TURN *** [8d 3c Ks][Qd]
livthe34 bets 0.06€
MoneyGrowing folds
luffy43770 folds
livthe34 collected 0.21€ from pot
*** SUMMARY ***
Total pot 0.21€ | Rake 0.01€
Board: [8d 3c Ks Qd]
Seat 1: livthe34 (small blind) won 0.21€


Winamax Poker - HOLD-UP "Colorado" - HandId: #19116069-777552-1701770841 - Holdem no limit (0.01€/0.02€) - 2023/12/05 10:07:21 UTC
Table: 'Colorado' 6-max (real money) Seat #6 is the button
Seat 1: RaseOnYou (4.05€)
Seat 2: Pierrof24 (3.35€)
Seat 3: EA_Stinger (0.58€)
Seat 4: Fried Berg (0.30€)
Seat 5: Alexisdpp (2.47€)
Seat 6: Noka1320 (0.25€)
*** ANTE/BLINDS ***
RaseOnYou posts small blind 0.01€
Pierrof24 posts big blind 0.02€
Dealt to Fried Berg [Qc 6s]
*** PRE-FLOP *** 
EA_Stinger raises 0.03€ to 0.05€
Fried Berg folds
Alexisdpp folds
Noka1320 calls 0.05€
RaseOnYou folds
Pierrof24 calls 0.03€
*** FLOP *** [4h 8d 5s]
Pierrof24 checks
EA_Stinger bets 0.10€
Noka1320 folds
Pierrof24 folds
EA_Stinger collected 0.24€ from pot
*** SUMMARY ***
Total pot 0.24€ | Rake 0.02€
Board: [4h 8d 5s]
Seat 3: EA_Stinger won 0.24€


Winamax Poker - HOLD-UP "Colorado" - HandId: #19116069-777555-1701770843 - Holdem no limit (0.01€/0.02€) - 2023/12/05 10:07:23 UTC
Table: 'Colorado' 6-max (real money) Seat #6 is the button
Seat 1: guevarache (2.01€)
Seat 2: Okapi_Poli29 (3.61€)
Seat 3: AdiTheKing (0.86€)
Seat 4: PIQSOU (3.96€)
Seat 5: Fried Berg (0.30€)
Seat 6: Alexisdpp (2.47€)
*** ANTE/BLINDS ***
guevarache posts small blind 0.01€
Okapi_Poli29 posts big blind 0.02€
Dealt to Fried Berg [Kd 8d]
*** PRE-FLOP *** 
AdiTheKing raises 0.03€ to 0.05€
PIQSOU folds
Fried Berg calls 0.05€
Alexisdpp calls 0.05€
guevarache calls 0.04€
Okapi_Poli29 folds
*** FLOP *** [7d As 9h]
guevarache checks
AdiTheKing checks
Fried Berg bets 0.12€
Alexisdpp calls 0.12€
guevarache folds
AdiTheKing folds
*** TURN *** [7d As 9h][6h]
Fried Berg checks
Alexisdpp checks
*** RIVER *** [7d As 9h 6h][Td]
Fried Berg checks
Alexisdpp checks
*** SHOW DOWN ***
Alexisdpp shows [2s 2h] (One pair : 2)
Fried Berg shows [Kd 8d] (Straight Ten high)
Fried Berg collected 0.41€ from pot
*** SUMMARY ***
Total pot 0.41€ | Rake 0.05€
Board: [7d As 9h 6h Td]
Seat 5: Fried Berg showed [Kd 8d] and won 0.41€ with Straight Ten high
Seat 6: Alexisdpp (button) showed [2s 2h] and lost with One pair : 2


Winamax Poker - HOLD-UP "Colorado" - HandId: #19116069-777661-1701770928 - Holdem no limit (0.01€/0.02€) - 2023/12/05 10:08:48 UTC
Table: 'Colorado' 6-max (real money) Seat #6 is the button
Seat 1: Pierrof24 (3.18€)
Seat 2: Fried Berg (0.54€)
Seat 3: Alexisdpp (2.30€)
Seat 4: AdiTheKing (1.75€)
Seat 5: kameleon73 (2.45€)
Seat 6: VanDolar (2€)
*** ANTE/BLINDS ***
Pierrof24 posts small blind 0.01€
Fried Berg posts big blind 0.02€
Dealt to Fried Berg [4h 5c]
*** PRE-FLOP *** 
Alexisdpp raises 0.03€ to 0.05€
AdiTheKing folds
kameleon73 folds
VanDolar folds
Pierrof24 folds
Fried Berg folds
Alexisdpp collected 0.08€ from pot
*** SUMMARY ***
Total pot 0.08€ | No rake
Seat 3: Alexisdpp won 0.08€


Winamax Poker - HOLD-UP "Colorado" - HandId: #19116069-777710-1701770965 - Holdem no limit (0.01€/0.02€) - 2023/12/05 10:09:25 UTC
Table: 'Colorado' 6-max (real money) Seat #6 is the button
Seat 1: kameleon73 (3.79€)
Seat 2: ninoujacou (0.50€)
Seat 3: grut28 (2.70€)
Seat 4: Fried Berg (0.52€)
Seat 5: Anty-dot (2.02€)
Seat 6: GF Warrior82 (2.03€)
*** ANTE/BLINDS ***
kameleon73 posts small blind 0.01€
ninoujacou posts big blind 0.02€
Dealt to Fried Berg [Qc Ad]
*** PRE-FLOP *** 
grut28 folds
Fried Berg raises 0.02€ to 0.04€
Anty-dot folds
GF Warrior82 calls 0.04€
kameleon73 calls 0.03€
ninoujacou calls 0.02€
*** FLOP *** [2h Qh 2s]
kameleon73 checks
ninoujacou checks
Fried Berg bets 0.02€
GF Warrior82 folds
kameleon73 calls 0.02€
ninoujacou calls 0.02€
*** TURN *** [2h Qh 2s][Jh]
kameleon73 checks
ninoujacou checks
Fried Berg bets 0.02€
kameleon73 calls 0.02€
ninoujacou calls 0.02€
*** RIVER *** [2h Qh 2s Jh][9h]
kameleon73 checks
ninoujacou checks
Fried Berg checks
*** SHOW DOWN ***
ninoujacou shows [8d 8s] (Two pairs : 8 and 2)
Fried Berg shows [Qc Ad] (Two pairs : Queens and 2)
kameleon73 shows [9s 9d] (Full of 9 and 2)
kameleon73 collected 0.25€ from pot
*** SUMMARY ***
Total pot 0.25€ | Rake 0.03€
Board: [2h Qh 2s Jh 9h]
Seat 1: kameleon73 (small blind) showed [9s 9d] and won 0.25€ with Full of 9 and 2
Seat 2: ninoujacou (big blind) showed [8d 8s] and lost with Two pairs : 8 and 2
Seat 4: Fried Berg showed [Qc Ad] and lost with Two pairs : Queens and 2


Winamax Poker - HOLD-UP "Colorado" - HandId: #19116069-777764-1701771014 - Holdem no limit (0.01€/0.02€) - 2023/12/05 10:10:14 UTC
Table: 'Colorado' 6-max (real money) Seat #6 is the button
Seat 1: Fried Berg (0.44€)
Seat 2: Anty-dot (2.04€)
Seat 3: GLDBZH (1.90€)
Seat 4: Japut (2.06€)
Seat 5: kameleon73 (3.96€)
Seat 6: slowreplay (3.11€)
*** ANTE/BLINDS ***
Fried Berg posts small blind 0.01€
Anty-dot posts big blind 0.02€
Dealt to Fried Berg [6s Kc]
*** PRE-FLOP *** 
GLDBZH folds
Japut folds
kameleon73 folds
slowreplay folds
Fried Berg folds
Anty-dot collected 0.03€ from pot
*** SUMMARY ***
Total pot 0.03€ | No rake
Seat 2: Anty-dot (big blind) won 0.03€


Winamax Poker - HOLD-UP "Colorado" - HandId: #19116069-777794-1701771035 - Holdem no limit (0.01€/0.02€) - 2023/12/05 10:10:35 UTC
Table: 'Colorado' 6-max (real money) Seat #6 is the button
Seat 1: slowreplay (3.09€)
Seat 2: _Queens_ (2.82€)
Seat 3: PACS 024 (0.62€)
Seat 4: Zard.Oz (3.37€)
Seat 5: Fried Berg (0.43€)
Seat 6: ninoujacou (0.41€)
Hold-up to Pot: total 0.10€
*** ANTE/BLINDS ***
slowreplay posts small blind 0.01€
_Queens_ posts big blind 0.02€
Dealt to Fried Berg [2c As]
*** PRE-FLOP *** 
PACS 024 folds
Zard.Oz raises 0.04€ to 0.06€
Fried Berg calls 0.06€
ninoujacou folds
slowreplay calls 0.05€
_Queens_ folds
*** FLOP *** [8d 7d 3h]
slowreplay checks
Zard.Oz bets 0.30€
Fried Berg folds
slowreplay folds
Zard.Oz collected 0.58€ from pot
*** SUMMARY ***
Total pot 0.58€ | Rake 0.02€
Board: [8d 7d 3h]
Seat 4: Zard.Oz won 0.58€


Winamax Poker - HOLD-UP "Colorado" - HandId: #19116069-777849-1701771081 - Holdem no limit (0.01€/0.02€) - 2023/12/05 10:11:21 UTC
Table: 'Colorado' 6-max (real money) Seat #6 is the button
Seat 1: ninoujacou (0.61€)
Seat 2: bananAsSplit (2€)
Seat 3: Fried Berg (0.37€)
Seat 4: Baston57 (2.44€)
Seat 5: trikar xx (2.43€)
Seat 6: Anty-dot (2.14€)
*** ANTE/BLINDS ***
ninoujacou posts small blind 0.01€
bananAsSplit posts big blind 0.02€
Dealt to Fried Berg [7c 9h]
*** PRE-FLOP *** 
Fried Berg folds
Baston57 calls 0.02€
trikar xx folds
Anty-dot raises 0.05€ to 0.07€
ninoujacou folds
bananAsSplit folds
Baston57 calls 0.05€
*** FLOP *** [Kc 4s 7h]
Baston57 checks
Anty-dot checks
*** TURN *** [Kc 4s 7h][8d]
Baston57 checks
Anty-dot checks
*** RIVER *** [Kc 4s 7h 8d][9c]
Baston57 checks
Anty-dot checks
*** SHOW DOWN ***
Anty-dot shows [2s 2d] (One pair : 2)
Baston57 shows [6s 6h] (One pair : 6)
Baston57 collected 0.15€ from pot
*** SUMMARY ***
Total pot 0.15€ | Rake 0.02€
Board: [Kc 4s 7h 8d 9c]
Seat 4: Baston57 showed [6s 6h] and won 0.15€ with One pair : 6
Seat 6: Anty-dot (button) showed [2s 2d] and lost with One pair : 2


Winamax Poker - HOLD-UP "Colorado" - HandId: #19116069-777850-1701771082 - Holdem no limit (0.01€/0.02€) - 2023/12/05 10:11:22 UTC
Table: 'Colorado' 6-max (real money) Seat #6 is the button
Seat 1: PoisSson69 (0.48€)
Seat 2: kameleon73 (2.10€)
Seat 3: fesacar (2.18€)
Seat 4: -genzo- (3.14€)
Seat 5: Fried Berg (0.37€)
Seat 6: Pierrof24 (3.10€)
*** ANTE/BLINDS ***
PoisSson69 posts small blind 0.01€
kameleon73 posts big blind 0.02€
Dealt to Fried Berg [7h 6h]
*** PRE-FLOP *** 
fesacar folds
-genzo- raises 0.04€ to 0.06€
Fried Berg calls 0.06€
Pierrof24 folds
PoisSson69 folds
kameleon73 calls 0.04€
*** FLOP *** [Jd Qh 2d]
kameleon73 checks
-genzo- checks
Fried Berg checks
*** TURN *** [Jd Qh 2d][As]
kameleon73 checks
-genzo- checks
Fried Berg checks
*** RIVER *** [Jd Qh 2d As][Js]
kameleon73 checks
-genzo- checks
Fried Berg bets 0.04€
kameleon73 folds
-genzo- folds
Fried Berg collected 0.21€ from pot
*** SUMMARY ***
Total pot 0.21€ | Rake 0.02€
Board: [Jd Qh 2d As Js]
Seat 5: Fried Berg won 0.21€


Winamax Poker - HOLD-UP "Colorado" - HandId: #19116069-777941-1701771156 - Holdem no limit (0.01€/0.02€) - 2023/12/05 10:12:36 UTC
Table: 'Colorado' 6-max (real money) Seat #6 is the button
Seat 1: MoneyGrowing (2€)
Seat 2: prudence34 (2.49€)
Seat 3: Ga31k (2€)
Seat 4: PIQSOU (2.83€)
Seat 5: Fried Berg (0.48€)
Seat 6: Richard Reuk (2.24€)
*** ANTE/BLINDS ***
MoneyGrowing posts small blind 0.01€
prudence34 posts big blind 0.02€
Dealt to Fried Berg [3h Kc]
*** PRE-FLOP *** 
Ga31k folds
PIQSOU folds
Fried Berg folds
Richard Reuk raises 0.03€ to 0.05€
MoneyGrowing folds
prudence34 folds
Richard Reuk collected 0.08€ from pot
*** SUMMARY ***
Total pot 0.08€ | No rake
Seat 6: Richard Reuk (button) won 0.08€


Winamax Poker - HOLD-UP "Colorado" - HandId: #19116069-777959-1701771169 - Holdem no limit (0.01€/0.02€) - 2023/12/05 10:12:49 UTC
Table: 'Colorado' 6-max (real money) Seat #6 is the button
Seat 1: Drogadicto87 (0.46€)
Seat 2: LMG22_23 (2€)
Seat 3: MoneyGrowing (2€)
Seat 4: Chanclaveloz (2.88€)
Seat 5: SirX (1.24€)
Seat 6: Fried Berg (0.48€)
*** ANTE/BLINDS ***
Drogadicto87 posts small blind 0.01€
LMG22_23 posts big blind 0.02€
Dealt to Fried Berg [3s 4s]
*** PRE-FLOP *** 
MoneyGrowing folds
Chanclaveloz raises 0.02€ to 0.04€
SirX folds
Fried Berg calls 0.04€
Drogadicto87 calls 0.03€
LMG22_23 folds
*** FLOP *** [Kh Qc 9h]
Drogadicto87 checks
Chanclaveloz bets 0.07€
Fried Berg folds
Drogadicto87 folds
Chanclaveloz collected 0.20€ from pot
*** SUMMARY ***
Total pot 0.20€ | Rake 0.01€
Board: [Kh Qc 9h]
Seat 4: Chanclaveloz won 0.20€


Winamax Poker - HOLD-UP "Colorado" - HandId: #19116069-778000-1701771199 - Holdem no limit (0.01€/0.02€) - 2023/12/05 10:13:19 UTC
Table: 'Colorado' 6-max (real money) Seat #6 is the button
Seat 1: bananAsSplit (2.50€)
Seat 2: Pierrof24 (3.04€)
Seat 3: Fried Berg (0.44€)
Seat 4: Quenelles (1.83€)
Seat 5: -genzo- (4.05€)
Seat 6: guevarache (2.25€)
*** ANTE/BLINDS ***
bananAsSplit posts small blind 0.01€
Pierrof24 posts big blind 0.02€
Dealt to Fried Berg [6d 5s]
*** PRE-FLOP *** 
Fried Berg folds
Quenelles folds
-genzo- folds
guevarache folds
bananAsSplit folds
Pierrof24 collected 0.03€ from pot
*** SUMMARY ***
Total pot 0.03€ | No rake
Seat 2: Pierrof24 (big blind) won 0.03€


Winamax Poker - HOLD-UP "Colorado" - HandId: #19116069-778002-1701771201 - Holdem no limit (0.01€/0.02€) - 2023/12/05 10:13:21 UTC
Table: 'Colorado' 6-max (real money) Seat #6 is the button
Seat 1: AdiTheKing (1.61€)
Seat 2: Fried Berg (0.44€)
Seat 3: didi5959 (0.41€)
Seat 4: P.BaIkany (5€)
Seat 5: DeX70 (1.92€)
Seat 6: prudence34 (2€)
*** ANTE/BLINDS ***
AdiTheKing posts small blind 0.01€
Fried Berg posts big blind 0.02€
Dealt to Fried Berg [2c Js]
*** PRE-FLOP *** 
didi5959 calls 0.02€
P.BaIkany raises 0.08€ to 0.10€
DeX70 folds
prudence34 folds
AdiTheKing folds
Fried Berg folds
didi5959 calls 0.08€
*** FLOP *** [Ts Th Kd]
didi5959 checks
P.BaIkany bets 0.09€
didi5959 folds
P.BaIkany collected 0.30€ from pot
*** SUMMARY ***
Total pot 0.30€ | Rake 0.02€
Board: [Ts Th Kd]
Seat 4: P.BaIkany won 0.30€


Winamax Poker - HOLD-UP "Colorado" - HandId: #19116069-778008-1701771208 - Holdem no limit (0.01€/0.02€) - 2023/12/05 10:13:28 UTC
Table: 'Colorado' 6-max (real money) Seat #6 is the button
Seat 1: Fried Berg (0.42€)
Seat 2: Jesperord98 (2.06€)
Seat 3: RaseOnYou (3.89€)
Seat 4: magnumbenji (1.11€)
Seat 5: Ertorko (7.79€)
Seat 6: ThePryce (3.19€)
Hold-up to Pot: total 0.10€
*** ANTE/BLINDS ***
Fried Berg posts small blind 0.01€
Jesperord98 posts big blind 0.02€
Dealt to Fried Berg [Jh 3d]
*** PRE-FLOP *** 
RaseOnYou raises 0.02€ to 0.04€
magnumbenji calls 0.04€
Ertorko folds
ThePryce folds
Fried Berg folds
Jesperord98 folds
*** FLOP *** [Ks Kd 2c]
RaseOnYou bets 0.07€
magnumbenji folds
RaseOnYou collected 0.27€ from pot
*** SUMMARY ***
Total pot 0.27€ | Rake 0.01€
Board: [Ks Kd 2c]
Seat 3: RaseOnYou won 0.27€


Winamax Poker - HOLD-UP "Colorado" - HandId: #19116069-778014-1701771213 - Holdem no limit (0.01€/0.02€) - 2023/12/05 10:13:33 UTC
Table: 'Colorado' 6-max (real money) Seat #6 is the button
Seat 1: kameleon73 (2€)
Seat 2: Rroozzo (2€)
Seat 3: Drogadicto87 (0.42€)
Seat 4: Fried Berg (0.41€)
Seat 5: dallo974 (4.37€)
Seat 6: -genzo- (3.19€)
*** ANTE/BLINDS ***
kameleon73 posts small blind 0.01€
Rroozzo posts big blind 0.02€
Dealt to Fried Berg [6s Kc]
*** PRE-FLOP *** 
Drogadicto87 calls 0.02€
Fried Berg folds
dallo974 calls 0.02€
-genzo- folds
kameleon73 folds
Rroozzo checks
*** FLOP *** [Th Ks 5d]
Rroozzo checks
Drogadicto87 bets 0.02€
dallo974 folds
Rroozzo folds
Drogadicto87 collected 0.08€ from pot
*** SUMMARY ***
Total pot 0.08€ | Rake 0.01€
Board: [Th Ks 5d]
Seat 3: Drogadicto87 won 0.08€


Winamax Poker - HOLD-UP "Colorado" - HandId: #19116069-778018-1701771215 - Holdem no limit (0.01€/0.02€) - 2023/12/05 10:13:35 UTC
Table: 'Colorado' 6-max (real money) Seat #6 is the button
Seat 1: Medoc94 (0.61€)
Seat 2: Richard Reuk (5.42€)
Seat 3: LMG22_23 (1.59€)
Seat 4: slowreplay (3.04€)
Seat 5: S-aaron24 (2€)
Seat 6: Fried Berg (0.41€)
*** ANTE/BLINDS ***
Medoc94 posts small blind 0.01€
Richard Reuk posts big blind 0.02€
Dealt to Fried Berg [4c 2c]
*** PRE-FLOP *** 
LMG22_23 folds
slowreplay folds
S-aaron24 raises 0.03€ to 0.05€
Fried Berg folds
Medoc94 folds
Richard Reuk folds
S-aaron24 collected 0.08€ from pot
*** SUMMARY ***
Total pot 0.08€ | No rake
Seat 5: S-aaron24 won 0.08€


Winamax Poker - HOLD-UP "Colorado" - HandId: #19116069-778022-1701771217 - Holdem no limit (0.01€/0.02€) - 2023/12/05 10:13:37 UTC
Table: 'Colorado' 6-max (real money) Seat #6 is the button
Seat 1: Jesperord98 (2.04€)
Seat 2: ThePryce (3.19€)
Seat 3: Fried Berg (0.41€)
Seat 4: grut28 (2.89€)
Seat 5: LM231620 (0.56€)
Seat 6: Baston57 (2.68€)
*** ANTE/BLINDS ***
Jesperord98 posts small blind 0.01€
ThePryce posts big blind 0.02€
Dealt to Fried Berg [Ks Jc]
*** PRE-FLOP *** 
Fried Berg raises 0.02€ to 0.04€
grut28 folds
LM231620 folds
Baston57 folds
Jesperord98 folds
ThePryce folds
Fried Berg collected 0.07€ from pot
*** SUMMARY ***
Total pot 0.07€ | No rake
Seat 3: Fried Berg won 0.07€


Winamax Poker - HOLD-UP "Colorado" - HandId: #19116069-778038-1701771226 - Holdem no limit (0.01€/0.02€) - 2023/12/05 10:13:46 UTC
Table: 'Colorado' 6-max (real money) Seat #6 is the button
Seat 1: ninoujacou (0.47€)
Seat 2: Fried Berg (0.44€)
Seat 3: trikar xx (3.41€)
Seat 4: AD-Genie8925 (0.34€)
Seat 5: Medoc94 (0.60€)
Seat 6: didi5959 (0.31€)
*** ANTE/BLINDS ***
ninoujacou posts small blind 0.01€
Fried Berg posts big blind 0.02€
Dealt to Fried Berg [3c Jc]
*** PRE-FLOP *** 
trikar xx folds
AD-Genie8925 folds
Medoc94 raises 0.03€ to 0.05€
didi5959 folds
ninoujacou folds
Fried Berg folds
Medoc94 collected 0.08€ from pot
*** SUMMARY ***
Total pot 0.08€ | No rake
Seat 5: Medoc94 won 0.08€


Winamax Poker - HOLD-UP "Colorado" - HandId: #19116069-778060-1701771242 - Holdem no limit (0.01€/0.02€) - 2023/12/05 10:14:02 UTC
Table: 'Colorado' 6-max (real money) Seat #6 is the button
Seat 1: Fried Berg (0.42€)
Seat 2: Anty-dot (2.09€)
Seat 3: _Queens_ (2.41€)
Seat 4: -genzo- (6.09€)
Seat 5: RaseOnYou (4.03€)
Seat 6: Ga31k (2.06€)
*** ANTE/BLINDS ***
Fried Berg posts small blind 0.01€
Anty-dot posts big blind 0.02€
Dealt to Fried Berg [Ts Tc]
*** PRE-FLOP *** 
_Queens_ raises 0.03€ to 0.05€
-genzo- folds
RaseOnYou folds
Ga31k folds
Fried Berg raises 0.10€ to 0.15€
Anty-dot folds
_Queens_ calls 0.10€
*** FLOP *** [4h 2s Td]
Fried Berg bets 0.20€
_Queens_ calls 0.20€
*** TURN *** [4h 2s Td][7h]
Fried Berg bets 0.07€ and is all-in
_Queens_ calls 0.07€
*** RIVER *** [4h 2s Td 7h][3d]
*** SHOW DOWN ***
_Queens_ shows [Ah Qd] (High card : Ace)
Fried Berg shows [Ts Tc] (Trips of Tens)
Fried Berg collected 0.77€ from pot
*** SUMMARY ***
Total pot 0.77€ | Rake 0.09€
Board: [4h 2s Td 7h 3d]
Seat 1: Fried Berg (small blind) showed [Ts Tc] and won 0.77€ with Trips of Tens
Seat 3: _Queens_ showed [Ah Qd] and lost with High card : Ace


Winamax Poker - HOLD-UP "Colorado" - HandId: #19116069-778103-1701771271 - Holdem no limit (0.01€/0.02€) - 2023/12/05 10:14:31 UTC
Table: 'Colorado' 6-max (real money) Seat #6 is the button
Seat 1: Alexisdpp (3.13€)
Seat 2: Richard Reuk (2.58€)
Seat 3: slowreplay (2.18€)
Seat 4: Fried Berg (0.77€)
Seat 5: G0R0N11 (2.15€)
Seat 6: sharkaponk78 (2€)
*** ANTE/BLINDS ***
Alexisdpp posts small blind 0.01€
Richard Reuk posts big blind 0.02€
Dealt to Fried Berg [Qd 8d]
*** PRE-FLOP *** 
slowreplay folds
Fried Berg raises 0.02€ to 0.04€
G0R0N11 calls 0.04€
sharkaponk78 folds
Alexisdpp calls 0.03€
Richard Reuk folds
*** FLOP *** [Qh 5d 9c]
Alexisdpp checks
Fried Berg bets 0.04€
G0R0N11 folds
Alexisdpp calls 0.04€
*** TURN *** [Qh 5d 9c][Jh]
Alexisdpp checks
Fried Berg bets 0.12€
Alexisdpp calls 0.12€
*** RIVER *** [Qh 5d 9c Jh][8h]
Alexisdpp checks
Fried Berg bets 0.16€
Alexisdpp calls 0.16€
*** SHOW DOWN ***
Alexisdpp shows [9s Ah] (One pair : 9)
Fried Berg shows [Qd 8d] (Two pairs : Queens and 8)
Fried Berg collected 0.70€ from pot
*** SUMMARY ***
Total pot 0.70€ | Rake 0.08€
Board: [Qh 5d 9c Jh 8h]
Seat 1: Alexisdpp (small blind) showed [9s Ah] and lost with One pair : 9
Seat 4: Fried Berg showed [Qd 8d] and won 0.70€ with Two pairs : Queens and 8


Winamax Poker - HOLD-UP "Colorado" - HandId: #19116069-778193-1701771345 - Holdem no limit (0.01€/0.02€) - 2023/12/05 10:15:45 UTC
Table: 'Colorado' 6-max (real money) Seat #6 is the button
Seat 1: Fried Berg (1.11€)
Seat 2: slowreplay (5.63€)
Seat 3: Ga31k (2€)
Seat 4: AdiTheKing (2.11€)
Seat 5: bananAsSplit (2.03€)
Seat 6: Alexisdpp (2.77€)
Hold-up to Pot: total 0.10€
*** ANTE/BLINDS ***
Fried Berg posts small blind 0.01€
slowreplay posts big blind 0.02€
Dealt to Fried Berg [Jh Td]
*** PRE-FLOP *** 
Ga31k folds
AdiTheKing raises 0.03€ to 0.05€
bananAsSplit folds
Alexisdpp folds
Fried Berg calls 0.04€
slowreplay calls 0.03€
*** FLOP *** [Jc Kh Tc]
Fried Berg bets 1.06€ and is all-in
slowreplay folds
AdiTheKing folds
Fried Berg collected 1.29€ from pot
*** SUMMARY ***
Total pot 1.29€ | Rake 0.02€
Board: [Jc Kh Tc]
Seat 1: Fried Berg (small blind) won 1.29€


Winamax Poker - HOLD-UP "Colorado" - HandId: #19116069-778226-1701771374 - Holdem no limit (0.01€/0.02€) - 2023/12/05 10:16:14 UTC
Table: 'Colorado' 6-max (real money) Seat #6 is the button
Seat 1: slowreplay (5.57€)
Seat 2: bananAsSplit (2.10€)
Seat 3: livthe34 (2.88€)
Seat 4: AdiTheKing (2.43€)
Seat 5: Fried Berg (1.29€)
Seat 6: MoneyGrowing (2.27€)
*** ANTE/BLINDS ***
slowreplay posts small blind 0.01€
bananAsSplit posts big blind 0.02€
Dealt to Fried Berg [6c Jd]
*** PRE-FLOP *** 
livthe34 raises 0.04€ to 0.06€
AdiTheKing folds
Fried Berg folds
MoneyGrowing folds
slowreplay folds
bananAsSplit folds
livthe34 collected 0.09€ from pot
*** SUMMARY ***
Total pot 0.09€ | No rake
Seat 3: livthe34 won 0.09€


Winamax Poker - HOLD-UP "Colorado" - HandId: #19116069-778245-1701771388 - Holdem no limit (0.01€/0.02€) - 2023/12/05 10:16:28 UTC
Table: 'Colorado' 6-max (real money) Seat #6 is the button
Seat 1: LM231620 (0.54€)
Seat 2: luffy43770 (3.23€)
Seat 3: Beso1Dartich (1.06€)
Seat 4: Fried Berg (1.29€)
Seat 5: Quenelles (2€)
Seat 6: slowreplay (2.99€)
*** ANTE/BLINDS ***
LM231620 posts small blind 0.01€
luffy43770 posts big blind 0.02€
Dealt to Fried Berg [5c 4d]
*** PRE-FLOP *** 
Beso1Dartich folds
Fried Berg folds
Quenelles folds
slowreplay folds
LM231620 folds
luffy43770 collected 0.03€ from pot
*** SUMMARY ***
Total pot 0.03€ | No rake
Seat 2: luffy43770 (big blind) won 0.03€


Winamax Poker - HOLD-UP "Colorado" - HandId: #19116069-778249-1701771390 - Holdem no limit (0.01€/0.02€) - 2023/12/05 10:16:30 UTC
Table: 'Colorado' 6-max (real money) Seat #6 is the button
Seat 1: Pierrof24 (2.37€)
Seat 2: Beso1Dartich (1.06€)
Seat 3: slowreplay (2.99€)
Seat 4: trikar xx (2.11€)
Seat 5: Fried Berg (1.29€)
Seat 6: livthe34 (2.91€)
*** ANTE/BLINDS ***
Pierrof24 posts small blind 0.01€
Beso1Dartich posts big blind 0.02€
Dealt to Fried Berg [9d 8s]
*** PRE-FLOP *** 
slowreplay folds
trikar xx folds
Fried Berg folds
livthe34 folds
Pierrof24 raises 0.02€ to 0.04€
Beso1Dartich folds
Pierrof24 collected 0.06€ from pot
*** SUMMARY ***
Total pot 0.06€ | No rake
Seat 1: Pierrof24 (small blind) won 0.06€


Winamax Poker - HOLD-UP "Colorado" - HandId: #19116069-778253-1701771393 - Holdem no limit (0.01€/0.02€) - 2023/12/05 10:16:33 UTC
Table: 'Colorado' 6-max (real money) Seat #6 is the button
Seat 1: Quenelles (2€)
Seat 2: slowreplay (2.99€)
Seat 3: luffy43770 (3.24€)
Seat 4: kameleon73 (2.36€)
Seat 5: LM231620 (0.52€)
Seat 6: Fried Berg (1.29€)
*** ANTE/BLINDS ***
Quenelles posts small blind 0.01€
slowreplay posts big blind 0.02€
Dealt to Fried Berg [Ks Qs]
*** PRE-FLOP *** 
luffy43770 folds
kameleon73 folds
LM231620 folds
Fried Berg raises 0.04€ to 0.06€
Quenelles folds
slowreplay calls 0.04€
*** FLOP *** [Ac Kh Js]
slowreplay checks
Fried Berg checks
*** TURN *** [Ac Kh Js][9s]
slowreplay checks
Fried Berg checks
*** RIVER *** [Ac Kh Js 9s][As]
slowreplay checks
Fried Berg bets 0.12€
slowreplay folds
Fried Berg collected 0.24€ from pot
*** SUMMARY ***
Total pot 0.24€ | Rake 0.01€
Board: [Ac Kh Js 9s As]
Seat 6: Fried Berg (button) won 0.24€


Winamax Poker - HOLD-UP "Colorado" - HandId: #19116069-778311-1701771437 - Holdem no limit (0.01€/0.02€) - 2023/12/05 10:17:17 UTC
Table: 'Colorado' 6-max (real money) Seat #6 is the button
Seat 1: Quenelles (2.62€)
Seat 2: _Queens_ (3.20€)
Seat 3: bananAsSplit (2.68€)
Seat 4: grut28 (2.90€)
Seat 5: Fried Berg (1.35€)
Seat 6: Bb68 (1.96€)
Hold-up to Pot: total 0.20€
*** ANTE/BLINDS ***
Quenelles posts small blind 0.01€
_Queens_ posts big blind 0.02€
Dealt to Fried Berg [9h Jc]
*** PRE-FLOP *** 
bananAsSplit folds
grut28 folds
Fried Berg folds
Bb68 folds
Quenelles raises 0.03€ to 0.05€
_Queens_ folds
Quenelles collected 0.27€ from pot
*** SUMMARY ***
Total pot 0.27€ | No rake
Seat 1: Quenelles (small blind) won 0.27€


Winamax Poker - HOLD-UP "Colorado" - HandId: #19116069-778319-1701771442 - Holdem no limit (0.01€/0.02€) - 2023/12/05 10:17:22 UTC
Table: 'Colorado' 6-max (real money) Seat #6 is the button
Seat 1: livthe34 (2.85€)
Seat 2: Fried Berg (1.35€)
Seat 3: Anty-dot (3.17€)
Seat 4: -genzo- (3.87€)
Seat 5: AdiTheKing (2.44€)
Seat 6: nemo5 (2€)
*** ANTE/BLINDS ***
livthe34 posts small blind 0.01€
Fried Berg posts big blind 0.02€
Dealt to Fried Berg [Qd 7s]
*** PRE-FLOP *** 
Anty-dot folds
-genzo- folds
AdiTheKing raises 0.03€ to 0.05€
nemo5 folds
livthe34 folds
Fried Berg folds
AdiTheKing collected 0.08€ from pot
*** SUMMARY ***
Total pot 0.08€ | No rake
Seat 5: AdiTheKing won 0.08€


Winamax Poker - HOLD-UP "Colorado" - HandId: #19116069-778336-1701771453 - Holdem no limit (0.01€/0.02€) - 2023/12/05 10:17:33 UTC
Table: 'Colorado' 6-max (real money) Seat #6 is the button
Seat 1: Anty-dot (2€)
Seat 2: guevarache (2.12€)
Seat 3: Fried Berg (1.33€)
Seat 4: Medoc94 (0.57€)
Seat 5: sharkaponk78 (2.21€)
Seat 6: Tompahmax (1.12€)
Hold-up to Pot: total 0.20€
*** ANTE/BLINDS ***
Anty-dot posts small blind 0.01€
guevarache posts big blind 0.02€
Dealt to Fried Berg [8s Ad]
*** PRE-FLOP *** 
Fried Berg raises 0.02€ to 0.04€
Medoc94 folds
sharkaponk78 folds
Tompahmax folds
Anty-dot folds
guevarache calls 0.02€
*** FLOP *** [9s 3c 2s]
guevarache checks
Fried Berg bets 0.12€
guevarache folds
Fried Berg collected 0.40€ from pot
*** SUMMARY ***
Total pot 0.40€ | Rake 0.01€
Board: [9s 3c 2s]
Seat 3: Fried Berg won 0.40€


Winamax Poker - HOLD-UP "Colorado" - HandId: #19116069-778374-1701771483 - Holdem no limit (0.01€/0.02€) - 2023/12/05 10:18:03 UTC
Table: 'Colorado' 6-max (real money) Seat #6 is the button
Seat 1: Jojo-andros5 (0.67€)
Seat 2: Marky Mark 9 (4.83€)
Seat 3: ThePryce (3.38€)
Seat 4: Fried Berg (1.57€)
Seat 5: Ga31k (2.14€)
Seat 6: Solda14 (1.97€)
*** ANTE/BLINDS ***
Jojo-andros5 posts small blind 0.01€
Marky Mark 9 posts big blind 0.02€
Dealt to Fried Berg [Kh 4s]
*** PRE-FLOP *** 
ThePryce folds
Fried Berg folds
Ga31k folds
Solda14 raises 0.04€ to 0.06€
Jojo-andros5 folds
Marky Mark 9 folds
Solda14 collected 0.09€ from pot
*** SUMMARY ***
Total pot 0.09€ | No rake
Seat 6: Solda14 (button) won 0.09€


Winamax Poker - HOLD-UP "Colorado" - HandId: #19116069-778378-1701771486 - Holdem no limit (0.01€/0.02€) - 2023/12/05 10:18:06 UTC
Table: 'Colorado' 6-max (real money) Seat #6 is the button
Seat 1: Fried Berg (1.57€)
Seat 2: sharkaponk78 (2.04€)
Seat 3: G0R0N11 (2.01€)
Seat 4: guevarache (3.38€)
Seat 5: Tompahmax (1.04€)
Seat 6: bananAsSplit (2.23€)
*** ANTE/BLINDS ***
Fried Berg posts small blind 0.01€
sharkaponk78 posts big blind 0.02€
Dealt to Fried Berg [7h Qc]
*** PRE-FLOP *** 
G0R0N11 folds
guevarache folds
Tompahmax folds
bananAsSplit raises 0.04€ to 0.06€
Fried Berg folds
sharkaponk78 raises 0.13€ to 0.19€
bananAsSplit folds
sharkaponk78 collected 0.26€ from pot
*** SUMMARY ***
Total pot 0.26€ | No rake
Seat 2: sharkaponk78 (big blind) won 0.26€


Winamax Poker - HOLD-UP "Colorado" - HandId: #19116069-778386-1701771496 - Holdem no limit (0.01€/0.02€) - 2023/12/05 10:18:16 UTC
Table: 'Colorado' 6-max (real money) Seat #6 is the button
Seat 1: Japut (2.66€)
Seat 2: _AKKA_ (1.47€)
Seat 3: Fried Berg (1.56€)
Seat 4: Beso1Dartich (1.40€)
Seat 5: Jojo-andros5 (0.66€)
Seat 6: slowreplay (2.06€)
*** ANTE/BLINDS ***
Japut posts small blind 0.01€
_AKKA_ posts big blind 0.02€
Dealt to Fried Berg [Th 8d]
*** PRE-FLOP *** 
Fried Berg folds
Beso1Dartich folds
Jojo-andros5 folds
slowreplay folds
Japut raises 0.03€ to 0.05€
_AKKA_ folds
Japut collected 0.07€ from pot
*** SUMMARY ***
Total pot 0.07€ | No rake
Seat 1: Japut (small blind) won 0.07€


Winamax Poker - HOLD-UP "Colorado" - HandId: #19116069-778390-1701771497 - Holdem no limit (0.01€/0.02€) - 2023/12/05 10:18:17 UTC
Table: 'Colorado' 6-max (real money) Seat #6 is the button
Seat 1: HOTGAME (3.60€)
Seat 2: Fried Berg (1.56€)
Seat 3: Jojo-andros5 (0.66€)
Seat 4: EA_Stinger (0.56€)
Seat 5: ThePryce (2.67€)
Seat 6: Marky Mark 9 (4.81€)
*** ANTE/BLINDS ***
HOTGAME posts small blind 0.01€
Fried Berg posts big blind 0.02€
Dealt to Fried Berg [2h Jc]
*** PRE-FLOP *** 
Jojo-andros5 folds
EA_Stinger folds
ThePryce folds
Marky Mark 9 raises 0.03€ to 0.05€
HOTGAME folds
Fried Berg folds
Marky Mark 9 collected 0.08€ from pot
*** SUMMARY ***
Total pot 0.08€ | No rake
Seat 6: Marky Mark 9 (button) won 0.08€


Winamax Poker - HOLD-UP "Colorado" - HandId: #19116069-778397-1701771502 - Holdem no limit (0.01€/0.02€) - 2023/12/05 10:18:22 UTC
Table: 'Colorado' 6-max (real money) Seat #6 is the button
Seat 1: livthe34 (2.85€)
Seat 2: slowreplay (2.06€)
Seat 3: trikar xx (3.43€)
Seat 4: Richard Reuk (5.88€)
Seat 5: ThePryce (2.67€)
Seat 6: Fried Berg (1.54€)
*** ANTE/BLINDS ***
livthe34 posts small blind 0.01€
slowreplay posts big blind 0.02€
Dealt to Fried Berg [8s 5d]
*** PRE-FLOP *** 
trikar xx folds
Richard Reuk folds
ThePryce folds
Fried Berg folds
livthe34 folds
slowreplay collected 0.03€ from pot
*** SUMMARY ***
Total pot 0.03€ | No rake
Seat 2: slowreplay (big blind) won 0.03€


Winamax Poker - HOLD-UP "Colorado" - HandId: #19116069-778400-1701771506 - Holdem no limit (0.01€/0.02€) - 2023/12/05 10:18:26 UTC
Table: 'Colorado' 6-max (real money) Seat #6 is the button
Seat 1: Sodam84 (2.02€)
Seat 2: grut28 (2.94€)
Seat 3: HOTGAME (3.59€)
Seat 4: trikar xx (3.43€)
Seat 5: duonrep (3.71€)
Seat 6: Fried Berg (1.54€)
*** ANTE/BLINDS ***
Sodam84 posts small blind 0.01€
grut28 posts big blind 0.02€
Dealt to Fried Berg [Qs 4d]
*** PRE-FLOP *** 
HOTGAME folds
trikar xx folds
duonrep folds
Fried Berg folds
Sodam84 raises 0.03€ to 0.05€
grut28 raises 2.89€ to 2.94€ and is all-in
Sodam84 folds
grut28 collected 2.99€ from pot
*** SUMMARY ***
Total pot 2.99€ | No rake
Seat 2: grut28 (big blind) won 2.99€


Winamax Poker - HOLD-UP "Colorado" - HandId: #19116069-778401-1701771508 - Holdem no limit (0.01€/0.02€) - 2023/12/05 10:18:28 UTC
Table: 'Colorado' 6-max (real money) Seat #6 is the button
Seat 1: nemo5 (2€)
Seat 2: Ga31k (2.14€)
Seat 3: ThePryce (3.36€)
Seat 4: Fried Berg (1.54€)
Seat 5: guevarache (3.38€)
Seat 6: Richard Reuk (5.88€)
*** ANTE/BLINDS ***
nemo5 posts small blind 0.01€
Ga31k posts big blind 0.02€
Dealt to Fried Berg [7s Kh]
*** PRE-FLOP *** 
ThePryce folds
Fried Berg folds
guevarache folds
Richard Reuk folds
nemo5 folds
Ga31k collected 0.03€ from pot
*** SUMMARY ***
Total pot 0.03€ | No rake
Seat 2: Ga31k (big blind) won 0.03€


Winamax Poker - HOLD-UP "Colorado" - HandId: #19116069-778408-1701771513 - Holdem no limit (0.01€/0.02€) - 2023/12/05 10:18:33 UTC
Table: 'Colorado' 6-max (real money) Seat #6 is the button
Seat 1: Fried Berg (1.54€)
Seat 2: MoneyGrowing (2.02€)
Seat 3: DeX70 (1.91€)
Seat 4: bahim9375 (0.34€)
Seat 5: P.BaIkany (4.97€)
Seat 6: dallo974 (1.94€)
*** ANTE/BLINDS ***
Fried Berg posts small blind 0.01€
MoneyGrowing posts big blind 0.02€
Dealt to Fried Berg [4s Jh]
*** PRE-FLOP *** 
DeX70 folds
bahim9375 folds
P.BaIkany folds
dallo974 folds
Fried Berg folds
MoneyGrowing collected 0.03€ from pot
*** SUMMARY ***
Total pot 0.03€ | No rake
Seat 2: MoneyGrowing (big blind) won 0.03€


Winamax Poker - HOLD-UP "Colorado" - HandId: #19116069-778413-1701771518 - Holdem no limit (0.01€/0.02€) - 2023/12/05 10:18:38 UTC
Table: 'Colorado' 6-max (real money) Seat #6 is the button
Seat 1: ThePryce (2.67€)
Seat 2: trikar xx (2.68€)
Seat 3: Fried Berg (1.53€)
Seat 4: Anty-dot (2.05€)
Seat 5: bananAsSplit (2.65€)
Seat 6: VanDolar (2.14€)
*** ANTE/BLINDS ***
ThePryce posts small blind 0.01€
trikar xx posts big blind 0.02€
Dealt to Fried Berg [5s 5h]
*** PRE-FLOP *** 
Fried Berg raises 0.02€ to 0.04€
Anty-dot folds
bananAsSplit folds
VanDolar folds
ThePryce calls 0.03€
trikar xx calls 0.02€
*** FLOP *** [6c Jc Qh]
ThePryce bets 0.06€
trikar xx calls 0.06€
Fried Berg folds
*** TURN *** [6c Jc Qh][3c]
ThePryce bets 0.18€
trikar xx folds
ThePryce collected 0.40€ from pot
*** SUMMARY ***
Total pot 0.40€ | Rake 0.02€
Board: [6c Jc Qh 3c]
Seat 1: ThePryce (small blind) won 0.40€


Winamax Poker - HOLD-UP "Colorado" - HandId: #19116069-778471-1701771570 - Holdem no limit (0.01€/0.02€) - 2023/12/05 10:19:30 UTC
Table: 'Colorado' 6-max (real money) Seat #6 is the button
Seat 1: Quenelles (2.88€)
Seat 2: HOTGAME (3.52€)
Seat 3: bananAsSplit (2.73€)
Seat 4: Anty-dot (2€)
Seat 5: Fried Berg (1.49€)
Seat 6: PIQSOU (3.41€)
*** ANTE/BLINDS ***
Quenelles posts small blind 0.01€
HOTGAME posts big blind 0.02€
Dealt to Fried Berg [Qd 8h]
*** PRE-FLOP *** 
bananAsSplit folds
Anty-dot folds
Fried Berg folds
PIQSOU folds
Quenelles folds
HOTGAME collected 0.03€ from pot
*** SUMMARY ***
Total pot 0.03€ | No rake
Seat 2: HOTGAME (big blind) won 0.03€


Winamax Poker - HOLD-UP "Colorado" - HandId: #19116069-778479-1701771576 - Holdem no limit (0.01€/0.02€) - 2023/12/05 10:19:36 UTC
Table: 'Colorado' 6-max (real money) Seat #6 is the button
Seat 1: trikar xx (2.07€)
Seat 2: Levanball18 (1.22€)
Seat 3: dallo974 (1.71€)
Seat 4: AdiTheKing (2.07€)
Seat 5: Fried Berg (1.49€)
Seat 6: -genzo- (3.12€)
*** ANTE/BLINDS ***
trikar xx posts small blind 0.01€
Levanball18 posts big blind 0.02€
Dealt to Fried Berg [Kd 2s]
*** PRE-FLOP *** 
dallo974 raises 0.02€ to 0.04€
AdiTheKing folds
Fried Berg folds
-genzo- folds
trikar xx folds
Levanball18 calls 0.02€
*** FLOP *** [Qc Tc Jc]
Levanball18 checks
dallo974 checks
*** TURN *** [Qc Tc Jc][8c]
Levanball18 checks
dallo974 checks
*** RIVER *** [Qc Tc Jc 8c][3d]
Levanball18 checks
dallo974 bets 1.45€
Levanball18 folds
dallo974 collected 1.53€ from pot
*** SUMMARY ***
Total pot 1.53€ | Rake 0.01€
Board: [Qc Tc Jc 8c 3d]
Seat 3: dallo974 won 1.53€


Winamax Poker - HOLD-UP "Colorado" - HandId: #19116069-778482-1701771578 - Holdem no limit (0.01€/0.02€) - 2023/12/05 10:19:38 UTC
Table: 'Colorado' 6-max (real money) Seat #6 is the button
Seat 1: Medoc94 (0.81€)
Seat 2: Fried Berg (1.49€)
Seat 3: P.BaIkany (4.86€)
Seat 4: slowreplay (2.88€)
Seat 5: Zard.Oz (3.45€)
Seat 6: nemo5 (2.08€)
*** ANTE/BLINDS ***
Medoc94 posts small blind 0.01€
Fried Berg posts big blind 0.02€
Dealt to Fried Berg [8s 3h]
*** PRE-FLOP *** 
P.BaIkany folds
slowreplay folds
Zard.Oz folds
nemo5 folds
Medoc94 folds
Fried Berg collected 0.03€ from pot
*** SUMMARY ***
Total pot 0.03€ | No rake
Seat 2: Fried Berg (big blind) won 0.03€


Winamax Poker - HOLD-UP "Colorado" - HandId: #19116069-778495-1701771588 - Holdem no limit (0.01€/0.02€) - 2023/12/05 10:19:48 UTC
Table: 'Colorado' 6-max (real money) Seat #6 is the button
Seat 1: S-aaron24 (2.06€)
Seat 2: papelitokbrn (2€)
Seat 3: Fried Berg (1.50€)
Seat 4: Ga31k (2.04€)
Seat 5: magnumbenji (0.95€)
Seat 6: ThePryce (3.34€)
*** ANTE/BLINDS ***
S-aaron24 posts small blind 0.01€
papelitokbrn posts big blind 0.02€
Dealt to Fried Berg [9c 2h]
*** PRE-FLOP *** 
Fried Berg folds
Ga31k folds
magnumbenji calls 0.02€
ThePryce calls 0.02€
S-aaron24 folds
papelitokbrn checks
*** FLOP *** [Qs As 4s]
papelitokbrn bets 0.07€
magnumbenji folds
ThePryce folds
papelitokbrn collected 0.13€ from pot
*** SUMMARY ***
Total pot 0.13€ | Rake 0.01€
Board: [Qs As 4s]
Seat 2: papelitokbrn (big blind) won 0.13€


Winamax Poker - HOLD-UP "Colorado" - HandId: #19116069-778497-1701771592 - Holdem no limit (0.01€/0.02€) - 2023/12/05 10:19:52 UTC
Table: 'Colorado' 6-max (real money) Seat #6 is the button
Seat 1: bananAsSplit (2.71€)
Seat 2: El tiki tiki (1.88€)
Seat 3: Richard Reuk (5.88€)
Seat 4: Ga31k (2.49€)
Seat 5: nemo5 (2€)
Seat 6: Fried Berg (1.50€)
*** ANTE/BLINDS ***
bananAsSplit posts small blind 0.01€
El tiki tiki posts big blind 0.02€
Dealt to Fried Berg [Ts 9d]
*** PRE-FLOP *** 
Richard Reuk folds
Ga31k folds
nemo5 folds
Fried Berg raises 0.02€ to 0.04€
bananAsSplit folds
El tiki tiki folds
Fried Berg collected 0.07€ from pot
*** SUMMARY ***
Total pot 0.07€ | No rake
Seat 6: Fried Berg (button) won 0.07€


Winamax Poker - HOLD-UP "Colorado" - HandId: #19116069-778517-1701771605 - Holdem no limit (0.01€/0.02€) - 2023/12/05 10:20:05 UTC
Table: 'Colorado' 6-max (real money) Seat #6 is the button
Seat 1: Quenelles (2.78€)
Seat 2: Fried Berg (1.53€)
Seat 3: MoneyGrowing (2.12€)
Seat 4: El tiki tiki (1.85€)
Seat 5: Anty-dot (2€)
Seat 6: Beso1Dartich (1.27€)
*** ANTE/BLINDS ***
Quenelles posts small blind 0.01€
Fried Berg posts big blind 0.02€
Dealt to Fried Berg [8d 2c]
*** PRE-FLOP *** 
MoneyGrowing folds
El tiki tiki folds
Anty-dot raises 0.03€ to 0.05€
Beso1Dartich calls 0.05€
Quenelles folds
Fried Berg folds
*** FLOP *** [7s Th 8c]
Anty-dot bets 0.05€
Beso1Dartich calls 0.05€
*** TURN *** [7s Th 8c][8s]
Anty-dot bets 0.15€
Beso1Dartich calls 0.15€
*** RIVER *** [7s Th 8c 8s][Js]
Anty-dot checks
Beso1Dartich bets 0.27€
Anty-dot calls 0.27€
*** SHOW DOWN ***
Anty-dot shows [Jc Ts] (Two pairs : Jacks and Tens)
Beso1Dartich shows [9d 9h] (Straight Jack high)
Beso1Dartich collected 0.96€ from pot
*** SUMMARY ***
Total pot 0.96€ | Rake 0.11€
Board: [7s Th 8c 8s Js]
Seat 5: Anty-dot showed [Jc Ts] and lost with Two pairs : Jacks and Tens
Seat 6: Beso1Dartich (button) showed [9d 9h] and won 0.96€ with Straight Jack high


Winamax Poker - HOLD-UP "Colorado" - HandId: #19116069-778523-1701771610 - Holdem no limit (0.01€/0.02€) - 2023/12/05 10:20:10 UTC
Table: 'Colorado' 6-max (real money) Seat #6 is the button
Seat 1: Fried Berg (1.51€)
Seat 2: Ga31k (2.03€)
Seat 3: Pierrof24 (3.16€)
Seat 4: PIQSOU (2.56€)
Seat 5: Jconde92 (1.90€)
Seat 6: kameleon73 (2€)
*** ANTE/BLINDS ***
Fried Berg posts small blind 0.01€
Ga31k posts big blind 0.02€
Dealt to Fried Berg [Jd Td]
*** PRE-FLOP *** 
Pierrof24 folds
PIQSOU folds
Jconde92 folds
kameleon73 folds
Fried Berg raises 0.02€ to 0.04€
Ga31k calls 0.02€
*** FLOP *** [8c Kc 7s]
Fried Berg bets 0.04€
Ga31k folds
Fried Berg collected 0.11€ from pot
*** SUMMARY ***
Total pot 0.11€ | Rake 0.01€
Board: [8c Kc 7s]
Seat 1: Fried Berg (small blind) won 0.11€


Winamax Poker - HOLD-UP "Colorado" - HandId: #19116069-778559-1701771635 - Holdem no limit (0.01€/0.02€) - 2023/12/05 10:20:35 UTC
Table: 'Colorado' 6-max (real money) Seat #6 is the button
Seat 1: Japut (2.72€)
Seat 2: mika9080 (2.78€)
Seat 3: prudence34 (2.24€)
Seat 4: Fried Berg (1.54€)
Seat 5: Sodam84 (2.24€)
Seat 6: RaseOnYou (6.33€)
*** ANTE/BLINDS ***
Japut posts small blind 0.01€
mika9080 posts big blind 0.02€
Dealt to Fried Berg [9h 6c]
*** PRE-FLOP *** 
prudence34 raises 0.04€ to 0.06€
Fried Berg folds
Sodam84 folds
RaseOnYou folds
Japut folds
mika9080 calls 0.04€
*** FLOP *** [As Qh 3s]
mika9080 checks
prudence34 bets 0.04€
mika9080 folds
prudence34 collected 0.16€ from pot
*** SUMMARY ***
Total pot 0.16€ | Rake 0.01€
Board: [As Qh 3s]
Seat 3: prudence34 won 0.16€


Winamax Poker - HOLD-UP "Colorado" - HandId: #19116069-778564-1701771638 - Holdem no limit (0.01€/0.02€) - 2023/12/05 10:20:38 UTC
Table: 'Colorado' 6-max (real money) Seat #6 is the button
Seat 1: OliwilO (1.98€)
Seat 2: Beso1Dartich (1.71€)
Seat 3: El tiki tiki (1.72€)
Seat 4: Anty-dot (2€)
Seat 5: Fried Berg (1.54€)
Seat 6: trikar xx (3.70€)
*** ANTE/BLINDS ***
OliwilO posts small blind 0.01€
Beso1Dartich posts big blind 0.02€
Dealt to Fried Berg [8s 8h]
*** PRE-FLOP *** 
El tiki tiki folds
Anty-dot raises 0.03€ to 0.05€
Fried Berg calls 0.05€
trikar xx folds
OliwilO folds
Beso1Dartich calls 0.03€
*** FLOP *** [9h 3h Qd]
Beso1Dartich bets 0.08€
Anty-dot calls 0.08€
Fried Berg folds
*** TURN *** [9h 3h Qd][As]
Beso1Dartich checks
Anty-dot bets 0.11€
Beso1Dartich folds
Anty-dot collected 0.40€ from pot
*** SUMMARY ***
Total pot 0.40€ | Rake 0.03€
Board: [9h 3h Qd As]
Seat 4: Anty-dot won 0.40€


Winamax Poker - HOLD-UP "Colorado" - HandId: #19116069-778607-1701771670 - Holdem no limit (0.01€/0.02€) - 2023/12/05 10:21:10 UTC
Table: 'Colorado' 6-max (real money) Seat #6 is the button
Seat 1: slowreplay (2.03€)
Seat 2: rick26 (2€)
Seat 3: MoneyGrowing (2.01€)
Seat 4: Fried Berg (1.49€)
Seat 5: bananAsSplit (2.24€)
Seat 6: El tiki tiki (1.72€)
*** ANTE/BLINDS ***
slowreplay posts small blind 0.01€
rick26 posts big blind 0.02€
Dealt to Fried Berg [9d Qs]
*** PRE-FLOP *** 
MoneyGrowing folds
Fried Berg folds
bananAsSplit raises 0.04€ to 0.06€
El tiki tiki calls 0.06€
slowreplay folds
rick26 folds
*** FLOP *** [7c 2d 9c]
bananAsSplit checks
El tiki tiki bets 0.10€
bananAsSplit folds
El tiki tiki collected 0.23€ from pot
*** SUMMARY ***
Total pot 0.23€ | Rake 0.02€
Board: [7c 2d 9c]
Seat 6: El tiki tiki (button) won 0.23€


Winamax Poker - HOLD-UP "Colorado" - HandId: #19116069-778612-1701771675 - Holdem no limit (0.01€/0.02€) - 2023/12/05 10:21:15 UTC
Table: 'Colorado' 6-max (real money) Seat #6 is the button
Seat 1: Fried Berg (1.49€)
Seat 2: Sodam84 (2.28€)
Seat 3: mika9080 (2.72€)
Seat 4: sacerx (2.23€)
Seat 5: MoneyGrowing (2.01€)
Seat 6: Beso1Dartich (1.57€)
*** ANTE/BLINDS ***
Fried Berg posts small blind 0.01€
Sodam84 posts big blind 0.02€
Dealt to Fried Berg [4s 5h]
*** PRE-FLOP *** 
mika9080 folds
sacerx raises 0.04€ to 0.06€
MoneyGrowing raises 0.12€ to 0.18€
Beso1Dartich calls 0.18€
Fried Berg folds
Sodam84 folds
sacerx raises 2.05€ to 2.23€ and is all-in
MoneyGrowing calls 1.83€ and is all-in
Beso1Dartich folds
*** FLOP *** [2c Qs 3h]
*** TURN *** [2c Qs 3h][9s]
*** RIVER *** [2c Qs 3h 9s][Tc]
*** SHOW DOWN ***
sacerx shows [Ah Kh] (High card : Ace)
MoneyGrowing shows [Ks Kd] (One pair : Kings)
MoneyGrowing collected 3.81€ from main pot
sacerx collected 0.22€ from side pot 1
*** SUMMARY ***
Total pot 4.03€ | Rake 0.42€
Board: [2c Qs 3h 9s Tc]
Seat 4: sacerx showed [Ah Kh] and won 0.22€ with High card : Ace
Seat 5: MoneyGrowing showed [Ks Kd] and won 3.81€ with One pair : Kings


Winamax Poker - HOLD-UP "Colorado" - HandId: #19116069-778615-1701771678 - Holdem no limit (0.01€/0.02€) - 2023/12/05 10:21:18 UTC
Table: 'Colorado' 6-max (real money) Seat #6 is the button
Seat 1: smpadrino (2€)
Seat 2: Fried Berg (1.48€)
Seat 3: -genzo- (3.03€)
Seat 4: prudence34 (2.30€)
Seat 5: S-aaron24 (2.15€)
Seat 6: Ga31k (2.19€)
*** ANTE/BLINDS ***
smpadrino posts small blind 0.01€
Fried Berg posts big blind 0.02€
Dealt to Fried Berg [4s 3s]
*** PRE-FLOP *** 
-genzo- folds
prudence34 folds
S-aaron24 folds
Ga31k raises 0.04€ to 0.06€
smpadrino folds
Fried Berg folds
Ga31k collected 0.09€ from pot
*** SUMMARY ***
Total pot 0.09€ | No rake
Seat 6: Ga31k (button) won 0.09€


Winamax Poker - HOLD-UP "Colorado" - HandId: #19116069-778631-1701771693 - Holdem no limit (0.01€/0.02€) - 2023/12/05 10:21:33 UTC
Table: 'Colorado' 6-max (real money) Seat #6 is the button
Seat 1: DeX70 (1.84€)
Seat 2: sharkaponk78 (2.18€)
Seat 3: Fried Berg (1.46€)
Seat 4: S-aaron24 (2.06€)
Seat 5: Levanball18 (1.09€)
Seat 6: trikar xx (3.64€)
*** ANTE/BLINDS ***
DeX70 posts small blind 0.01€
sharkaponk78 posts big blind 0.02€
Dealt to Fried Berg [3s 4s]
*** PRE-FLOP *** 
Fried Berg folds
S-aaron24 folds
Levanball18 folds
trikar xx folds
DeX70 raises 0.02€ to 0.04€
sharkaponk78 folds
DeX70 collected 0.06€ from pot
*** SUMMARY ***
Total pot 0.06€ | No rake
Seat 1: DeX70 (small blind) won 0.06€


Winamax Poker - HOLD-UP "Colorado" - HandId: #19116069-778636-1701771696 - Holdem no limit (0.01€/0.02€) - 2023/12/05 10:21:36 UTC
Table: 'Colorado' 6-max (real money) Seat #6 is the button
Seat 1: kameleon73 (2.18€)
Seat 2: Pierrof24 (2.15€)
Seat 3: S-aaron24 (2.06€)
Seat 4: Anty-dot (3.34€)
Seat 5: Fried Berg (1.46€)
Seat 6: nemo5 (2€)
*** ANTE/BLINDS ***
kameleon73 posts small blind 0.01€
Pierrof24 posts big blind 0.02€
Dealt to Fried Berg [Kc Tc]
*** PRE-FLOP *** 
S-aaron24 folds
Anty-dot raises 0.03€ to 0.05€
Fried Berg calls 0.05€
nemo5 folds
kameleon73 folds
Pierrof24 calls 0.03€
*** FLOP *** [4s 8c Qs]
Pierrof24 checks
Anty-dot checks
Fried Berg checks
*** TURN *** [4s 8c Qs][Qc]
Pierrof24 checks
Anty-dot checks
Fried Berg checks
*** RIVER *** [4s 8c Qs Qc][Jc]
Pierrof24 checks
Anty-dot checks
Fried Berg bets 0.08€
Pierrof24 folds
Anty-dot folds
Fried Berg collected 0.22€ from pot
*** SUMMARY ***
Total pot 0.22€ | Rake 0.02€
Board: [4s 8c Qs Qc Jc]
Seat 5: Fried Berg won 0.22€


Winamax Poker - HOLD-UP "Colorado" - HandId: #19116069-778702-1701771747 - Holdem no limit (0.01€/0.02€) - 2023/12/05 10:22:27 UTC
Table: 'Colorado' 6-max (real money) Seat #6 is the button
Seat 1: Fried Berg (1.55€)
Seat 2: mika9080 (1.22€)
Seat 3: P.BaIkany (4.22€)
Seat 4: trikar xx (2€)
Seat 5: wAAlterrr (2.22€)
Seat 6: nemo5 (2.17€)
*** ANTE/BLINDS ***
Fried Berg posts small blind 0.01€
mika9080 posts big blind 0.02€
Dealt to Fried Berg [4c Jc]
*** PRE-FLOP *** 
P.BaIkany folds
trikar xx folds
wAAlterrr folds
nemo5 folds
Fried Berg raises 0.02€ to 0.04€
mika9080 folds
Fried Berg collected 0.06€ from pot
*** SUMMARY ***
Total pot 0.06€ | No rake
Seat 1: Fried Berg (small blind) won 0.06€


Winamax Poker - HOLD-UP "Colorado" - HandId: #19116069-778725-1701771762 - Holdem no limit (0.01€/0.02€) - 2023/12/05 10:22:42 UTC
Table: 'Colorado' 6-max (real money) Seat #6 is the button
Seat 1: AdiTheKing (0.98€)
Seat 2: DeX70 (1.87€)
Seat 3: Jojo-andros5 (0.67€)
Seat 4: Fried Berg (1.57€)
Seat 5: Richard Reuk (3.95€)
Seat 6: S-aaron24 (2.03€)
*** ANTE/BLINDS ***
AdiTheKing posts small blind 0.01€
DeX70 posts big blind 0.02€
Dealt to Fried Berg [9h 8s]
*** PRE-FLOP *** 
Jojo-andros5 folds
Fried Berg folds
Richard Reuk folds
S-aaron24 folds
AdiTheKing calls 0.01€
DeX70 checks
*** FLOP *** [6s 8d 6d]
AdiTheKing checks
DeX70 checks
*** TURN *** [6s 8d 6d][8c]
AdiTheKing checks
DeX70 checks
*** RIVER *** [6s 8d 6d 8c][Jd]
AdiTheKing checks
DeX70 checks
*** SHOW DOWN ***
DeX70 shows [7h 4s] (Two pairs : 8 and 6)
AdiTheKing shows [2c Ah] (Two pairs : 8 and 6)
AdiTheKing collected 0.04€ from pot
*** SUMMARY ***
Total pot 0.04€ | No rake
Board: [6s 8d 6d 8c Jd]
Seat 1: AdiTheKing (small blind) showed [2c Ah] and won 0.04€ with Two pairs : 8 and 6
Seat 2: DeX70 (big blind) showed [7h 4s] and lost with Two pairs : 8 and 6


Winamax Poker - HOLD-UP "Colorado" - HandId: #19116069-778730-1701771765 - Holdem no limit (0.01€/0.02€) - 2023/12/05 10:22:45 UTC
Table: 'Colorado' 6-max (real money) Seat #6 is the button
Seat 1: magnumbenji (0.43€)
Seat 2: G0R0N11 (2€)
Seat 3: Fried Berg (1.57€)
Seat 4: Vl1204 (1.47€)
Seat 5: -genzo- (3€)
Seat 6: MoneyGrowing (2€)
*** ANTE/BLINDS ***
magnumbenji posts small blind 0.01€
G0R0N11 posts big blind 0.02€
Dealt to Fried Berg [5d 3c]
*** PRE-FLOP *** 
Fried Berg folds
Vl1204 raises 0.03€ to 0.05€
-genzo- folds
MoneyGrowing folds
magnumbenji folds
G0R0N11 calls 0.03€
*** FLOP *** [Th Kh 6d]
G0R0N11 checks
Vl1204 bets 0.07€
G0R0N11 folds
Vl1204 collected 0.17€ from pot
*** SUMMARY ***
Total pot 0.17€ | Rake 0.01€
Board: [Th Kh 6d]
Seat 4: Vl1204 won 0.17€


Winamax Poker - HOLD-UP "Colorado" - HandId: #19116069-778748-1701771778 - Holdem no limit (0.01€/0.02€) - 2023/12/05 10:22:58 UTC
Table: 'Colorado' 6-max (real money) Seat #6 is the button
Seat 1: sharkaponk78 (2€)
Seat 2: P.BaIkany (4.31€)
Seat 3: Quenelles (2.80€)
Seat 4: slowreplay (2.05€)
Seat 5: El tiki tiki (1.57€)
Seat 6: Fried Berg (1.57€)
*** ANTE/BLINDS ***
sharkaponk78 posts small blind 0.01€
P.BaIkany posts big blind 0.02€
Dealt to Fried Berg [Tc Ac]
*** PRE-FLOP *** 
Quenelles raises 0.03€ to 0.05€
slowreplay folds
El tiki tiki folds
Fried Berg calls 0.05€
sharkaponk78 folds
P.BaIkany folds
*** FLOP *** [9d 6c 2d]
Quenelles bets 0.08€
Fried Berg folds
Quenelles collected 0.20€ from pot
*** SUMMARY ***
Total pot 0.20€ | Rake 0.01€
Board: [9d 6c 2d]
Seat 3: Quenelles won 0.20€


Winamax Poker - HOLD-UP "Colorado" - HandId: #19116069-778780-1701771802 - Holdem no limit (0.01€/0.02€) - 2023/12/05 10:23:22 UTC
Table: 'Colorado' 6-max (real money) Seat #6 is the button
Seat 1: AdiTheKing (0.96€)
Seat 2: bahim9375 (0.38€)
Seat 3: sacerx (2.12€)
Seat 4: Dulcran (1.97€)
Seat 5: -genzo- (3.08€)
Seat 6: Fried Berg (1.52€)
*** ANTE/BLINDS ***
AdiTheKing posts small blind 0.01€
bahim9375 posts big blind 0.02€
Dealt to Fried Berg [8h 8d]
*** PRE-FLOP *** 
sacerx folds
Dulcran raises 0.03€ to 0.05€
-genzo- folds
Fried Berg raises 0.10€ to 0.15€
AdiTheKing folds
bahim9375 folds
Dulcran folds
Fried Berg collected 0.23€ from pot
*** SUMMARY ***
Total pot 0.23€ | No rake
Seat 6: Fried Berg (button) won 0.23€


Winamax Poker - HOLD-UP "Colorado" - HandId: #19116069-783391-1701775280 - Holdem no limit (0.01€/0.02€) - 2023/12/05 11:21:20 UTC
Table: 'Colorado' 6-max (real money) Seat #6 is the button
Seat 1: Arumakan (0.29€)
Seat 2: Fried Berg (0.50€)
Seat 3: DoctorBlack (3.85€)
Seat 4: Ertorko (3.24€)
Seat 5: Meg a lodon (0.50€)
Seat 6: Jesperord98 (2.74€)
*** ANTE/BLINDS ***
Arumakan posts small blind 0.01€
Fried Berg posts big blind 0.02€
Dealt to Fried Berg [Qh Ac]
*** PRE-FLOP *** 
DoctorBlack folds
Ertorko folds
Meg a lodon raises 0.03€ to 0.05€
Jesperord98 folds
Arumakan folds
Fried Berg calls 0.03€
*** FLOP *** [6d 4h 4c]
Fried Berg checks
Meg a lodon checks
*** TURN *** [6d 4h 4c][Kd]
Fried Berg bets 0.02€
Meg a lodon calls 0.02€
*** RIVER *** [6d 4h 4c Kd][5c]
Fried Berg checks
Meg a lodon checks
*** SHOW DOWN ***
Meg a lodon shows [Ad Tc] (One pair : 4)
Fried Berg shows [Qh Ac] (One pair : 4)
Fried Berg collected 0.13€ from pot
*** SUMMARY ***
Total pot 0.13€ | Rake 0.02€
Board: [6d 4h 4c Kd 5c]
Seat 2: Fried Berg (big blind) showed [Qh Ac] and won 0.13€ with One pair : 4
Seat 5: Meg a lodon showed [Ad Tc] and lost with One pair : 4


Winamax Poker - HOLD-UP "Colorado" - HandId: #19116069-783441-1701775314 - Holdem no limit (0.01€/0.02€) - 2023/12/05 11:21:54 UTC
Table: 'Colorado' 6-max (real money) Seat #6 is the button
Seat 1: Fried Berg (0.56€)
Seat 2: Thequeen1205 (2.63€)
Seat 3: Dulcran (2.60€)
Seat 4: Aggro Loser (3.43€)
Seat 5: Holiap (2€)
Seat 6: Meg a lodon (0.43€)
*** ANTE/BLINDS ***
Fried Berg posts small blind 0.01€
Thequeen1205 posts big blind 0.02€
Dealt to Fried Berg [2h Th]
*** PRE-FLOP *** 
Dulcran folds
Aggro Loser folds
Holiap folds
Meg a lodon raises 0.03€ to 0.05€
Fried Berg folds
Thequeen1205 folds
Meg a lodon collected 0.08€ from pot
*** SUMMARY ***
Total pot 0.08€ | No rake
Seat 6: Meg a lodon (button) won 0.08€


Winamax Poker - HOLD-UP "Colorado" - HandId: #19116069-783517-1701775366 - Holdem no limit (0.01€/0.02€) - 2023/12/05 11:22:46 UTC
Table: 'Colorado' 6-max (real money) Seat #6 is the button
Seat 1: VanDolar (2.01€)
Seat 2: Dulcran (6.71€)
Seat 3: Fried Berg (0.55€)
Seat 4: Elou84 (1.28€)
Seat 5: Thequeen1205 (2€)
Seat 6: MrFlash9 (2.01€)
*** ANTE/BLINDS ***
VanDolar posts small blind 0.01€
Dulcran posts big blind 0.02€
Dealt to Fried Berg [6h 7c]
*** PRE-FLOP *** 
Fried Berg folds
Elou84 folds
Thequeen1205 folds
MrFlash9 raises 0.03€ to 0.05€
VanDolar folds
Dulcran calls 0.03€
*** FLOP *** [4s Tc 6d]
Dulcran checks
MrFlash9 checks
*** TURN *** [4s Tc 6d][2h]
Dulcran checks
MrFlash9 checks
*** RIVER *** [4s Tc 6d 2h][Kh]
Dulcran bets 0.09€
MrFlash9 folds
Dulcran collected 0.19€ from pot
*** SUMMARY ***
Total pot 0.19€ | Rake 0.01€
Board: [4s Tc 6d 2h Kh]
Seat 2: Dulcran (big blind) won 0.19€


Winamax Poker - HOLD-UP "Colorado" - HandId: #19116069-783533-1701775378 - Holdem no limit (0.01€/0.02€) - 2023/12/05 11:22:58 UTC
Table: 'Colorado' 6-max (real money) Seat #6 is the button
Seat 1: Richard Reuk (2.03€)
Seat 2: Kette624 (0.21€)
Seat 3: AlexxTorres (1.33€)
Seat 4: Fried Berg (0.55€)
Seat 5: smpadrino (3.98€)
Seat 6: Raggamin (2.21€)
*** ANTE/BLINDS ***
Richard Reuk posts small blind 0.01€
Kette624 posts big blind 0.02€
Dealt to Fried Berg [8h 4d]
*** PRE-FLOP *** 
AlexxTorres folds
Fried Berg folds
smpadrino folds
Raggamin raises 0.03€ to 0.05€
Richard Reuk calls 0.04€
Kette624 folds
*** FLOP *** [Jd Js Tc]
Richard Reuk checks
Raggamin bets 0.06€
Richard Reuk calls 0.06€
*** TURN *** [Jd Js Tc][Jh]
Richard Reuk checks
Raggamin checks
*** RIVER *** [Jd Js Tc Jh][Qc]
Richard Reuk bets 0.16€
Raggamin raises 0.28€ to 0.44€
Richard Reuk calls 0.28€
*** SHOW DOWN ***
Richard Reuk shows [Td Th] (Full of Jacks and Tens)
Raggamin shows [Qs Jc] (Quads of Jacks)
Raggamin collected 1.01€ from pot
*** SUMMARY ***
Total pot 1.01€ | Rake 0.11€
Board: [Jd Js Tc Jh Qc]
Seat 1: Richard Reuk (small blind) showed [Td Th] and lost with Full of Jacks and Tens
Seat 6: Raggamin (button) showed [Qs Jc] and won 1.01€ with Quads of Jacks


Winamax Poker - HOLD-UP "Colorado" - HandId: #19116069-783557-1701775392 - Holdem no limit (0.01€/0.02€) - 2023/12/05 11:23:12 UTC
Table: 'Colorado' 6-max (real money) Seat #6 is the button
Seat 1: Brants 95 (2.37€)
Seat 2: Thequeen1205 (2.03€)
Seat 3: El tiki tiki (2.51€)
Seat 4: D_A_R_K_ (2.04€)
Seat 5: Fried Berg (0.55€)
Seat 6: PseudoFC (2€)
*** ANTE/BLINDS ***
Brants 95 posts small blind 0.01€
Thequeen1205 posts big blind 0.02€
Dealt to Fried Berg [7s 2c]
*** PRE-FLOP *** 
El tiki tiki raises 0.02€ to 0.04€
D_A_R_K_ folds
Fried Berg folds
PseudoFC calls 0.04€
Brants 95 folds
Thequeen1205 folds
*** FLOP *** [4c 9c Td]
El tiki tiki bets 0.04€
PseudoFC calls 0.04€
*** TURN *** [4c 9c Td][Qh]
El tiki tiki checks
PseudoFC bets 0.07€
El tiki tiki calls 0.07€
*** RIVER *** [4c 9c Td Qh][6h]
El tiki tiki checks
PseudoFC bets 1.85€ and is all-in
El tiki tiki folds
PseudoFC collected 2.15€ from pot
*** SUMMARY ***
Total pot 2.15€ | Rake 0.03€
Board: [4c 9c Td Qh 6h]
Seat 6: PseudoFC (button) won 2.15€


Winamax Poker - HOLD-UP "Colorado" - HandId: #19116069-783572-1701775404 - Holdem no limit (0.01€/0.02€) - 2023/12/05 11:23:24 UTC
Table: 'Colorado' 6-max (real money) Seat #6 is the button
Seat 1: smpadrino (3.98€)
Seat 2: G0R0N11 (2€)
Seat 3: Brants 95 (0.91€)
Seat 4: pablo69400 (2.23€)
Seat 5: Davidoo36 (1.29€)
Seat 6: Fried Berg (0.55€)
*** ANTE/BLINDS ***
smpadrino posts small blind 0.01€
G0R0N11 posts big blind 0.02€
Dealt to Fried Berg [7s 8c]
*** PRE-FLOP *** 
Brants 95 folds
pablo69400 folds
Davidoo36 folds
Fried Berg folds
smpadrino calls 0.01€
G0R0N11 raises 0.06€ to 0.08€
smpadrino folds
G0R0N11 collected 0.10€ from pot
*** SUMMARY ***
Total pot 0.10€ | No rake
Seat 2: G0R0N11 (big blind) won 0.10€


Winamax Poker - HOLD-UP "Colorado" - HandId: #19116069-783590-1701775417 - Holdem no limit (0.01€/0.02€) - 2023/12/05 11:23:37 UTC
Table: 'Colorado' 6-max (real money) Seat #6 is the button
Seat 1: Willcv (1.95€)
Seat 2: Fried Berg (0.55€)
Seat 3: KON-2-PEUTE (2.39€)
Seat 4: Dilori (7.55€)
Seat 5: Thequeen1205 (2.42€)
Seat 6: Delmore (5.13€)
*** ANTE/BLINDS ***
Willcv posts small blind 0.01€
Fried Berg posts big blind 0.02€
Dealt to Fried Berg [4c Ad]
*** PRE-FLOP *** 
KON-2-PEUTE raises 0.03€ to 0.05€
Dilori folds
Thequeen1205 folds
Delmore folds
Willcv calls 0.04€
Fried Berg folds
*** FLOP *** [3d 3h 6h]
Willcv checks
KON-2-PEUTE bets 0.04€
Willcv folds
KON-2-PEUTE collected 0.15€ from pot
*** SUMMARY ***
Total pot 0.15€ | Rake 0.01€
Board: [3d 3h 6h]
Seat 3: KON-2-PEUTE won 0.15€


Winamax Poker - HOLD-UP "Colorado" - HandId: #19116069-783598-1701775423 - Holdem no limit (0.01€/0.02€) - 2023/12/05 11:23:43 UTC
Table: 'Colorado' 6-max (real money) Seat #6 is the button
Seat 1: Fried Berg (0.53€)
Seat 2: Davidoo36 (1.28€)
Seat 3: Delmore (5.11€)
Seat 4: Arumakan (0.25€)
Seat 5: Beriaimo (0.66€)
Seat 6: Dulcran (6.76€)
*** ANTE/BLINDS ***
Fried Berg posts small blind 0.01€
Davidoo36 posts big blind 0.02€
Dealt to Fried Berg [7c 4h]
*** PRE-FLOP *** 
Delmore folds
Arumakan folds
Beriaimo folds
Dulcran folds
Fried Berg folds
Davidoo36 collected 0.03€ from pot
*** SUMMARY ***
Total pot 0.03€ | No rake
Seat 2: Davidoo36 (big blind) won 0.03€


Winamax Poker - HOLD-UP "Colorado" - HandId: #19116069-783603-1701775426 - Holdem no limit (0.01€/0.02€) - 2023/12/05 11:23:46 UTC
Table: 'Colorado' 6-max (real money) Seat #6 is the button
Seat 1: Brants 95 (2.33€)
Seat 2: VanDolar (2.25€)
Seat 3: Fried Berg (0.52€)
Seat 4: Holiap (2.50€)
Seat 5: Pocho7 (1.84€)
Seat 6: MrFlash9 (8.43€)
*** ANTE/BLINDS ***
Brants 95 posts small blind 0.01€
VanDolar posts big blind 0.02€
Dealt to Fried Berg [Th 4d]
*** PRE-FLOP *** 
Fried Berg folds
Holiap folds
Pocho7 folds
MrFlash9 raises 0.03€ to 0.05€
Brants 95 folds
VanDolar folds
MrFlash9 collected 0.08€ from pot
*** SUMMARY ***
Total pot 0.08€ | No rake
Seat 6: MrFlash9 (button) won 0.08€


Winamax Poker - HOLD-UP "Colorado" - HandId: #19116069-783605-1701775427 - Holdem no limit (0.01€/0.02€) - 2023/12/05 11:23:47 UTC
Table: 'Colorado' 6-max (real money) Seat #6 is the button
Seat 1: Dulcran (6.76€)
Seat 2: Pierrof24 (1.46€)
Seat 3: Fripon_77201 (2.27€)
Seat 4: Fried Berg (0.52€)
Seat 5: Joan009 (2.11€)
Seat 6: eflower94 (2.07€)
*** ANTE/BLINDS ***
Dulcran posts small blind 0.01€
Pierrof24 posts big blind 0.02€
Dealt to Fried Berg [8s 7d]
*** PRE-FLOP *** 
Fripon_77201 folds
Fried Berg folds
Joan009 folds
eflower94 folds
Dulcran raises 0.03€ to 0.05€
Pierrof24 folds
Dulcran collected 0.07€ from pot
*** SUMMARY ***
Total pot 0.07€ | No rake
Seat 1: Dulcran (small blind) won 0.07€


Winamax Poker - HOLD-UP "Colorado" - HandId: #19116069-783613-1701775432 - Holdem no limit (0.01€/0.02€) - 2023/12/05 11:23:52 UTC
Table: 'Colorado' 6-max (real money) Seat #6 is the button
Seat 1: Fripon_77201 (3.51€)
Seat 2: VienMonCorbo (2.36€)
Seat 3: Holiap (3.74€)
Seat 4: Ga31k (2.03€)
Seat 5: Fried Berg (0.52€)
Seat 6: ByMatix (4.43€)
*** ANTE/BLINDS ***
Fripon_77201 posts small blind 0.01€
VienMonCorbo posts big blind 0.02€
Dealt to Fried Berg [6h 2h]
*** PRE-FLOP *** 
Holiap folds
Ga31k folds
Fried Berg folds
ByMatix raises 0.05€ to 0.07€
Fripon_77201 raises 0.16€ to 0.23€
VienMonCorbo folds
ByMatix calls 0.16€
*** FLOP *** [9s 9c 7d]
Fripon_77201 bets 0.31€
ByMatix raises 3.89€ to 4.20€ and is all-in
Fripon_77201 calls 2.97€ and is all-in
*** TURN *** [9s 9c 7d][Td]
*** RIVER *** [9s 9c 7d Td][4d]
*** SHOW DOWN ***
Fripon_77201 shows [Jc Js] (Two pairs : Jacks and 9)
ByMatix shows [Tc Ac] (Two pairs : Tens and 9)
ByMatix collected 0.92€ from side pot 1
Fripon_77201 collected 6.34€ from main pot
*** SUMMARY ***
Total pot 7.26€ | Rake 0.70€
Board: [9s 9c 7d Td 4d]
Seat 1: Fripon_77201 (small blind) showed [Jc Js] and won 6.34€ with Two pairs : Jacks and 9
Seat 6: ByMatix (button) showed [Tc Ac] and won 0.92€ with Two pairs : Tens and 9


Winamax Poker - HOLD-UP "Colorado" - HandId: #19116069-783630-1701775442 - Holdem no limit (0.01€/0.02€) - 2023/12/05 11:24:02 UTC
Table: 'Colorado' 6-max (real money) Seat #6 is the button
Seat 1: Thequeen1205 (2.39€)
Seat 2: MrFlash9 (8.45€)
Seat 3: Joan009 (2€)
Seat 4: PseudoFC (2.15€)
Seat 5: Chanclaveloz (2.80€)
Seat 6: Fried Berg (0.52€)
*** ANTE/BLINDS ***
Thequeen1205 posts small blind 0.01€
MrFlash9 posts big blind 0.02€
Dealt to Fried Berg [Kc Ks]
*** PRE-FLOP *** 
Joan009 raises 0.03€ to 0.05€
PseudoFC folds
Chanclaveloz folds
Fried Berg raises 0.10€ to 0.15€
Thequeen1205 folds
MrFlash9 folds
Joan009 folds
Fried Berg collected 0.23€ from pot
*** SUMMARY ***
Total pot 0.23€ | No rake
Seat 6: Fried Berg (button) won 0.23€


Winamax Poker - HOLD-UP "Colorado" - HandId: #19116069-783673-1701775467 - Holdem no limit (0.01€/0.02€) - 2023/12/05 11:24:27 UTC
Table: 'Colorado' 6-max (real money) Seat #6 is the button
Seat 1: Fripon_77201 (2.95€)
Seat 2: Ga31k (2€)
Seat 3: Thequeen1205 (2.37€)
Seat 4: Ertorko (2€)
Seat 5: Fried Berg (0.60€)
Seat 6: antoniusivey (2.51€)
*** ANTE/BLINDS ***
Fripon_77201 posts small blind 0.01€
Ga31k posts big blind 0.02€
Dealt to Fried Berg [9d 3c]
*** PRE-FLOP *** 
Thequeen1205 folds
Ertorko raises 0.03€ to 0.05€
Fried Berg folds
antoniusivey calls 0.05€
Fripon_77201 folds
Ga31k raises 0.21€ to 0.26€
Ertorko folds
antoniusivey calls 0.21€
*** FLOP *** [8d 6d 8c]
Ga31k checks
antoniusivey checks
*** TURN *** [8d 6d 8c][2h]
Ga31k checks
antoniusivey checks
*** RIVER *** [8d 6d 8c 2h][Jd]
Ga31k checks
antoniusivey bets 0.14€
Ga31k folds
antoniusivey collected 0.66€ from pot
*** SUMMARY ***
Total pot 0.66€ | Rake 0.06€
Board: [8d 6d 8c 2h Jd]
Seat 6: antoniusivey (button) won 0.66€


Winamax Poker - HOLD-UP "Colorado" - HandId: #19116069-783680-1701775474 - Holdem no limit (0.01€/0.02€) - 2023/12/05 11:24:34 UTC
Table: 'Colorado' 6-max (real money) Seat #6 is the button
Seat 1: MrFlash9 (2€)
Seat 2: Fried Berg (0.60€)
Seat 3: Jimbiosis (3.06€)
Seat 4: Quenelles (2.23€)
Seat 5: Joan009 (2€)
Seat 6: Chanclaveloz (2.10€)
*** ANTE/BLINDS ***
MrFlash9 posts small blind 0.01€
Fried Berg posts big blind 0.02€
Dealt to Fried Berg [6s 2s]
*** PRE-FLOP *** 
Jimbiosis folds
Quenelles folds
Joan009 folds
Chanclaveloz folds
MrFlash9 raises 0.04€ to 0.06€
Fried Berg folds
MrFlash9 collected 0.08€ from pot
*** SUMMARY ***
Total pot 0.08€ | No rake
Seat 1: MrFlash9 (small blind) won 0.08€


Winamax Poker - HOLD-UP "Colorado" - HandId: #19116069-783695-1701775486 - Holdem no limit (0.01€/0.02€) - 2023/12/05 11:24:46 UTC
Table: 'Colorado' 6-max (real money) Seat #6 is the button
Seat 1: Joan009 (2.08€)
Seat 2: sandrine1983 (0.79€)
Seat 3: Fried Berg (0.58€)
Seat 4: Brants 95 (2.29€)
Seat 5: Le_zigauto (4.84€)
Seat 6: Ertorko (2€)
*** ANTE/BLINDS ***
Joan009 posts small blind 0.01€
sandrine1983 posts big blind 0.02€
Dealt to Fried Berg [Kd 7s]
*** PRE-FLOP *** 
Fried Berg folds
Brants 95 raises 2.27€ to 2.29€ and is all-in
Le_zigauto folds
Ertorko folds
Joan009 folds
sandrine1983 folds
Brants 95 collected 2.32€ from pot
*** SUMMARY ***
Total pot 2.32€ | No rake
Seat 4: Brants 95 won 2.32€


Winamax Poker - HOLD-UP "Colorado" - HandId: #19116069-783711-1701775495 - Holdem no limit (0.01€/0.02€) - 2023/12/05 11:24:55 UTC
Table: 'Colorado' 6-max (real money) Seat #6 is the button
Seat 1: Fried Berg (0.58€)
Seat 2: KON-2-PEUTE (2€)
Seat 3: Raggamin (3.63€)
Seat 4: Tofini (2€)
Seat 5: Richard Reuk (2.48€)
Seat 6: Dilori (7.76€)
*** ANTE/BLINDS ***
Fried Berg posts small blind 0.01€
KON-2-PEUTE posts big blind 0.02€
Dealt to Fried Berg [8h Qh]
*** PRE-FLOP *** 
Raggamin folds
Tofini folds
Richard Reuk raises 0.03€ to 0.05€
Dilori folds
Fried Berg calls 0.04€
KON-2-PEUTE calls 0.03€
*** FLOP *** [2d Kc 8s]
Fried Berg checks
KON-2-PEUTE checks
Richard Reuk bets 0.10€
Fried Berg folds
KON-2-PEUTE folds
Richard Reuk collected 0.23€ from pot
*** SUMMARY ***
Total pot 0.23€ | Rake 0.02€
Board: [2d Kc 8s]
Seat 5: Richard Reuk won 0.23€


Winamax Poker - HOLD-UP "Colorado" - HandId: #19116069-783803-1701775550 - Holdem no limit (0.01€/0.02€) - 2023/12/05 11:25:50 UTC
Table: 'Colorado' 6-max (real money) Seat #6 is the button
Seat 1: smpadrino (2.01€)
Seat 2: PseudoFC (2.32€)
Seat 3: Le_zigauto (1.39€)
Seat 4: Fried Berg (0.53€)
Seat 5: pablo69400 (1.83€)
Seat 6: Tofini (2€)
*** ANTE/BLINDS ***
smpadrino posts small blind 0.01€
PseudoFC posts big blind 0.02€
Dealt to Fried Berg [Jc 3s]
*** PRE-FLOP *** 
Le_zigauto folds
Fried Berg folds
pablo69400 folds
Tofini folds
smpadrino folds
PseudoFC collected 0.03€ from pot
*** SUMMARY ***
Total pot 0.03€ | No rake
Seat 2: PseudoFC (big blind) won 0.03€


Winamax Poker - HOLD-UP "Colorado" - HandId: #19116069-783825-1701775562 - Holdem no limit (0.01€/0.02€) - 2023/12/05 11:26:02 UTC
Table: 'Colorado' 6-max (real money) Seat #6 is the button
Seat 1: Richard Reuk (2.54€)
Seat 2: Chanclaveloz (2.79€)
Seat 3: smpadrino (2€)
Seat 4: Thequeen1205 (3.41€)
Seat 5: Jesperord98 (2.58€)
Seat 6: Fried Berg (0.53€)
*** ANTE/BLINDS ***
Richard Reuk posts small blind 0.01€
Chanclaveloz posts big blind 0.02€
Dealt to Fried Berg [Qd Kh]
*** PRE-FLOP *** 
smpadrino folds
Thequeen1205 raises 0.03€ to 0.05€
Jesperord98 folds
Fried Berg calls 0.05€
Richard Reuk folds
Chanclaveloz calls 0.03€
*** FLOP *** [Td 6s 4c]
Chanclaveloz checks
Thequeen1205 checks
Fried Berg checks
*** TURN *** [Td 6s 4c][Ks]
Chanclaveloz bets 0.06€
Thequeen1205 calls 0.06€
Fried Berg calls 0.06€
*** RIVER *** [Td 6s 4c Ks][4s]
Chanclaveloz checks
Thequeen1205 checks
Fried Berg checks
*** SHOW DOWN ***
Chanclaveloz shows [Kd 7d] (Two pairs : Kings and 4)
Thequeen1205 shows [Ac Qh] (One pair : 4)
Fried Berg shows [Qd Kh] (Two pairs : Kings and 4)
Fried Berg collected 0.31€ from pot
*** SUMMARY ***
Total pot 0.31€ | Rake 0.03€
Board: [Td 6s 4c Ks 4s]
Seat 2: Chanclaveloz (big blind) showed [Kd 7d] and lost with Two pairs : Kings and 4
Seat 4: Thequeen1205 showed [Ac Qh] and lost with One pair : 4
Seat 6: Fried Berg (button) showed [Qd Kh] and won 0.31€ with Two pairs : Kings and 4


Winamax Poker - HOLD-UP "Colorado" - HandId: #19116069-783940-1701775631 - Holdem no limit (0.01€/0.02€) - 2023/12/05 11:27:11 UTC
Table: 'Colorado' 6-max (real money) Seat #6 is the button
Seat 1: Brants 95 (2.54€)
Seat 2: sandrine1983 (0.90€)
Seat 3: Chanclaveloz (2.68€)
Seat 4: Fried Berg (0.73€)
Seat 5: Thequeen1205 (3.30€)
Seat 6: Un_brochet (1.94€)
*** ANTE/BLINDS ***
Brants 95 posts small blind 0.01€
sandrine1983 posts big blind 0.02€
Dealt to Fried Berg [Ks Kh]
*** PRE-FLOP *** 
Chanclaveloz folds
Fried Berg raises 0.02€ to 0.04€
Thequeen1205 calls 0.04€
Un_brochet folds
Brants 95 folds
sandrine1983 folds
*** FLOP *** [3h Kc Jc]
Fried Berg bets 0.08€
Thequeen1205 calls 0.08€
*** TURN *** [3h Kc Jc][8d]
Fried Berg bets 0.16€
Thequeen1205 calls 0.16€
*** RIVER *** [3h Kc Jc 8d][Qs]
Fried Berg checks
Thequeen1205 checks
*** SHOW DOWN ***
Thequeen1205 shows [Ah Jh] (One pair : Jacks)
Fried Berg shows [Ks Kh] (Trips of Kings)
Fried Berg collected 0.53€ from pot
*** SUMMARY ***
Total pot 0.53€ | Rake 0.06€
Board: [3h Kc Jc 8d Qs]
Seat 4: Fried Berg showed [Ks Kh] and won 0.53€ with Trips of Kings
Seat 5: Thequeen1205 showed [Ah Jh] and lost with One pair : Jacks


Winamax Poker - HOLD-UP "Colorado" - HandId: #19116069-784006-1701775672 - Holdem no limit (0.01€/0.02€) - 2023/12/05 11:27:52 UTC
Table: 'Colorado' 6-max (real money) Seat #6 is the button
Seat 1: LM231620 (0.48€)
Seat 2: Fried Berg (0.98€)
Seat 3: JissEl1te (3.16€)
Seat 4: Niizumax (3.58€)
Seat 5: Thequeen1205 (3.02€)
Seat 6: D_A_R_K_ (2€)
*** ANTE/BLINDS ***
LM231620 posts small blind 0.01€
Fried Berg posts big blind 0.02€
Dealt to Fried Berg [Ks 9c]
*** PRE-FLOP *** 
JissEl1te raises 0.03€ to 0.05€
Niizumax raises 0.13€ to 0.18€
Thequeen1205 folds
D_A_R_K_ folds
LM231620 folds
Fried Berg folds
JissEl1te calls 0.13€
*** FLOP *** [Th Qh Kd]
JissEl1te checks
Niizumax bets 0.14€
JissEl1te folds
Niizumax collected 0.49€ from pot
*** SUMMARY ***
Total pot 0.49€ | Rake 0.04€
Board: [Th Qh Kd]
Seat 4: Niizumax won 0.49€


Winamax Poker - HOLD-UP "Colorado" - HandId: #19116069-784059-1701775701 - Holdem no limit (0.01€/0.02€) - 2023/12/05 11:28:21 UTC
Table: 'Colorado' 6-max (real money) Seat #6 is the button
Seat 1: Fried Berg (0.96€)
Seat 2: AlexxTorres (1.95€)
Seat 3: Ga31k (2.02€)
Seat 4: JJ Cat2198 (0.36€)
Seat 5: Yanmya33 (1.03€)
Seat 6: Richard Reuk (4.18€)
*** ANTE/BLINDS ***
Fried Berg posts small blind 0.01€
AlexxTorres posts big blind 0.02€
Dealt to Fried Berg [Js Qc]
*** PRE-FLOP *** 
Ga31k folds
JJ Cat2198 folds
Yanmya33 folds
Richard Reuk folds
Fried Berg raises 0.02€ to 0.04€
AlexxTorres folds
Fried Berg collected 0.06€ from pot
*** SUMMARY ***
Total pot 0.06€ | No rake
Seat 1: Fried Berg (small blind) won 0.06€


Winamax Poker - HOLD-UP "Colorado" - HandId: #19116069-784082-1701775713 - Holdem no limit (0.01€/0.02€) - 2023/12/05 11:28:33 UTC
Table: 'Colorado' 6-max (real money) Seat #6 is the button
Seat 1: Br3izh_P0k3r (2.03€)
Seat 2: Joan009 (2.19€)
Seat 3: Fried Berg (0.98€)
Seat 4: Raggamin (2€)
Seat 5: Tofini (2€)
Seat 6: AlexxTorres (1.22€)
*** ANTE/BLINDS ***
Br3izh_P0k3r posts small blind 0.01€
Joan009 posts big blind 0.02€
Dealt to Fried Berg [Ah 9h]
*** PRE-FLOP *** 
Fried Berg raises 0.02€ to 0.04€
Raggamin folds
Tofini folds
AlexxTorres folds
Br3izh_P0k3r folds
Joan009 calls 0.02€
*** FLOP *** [8c 8d 4d]
Joan009 checks
Fried Berg checks
*** TURN *** [8c 8d 4d][Ts]
Joan009 checks
Fried Berg checks
*** RIVER *** [8c 8d 4d Ts][7s]
Joan009 checks
Fried Berg checks
*** SHOW DOWN ***
Fried Berg shows [Ah 9h] (One pair : 8)
Joan009 shows [Jd Td] (Two pairs : Tens and 8)
Joan009 collected 0.08€ from pot
*** SUMMARY ***
Total pot 0.08€ | Rake 0.01€
Board: [8c 8d 4d Ts 7s]
Seat 2: Joan009 (big blind) showed [Jd Td] and won 0.08€ with Two pairs : Tens and 8
Seat 3: Fried Berg showed [Ah 9h] and lost with One pair : 8


Winamax Poker - HOLD-UP "Colorado" - HandId: #19116069-784155-1701775759 - Holdem no limit (0.01€/0.02€) - 2023/12/05 11:29:19 UTC
Table: 'Colorado' 6-max (real money) Seat #6 is the button
Seat 1: Brants 95 (0.68€)
Seat 2: AMBM2729 (1.20€)
Seat 3: DaniRama (2.02€)
Seat 4: Joan009 (2.23€)
Seat 5: Fried Berg (0.94€)
Seat 6: Tofini (2€)
*** ANTE/BLINDS ***
Brants 95 posts small blind 0.01€
AMBM2729 posts big blind 0.02€
Dealt to Fried Berg [6h 7c]
*** PRE-FLOP *** 
DaniRama folds
Joan009 folds
Fried Berg folds
Tofini folds
Brants 95 folds
AMBM2729 collected 0.03€ from pot
*** SUMMARY ***
Total pot 0.03€ | No rake
Seat 2: AMBM2729 (big blind) won 0.03€


Winamax Poker - HOLD-UP "Colorado" - HandId: #19116069-784171-1701775768 - Holdem no limit (0.01€/0.02€) - 2023/12/05 11:29:28 UTC
Table: 'Colorado' 6-max (real money) Seat #6 is the button
Seat 1: Pocho7 (1.42€)
Seat 2: Un_brochet (2.18€)
Seat 3: Delmore (5.48€)
Seat 4: Fried Berg (0.94€)
Seat 5: popoche29 (2.04€)
Seat 6: DaniRama (2.16€)
*** ANTE/BLINDS ***
Pocho7 posts small blind 0.01€
Un_brochet posts big blind 0.02€
Dealt to Fried Berg [5c 9h]
*** PRE-FLOP *** 
Delmore folds
Fried Berg folds
popoche29 raises 0.02€ to 0.04€
DaniRama folds
Pocho7 raises 1.38€ to 1.42€ and is all-in
Un_brochet folds
popoche29 folds
Pocho7 collected 1.48€ from pot
*** SUMMARY ***
Total pot 1.48€ | No rake
Seat 1: Pocho7 (small blind) won 1.48€


Winamax Poker - HOLD-UP "Colorado" - HandId: #19116069-784177-1701775771 - Holdem no limit (0.01€/0.02€) - 2023/12/05 11:29:31 UTC
Table: 'Colorado' 6-max (real money) Seat #6 is the button
Seat 1: JJ Cat2198 (0.30€)
Seat 2: Beretta56 (2.71€)
Seat 3: AMBM2729 (1.21€)
Seat 4: Donky Shot (2.55€)
Seat 5: Fried Berg (0.94€)
Seat 6: JissEl1te (2.92€)
*** ANTE/BLINDS ***
JJ Cat2198 posts small blind 0.01€
Beretta56 posts big blind 0.02€
Dealt to Fried Berg [2c As]
*** PRE-FLOP *** 
AMBM2729 folds
Donky Shot raises 0.03€ to 0.05€
Fried Berg folds
JissEl1te folds
JJ Cat2198 folds
Beretta56 folds
Donky Shot collected 0.08€ from pot
*** SUMMARY ***
Total pot 0.08€ | No rake
Seat 4: Donky Shot won 0.08€


Winamax Poker - HOLD-UP "Colorado" - HandId: #19116069-784196-1701775784 - Holdem no limit (0.01€/0.02€) - 2023/12/05 11:29:44 UTC
Table: 'Colorado' 6-max (real money) Seat #6 is the button
Seat 1: Cortes95 (2.14€)
Seat 2: Fried Berg (0.94€)
Seat 3: Chanclaveloz (2€)
Seat 4: Dilori (7.80€)
Seat 5: Dulcran (6.94€)
Seat 6: Itashi.95 (2.10€)
*** ANTE/BLINDS ***
Cortes95 posts small blind 0.01€
Fried Berg posts big blind 0.02€
Dealt to Fried Berg [8c Jd]
*** PRE-FLOP *** 
Chanclaveloz folds
Dilori folds
Dulcran folds
Itashi.95 folds
Cortes95 raises 0.04€ to 0.06€
Fried Berg folds
Cortes95 collected 0.08€ from pot
*** SUMMARY ***
Total pot 0.08€ | No rake
Seat 1: Cortes95 (small blind) won 0.08€


Winamax Poker - HOLD-UP "Colorado" - HandId: #19116069-784209-1701775794 - Holdem no limit (0.01€/0.02€) - 2023/12/05 11:29:54 UTC
Table: 'Colorado' 6-max (real money) Seat #6 is the button
Seat 1: Fried Berg (0.92€)
Seat 2: popoche29 (2€)
Seat 3: Un_brochet (2.15€)
Seat 4: ByMatix (0.82€)
Seat 5: DaniRama (2.58€)
Seat 6: Brut2pok (3.68€)
Hold-up to Pot: total 0.20€
*** ANTE/BLINDS ***
Fried Berg posts small blind 0.01€
popoche29 posts big blind 0.02€
Dealt to Fried Berg [Jd 8d]
*** PRE-FLOP *** 
Un_brochet raises 0.03€ to 0.05€
ByMatix calls 0.05€
DaniRama folds
Brut2pok folds
Fried Berg calls 0.04€
popoche29 calls 0.03€
*** FLOP *** [Ac 2d 6d]
Fried Berg checks
popoche29 checks
Un_brochet bets 0.14€
ByMatix raises 0.39€ to 0.53€
Fried Berg folds
popoche29 folds
Un_brochet raises 1.57€ to 2.10€ and is all-in
ByMatix calls 0.24€ and is all-in
*** TURN *** [Ac 2d 6d][Th]
*** RIVER *** [Ac 2d 6d Th][Qc]
*** SHOW DOWN ***
Un_brochet shows [Ad 7h] (One pair : Aces)
ByMatix shows [9c Ah] (One pair : Aces)
ByMatix collected 1.77€ from main pot
Un_brochet collected 1.33€ from side pot 1
*** SUMMARY ***
Total pot 3.10€ | Rake 0.17€
Board: [Ac 2d 6d Th Qc]
Seat 3: Un_brochet showed [Ad 7h] and won 1.33€ with One pair : Aces
Seat 4: ByMatix showed [9c Ah] and won 1.77€ with One pair : Aces


Winamax Poker - HOLD-UP "Colorado" - HandId: #19116069-784305-1701775856 - Holdem no limit (0.01€/0.02€) - 2023/12/05 11:30:56 UTC
Table: 'Colorado' 6-max (real money) Seat #6 is the button
Seat 1: Ga31k (3.43€)
Seat 2: AMBM2729 (1.27€)
Seat 3: Fried Berg (0.87€)
Seat 4: Jimbiosis (2.78€)
Seat 5: Ertorko (3.27€)
Seat 6: Richard Reuk (2.42€)
*** ANTE/BLINDS ***
Ga31k posts small blind 0.01€
AMBM2729 posts big blind 0.02€
Dealt to Fried Berg [8s 3d]
*** PRE-FLOP *** 
Fried Berg folds
Jimbiosis folds
Ertorko folds
Richard Reuk raises 0.03€ to 0.05€
Ga31k folds
AMBM2729 folds
Richard Reuk collected 0.08€ from pot
*** SUMMARY ***
Total pot 0.08€ | No rake
Seat 6: Richard Reuk (button) won 0.08€


Winamax Poker - HOLD-UP "Colorado" - HandId: #19116069-784309-1701775859 - Holdem no limit (0.01€/0.02€) - 2023/12/05 11:30:59 UTC
Table: 'Colorado' 6-max (real money) Seat #6 is the button
Seat 1: Jimbiosis (2.78€)
Seat 2: Durantula_6 (2.03€)
Seat 3: Pierrof24 (1.33€)
Seat 4: Fried Berg (0.87€)
Seat 5: Herocall28 (2€)
Seat 6: JV_Titan0 (2.41€)
*** ANTE/BLINDS ***
Jimbiosis posts small blind 0.01€
Durantula_6 posts big blind 0.02€
Dealt to Fried Berg [4c Ad]
*** PRE-FLOP *** 
Pierrof24 folds
Fried Berg folds
Herocall28 folds
JV_Titan0 folds
Jimbiosis folds
Durantula_6 collected 0.03€ from pot
*** SUMMARY ***
Total pot 0.03€ | No rake
Seat 2: Durantula_6 (big blind) won 0.03€


Winamax Poker - HOLD-UP "Colorado" - HandId: #19116069-784322-1701775867 - Holdem no limit (0.01€/0.02€) - 2023/12/05 11:31:07 UTC
Table: 'Colorado' 6-max (real money) Seat #6 is the button
Seat 1: Dilori (5.80€)
Seat 2: SirX (3.69€)
Seat 3: G0R0N11 (2.64€)
Seat 4: Donky Shot (2.36€)
Seat 5: -CrAnkB8t- (0.84€)
Seat 6: Fried Berg (0.87€)
*** ANTE/BLINDS ***
Dilori posts small blind 0.01€
SirX posts big blind 0.02€
Dealt to Fried Berg [Td Jd]
*** PRE-FLOP *** 
G0R0N11 folds
Donky Shot folds
-CrAnkB8t- folds
Fried Berg raises 0.02€ to 0.04€
Dilori folds
SirX calls 0.02€
*** FLOP *** [Ah 9s Ts]
SirX checks
Fried Berg bets 0.02€
SirX folds
Fried Berg collected 0.10€ from pot
*** SUMMARY ***
Total pot 0.10€ | Rake 0.01€
Board: [Ah 9s Ts]
Seat 6: Fried Berg (button) won 0.10€


Winamax Poker - HOLD-UP "Colorado" - HandId: #19116069-784393-1701775909 - Holdem no limit (0.01€/0.02€) - 2023/12/05 11:31:49 UTC
Table: 'Colorado' 6-max (real money) Seat #6 is the button
Seat 1: Chanclaveloz (2.38€)
Seat 2: Fried Berg (0.91€)
Seat 3: AlexxTorres (1.23€)
Seat 4: dadou13100 (1.96€)
Seat 5: DaniRama (2.62€)
Seat 6: JJ Cat2198 (0.42€)
*** ANTE/BLINDS ***
Chanclaveloz posts small blind 0.01€
Fried Berg posts big blind 0.02€
Dealt to Fried Berg [3s As]
*** PRE-FLOP *** 
AlexxTorres folds
dadou13100 folds
DaniRama folds
JJ Cat2198 folds
Chanclaveloz raises 0.02€ to 0.04€
Fried Berg calls 0.02€
*** FLOP *** [Qd Ac 6h]
Chanclaveloz bets 0.03€
Fried Berg raises 0.06€ to 0.09€
Chanclaveloz calls 0.06€
*** TURN *** [Qd Ac 6h][Kd]
Chanclaveloz checks
Fried Berg checks
*** RIVER *** [Qd Ac 6h Kd][8s]
Chanclaveloz checks
Fried Berg checks
*** SHOW DOWN ***
Chanclaveloz shows [Td Kh] (One pair : Kings)
Fried Berg shows [3s As] (One pair : Aces)
Fried Berg collected 0.23€ from pot
*** SUMMARY ***
Total pot 0.23€ | Rake 0.03€
Board: [Qd Ac 6h Kd 8s]
Seat 1: Chanclaveloz (small blind) showed [Td Kh] and lost with One pair : Kings
Seat 2: Fried Berg (big blind) showed [3s As] and won 0.23€ with One pair : Aces


Winamax Poker - HOLD-UP "Colorado" - HandId: #19116069-784473-1701775963 - Holdem no limit (0.01€/0.02€) - 2023/12/05 11:32:43 UTC
Table: 'Colorado' 6-max (real money) Seat #6 is the button
Seat 1: Richard Reuk (2.37€)
Seat 2: DaniRama (2.61€)
Seat 3: Fried Berg (1.01€)
Seat 4: Brut2pok (2.29€)
Seat 5: Chanclaveloz (2.25€)
Seat 6: EDPR (2.22€)
*** ANTE/BLINDS ***
Richard Reuk posts small blind 0.01€
DaniRama posts big blind 0.02€
Dealt to Fried Berg [3s 4s]
*** PRE-FLOP *** 
Fried Berg folds
Brut2pok folds
Chanclaveloz folds
EDPR raises 0.04€ to 0.06€
Richard Reuk raises 0.19€ to 0.25€
DaniRama folds
EDPR raises 0.50€ to 0.75€
Richard Reuk folds
EDPR collected 1.02€ from pot
*** SUMMARY ***
Total pot 1.02€ | No rake
Seat 6: EDPR (button) won 1.02€


Winamax Poker - HOLD-UP "Colorado" - HandId: #19116069-784479-1701775967 - Holdem no limit (0.01€/0.02€) - 2023/12/05 11:32:47 UTC
Table: 'Colorado' 6-max (real money) Seat #6 is the button
Seat 1: Fried Berg (1.01€)
Seat 2: AlexxTorres (2.42€)
Seat 3: Chanclaveloz (2.10€)
Seat 4: Br3izh_P0k3r (2.18€)
Seat 5: Justo_170382 (0.52€)
Seat 6: Brants 95 (0.82€)
*** ANTE/BLINDS ***
Fried Berg posts small blind 0.01€
AlexxTorres posts big blind 0.02€
Dealt to Fried Berg [Qh 3c]
*** PRE-FLOP *** 
Chanclaveloz folds
Br3izh_P0k3r folds
Justo_170382 folds
Brants 95 folds
Fried Berg folds
AlexxTorres collected 0.03€ from pot
*** SUMMARY ***
Total pot 0.03€ | No rake
Seat 2: AlexxTorres (big blind) won 0.03€


Winamax Poker - HOLD-UP "Colorado" - HandId: #19116069-784493-1701775974 - Holdem no limit (0.01€/0.02€) - 2023/12/05 11:32:54 UTC
Table: 'Colorado' 6-max (real money) Seat #6 is the button
Seat 1: kRaSsNy (0.83€)
Seat 2: Rom-rais1 (1.87€)
Seat 3: Itashi.95 (2.42€)
Seat 4: PseudoFC (1.54€)
Seat 5: Fried Berg (1€)
Seat 6: AMBM2729 (1.20€)
*** ANTE/BLINDS ***
kRaSsNy posts small blind 0.01€
Rom-rais1 posts big blind 0.02€
Dealt to Fried Berg [4h 3s]
*** PRE-FLOP *** 
Itashi.95 folds
PseudoFC folds
Fried Berg folds
AMBM2729 folds
kRaSsNy raises 0.04€ to 0.06€
Rom-rais1 calls 0.04€
*** FLOP *** [Ts 6s 9c]
kRaSsNy bets 0.10€
Rom-rais1 calls 0.10€
*** TURN *** [Ts 6s 9c][Tc]
kRaSsNy bets 0.18€
Rom-rais1 folds
kRaSsNy collected 0.47€ from pot
*** SUMMARY ***
Total pot 0.47€ | Rake 0.03€
Board: [Ts 6s 9c Tc]
Seat 1: kRaSsNy (small blind) won 0.47€


Winamax Poker - HOLD-UP "Colorado" - HandId: #19116069-784496-1701775976 - Holdem no limit (0.01€/0.02€) - 2023/12/05 11:32:56 UTC
Table: 'Colorado' 6-max (real money) Seat #6 is the button
Seat 1: Itashi.95 (2.42€)
Seat 2: Beretta56 (2.68€)
Seat 3: Brut2pok (7.48€)
Seat 4: antony49370 (0.80€)
Seat 5: Br3izh_P0k3r (2.06€)
Seat 6: Fried Berg (1€)
*** ANTE/BLINDS ***
Itashi.95 posts small blind 0.01€
Beretta56 posts big blind 0.02€
Dealt to Fried Berg [9d 6c]
*** PRE-FLOP *** 
Brut2pok folds
antony49370 folds
Br3izh_P0k3r folds
Fried Berg folds
Itashi.95 calls 0.01€
Beretta56 checks
*** FLOP *** [Qs 2d 7s]
Itashi.95 checks
Beretta56 bets 0.04€
Itashi.95 folds
Beretta56 collected 0.08€ from pot
*** SUMMARY ***
Total pot 0.08€ | No rake
Board: [Qs 2d 7s]
Seat 2: Beretta56 (big blind) won 0.08€


Winamax Poker - HOLD-UP "Colorado" - HandId: #19116069-784506-1701775984 - Holdem no limit (0.01€/0.02€) - 2023/12/05 11:33:04 UTC
Table: 'Colorado' 6-max (real money) Seat #6 is the button
Seat 1: Br3izh_P0k3r (2.16€)
Seat 2: Richard Reuk (2.12€)
Seat 3: Donky Shot (3.14€)
Seat 4: Joan009 (2.30€)
Seat 5: Fried Berg (1€)
Seat 6: Chanclaveloz (2.26€)
*** ANTE/BLINDS ***
Br3izh_P0k3r posts small blind 0.01€
Richard Reuk posts big blind 0.02€
Dealt to Fried Berg [7h 5c]
*** PRE-FLOP *** 
Donky Shot folds
Joan009 folds
Fried Berg folds
Chanclaveloz folds
Br3izh_P0k3r folds
Richard Reuk collected 0.03€ from pot
*** SUMMARY ***
Total pot 0.03€ | No rake
Seat 2: Richard Reuk (big blind) won 0.03€


Winamax Poker - HOLD-UP "Colorado" - HandId: #19116069-784514-1701775989 - Holdem no limit (0.01€/0.02€) - 2023/12/05 11:33:09 UTC
Table: 'Colorado' 6-max (real money) Seat #6 is the button
Seat 1: DaniRama (2€)
Seat 2: Fran1Oller (2€)
Seat 3: gitPush (2€)
Seat 4: Brut2pok (2.29€)
Seat 5: Jimbiosis (3.22€)
Seat 6: Fried Berg (1€)
*** ANTE/BLINDS ***
DaniRama posts small blind 0.01€
Fran1Oller posts big blind 0.02€
Dealt to Fried Berg [3c Ad]
*** PRE-FLOP *** 
gitPush folds
Brut2pok folds
Jimbiosis folds
Fried Berg raises 0.02€ to 0.04€
DaniRama folds
Fran1Oller calls 0.02€
*** FLOP *** [3h 9s 7h]
Fran1Oller checks
Fried Berg checks
*** TURN *** [3h 9s 7h][Ks]
Fran1Oller checks
Fried Berg checks
*** RIVER *** [3h 9s 7h Ks][Jc]
Fran1Oller bets 0.04€
Fried Berg folds
Fran1Oller collected 0.12€ from pot
*** SUMMARY ***
Total pot 0.12€ | Rake 0.01€
Board: [3h 9s 7h Ks Jc]
Seat 2: Fran1Oller (big blind) won 0.12€


Winamax Poker - HOLD-UP "Colorado" - HandId: #19116069-784584-1701776036 - Holdem no limit (0.01€/0.02€) - 2023/12/05 11:33:56 UTC
Table: 'Colorado' 6-max (real money) Seat #6 is the button
Seat 1: G0R0N11 (2€)
Seat 2: Fried Berg (0.96€)
Seat 3: antony49370 (0.66€)
Seat 4: KON-2-PEUTE (2€)
Seat 5: VanDolar (2.03€)
Seat 6: Ertorko (2.10€)
*** ANTE/BLINDS ***
G0R0N11 posts small blind 0.01€
Fried Berg posts big blind 0.02€
Dealt to Fried Berg [4c Th]
*** PRE-FLOP *** 
antony49370 folds
KON-2-PEUTE folds
VanDolar folds
Ertorko folds
G0R0N11 folds
Fried Berg collected 0.03€ from pot
*** SUMMARY ***
Total pot 0.03€ | No rake
Seat 2: Fried Berg (big blind) won 0.03€


Winamax Poker - HOLD-UP "Colorado" - HandId: #19116069-784615-1701776053 - Holdem no limit (0.01€/0.02€) - 2023/12/05 11:34:13 UTC
Table: 'Colorado' 6-max (real money) Seat #6 is the button
Seat 1: Fran1Oller (2.11€)
Seat 2: G0R0N11 (2€)
Seat 3: Fried Berg (0.97€)
Seat 4: Richard Reuk (2.44€)
Seat 5: gitPush (2€)
Seat 6: totomax22 (2€)
*** ANTE/BLINDS ***
Fran1Oller posts small blind 0.01€
G0R0N11 posts big blind 0.02€
Dealt to Fried Berg [Ad Jc]
*** PRE-FLOP *** 
Fried Berg raises 0.02€ to 0.04€
Richard Reuk calls 0.04€
gitPush folds
totomax22 folds
Fran1Oller folds
G0R0N11 folds
*** FLOP *** [Qs 3d 5s]
Fried Berg bets 0.04€
Richard Reuk calls 0.04€
*** TURN *** [Qs 3d 5s][2h]
Fried Berg checks
Richard Reuk bets 0.07€
Fried Berg folds
Richard Reuk collected 0.24€ from pot
*** SUMMARY ***
Total pot 0.24€ | Rake 0.02€
Board: [Qs 3d 5s 2h]
Seat 4: Richard Reuk won 0.24€


Winamax Poker - HOLD-UP "Colorado" - HandId: #19116069-784698-1701776106 - Holdem no limit (0.01€/0.02€) - 2023/12/05 11:35:06 UTC
Table: 'Colorado' 6-max (real money) Seat #6 is the button
Seat 1: Fried Berg (0.89€)
Seat 2: EDPR (2€)
Seat 3: Ertorko (2.29€)
Seat 4: sandrine1983 (0.51€)
Seat 5: Raggamin (2.05€)
Seat 6: Dilori (5.77€)
*** ANTE/BLINDS ***
Fried Berg posts small blind 0.01€
EDPR posts big blind 0.02€
Dealt to Fried Berg [Qh 7s]
*** PRE-FLOP *** 
Ertorko folds
sandrine1983 calls 0.02€
Raggamin folds
Dilori folds
Fried Berg folds
EDPR checks
*** FLOP *** [7c Kd 7d]
EDPR checks
sandrine1983 checks
*** TURN *** [7c Kd 7d][8c]
EDPR checks
sandrine1983 checks
*** RIVER *** [7c Kd 7d 8c][6h]
EDPR checks
sandrine1983 bets 0.02€
EDPR calls 0.02€
*** SHOW DOWN ***
sandrine1983 shows [Ac 6s] (Two pairs : 7 and 6)
EDPR shows [2d Kc] (Two pairs : Kings and 7)
EDPR collected 0.08€ from pot
*** SUMMARY ***
Total pot 0.08€ | Rake 0.01€
Board: [7c Kd 7d 8c 6h]
Seat 2: EDPR (big blind) showed [2d Kc] and won 0.08€ with Two pairs : Kings and 7
Seat 4: sandrine1983 showed [Ac 6s] and lost with Two pairs : 7 and 6


Winamax Poker - HOLD-UP "Colorado" - HandId: #19116069-784711-1701776114 - Holdem no limit (0.01€/0.02€) - 2023/12/05 11:35:14 UTC
Table: 'Colorado' 6-max (real money) Seat #6 is the button
Seat 1: KON-2-PEUTE (3.72€)
Seat 2: EA_Stinger (0.49€)
Seat 3: DaniRama (2.74€)
Seat 4: Fried Berg (0.88€)
Seat 5: AlexxTorres (2.88€)
Seat 6: Brut2pok (7.40€)
*** ANTE/BLINDS ***
KON-2-PEUTE posts small blind 0.01€
EA_Stinger posts big blind 0.02€
Dealt to Fried Berg [Ah Kc]
*** PRE-FLOP *** 
DaniRama folds
Fried Berg raises 0.02€ to 0.04€
AlexxTorres folds
Brut2pok folds
KON-2-PEUTE folds
EA_Stinger calls 0.02€
*** FLOP *** [8c Qs 4d]
EA_Stinger checks
Fried Berg bets 0.04€
EA_Stinger calls 0.04€
*** TURN *** [8c Qs 4d][Kd]
EA_Stinger checks
Fried Berg bets 0.08€
EA_Stinger folds
Fried Berg collected 0.23€ from pot
*** SUMMARY ***
Total pot 0.23€ | Rake 0.02€
Board: [8c Qs 4d Kd]
Seat 4: Fried Berg won 0.23€


Winamax Poker - HOLD-UP "Colorado" - HandId: #19116069-784781-1701776151 - Holdem no limit (0.01€/0.02€) - 2023/12/05 11:35:51 UTC
Table: 'Colorado' 6-max (real money) Seat #6 is the button
Seat 1: Anme41 (3.96€)
Seat 2: Raggamin (2.01€)
Seat 3: DoctorBlack (5.32€)
Seat 4: Tofini (2.21€)
Seat 5: Fried Berg (0.95€)
Seat 6: LM231620 (0.41€)
*** ANTE/BLINDS ***
Anme41 posts small blind 0.01€
Raggamin posts big blind 0.02€
Dealt to Fried Berg [3c 4s]
*** PRE-FLOP *** 
DoctorBlack folds
Tofini folds
Fried Berg folds
LM231620 folds
Anme41 folds
Raggamin collected 0.03€ from pot
*** SUMMARY ***
Total pot 0.03€ | No rake
Seat 2: Raggamin (big blind) won 0.03€


Winamax Poker - HOLD-UP "Colorado" - HandId: #19116069-784797-1701776161 - Holdem no limit (0.01€/0.02€) - 2023/12/05 11:36:01 UTC
Table: 'Colorado' 6-max (real money) Seat #6 is the button
Seat 1: sandrine1983 (0.48€)
Seat 2: Joan009 (2.24€)
Seat 3: Fried Berg (0.95€)
Seat 4: Yanmya33 (2.11€)
Seat 5: DaniRama (2.09€)
Seat 6: Fran1Oller (2.61€)
*** ANTE/BLINDS ***
sandrine1983 posts small blind 0.01€
Joan009 posts big blind 0.02€
Dealt to Fried Berg [3s 3d]
*** PRE-FLOP *** 
Fried Berg folds
Yanmya33 folds
DaniRama folds
Fran1Oller folds
sandrine1983 folds
Joan009 collected 0.03€ from pot
*** SUMMARY ***
Total pot 0.03€ | No rake
Seat 2: Joan009 (big blind) won 0.03€


Winamax Poker - HOLD-UP "Colorado" - HandId: #19116069-784804-1701776165 - Holdem no limit (0.01€/0.02€) - 2023/12/05 11:36:05 UTC
Table: 'Colorado' 6-max (real money) Seat #6 is the button
Seat 1: Tofini (2.03€)
Seat 2: Fried Berg (0.95€)
Seat 3: Ertorko (2.23€)
Seat 4: EDPR (2.03€)
Seat 5: Eytrewq (1.32€)
Seat 6: Pierrof24 (1.28€)
*** ANTE/BLINDS ***
Tofini posts small blind 0.01€
Fried Berg posts big blind 0.02€
Dealt to Fried Berg [Ts Kc]
*** PRE-FLOP *** 
Ertorko folds
EDPR folds
Eytrewq raises 0.04€ to 0.06€
Pierrof24 folds
Tofini folds
Fried Berg calls 0.04€
*** FLOP *** [3d 2s 6h]
Fried Berg checks
Eytrewq bets 0.07€
Fried Berg folds
Eytrewq collected 0.19€ from pot
*** SUMMARY ***
Total pot 0.19€ | Rake 0.01€
Board: [3d 2s 6h]
Seat 5: Eytrewq won 0.19€


Winamax Poker - HOLD-UP "Colorado" - HandId: #19116069-784841-1701776193 - Holdem no limit (0.01€/0.02€) - 2023/12/05 11:36:33 UTC
Table: 'Colorado' 6-max (real money) Seat #6 is the button
Seat 1: Fried Berg (0.89€)
Seat 2: Raggamin (3.20€)
Seat 3: Pierrof24 (1.26€)
Seat 4: gitPush (2.37€)
Seat 5: MrFlash9 (5.40€)
Seat 6: totomax22 (2.61€)
*** ANTE/BLINDS ***
Fried Berg posts small blind 0.01€
Raggamin posts big blind 0.02€
Dealt to Fried Berg [3d Kh]
*** PRE-FLOP *** 
Pierrof24 folds
gitPush folds
MrFlash9 folds
totomax22 raises 0.03€ to 0.05€
Fried Berg folds
Raggamin folds
totomax22 collected 0.08€ from pot
*** SUMMARY ***
Total pot 0.08€ | No rake
Seat 6: totomax22 (button) won 0.08€


Winamax Poker - HOLD-UP "Colorado" - HandId: #19116069-784848-1701776198 - Holdem no limit (0.01€/0.02€) - 2023/12/05 11:36:38 UTC
Table: 'Colorado' 6-max (real money) Seat #6 is the button
Seat 1: Brut2pok (4.06€)
Seat 2: Brants 95 (2.08€)
Seat 3: Cortes95 (3.18€)
Seat 4: Fried Berg (0.88€)
Seat 5: JJ Cat2198 (0.37€)
Seat 6: Le_zigauto (1.35€)
*** ANTE/BLINDS ***
Brut2pok posts small blind 0.01€
Brants 95 posts big blind 0.02€
Dealt to Fried Berg [Qh 5s]
*** PRE-FLOP *** 
Cortes95 folds
Fried Berg folds
JJ Cat2198 folds
Le_zigauto folds
Brut2pok folds
Brants 95 collected 0.03€ from pot
*** SUMMARY ***
Total pot 0.03€ | No rake
Seat 2: Brants 95 (big blind) won 0.03€


Winamax Poker - HOLD-UP "Colorado" - HandId: #19116069-784857-1701776203 - Holdem no limit (0.01€/0.02€) - 2023/12/05 11:36:43 UTC
Table: 'Colorado' 6-max (real money) Seat #6 is the button
Seat 1: Chanclaveloz (2.59€)
Seat 2: Niizumax (6.25€)
Seat 3: Raggamin (3.18€)
Seat 4: Brut2pok (4.05€)
Seat 5: AMBM2729 (1.20€)
Seat 6: Fried Berg (0.88€)
*** ANTE/BLINDS ***
Chanclaveloz posts small blind 0.01€
Niizumax posts big blind 0.02€
Dealt to Fried Berg [8s 4h]
*** PRE-FLOP *** 
Raggamin folds
Brut2pok raises 0.04€ to 0.06€
AMBM2729 folds
Fried Berg folds
Chanclaveloz folds
Niizumax calls 0.04€
*** FLOP *** [5c 7c 2h]
Niizumax checks
Brut2pok bets 0.13€
Niizumax folds
Brut2pok collected 0.25€ from pot
*** SUMMARY ***
Total pot 0.25€ | Rake 0.01€
Board: [5c 7c 2h]
Seat 4: Brut2pok won 0.25€


Winamax Poker - HOLD-UP "Colorado" - HandId: #19116069-784863-1701776205 - Holdem no limit (0.01€/0.02€) - 2023/12/05 11:36:45 UTC
Table: 'Colorado' 6-max (real money) Seat #6 is the button
Seat 1: Jesperord98 (3.08€)
Seat 2: pablo69400 (2.46€)
Seat 3: VanDolar (2.02€)
Seat 4: totomax22 (2.64€)
Seat 5: KON-2-PEUTE (2.29€)
Seat 6: Fried Berg (0.88€)
*** ANTE/BLINDS ***
Jesperord98 posts small blind 0.01€
pablo69400 posts big blind 0.02€
Dealt to Fried Berg [Kd 6c]
*** PRE-FLOP *** 
VanDolar folds
totomax22 raises 0.03€ to 0.05€
KON-2-PEUTE folds
Fried Berg folds
Jesperord98 folds
pablo69400 calls 0.03€
*** FLOP *** [9d Ah 9c]
pablo69400 checks
totomax22 bets 0.07€
pablo69400 folds
totomax22 collected 0.17€ from pot
*** SUMMARY ***
Total pot 0.17€ | Rake 0.01€
Board: [9d Ah 9c]
Seat 4: totomax22 won 0.17€


Winamax Poker - HOLD-UP "Colorado" - HandId: #19116069-784881-1701776215 - Holdem no limit (0.01€/0.02€) - 2023/12/05 11:36:55 UTC
Table: 'Colorado' 6-max (real money) Seat #6 is the button
Seat 1: Raggamin (3.18€)
Seat 2: Br3izh_P0k3r (2.40€)
Seat 3: livthe34 (1.77€)
Seat 4: Bennnnnn62 (0.51€)
Seat 5: MrFlash9 (5.39€)
Seat 6: Fried Berg (0.88€)
*** ANTE/BLINDS ***
Raggamin posts small blind 0.01€
Br3izh_P0k3r posts big blind 0.02€
Dealt to Fried Berg [4h Ah]
*** PRE-FLOP *** 
livthe34 folds
Bennnnnn62 folds
MrFlash9 folds
Fried Berg raises 0.02€ to 0.04€
Raggamin folds
Br3izh_P0k3r folds
Fried Berg collected 0.07€ from pot
*** SUMMARY ***
Total pot 0.07€ | No rake
Seat 6: Fried Berg (button) won 0.07€


Winamax Poker - HOLD-UP "Colorado" - HandId: #19116069-784935-1701776243 - Holdem no limit (0.01€/0.02€) - 2023/12/05 11:37:23 UTC
Table: 'Colorado' 6-max (real money) Seat #6 is the button
Seat 1: Fried Berg (0.91€)
Seat 2: Ice945 (2€)
Seat 3: Dulcran (7.66€)
Seat 4: Quenelles (4.15€)
Seat 5: Br3izh_P0k3r (2.38€)
Seat 6: titifull (1€)
*** ANTE/BLINDS ***
Fried Berg posts small blind 0.01€
Ice945 posts big blind 0.02€
Dealt to Fried Berg [Qd 6d]
*** PRE-FLOP *** 
Dulcran folds
Quenelles folds
Br3izh_P0k3r folds
titifull folds
Fried Berg raises 0.02€ to 0.04€
Ice945 calls 0.02€
*** FLOP *** [Qc 4d 2d]
Fried Berg bets 0.04€
Ice945 calls 0.04€
*** TURN *** [Qc 4d 2d][Ac]
Fried Berg checks
Ice945 bets 0.06€
Fried Berg calls 0.06€
*** RIVER *** [Qc 4d 2d Ac][Js]
Fried Berg checks
Ice945 checks
*** SHOW DOWN ***
Ice945 shows [7h Tc] (High card : Ace)
Fried Berg shows [Qd 6d] (One pair : Queens)
Fried Berg collected 0.25€ from pot
*** SUMMARY ***
Total pot 0.25€ | Rake 0.03€
Board: [Qc 4d 2d Ac Js]
Seat 1: Fried Berg (small blind) showed [Qd 6d] and won 0.25€ with One pair : Queens
Seat 2: Ice945 (big blind) showed [7h Tc] and lost with High card : Ace


Winamax Poker - HOLD-UP "Colorado" - HandId: #19116069-785025-1701776302 - Holdem no limit (0.01€/0.02€) - 2023/12/05 11:38:22 UTC
Table: 'Colorado' 6-max (real money) Seat #6 is the button
Seat 1: Ice945 (1.86€)
Seat 2: DaniRama (2€)
Seat 3: Fried Berg (1.02€)
Seat 4: Quenelles (4.14€)
Seat 5: AMBM2729 (1.23€)
Seat 6: Raggamin (2.12€)
*** ANTE/BLINDS ***
Ice945 posts small blind 0.01€
DaniRama posts big blind 0.02€
Dealt to Fried Berg [7s As]
*** PRE-FLOP *** 
Fried Berg raises 0.02€ to 0.04€
Quenelles folds
AMBM2729 folds
Raggamin calls 0.04€
Ice945 folds
DaniRama folds
*** FLOP *** [2s 9d 5h]
Fried Berg checks
Raggamin checks
*** TURN *** [2s 9d 5h][4h]
Fried Berg checks
Raggamin checks
*** RIVER *** [2s 9d 5h 4h][5d]
Fried Berg checks
Raggamin checks
*** SHOW DOWN ***
Raggamin shows [Qh Jc] (One pair : 5)
Fried Berg shows [7s As] (One pair : 5)
Fried Berg collected 0.10€ from pot
*** SUMMARY ***
Total pot 0.10€ | Rake 0.01€
Board: [2s 9d 5h 4h 5d]
Seat 3: Fried Berg showed [7s As] and won 0.10€ with One pair : 5
Seat 6: Raggamin (button) showed [Qh Jc] and lost with One pair : 5


Winamax Poker - HOLD-UP "Colorado" - HandId: #19116069-785076-1701776338 - Holdem no limit (0.01€/0.02€) - 2023/12/05 11:38:58 UTC
Table: 'Colorado' 6-max (real money) Seat #6 is the button
Seat 1: Chanclaveloz (4.14€)
Seat 2: Fried Berg (1.08€)
Seat 3: D_A_R_K_ (2€)
Seat 4: Dulcran (5.67€)
Seat 5: Brants 95 (0.76€)
Seat 6: Tofini (2.02€)
*** ANTE/BLINDS ***
Chanclaveloz posts small blind 0.01€
Fried Berg posts big blind 0.02€
Dealt to Fried Berg [Js 5h]
*** PRE-FLOP *** 
D_A_R_K_ folds
Dulcran folds
Brants 95 folds
Tofini folds
Chanclaveloz raises 0.02€ to 0.04€
Fried Berg folds
Chanclaveloz collected 0.06€ from pot
*** SUMMARY ***
Total pot 0.06€ | No rake
Seat 1: Chanclaveloz (small blind) won 0.06€


Winamax Poker - HOLD-UP "Colorado" - HandId: #19116069-785099-1701776358 - Holdem no limit (0.01€/0.02€) - 2023/12/05 11:39:18 UTC
Table: 'Colorado' 6-max (real money) Seat #6 is the button
Seat 1: sandrine1983 (0.52€)
Seat 2: Raggamin (2.07€)
Seat 3: AlexxTorres (2.96€)
Seat 4: Fried Berg (1.06€)
Seat 5: Pierrof24 (1.25€)
Seat 6: Br3izh_P0k3r (2.47€)
*** ANTE/BLINDS ***
sandrine1983 posts small blind 0.01€
Raggamin posts big blind 0.02€
Dealt to Fried Berg [Qh Kh]
*** PRE-FLOP *** 
AlexxTorres folds
Fried Berg raises 0.02€ to 0.04€
Pierrof24 folds
Br3izh_P0k3r folds
sandrine1983 folds
Raggamin calls 0.02€
*** FLOP *** [Kc 5d 9d]
Raggamin checks
Fried Berg bets 0.02€
Raggamin folds
Fried Berg collected 0.10€ from pot
*** SUMMARY ***
Total pot 0.10€ | Rake 0.01€
Board: [Kc 5d 9d]
Seat 4: Fried Berg won 0.10€


Winamax Poker - HOLD-UP "Colorado" - HandId: #19116069-785264-1701776451 - Holdem no limit (0.01€/0.02€) - 2023/12/05 11:40:51 UTC
Table: 'Colorado' 6-max (real money) Seat #6 is the button
Seat 1: Roberfrk (2.01€)
Seat 2: D_A_R_K_ (2€)
Seat 3: VanDolar (2.68€)
Seat 4: elAfiliado (0.06€)
Seat 5: Fried Berg (1.10€)
Seat 6: Tofini (2.09€)
*** ANTE/BLINDS ***
Roberfrk posts small blind 0.01€
D_A_R_K_ posts big blind 0.02€
Dealt to Fried Berg [Ts 4d]
*** PRE-FLOP *** 
VanDolar folds
elAfiliado folds
Fried Berg folds
Tofini folds
Roberfrk raises 0.04€ to 0.06€
D_A_R_K_ folds
Roberfrk collected 0.08€ from pot
*** SUMMARY ***
Total pot 0.08€ | No rake
Seat 1: Roberfrk (small blind) won 0.08€


Winamax Poker - HOLD-UP "Colorado" - HandId: #19116069-785294-1701776465 - Holdem no limit (0.01€/0.02€) - 2023/12/05 11:41:05 UTC
Table: 'Colorado' 6-max (real money) Seat #6 is the button
Seat 1: GuizouOmFada (4.44€)
Seat 2: Fran1Oller (2.56€)
Seat 3: Herocall28 (3.54€)
Seat 4: Brants 95 (0.70€)
Seat 5: sandrine1983 (0.49€)
Seat 6: Fried Berg (1.10€)
*** ANTE/BLINDS ***
GuizouOmFada posts small blind 0.01€
Fran1Oller posts big blind 0.02€
Dealt to Fried Berg [6d 3d]
*** PRE-FLOP *** 
Herocall28 folds
Brants 95 folds
sandrine1983 folds
Fried Berg folds
GuizouOmFada folds
Fran1Oller collected 0.03€ from pot
*** SUMMARY ***
Total pot 0.03€ | No rake
Seat 2: Fran1Oller (big blind) won 0.03€


Winamax Poker - HOLD-UP "Colorado" - HandId: #19116069-785325-1701776481 - Holdem no limit (0.01€/0.02€) - 2023/12/05 11:41:21 UTC
Table: 'Colorado' 6-max (real money) Seat #6 is the button
Seat 1: SirX (5.05€)
Seat 2: Fried Berg (1.10€)
Seat 3: G0R0N11 (2.54€)
Seat 4: Dulcran (5.88€)
Seat 5: Raggamin (2.03€)
Seat 6: nico033 (1.73€)
*** ANTE/BLINDS ***
SirX posts small blind 0.01€
Fried Berg posts big blind 0.02€
Dealt to Fried Berg [6s 4d]
*** PRE-FLOP *** 
G0R0N11 folds
Dulcran folds
Raggamin folds
nico033 folds
SirX raises 0.04€ to 0.06€
Fried Berg folds
SirX collected 0.08€ from pot
*** SUMMARY ***
Total pot 0.08€ | No rake
Seat 1: SirX (small blind) won 0.08€


Winamax Poker - HOLD-UP "Colorado" - HandId: #19116069-785359-1701776497 - Holdem no limit (0.01€/0.02€) - 2023/12/05 11:41:37 UTC
Table: 'Colorado' 6-max (real money) Seat #6 is the button
Seat 1: Br3izh_P0k3r (2.36€)
Seat 2: antoniusivey (1.85€)
Seat 3: dadou13100 (1.86€)
Seat 4: gitPush (2€)
Seat 5: popoche29 (3.78€)
Seat 6: Fried Berg (1.08€)
*** ANTE/BLINDS ***
Br3izh_P0k3r posts small blind 0.01€
antoniusivey posts big blind 0.02€
Dealt to Fried Berg [6h Kc]
*** PRE-FLOP *** 
dadou13100 folds
gitPush folds
popoche29 folds
Fried Berg folds
Br3izh_P0k3r raises 0.04€ to 0.06€
antoniusivey calls 0.04€
*** FLOP *** [8s 2h 7d]
Br3izh_P0k3r checks
antoniusivey checks
*** TURN *** [8s 2h 7d][Jh]
Br3izh_P0k3r checks
antoniusivey bets 0.12€
Br3izh_P0k3r folds
antoniusivey collected 0.23€ from pot
*** SUMMARY ***
Total pot 0.23€ | Rake 0.01€
Board: [8s 2h 7d Jh]
Seat 2: antoniusivey (big blind) won 0.23€


Winamax Poker - HOLD-UP "Colorado" - HandId: #19116069-785387-1701776511 - Holdem no limit (0.01€/0.02€) - 2023/12/05 11:41:51 UTC
Table: 'Colorado' 6-max (real money) Seat #6 is the button
Seat 1: Overcall (1.14€)
Seat 2: Durantula_6 (2€)
Seat 3: Fried Berg (1.08€)
Seat 4: Le_zigauto (2.39€)
Seat 5: Samuelillo07 (2€)
Seat 6: Raggamin (2.03€)
*** ANTE/BLINDS ***
Overcall posts small blind 0.01€
Durantula_6 posts big blind 0.02€
Dealt to Fried Berg [2d 9h]
*** PRE-FLOP *** 
Fried Berg folds
Le_zigauto folds
Samuelillo07 folds
Raggamin folds
Overcall folds
Durantula_6 collected 0.03€ from pot
*** SUMMARY ***
Total pot 0.03€ | No rake
Seat 2: Durantula_6 (big blind) won 0.03€


Winamax Poker - HOLD-UP "Colorado" - HandId: #19116069-785414-1701776526 - Holdem no limit (0.01€/0.02€) - 2023/12/05 11:42:06 UTC
Table: 'Colorado' 6-max (real money) Seat #6 is the button
Seat 1: D_A_R_K_ (2.08€)
Seat 2: Brut2pok (3.55€)
Seat 3: Cortes95 (2.24€)
Seat 4: Fried Berg (1.08€)
Seat 5: Ice945 (1.69€)
Seat 6: Davidoo36 (0.49€)
*** ANTE/BLINDS ***
D_A_R_K_ posts small blind 0.01€
Brut2pok posts big blind 0.02€
Dealt to Fried Berg [2s Kh]
*** PRE-FLOP *** 
Cortes95 folds
Fried Berg folds
Ice945 folds
Davidoo36 folds
D_A_R_K_ folds
Brut2pok collected 0.03€ from pot
*** SUMMARY ***
Total pot 0.03€ | No rake
Seat 2: Brut2pok (big blind) won 0.03€


Winamax Poker - HOLD-UP "Colorado" - HandId: #19116069-785477-1701776559 - Holdem no limit (0.01€/0.02€) - 2023/12/05 11:42:39 UTC
Table: 'Colorado' 6-max (real money) Seat #6 is the button
Seat 1: Fried Berg (1.08€)
Seat 2: Delpierrot10 (2€)
Seat 3: Dulcran (2.27€)
Seat 4: Brants 95 (1.68€)
Seat 5: GTO-Mieko (2€)
Seat 6: -CrAnkB8t- (0.49€)
*** ANTE/BLINDS ***
Fried Berg posts small blind 0.01€
Delpierrot10 posts big blind 0.02€
Dealt to Fried Berg [5d Qd]
*** PRE-FLOP *** 
Dulcran folds
Brants 95 folds
GTO-Mieko folds
-CrAnkB8t- folds
Fried Berg raises 0.02€ to 0.04€
Delpierrot10 calls 0.02€
*** FLOP *** [4s 7c Kc]
Fried Berg checks
Delpierrot10 bets 0.03€
Fried Berg folds
Delpierrot10 collected 0.10€ from pot
*** SUMMARY ***
Total pot 0.10€ | Rake 0.01€
Board: [4s 7c Kc]
Seat 2: Delpierrot10 (big blind) won 0.10€


Winamax Poker - HOLD-UP "Colorado" - HandId: #19116069-785514-1701776579 - Holdem no limit (0.01€/0.02€) - 2023/12/05 11:42:59 UTC
Table: 'Colorado' 6-max (real money) Seat #6 is the button
Seat 1: FJM-MJF (1.58€)
Seat 2: EDPR (2.15€)
Seat 3: lefraisier (1.85€)
Seat 4: gitPush (2€)
Seat 5: Fried Berg (1.04€)
Seat 6: JeSuisTonFis (4.90€)
*** ANTE/BLINDS ***
FJM-MJF posts small blind 0.01€
EDPR posts big blind 0.02€
Dealt to Fried Berg [Ah 7s]
*** PRE-FLOP *** 
lefraisier folds
gitPush folds
Fried Berg raises 0.02€ to 0.04€
JeSuisTonFis folds
FJM-MJF folds
EDPR folds
Fried Berg collected 0.07€ from pot
*** SUMMARY ***
Total pot 0.07€ | No rake
Seat 5: Fried Berg won 0.07€


Winamax Poker - HOLD-UP "Colorado" - HandId: #19116069-785532-1701776590 - Holdem no limit (0.01€/0.02€) - 2023/12/05 11:43:10 UTC
Table: 'Colorado' 6-max (real money) Seat #6 is the button
Seat 1: EA_Stinger (0.88€)
Seat 2: Fried Berg (1.07€)
Seat 3: GTO-Mieko (2.24€)
Seat 4: Brants 95 (1.91€)
Seat 5: antoclem2A (1.97€)
Seat 6: Durantula_6 (2€)
*** ANTE/BLINDS ***
EA_Stinger posts small blind 0.01€
Fried Berg posts big blind 0.02€
Dealt to Fried Berg [Js 2h]
*** PRE-FLOP *** 
GTO-Mieko folds
Brants 95 folds
antoclem2A folds
Durantula_6 folds
EA_Stinger folds
Fried Berg collected 0.03€ from pot
*** SUMMARY ***
Total pot 0.03€ | No rake
Seat 2: Fried Berg (big blind) won 0.03€


Winamax Poker - HOLD-UP "Colorado" - HandId: #19116069-785564-1701776605 - Holdem no limit (0.01€/0.02€) - 2023/12/05 11:43:25 UTC
Table: 'Colorado' 6-max (real money) Seat #6 is the button
Seat 1: XxTeamxX (2.11€)
Seat 2: JFSredbaron (2€)
Seat 3: Fried Berg (1.08€)
Seat 4: Niizumax (2.31€)
Seat 5: SirX (5.12€)
Seat 6: dadou13100 (2.41€)
*** ANTE/BLINDS ***
XxTeamxX posts small blind 0.01€
JFSredbaron posts big blind 0.02€
Dealt to Fried Berg [9d 3c]
*** PRE-FLOP *** 
Fried Berg folds
Niizumax raises 0.03€ to 0.05€
SirX folds
dadou13100 folds
XxTeamxX folds
JFSredbaron folds
Niizumax collected 0.08€ from pot
*** SUMMARY ***
Total pot 0.08€ | No rake
Seat 4: Niizumax won 0.08€


Winamax Poker - HOLD-UP "Colorado" - HandId: #19116069-785567-1701776607 - Holdem no limit (0.01€/0.02€) - 2023/12/05 11:43:27 UTC
Table: 'Colorado' 6-max (real money) Seat #6 is the button
Seat 1: VR_Chasseur2 (3.12€)
Seat 2: totomax22 (3.21€)
Seat 3: _Sephi (4.97€)
Seat 4: Fried Berg (1.08€)
Seat 5: SirX (5.12€)
Seat 6: sandrine1983 (1.42€)
*** ANTE/BLINDS ***
VR_Chasseur2 posts small blind 0.01€
totomax22 posts big blind 0.02€
Dealt to Fried Berg [7d 5s]
*** PRE-FLOP *** 
_Sephi folds
Fried Berg folds
SirX folds
sandrine1983 folds
VR_Chasseur2 calls 0.01€
totomax22 raises 0.04€ to 0.06€
VR_Chasseur2 calls 0.04€
*** FLOP *** [Jh 2d Ts]
VR_Chasseur2 checks
totomax22 bets 0.06€
VR_Chasseur2 folds
totomax22 collected 0.17€ from pot
*** SUMMARY ***
Total pot 0.17€ | Rake 0.01€
Board: [Jh 2d Ts]
Seat 2: totomax22 (big blind) won 0.17€


Winamax Poker - HOLD-UP "Colorado" - HandId: #19116069-785572-1701776609 - Holdem no limit (0.01€/0.02€) - 2023/12/05 11:43:29 UTC
Table: 'Colorado' 6-max (real money) Seat #6 is the button
Seat 1: Wabule23 (2.29€)
Seat 2: dadou13100 (2.41€)
Seat 3: Richard Reuk (3.47€)
Seat 4: _Sephi (4.97€)
Seat 5: Fried Berg (1.08€)
Seat 6: Anme41 (3.68€)
*** ANTE/BLINDS ***
Wabule23 posts small blind 0.01€
dadou13100 posts big blind 0.02€
Dealt to Fried Berg [7s 3s]
*** PRE-FLOP *** 
Richard Reuk folds
_Sephi raises 0.03€ to 0.05€
Fried Berg folds
Anme41 folds
Wabule23 folds
dadou13100 calls 0.03€
*** FLOP *** [6d 7c 8s]
dadou13100 bets 0.05€
_Sephi folds
dadou13100 collected 0.15€ from pot
*** SUMMARY ***
Total pot 0.15€ | Rake 0.01€
Board: [6d 7c 8s]
Seat 2: dadou13100 (big blind) won 0.15€


Winamax Poker - HOLD-UP "Colorado" - HandId: #19116069-785576-1701776611 - Holdem no limit (0.01€/0.02€) - 2023/12/05 11:43:31 UTC
Table: 'Colorado' 6-max (real money) Seat #6 is the button
Seat 1: Direct Oli (1.68€)
Seat 2: Richard Reuk (3.47€)
Seat 3: Jesperord98 (2€)
Seat 4: antoclem2A (1.97€)
Seat 5: Fried Berg (1.08€)
Seat 6: Samuelillo07 (2€)
*** ANTE/BLINDS ***
Direct Oli posts small blind 0.01€
Richard Reuk posts big blind 0.02€
Dealt to Fried Berg [Jh 7c]
*** PRE-FLOP *** 
Jesperord98 raises 0.04€ to 0.06€
antoclem2A folds
Fried Berg folds
Samuelillo07 folds
Direct Oli folds
Richard Reuk folds
Jesperord98 collected 0.09€ from pot
*** SUMMARY ***
Total pot 0.09€ | No rake
Seat 3: Jesperord98 won 0.09€


Winamax Poker - HOLD-UP "Colorado" - HandId: #19116069-785582-1701776614 - Holdem no limit (0.01€/0.02€) - 2023/12/05 11:43:34 UTC
Table: 'Colorado' 6-max (real money) Seat #6 is the button
Seat 1: Fried Berg (1.08€)
Seat 2: Zard.Oz (2.67€)
Seat 3: DaniRama (2.39€)
Seat 4: Brants 95 (1.65€)
Seat 5: KON-2-PEUTE (3.41€)
Seat 6: Tofini (2.03€)
*** ANTE/BLINDS ***
Fried Berg posts small blind 0.01€
Zard.Oz posts big blind 0.02€
Dealt to Fried Berg [2h 9s]
*** PRE-FLOP *** 
DaniRama folds
Brants 95 folds
KON-2-PEUTE folds
Tofini raises 0.03€ to 0.05€
Fried Berg folds
Zard.Oz calls 0.03€
*** FLOP *** [Ac Td 8d]
Zard.Oz checks
Tofini checks
*** TURN *** [Ac Td 8d][7h]
Zard.Oz checks
Tofini bets 0.04€
Zard.Oz folds
Tofini collected 0.14€ from pot
*** SUMMARY ***
Total pot 0.14€ | Rake 0.01€
Board: [Ac Td 8d 7h]
Seat 6: Tofini (button) won 0.14€


Winamax Poker - HOLD-UP "Colorado" - HandId: #19116069-785585-1701776615 - Holdem no limit (0.01€/0.02€) - 2023/12/05 11:43:35 UTC
Table: 'Colorado' 6-max (real money) Seat #6 is the button
Seat 1: Fried Berg (1.07€)
Seat 2: Samuelillo07 (2€)
Seat 3: Fran1Oller (2.53€)
Seat 4: EDPR (2.01€)
Seat 5: narcam01 (0.41€)
Seat 6: JeSuisTonFis (4.85€)
*** ANTE/BLINDS ***
Fried Berg posts small blind 0.01€
Samuelillo07 posts big blind 0.02€
Dealt to Fried Berg [6s Jd]
*** PRE-FLOP *** 
Fran1Oller folds
EDPR folds
narcam01 calls 0.02€
JeSuisTonFis raises 0.06€ to 0.08€
Fried Berg folds
Samuelillo07 folds
narcam01 folds
JeSuisTonFis collected 0.13€ from pot
*** SUMMARY ***
Total pot 0.13€ | No rake
Seat 6: JeSuisTonFis (button) won 0.13€


Winamax Poker - HOLD-UP "Colorado" - HandId: #19116069-785593-1701776621 - Holdem no limit (0.01€/0.02€) - 2023/12/05 11:43:41 UTC
Table: 'Colorado' 6-max (real money) Seat #6 is the button
Seat 1: GTO-Mieko (2.01€)
Seat 2: F.k.theriver (1.28€)
Seat 3: Fried Berg (1.06€)
Seat 4: Joan009 (2.25€)
Seat 5: Brants 95 (0.56€)
Seat 6: DoctorBlack (5.54€)
*** ANTE/BLINDS ***
GTO-Mieko posts small blind 0.01€
F.k.theriver posts big blind 0.02€
Dealt to Fried Berg [Js 4h]
*** PRE-FLOP *** 
Fried Berg folds
Joan009 folds
Brants 95 folds
DoctorBlack raises 0.03€ to 0.05€
GTO-Mieko folds
F.k.theriver folds
DoctorBlack collected 0.08€ from pot
*** SUMMARY ***
Total pot 0.08€ | No rake
Seat 6: DoctorBlack (button) won 0.08€


Winamax Poker - HOLD-UP "Colorado" - HandId: #19116069-785596-1701776622 - Holdem no limit (0.01€/0.02€) - 2023/12/05 11:43:42 UTC
Table: 'Colorado' 6-max (real money) Seat #6 is the button
Seat 1: Brants 95 (0.56€)
Seat 2: Fried Berg (1.06€)
Seat 3: Anme41 (3.68€)
Seat 4: nico033 (1.67€)
Seat 5: GTO-Mieko (2€)
Seat 6: Fran1Oller (2.53€)
*** ANTE/BLINDS ***
Brants 95 posts small blind 0.01€
Fried Berg posts big blind 0.02€
Dealt to Fried Berg [4h Qc]
*** PRE-FLOP *** 
Anme41 folds
nico033 raises 0.03€ to 0.05€
GTO-Mieko folds
Fran1Oller folds
Brants 95 folds
Fried Berg folds
nico033 collected 0.08€ from pot
*** SUMMARY ***
Total pot 0.08€ | No rake
Seat 4: nico033 won 0.08€


Winamax Poker - HOLD-UP "Colorado" - HandId: #19116069-785610-1701776631 - Holdem no limit (0.01€/0.02€) - 2023/12/05 11:43:51 UTC
Table: 'Colorado' 6-max (real money) Seat #6 is the button
Seat 1: AMBM2729 (2.13€)
Seat 2: XxTeamxX (2.10€)
Seat 3: Richard Reuk (3.79€)
Seat 4: Fried Berg (1.04€)
Seat 5: Jesperord98 (2.22€)
Seat 6: K2Shi (5.71€)
Hold-up to Pot: total 0.10€
*** ANTE/BLINDS ***
AMBM2729 posts small blind 0.01€
XxTeamxX posts big blind 0.02€
Dealt to Fried Berg [8s 5h]
*** PRE-FLOP *** 
Richard Reuk folds
Fried Berg folds
Jesperord98 folds
K2Shi folds
AMBM2729 folds
XxTeamxX collected 0.13€ from pot
*** SUMMARY ***
Total pot 0.13€ | No rake
Seat 2: XxTeamxX (big blind) won 0.13€


Winamax Poker - HOLD-UP "Colorado" - HandId: #19116069-785622-1701776638 - Holdem no limit (0.01€/0.02€) - 2023/12/05 11:43:58 UTC
Table: 'Colorado' 6-max (real money) Seat #6 is the button
Seat 1: Br3izh_P0k3r (2€)
Seat 2: GuizouOmFada (4.77€)
Seat 3: F.k.theriver (1.25€)
Seat 4: Samuelillo07 (2.03€)
Seat 5: Fried Berg (1.04€)
Seat 6: popoche29 (3.80€)
*** ANTE/BLINDS ***
Br3izh_P0k3r posts small blind 0.01€
GuizouOmFada posts big blind 0.02€
Dealt to Fried Berg [Ac 7d]
*** PRE-FLOP *** 
F.k.theriver folds
Samuelillo07 folds
Fried Berg raises 0.02€ to 0.04€
popoche29 calls 0.04€
Br3izh_P0k3r folds
GuizouOmFada calls 0.02€
*** FLOP *** [Js 7h 3s]
GuizouOmFada bets 0.13€
Fried Berg folds
popoche29 folds
GuizouOmFada collected 0.25€ from pot
*** SUMMARY ***
Total pot 0.25€ | Rake 0.01€
Board: [Js 7h 3s]
Seat 2: GuizouOmFada (big blind) won 0.25€


Winamax Poker - HOLD-UP "Colorado" - HandId: #19116069-785669-1701776664 - Holdem no limit (0.01€/0.02€) - 2023/12/05 11:44:24 UTC
Table: 'Colorado' 6-max (real money) Seat #6 is the button
Seat 1: Chanclaveloz (2€)
Seat 2: KON-2-PEUTE (2.02€)
Seat 3: EDPR (2.85€)
Seat 4: Samuelillo07 (2.04€)
Seat 5: Brants 95 (1.62€)
Seat 6: Fried Berg (1€)
*** ANTE/BLINDS ***
Chanclaveloz posts small blind 0.01€
KON-2-PEUTE posts big blind 0.02€
Dealt to Fried Berg [Td 2h]
*** PRE-FLOP *** 
EDPR folds
Samuelillo07 folds
Brants 95 folds
Fried Berg folds
Chanclaveloz folds
KON-2-PEUTE collected 0.03€ from pot
*** SUMMARY ***
Total pot 0.03€ | No rake
Seat 2: KON-2-PEUTE (big blind) won 0.03€


Winamax Poker - HOLD-UP "Colorado" - HandId: #19116069-785679-1701776668 - Holdem no limit (0.01€/0.02€) - 2023/12/05 11:44:28 UTC
Table: 'Colorado' 6-max (real money) Seat #6 is the button
Seat 1: YellowStarVl (2€)
Seat 2: Delmore (5.37€)
Seat 3: Fried Berg (1€)
Seat 4: EDPR (2.85€)
Seat 5: Richard Reuk (3.80€)
Seat 6: kRaSsNy (2.03€)
*** ANTE/BLINDS ***
YellowStarVl posts small blind 0.01€
Delmore posts big blind 0.02€
Dealt to Fried Berg [8h 8c]
*** PRE-FLOP *** 
Fried Berg raises 0.02€ to 0.04€
EDPR folds
Richard Reuk calls 0.04€
kRaSsNy folds
YellowStarVl calls 0.03€
Delmore folds
*** FLOP *** [2d 3c 3s]
YellowStarVl checks
Fried Berg bets 0.12€
Richard Reuk folds
YellowStarVl raises 0.38€ to 0.50€
Fried Berg folds
YellowStarVl collected 0.72€ from pot
*** SUMMARY ***
Total pot 0.72€ | Rake 0.04€
Board: [2d 3c 3s]
Seat 1: YellowStarVl (small blind) won 0.72€


Winamax Poker - HOLD-UP "Colorado" - HandId: #19116069-785750-1701776719 - Holdem no limit (0.01€/0.02€) - 2023/12/05 11:45:19 UTC
Table: 'Colorado' 6-max (real money) Seat #6 is the button
Seat 1: Fried Berg (0.84€)
Seat 2: EDPR (2€)
Seat 3: Le_zigauto (2.32€)
Seat 4: Samuelillo07 (2€)
Seat 5: Tofini (2.06€)
Seat 6: Annemarie66 (0.41€)
*** ANTE/BLINDS ***
Fried Berg posts small blind 0.01€
EDPR posts big blind 0.02€
Dealt to Fried Berg [4d Qd]
*** PRE-FLOP *** 
Le_zigauto folds
Samuelillo07 folds
Tofini folds
Annemarie66 folds
Fried Berg raises 0.02€ to 0.04€
EDPR calls 0.02€
*** FLOP *** [Th 2h 8c]
Fried Berg checks
EDPR bets 0.05€
Fried Berg folds
EDPR collected 0.12€ from pot
*** SUMMARY ***
Total pot 0.12€ | Rake 0.01€
Board: [Th 2h 8c]
Seat 2: EDPR (big blind) won 0.12€


Winamax Poker - HOLD-UP "Colorado" - HandId: #19116069-785816-1701776757 - Holdem no limit (0.01€/0.02€) - 2023/12/05 11:45:57 UTC
Table: 'Colorado' 6-max (real money) Seat #6 is the button
Seat 1: Fran1Oller (2€)
Seat 2: Delpierrot10 (2.45€)
Seat 3: Roberfrk (2.58€)
Seat 4: Fried Berg (0.80€)
Seat 5: Anme41 (4.10€)
Seat 6: Raggamin (2.42€)
*** ANTE/BLINDS ***
Fran1Oller posts small blind 0.01€
Delpierrot10 posts big blind 0.02€
Dealt to Fried Berg [6h Tc]
*** PRE-FLOP *** 
Roberfrk folds
Fried Berg folds
Anme41 folds
Raggamin folds
Fran1Oller folds
Delpierrot10 collected 0.03€ from pot
*** SUMMARY ***
Total pot 0.03€ | No rake
Seat 2: Delpierrot10 (big blind) won 0.03€


Winamax Poker - HOLD-UP "Colorado" - HandId: #19116069-785823-1701776762 - Holdem no limit (0.01€/0.02€) - 2023/12/05 11:46:02 UTC
Table: 'Colorado' 6-max (real money) Seat #6 is the button
Seat 1: Polanskii (2.65€)
Seat 2: sandrine1983 (2€)
Seat 3: Brants 95 (1.52€)
Seat 4: D_A_R_K_ (2.29€)
Seat 5: livthe34 (1.31€)
Seat 6: Fried Berg (0.80€)
*** ANTE/BLINDS ***
Polanskii posts small blind 0.01€
sandrine1983 posts big blind 0.02€
Dealt to Fried Berg [6c As]
*** PRE-FLOP *** 
Brants 95 folds
D_A_R_K_ folds
livthe34 folds
Fried Berg raises 0.02€ to 0.04€
Polanskii folds
sandrine1983 calls 0.02€
*** FLOP *** [3s 3c 9d]
sandrine1983 checks
Fried Berg bets 0.04€
sandrine1983 folds
Fried Berg collected 0.12€ from pot
*** SUMMARY ***
Total pot 0.12€ | Rake 0.01€
Board: [3s 3c 9d]
Seat 6: Fried Berg (button) won 0.12€


Winamax Poker - HOLD-UP "Colorado" - HandId: #19116069-785897-1701776809 - Holdem no limit (0.01€/0.02€) - 2023/12/05 11:46:49 UTC
Table: 'Colorado' 6-max (real money) Seat #6 is the button
Seat 1: Jojo-andros5 (0.95€)
Seat 2: Joan009 (2€)
Seat 3: Marto69 (3.02€)
Seat 4: Pierrof24 (1.21€)
Seat 5: YellowStarVl (2.24€)
Seat 6: Fried Berg (0.84€)
*** ANTE/BLINDS ***
Jojo-andros5 posts small blind 0.01€
Joan009 posts big blind 0.02€
Dealt to Fried Berg [Qs 7d]
*** PRE-FLOP *** 
Marto69 raises 0.04€ to 0.06€
Pierrof24 folds
YellowStarVl folds
Fried Berg folds
Jojo-andros5 folds
Joan009 folds
Marto69 collected 0.09€ from pot
*** SUMMARY ***
Total pot 0.09€ | No rake
Seat 3: Marto69 won 0.09€


Winamax Poker - HOLD-UP "Colorado" - HandId: #19116069-785919-1701776821 - Holdem no limit (0.01€/0.02€) - 2023/12/05 11:47:01 UTC
Table: 'Colorado' 6-max (real money) Seat #6 is the button
Seat 1: Tofini (2.26€)
Seat 2: Fried Berg (0.84€)
Seat 3: livthe34 (1.26€)
Seat 4: antoclem2A (0.69€)
Seat 5: Clochitte974 (1.26€)
Seat 6: franrapid (2.84€)
*** ANTE/BLINDS ***
Tofini posts small blind 0.01€
Fried Berg posts big blind 0.02€
Dealt to Fried Berg [9s Kd]
*** PRE-FLOP *** 
livthe34 folds
antoclem2A raises 0.03€ to 0.05€
Clochitte974 calls 0.05€
franrapid folds
Tofini folds
Fried Berg folds
*** FLOP *** [8c Qd 7d]
antoclem2A bets 0.08€
Clochitte974 raises 0.16€ to 0.24€
antoclem2A raises 0.40€ to 0.64€ and is all-in
Clochitte974 calls 0.40€
*** TURN *** [8c Qd 7d][3h]
*** RIVER *** [8c Qd 7d 3h][7c]
*** SHOW DOWN ***
Clochitte974 shows [Ks Qc] (Two pairs : Queens and 7)
antoclem2A shows [Ah 7h] (Trips of 7)
antoclem2A collected 1.27€ from pot
*** SUMMARY ***
Total pot 1.27€ | Rake 0.14€
Board: [8c Qd 7d 3h 7c]
Seat 4: antoclem2A showed [Ah 7h] and won 1.27€ with Trips of 7
Seat 5: Clochitte974 showed [Ks Qc] and lost with Two pairs : Queens and 7


Winamax Poker - HOLD-UP "Colorado" - HandId: #19116069-785924-1701776823 - Holdem no limit (0.01€/0.02€) - 2023/12/05 11:47:03 UTC
Table: 'Colorado' 6-max (real money) Seat #6 is the button
Seat 1: Fried Berg (0.82€)
Seat 2: Melielvir (1.31€)
Seat 3: Samuelillo07 (2€)
Seat 4: sandrine1983 (1.95€)
Seat 5: Br3izh_P0k3r (2.34€)
Seat 6: Jesperord98 (2.50€)
*** ANTE/BLINDS ***
Fried Berg posts small blind 0.01€
Melielvir posts big blind 0.02€
Dealt to Fried Berg [4h 8c]
*** PRE-FLOP *** 
Samuelillo07 folds
sandrine1983 calls 0.02€
Br3izh_P0k3r folds
Jesperord98 folds
Fried Berg folds
Melielvir checks
*** FLOP *** [Jd 7s Ad]
Melielvir checks
sandrine1983 bets 0.03€
Melielvir folds
sandrine1983 collected 0.07€ from pot
*** SUMMARY ***
Total pot 0.07€ | Rake 0.01€
Board: [Jd 7s Ad]
Seat 4: sandrine1983 won 0.07€


Winamax Poker - HOLD-UP "Colorado" - HandId: #19116069-785939-1701776832 - Holdem no limit (0.01€/0.02€) - 2023/12/05 11:47:12 UTC
Table: 'Colorado' 6-max (real money) Seat #6 is the button
Seat 1: AlexxTorres (0.96€)
Seat 2: Fried Berg (0.81€)
Seat 3: tprosper (1.38€)
Seat 4: Roberfrk (1.47€)
Seat 5: Dulcran (2.71€)
Seat 6: EDPR (3.65€)
*** ANTE/BLINDS ***
AlexxTorres posts small blind 0.01€
Fried Berg posts big blind 0.02€
Dealt to Fried Berg [6s 9d]
*** PRE-FLOP *** 
tprosper folds
Roberfrk folds
Dulcran folds
EDPR folds
AlexxTorres folds
Fried Berg collected 0.03€ from pot
*** SUMMARY ***
Total pot 0.03€ | No rake
Seat 2: Fried Berg (big blind) won 0.03€


Winamax Poker - HOLD-UP "Colorado" - HandId: #19116069-785953-1701776840 - Holdem no limit (0.01€/0.02€) - 2023/12/05 11:47:20 UTC
Table: 'Colorado' 6-max (real money) Seat #6 is the button
Seat 1: YellowStarVl (2.01€)
Seat 2: Zard.Oz (2.60€)
Seat 3: Stimulus (2.48€)
Seat 4: Fried Berg (0.82€)
Seat 5: Wabule23 (2.84€)
Seat 6: Delpierrot10 (2.45€)
*** ANTE/BLINDS ***
YellowStarVl posts small blind 0.01€
Zard.Oz posts big blind 0.02€
Dealt to Fried Berg [9h 6d]
*** PRE-FLOP *** 
Stimulus raises 0.02€ to 0.04€
Fried Berg folds
Wabule23 folds
Delpierrot10 folds
YellowStarVl folds
Zard.Oz calls 0.02€
*** FLOP *** [3h 2h 5c]
Zard.Oz checks
Stimulus bets 0.03€
Zard.Oz raises 0.09€ to 0.12€
Stimulus calls 0.09€
*** TURN *** [3h 2h 5c][6s]
Zard.Oz checks
Stimulus checks
*** RIVER *** [3h 2h 5c 6s][Kh]
Zard.Oz checks
Stimulus checks
*** SHOW DOWN ***
Stimulus shows [Tc Qc] (High card : King)
Zard.Oz shows [6c 5d] (Two pairs : 6 and 5)
Zard.Oz collected 0.30€ from pot
*** SUMMARY ***
Total pot 0.30€ | Rake 0.03€
Board: [3h 2h 5c 6s Kh]
Seat 2: Zard.Oz (big blind) showed [6c 5d] and won 0.30€ with Two pairs : 6 and 5
Seat 3: Stimulus showed [Tc Qc] and lost with High card : King


Winamax Poker - HOLD-UP "Colorado" - HandId: #19116069-785961-1701776846 - Holdem no limit (0.01€/0.02€) - 2023/12/05 11:47:26 UTC
Table: 'Colorado' 6-max (real money) Seat #6 is the button
Seat 1: Raggamin (2.89€)
Seat 2: Clochitte974 (0.57€)
Seat 3: EDPR (2€)
Seat 4: Brut2pok (5.50€)
Seat 5: GTO-Mieko (2.12€)
Seat 6: Fried Berg (0.82€)
*** ANTE/BLINDS ***
Raggamin posts small blind 0.01€
Clochitte974 posts big blind 0.02€
Dealt to Fried Berg [5d Ah]
*** PRE-FLOP *** 
EDPR folds
Brut2pok folds
GTO-Mieko folds
Fried Berg raises 0.02€ to 0.04€
Raggamin folds
Clochitte974 calls 0.02€
*** FLOP *** [4c 9s Tc]
Clochitte974 checks
Fried Berg checks
*** TURN *** [4c 9s Tc][3c]
Clochitte974 checks
Fried Berg checks
*** RIVER *** [4c 9s Tc 3c][Td]
Clochitte974 bets 0.09€
Fried Berg calls 0.09€
*** SHOW DOWN ***
Clochitte974 shows [5s Qs] (One pair : Tens)
Fried Berg shows [5d Ah] (One pair : Tens)
Fried Berg collected 0.24€ from pot
*** SUMMARY ***
Total pot 0.24€ | Rake 0.03€
Board: [4c 9s Tc 3c Td]
Seat 2: Clochitte974 (big blind) showed [5s Qs] and lost with One pair : Tens
Seat 6: Fried Berg (button) showed [5d Ah] and won 0.24€ with One pair : Tens


Winamax Poker - HOLD-UP "Colorado" - HandId: #19116069-786053-1701776899 - Holdem no limit (0.01€/0.02€) - 2023/12/05 11:48:19 UTC
Table: 'Colorado' 6-max (real money) Seat #6 is the button
Seat 1: Clochitte974 (0.44€)
Seat 2: Chanclaveloz (5.57€)
Seat 3: Fcgb_2907 (0.76€)
Seat 4: Jimbiosis (3.35€)
Seat 5: metamex (1.91€)
Seat 6: Fried Berg (0.93€)
*** ANTE/BLINDS ***
Clochitte974 posts small blind 0.01€
Chanclaveloz posts big blind 0.02€
Dealt to Fried Berg [Js 8s]
*** PRE-FLOP *** 
Fcgb_2907 calls 0.02€
Jimbiosis folds
metamex calls 0.02€
Fried Berg raises 0.02€ to 0.04€
Clochitte974 folds
Chanclaveloz folds
Fcgb_2907 calls 0.02€
metamex calls 0.02€
*** FLOP *** [7d 4s 7c]
Fcgb_2907 checks
metamex checks
Fried Berg checks
*** TURN *** [7d 4s 7c][Ks]
Fcgb_2907 checks
metamex checks
Fried Berg checks
*** RIVER *** [7d 4s 7c Ks][2h]
Fcgb_2907 checks
metamex bets 0.08€
Fried Berg folds
Fcgb_2907 folds
metamex collected 0.21€ from pot
*** SUMMARY ***
Total pot 0.21€ | Rake 0.02€
Board: [7d 4s 7c Ks 2h]
Seat 5: metamex won 0.21€


Winamax Poker - HOLD-UP "Colorado" - HandId: #19116069-786137-1701776952 - Holdem no limit (0.01€/0.02€) - 2023/12/05 11:49:12 UTC
Table: 'Colorado' 6-max (real money) Seat #6 is the button
Seat 1: Fried Berg (0.89€)
Seat 2: ForasteroTT (2€)
Seat 3: Fran1Oller (2€)
Seat 4: EB Matador72 (1.78€)
Seat 5: gitPush (2.75€)
Seat 6: Redemption90 (2€)
*** ANTE/BLINDS ***
Fried Berg posts small blind 0.01€
ForasteroTT posts big blind 0.02€
Dealt to Fried Berg [9s 8s]
*** PRE-FLOP *** 
Fran1Oller folds
EB Matador72 folds
gitPush folds
Redemption90 folds
Fried Berg raises 0.02€ to 0.04€
ForasteroTT folds
Fried Berg collected 0.06€ from pot
*** SUMMARY ***
Total pot 0.06€ | No rake
Seat 1: Fried Berg (small blind) won 0.06€


Winamax Poker - HOLD-UP "Colorado" - HandId: #19116069-786170-1701776968 - Holdem no limit (0.01€/0.02€) - 2023/12/05 11:49:28 UTC
Table: 'Colorado' 6-max (real money) Seat #6 is the button
Seat 1: SirX (2€)
Seat 2: Yanmya33 (3.10€)
Seat 3: RaseOnYou (2.15€)
Seat 4: PoissonC (1.34€)
Seat 5: Fried Berg (0.91€)
Seat 6: Tehufred (2€)
*** ANTE/BLINDS ***
SirX posts small blind 0.01€
Yanmya33 posts big blind 0.02€
Dealt to Fried Berg [4s As]
*** PRE-FLOP *** 
RaseOnYou folds
PoissonC raises 0.04€ to 0.06€
Fried Berg calls 0.06€
Tehufred folds
SirX raises 1.94€ to 2€ and is all-in
Yanmya33 folds
PoissonC folds
Fried Berg folds
SirX collected 2.14€ from pot
*** SUMMARY ***
Total pot 2.14€ | No rake
Seat 1: SirX (small blind) won 2.14€


Winamax Poker - HOLD-UP "Colorado" - HandId: #19116069-786212-1701776994 - Holdem no limit (0.01€/0.02€) - 2023/12/05 11:49:54 UTC
Table: 'Colorado' 6-max (real money) Seat #6 is the button
Seat 1: Raggamin (2.05€)
Seat 2: G0R0N11 (2.76€)
Seat 3: Fried Berg (0.85€)
Seat 4: Tofini (2.97€)
Seat 5: GTO-Mieko (2.40€)
Seat 6: dadou13100 (2.33€)
*** ANTE/BLINDS ***
Raggamin posts small blind 0.01€
G0R0N11 posts big blind 0.02€
Dealt to Fried Berg [6s 7d]
*** PRE-FLOP *** 
Fried Berg folds
Tofini folds
GTO-Mieko folds
dadou13100 folds
Raggamin folds
G0R0N11 collected 0.03€ from pot
*** SUMMARY ***
Total pot 0.03€ | No rake
Seat 2: G0R0N11 (big blind) won 0.03€


Winamax Poker - HOLD-UP "Colorado" - HandId: #19116069-786219-1701776997 - Holdem no limit (0.01€/0.02€) - 2023/12/05 11:49:57 UTC
Table: 'Colorado' 6-max (real money) Seat #6 is the button
Seat 1: Pierrof24 (1.63€)
Seat 2: Fried Berg (0.85€)
Seat 3: Chanclaveloz (4.10€)
Seat 4: Ertorko (2.62€)
Seat 5: Le_zigauto (2.37€)
Seat 6: EDPR (3.82€)
*** ANTE/BLINDS ***
Pierrof24 posts small blind 0.01€
Fried Berg posts big blind 0.02€
Dealt to Fried Berg [Kc 9s]
*** PRE-FLOP *** 
Chanclaveloz folds
Ertorko folds
Le_zigauto folds
EDPR folds
Pierrof24 raises 0.02€ to 0.04€
Fried Berg calls 0.02€
*** FLOP *** [5h Tc Ks]
Pierrof24 checks
Fried Berg bets 0.04€
Pierrof24 folds
Fried Berg collected 0.11€ from pot
*** SUMMARY ***
Total pot 0.11€ | Rake 0.01€
Board: [5h Tc Ks]
Seat 2: Fried Berg (big blind) won 0.11€


Winamax Poker - HOLD-UP "Colorado" - HandId: #19116069-786298-1701777037 - Holdem no limit (0.01€/0.02€) - 2023/12/05 11:50:37 UTC
Table: 'Colorado' 6-max (real money) Seat #6 is the button
Seat 1: Delpierrot10 (2.27€)
Seat 2: Pocho7 (2.68€)
Seat 3: Fcgb_2907 (0.66€)
Seat 4: KON-2-PEUTE (3.38€)
Seat 5: Fried Berg (0.88€)
Seat 6: G0R0N11 (2.77€)
*** ANTE/BLINDS ***
Delpierrot10 posts small blind 0.01€
Pocho7 posts big blind 0.02€
Dealt to Fried Berg [2h 2s]
*** PRE-FLOP *** 
Fcgb_2907 raises 0.04€ to 0.06€
KON-2-PEUTE folds
Fried Berg folds
G0R0N11 folds
Delpierrot10 calls 0.05€
Pocho7 folds
*** FLOP *** [5h 7h Jh]
Delpierrot10 checks
Fcgb_2907 bets 0.05€
Delpierrot10 folds
Fcgb_2907 collected 0.18€ from pot
*** SUMMARY ***
Total pot 0.18€ | Rake 0.01€
Board: [5h 7h Jh]
Seat 3: Fcgb_2907 won 0.18€


Winamax Poker - HOLD-UP "Colorado" - HandId: #19116069-786326-1701777050 - Holdem no limit (0.01€/0.02€) - 2023/12/05 11:50:50 UTC
Table: 'Colorado' 6-max (real money) Seat #6 is the button
Seat 1: Ice945 (1.91€)
Seat 2: gitPush (2.69€)
Seat 3: Fried Berg (0.88€)
Seat 4: Dulcran (1.86€)
Seat 5: Pocho7 (2.64€)
Seat 6: Ertorko (2.73€)
*** ANTE/BLINDS ***
Ice945 posts small blind 0.01€
gitPush posts big blind 0.02€
Dealt to Fried Berg [Qh 7h]
*** PRE-FLOP *** 
Fried Berg raises 0.02€ to 0.04€
Dulcran folds
Pocho7 folds
Ertorko raises 0.10€ to 0.14€
Ice945 folds
gitPush folds
Fried Berg folds
Ertorko collected 0.21€ from pot
*** SUMMARY ***
Total pot 0.21€ | No rake
Seat 6: Ertorko (button) won 0.21€


Winamax Poker - HOLD-UP "Colorado" - HandId: #19116069-786378-1701777079 - Holdem no limit (0.01€/0.02€) - 2023/12/05 11:51:19 UTC
Table: 'Colorado' 6-max (real money) Seat #6 is the button
Seat 1: kamoulox_93 (1.57€)
Seat 2: AMBM2729 (1.20€)
Seat 3: DaniRama (2.25€)
Seat 4: Fried Berg (0.84€)
Seat 5: OjoAlTejo (1.46€)
Seat 6: ForasteroTT (2€)
*** ANTE/BLINDS ***
kamoulox_93 posts small blind 0.01€
AMBM2729 posts big blind 0.02€
Dealt to Fried Berg [6d As]
*** PRE-FLOP *** 
DaniRama folds
Fried Berg raises 0.02€ to 0.04€
OjoAlTejo folds
ForasteroTT folds
kamoulox_93 folds
AMBM2729 folds
Fried Berg collected 0.07€ from pot
*** SUMMARY ***
Total pot 0.07€ | No rake
Seat 4: Fried Berg won 0.07€


Winamax Poker - HOLD-UP "Colorado" - HandId: #19116069-786435-1701777111 - Holdem no limit (0.01€/0.02€) - 2023/12/05 11:51:51 UTC
Table: 'Colorado' 6-max (real money) Seat #6 is the button
Seat 1: Fried Berg (0.87€)
Seat 2: GTO-Mieko (2.43€)
Seat 3: Itashi.95 (1.70€)
Seat 4: YellowStarVl (2.03€)
Seat 5: lefraisier (2.67€)
Seat 6: nico033 (1.68€)
*** ANTE/BLINDS ***
Fried Berg posts small blind 0.01€
GTO-Mieko posts big blind 0.02€
Dealt to Fried Berg [5c 7s]
*** PRE-FLOP *** 
Itashi.95 folds
YellowStarVl folds
lefraisier folds
nico033 folds
Fried Berg folds
GTO-Mieko collected 0.03€ from pot
*** SUMMARY ***
Total pot 0.03€ | No rake
Seat 2: GTO-Mieko (big blind) won 0.03€


Winamax Poker - HOLD-UP "Colorado" - HandId: #19116069-786487-1701777135 - Holdem no limit (0.01€/0.02€) - 2023/12/05 11:52:15 UTC
Table: 'Colorado' 6-max (real money) Seat #6 is the button
Seat 1: DaniRama (2.23€)
Seat 2: JeSuisTonFis (4.49€)
Seat 3: Raggamin (2.03€)
Seat 4: Fried Berg (0.86€)
Seat 5: Brut2pok (3.66€)
Seat 6: Itashi.95 (1.70€)
*** ANTE/BLINDS ***
DaniRama posts small blind 0.01€
JeSuisTonFis posts big blind 0.02€
Dealt to Fried Berg [Qs Jc]
*** PRE-FLOP *** 
Raggamin folds
Fried Berg raises 0.02€ to 0.04€
Brut2pok folds
Itashi.95 folds
DaniRama folds
JeSuisTonFis calls 0.02€
*** FLOP *** [Td 2h 4d]
JeSuisTonFis checks
Fried Berg checks
*** TURN *** [Td 2h 4d][9c]
JeSuisTonFis bets 0.07€
Fried Berg folds
JeSuisTonFis collected 0.15€ from pot
*** SUMMARY ***
Total pot 0.15€ | Rake 0.01€
Board: [Td 2h 4d 9c]
Seat 2: JeSuisTonFis (big blind) won 0.15€


Winamax Poker - HOLD-UP "Colorado" - HandId: #19116069-786564-1701777178 - Holdem no limit (0.01€/0.02€) - 2023/12/05 11:52:58 UTC
Table: 'Colorado' 6-max (real money) Seat #6 is the button
Seat 1: Tofini (2€)
Seat 2: Br3izh_P0k3r (4.72€)
Seat 3: Fried Berg (0.82€)
Seat 4: RaseOnYou (1.87€)
Seat 5: _Sephi (4.44€)
Seat 6: JissEl1te (5.89€)
*** ANTE/BLINDS ***
Tofini posts small blind 0.01€
Br3izh_P0k3r posts big blind 0.02€
Dealt to Fried Berg [6d 7h]
*** PRE-FLOP *** 
Fried Berg folds
RaseOnYou raises 0.02€ to 0.04€
_Sephi folds
JissEl1te folds
Tofini folds
Br3izh_P0k3r folds
RaseOnYou collected 0.07€ from pot
*** SUMMARY ***
Total pot 0.07€ | No rake
Seat 4: RaseOnYou won 0.07€


Winamax Poker - HOLD-UP "Colorado" - HandId: #19116069-786572-1701777182 - Holdem no limit (0.01€/0.02€) - 2023/12/05 11:53:02 UTC
Table: 'Colorado' 6-max (real money) Seat #6 is the button
Seat 1: Chanclaveloz (3.93€)
Seat 2: Fried Berg (0.82€)
Seat 3: sandrine1983 (0.67€)
Seat 4: Yanmya33 (3.12€)
Seat 5: GTO-Mieko (2.09€)
Seat 6: G0R0N11 (2.63€)
*** ANTE/BLINDS ***
Chanclaveloz posts small blind 0.01€
Fried Berg posts big blind 0.02€
Dealt to Fried Berg [6s 6h]
*** PRE-FLOP *** 
sandrine1983 calls 0.02€
Yanmya33 calls 0.02€
GTO-Mieko folds
G0R0N11 folds
Chanclaveloz folds
Fried Berg raises 0.10€ to 0.12€
sandrine1983 folds
Yanmya33 folds
Fried Berg collected 0.17€ from pot
*** SUMMARY ***
Total pot 0.17€ | No rake
Seat 2: Fried Berg (big blind) won 0.17€


Winamax Poker - HOLD-UP "Colorado" - HandId: #19116069-786638-1701777212 - Holdem no limit (0.01€/0.02€) - 2023/12/05 11:53:32 UTC
Table: 'Colorado' 6-max (real money) Seat #6 is the button
Seat 1: AMBM2729 (1.21€)
Seat 2: Dulcran (2.96€)
Seat 3: YellowStarVl (2.11€)
Seat 4: cmoijp1721 (2.13€)
Seat 5: sandrine1983 (0.65€)
Seat 6: Fried Berg (0.87€)
*** ANTE/BLINDS ***
AMBM2729 posts small blind 0.01€
Dulcran posts big blind 0.02€
Dealt to Fried Berg [4h Th]
*** PRE-FLOP *** 
YellowStarVl folds
cmoijp1721 folds
sandrine1983 folds
Fried Berg folds
AMBM2729 folds
Dulcran collected 0.03€ from pot
*** SUMMARY ***
Total pot 0.03€ | No rake
Seat 2: Dulcran (big blind) won 0.03€


Winamax Poker - HOLD-UP "Colorado" - HandId: #19116069-786657-1701777222 - Holdem no limit (0.01€/0.02€) - 2023/12/05 11:53:42 UTC
Table: 'Colorado' 6-max (real money) Seat #6 is the button
Seat 1: antoniusivey (0.58€)
Seat 2: JFSredbaron (2.20€)
Seat 3: Samuelillo07 (2.52€)
Seat 4: Fried Berg (0.87€)
Seat 5: DigBick99 (2€)
Seat 6: Polanskii (5.71€)
*** ANTE/BLINDS ***
antoniusivey posts small blind 0.01€
JFSredbaron posts big blind 0.02€
Dealt to Fried Berg [6s 3s]
*** PRE-FLOP *** 
Samuelillo07 folds
Fried Berg folds
DigBick99 folds
Polanskii folds
antoniusivey calls 0.01€
JFSredbaron raises 0.04€ to 0.06€
antoniusivey calls 0.04€
*** FLOP *** [4c Jh 9h]
antoniusivey checks
JFSredbaron bets 0.08€
antoniusivey folds
JFSredbaron collected 0.19€ from pot
*** SUMMARY ***
Total pot 0.19€ | Rake 0.01€
Board: [4c Jh 9h]
Seat 2: JFSredbaron (big blind) won 0.19€


Winamax Poker - HOLD-UP "Colorado" - HandId: #19116069-786662-1701777224 - Holdem no limit (0.01€/0.02€) - 2023/12/05 11:53:44 UTC
Table: 'Colorado' 6-max (real money) Seat #6 is the button
Seat 1: Fried Berg (0.87€)
Seat 2: kickerace59 (4.41€)
Seat 3: MeR2GPa1rOnd (2.16€)
Seat 4: Joan009 (2€)
Seat 5: Lumayou (2.31€)
Seat 6: DigBick99 (2€)
*** ANTE/BLINDS ***
Fried Berg posts small blind 0.01€
kickerace59 posts big blind 0.02€
Dealt to Fried Berg [3c 5h]
*** PRE-FLOP *** 
MeR2GPa1rOnd folds
Joan009 folds
Lumayou raises 0.03€ to 0.05€
DigBick99 folds
Fried Berg folds
kickerace59 folds
Lumayou collected 0.08€ from pot
*** SUMMARY ***
Total pot 0.08€ | No rake
Seat 5: Lumayou won 0.08€


Winamax Poker - HOLD-UP "Colorado" - HandId: #19116069-786666-1701777226 - Holdem no limit (0.01€/0.02€) - 2023/12/05 11:53:46 UTC
Table: 'Colorado' 6-max (real money) Seat #6 is the button
Seat 1: Samuelillo07 (2.08€)
Seat 2: Syssy43 (2.09€)
Seat 3: Fried Berg (0.86€)
Seat 4: MeR2GPa1rOnd (2.16€)
Seat 5: Stimulus (4.08€)
Seat 6: Br3izh_P0k3r (4.67€)
*** ANTE/BLINDS ***
Samuelillo07 posts small blind 0.01€
Syssy43 posts big blind 0.02€
Dealt to Fried Berg [Kd 5s]
*** PRE-FLOP *** 
Fried Berg folds
MeR2GPa1rOnd folds
Stimulus folds
Br3izh_P0k3r folds
Samuelillo07 folds
Syssy43 collected 0.03€ from pot
*** SUMMARY ***
Total pot 0.03€ | No rake
Seat 2: Syssy43 (big blind) won 0.03€


Winamax Poker - HOLD-UP "Colorado" - HandId: #19116069-786672-1701777228 - Holdem no limit (0.01€/0.02€) - 2023/12/05 11:53:48 UTC
Table: 'Colorado' 6-max (real money) Seat #6 is the button
Seat 1: Delpierrot10 (2.26€)
Seat 2: Fcgb_2907 (0.48€)
Seat 3: Dulcran (2.97€)
Seat 4: Roberfrk (1.90€)
Seat 5: Fried Berg (0.86€)
Seat 6: FisherManF (2.22€)
Hold-up to Pot: total 0.10€
*** ANTE/BLINDS ***
Delpierrot10 posts small blind 0.01€
Fcgb_2907 posts big blind 0.02€
Dealt to Fried Berg [9s Kd]
*** PRE-FLOP *** 
Dulcran folds
Roberfrk calls 0.02€
Fried Berg folds
FisherManF folds
Delpierrot10 calls 0.01€
Fcgb_2907 checks
*** FLOP *** [5c Ah 6c]
Delpierrot10 bets 0.06€
Fcgb_2907 folds
Roberfrk folds
Delpierrot10 collected 0.21€ from pot
*** SUMMARY ***
Total pot 0.21€ | Rake 0.01€
Board: [5c Ah 6c]
Seat 1: Delpierrot10 (small blind) won 0.21€


Winamax Poker - HOLD-UP "Colorado" - HandId: #19116069-786687-1701777235 - Holdem no limit (0.01€/0.02€) - 2023/12/05 11:53:55 UTC
Table: 'Colorado' 6-max (real money) Seat #6 is the button
Seat 1: FenderTolra (2.02€)
Seat 2: Lion 77858 (2.19€)
Seat 3: DaniRama (2.44€)
Seat 4: Fried Berg (0.86€)
Seat 5: MeR2GPa1rOnd (2.15€)
Seat 6: D_A_R_K_ (2€)
*** ANTE/BLINDS ***
FenderTolra posts small blind 0.01€
Lion 77858 posts big blind 0.02€
Dealt to Fried Berg [2d 8d]
*** PRE-FLOP *** 
DaniRama folds
Fried Berg folds
MeR2GPa1rOnd folds
D_A_R_K_ folds
FenderTolra folds
Lion 77858 collected 0.03€ from pot
*** SUMMARY ***
Total pot 0.03€ | No rake
Seat 2: Lion 77858 (big blind) won 0.03€


Winamax Poker - HOLD-UP "Colorado" - HandId: #19116069-786693-1701777238 - Holdem no limit (0.01€/0.02€) - 2023/12/05 11:53:58 UTC
Table: 'Colorado' 6-max (real money) Seat #6 is the button
Seat 1: Br3izh_P0k3r (2.28€)
Seat 2: Fried Berg (0.86€)
Seat 3: joalbralo (2.03€)
Seat 4: Bennnnnn62 (1.01€)
Seat 5: Samuelillo07 (2.50€)
Seat 6: Lumayou (2.34€)
*** ANTE/BLINDS ***
Br3izh_P0k3r posts small blind 0.01€
Fried Berg posts big blind 0.02€
Dealt to Fried Berg [Ah 3d]
*** PRE-FLOP *** 
joalbralo folds
Bennnnnn62 folds
Samuelillo07 folds
Lumayou raises 0.03€ to 0.05€
Br3izh_P0k3r folds
Fried Berg folds
Lumayou collected 0.08€ from pot
*** SUMMARY ***
Total pot 0.08€ | No rake
Seat 6: Lumayou (button) won 0.08€


Winamax Poker - HOLD-UP "Colorado" - HandId: #19116069-786724-1701777254 - Holdem no limit (0.01€/0.02€) - 2023/12/05 11:54:14 UTC
Table: 'Colorado' 6-max (real money) Seat #6 is the button
Seat 1: DonKmillo (1.87€)
Seat 2: Ertorko (2.30€)
Seat 3: Fran1Oller (3.09€)
Seat 4: FenderTolra (2€)
Seat 5: Fried Berg (0.84€)
Seat 6: JissEl1te (6.59€)
*** ANTE/BLINDS ***
DonKmillo posts small blind 0.01€
Ertorko posts big blind 0.02€
Dealt to Fried Berg [3s 6d]
*** PRE-FLOP *** 
Fran1Oller raises 0.04€ to 0.06€
FenderTolra folds
Fried Berg folds
JissEl1te folds
DonKmillo folds
Ertorko folds
Fran1Oller collected 0.09€ from pot
*** SUMMARY ***
Total pot 0.09€ | No rake
Seat 3: Fran1Oller won 0.09€


Winamax Poker - HOLD-UP "Colorado" - HandId: #19116069-786731-1701777258 - Holdem no limit (0.01€/0.02€) - 2023/12/05 11:54:18 UTC
Table: 'Colorado' 6-max (real money) Seat #6 is the button
Seat 1: cmoijp1721 (2.22€)
Seat 2: YellowStarVl (3.52€)
Seat 3: LE DARON40 (0.52€)
Seat 4: Richard Reuk (3.21€)
Seat 5: Fried Berg (0.84€)
Seat 6: G0R0N11 (2.66€)
*** ANTE/BLINDS ***
cmoijp1721 posts small blind 0.01€
YellowStarVl posts big blind 0.02€
Dealt to Fried Berg [Tc 8s]
*** PRE-FLOP *** 
LE DARON40 raises 0.02€ to 0.04€
Richard Reuk folds
Fried Berg folds
G0R0N11 folds
cmoijp1721 folds
YellowStarVl folds
LE DARON40 collected 0.07€ from pot
*** SUMMARY ***
Total pot 0.07€ | No rake
Seat 3: LE DARON40 won 0.07€


Winamax Poker - HOLD-UP "Colorado" - HandId: #19116069-786744-1701777264 - Holdem no limit (0.01€/0.02€) - 2023/12/05 11:54:24 UTC
Table: 'Colorado' 6-max (real money) Seat #6 is the button
Seat 1: Fried Berg (0.84€)
Seat 2: Samuelillo07 (2.10€)
Seat 3: Polanskii (5.71€)
Seat 4: G0R0N11 (2.66€)
Seat 5: Redemption90 (2.12€)
Seat 6: Yanmya33 (3.17€)
Hold-up to Pot: total 0.10€
*** ANTE/BLINDS ***
Fried Berg posts small blind 0.01€
Samuelillo07 posts big blind 0.02€
Dealt to Fried Berg [2d Ad]
*** PRE-FLOP *** 
Polanskii raises 0.04€ to 0.06€
G0R0N11 folds
Redemption90 folds
Yanmya33 folds
Fried Berg raises 0.12€ to 0.18€
Samuelillo07 folds
Polanskii calls 0.12€
*** FLOP *** [3c 7h 9h]
Fried Berg bets 0.66€ and is all-in
Polanskii calls 0.66€
*** TURN *** [3c 7h 9h][7d]
*** RIVER *** [3c 7h 9h 7d][Th]
*** SHOW DOWN ***
Polanskii shows [Qh Ks] (One pair : 7)
Fried Berg shows [2d Ad] (One pair : 7)
Fried Berg collected 1.63€ from pot
*** SUMMARY ***
Total pot 1.63€ | Rake 0.17€
Board: [3c 7h 9h 7d Th]
Seat 1: Fried Berg (small blind) showed [2d Ad] and won 1.63€ with One pair : 7
Seat 3: Polanskii showed [Qh Ks] and lost with One pair : 7


Winamax Poker - HOLD-UP "Colorado" - HandId: #19116069-786820-1701777307 - Holdem no limit (0.01€/0.02€) - 2023/12/05 11:55:07 UTC
Table: 'Colorado' 6-max (real money) Seat #6 is the button
Seat 1: dadou13100 (1.34€)
Seat 2: Durantula_6 (2.44€)
Seat 3: Fried Berg (1.63€)
Seat 4: wax94 (0.37€)
Seat 5: Ice945 (1.97€)
Seat 6: F.k.theriver (1.31€)
*** ANTE/BLINDS ***
dadou13100 posts small blind 0.01€
Durantula_6 posts big blind 0.02€
Dealt to Fried Berg [5h 2d]
*** PRE-FLOP *** 
Fried Berg folds
wax94 folds
Ice945 folds
F.k.theriver folds
dadou13100 folds
Durantula_6 collected 0.03€ from pot
*** SUMMARY ***
Total pot 0.03€ | No rake
Seat 2: Durantula_6 (big blind) won 0.03€


Winamax Poker - HOLD-UP "Colorado" - HandId: #19116069-786843-1701777318 - Holdem no limit (0.01€/0.02€) - 2023/12/05 11:55:18 UTC
Table: 'Colorado' 6-max (real money) Seat #6 is the button
Seat 1: KON-2-PEUTE (3.68€)
Seat 2: Kira17 (2€)
Seat 3: SirX (0.28€)
Seat 4: Le_zigauto (2.65€)
Seat 5: Fried Berg (1.63€)
Seat 6: slowreplay (2€)
*** ANTE/BLINDS ***
KON-2-PEUTE posts small blind 0.01€
Kira17 posts big blind 0.02€
Dealt to Fried Berg [7h Ah]
*** PRE-FLOP *** 
SirX raises 0.26€ to 0.28€ and is all-in
Le_zigauto folds
Fried Berg calls 0.28€
slowreplay folds
KON-2-PEUTE folds
Kira17 calls 0.26€
*** FLOP *** [3c 6s Ad]
Kira17 checks
Fried Berg bets 0.12€
Kira17 folds
*** TURN *** [3c 6s Ad][9d]
*** RIVER *** [3c 6s Ad 9d][5s]
*** SHOW DOWN ***
SirX shows [4c 6c] (One pair : 6)
Fried Berg shows [7h Ah] (One pair : Aces)
Fried Berg collected 0.88€ from pot
*** SUMMARY ***
Total pot 0.88€ | Rake 0.09€
Board: [3c 6s Ad 9d 5s]
Seat 3: SirX showed [4c 6c] and lost with One pair : 6
Seat 5: Fried Berg showed [7h Ah] and won 0.88€ with One pair : Aces


Winamax Poker - HOLD-UP "Colorado" - HandId: #19116069-786935-1701777358 - Holdem no limit (0.01€/0.02€) - 2023/12/05 11:55:58 UTC
Table: 'Colorado' 6-max (real money) Seat #6 is the button
Seat 1: Scooby Doo (2.46€)
Seat 2: Fried Berg (2.11€)
Seat 3: antoniusivey (2€)
Seat 4: Lumayou (2.50€)
Seat 5: dadou13100 (0.83€)
Seat 6: Ertorko (2.15€)
*** ANTE/BLINDS ***
Scooby Doo posts small blind 0.01€
Fried Berg posts big blind 0.02€
Dealt to Fried Berg [5h Jh]
*** PRE-FLOP *** 
antoniusivey calls 0.02€
Lumayou raises 0.03€ to 0.05€
dadou13100 folds
Ertorko folds
Scooby Doo folds
Fried Berg calls 0.03€
antoniusivey calls 0.03€
*** FLOP *** [6s 8c Kd]
Fried Berg checks
antoniusivey checks
Lumayou bets 0.06€
Fried Berg folds
antoniusivey folds
Lumayou collected 0.20€ from pot
*** SUMMARY ***
Total pot 0.20€ | Rake 0.02€
Board: [6s 8c Kd]
Seat 4: Lumayou won 0.20€


Winamax Poker - HOLD-UP "Colorado" - HandId: #19116069-787029-1701777406 - Holdem no limit (0.01€/0.02€) - 2023/12/05 11:56:46 UTC
Table: 'Colorado' 6-max (real money) Seat #6 is the button
Seat 1: JV_Titan0 (4.53€)
Seat 2: Samuelillo07 (2€)
Seat 3: Marto69 (2.14€)
Seat 4: DonKmillo (2.88€)
Seat 5: Zazoe (0.60€)
Seat 6: Fried Berg (2.06€)
*** ANTE/BLINDS ***
JV_Titan0 posts small blind 0.01€
Samuelillo07 posts big blind 0.02€
Dealt to Fried Berg [Jh 8h]
*** PRE-FLOP *** 
Marto69 folds
DonKmillo folds
Zazoe folds
Fried Berg raises 0.02€ to 0.04€
JV_Titan0 calls 0.03€
Samuelillo07 calls 0.02€
*** FLOP *** [Ad 8s Kd]
JV_Titan0 checks
Samuelillo07 checks
Fried Berg checks
*** TURN *** [Ad 8s Kd][5h]
JV_Titan0 checks
Samuelillo07 checks
Fried Berg checks
*** RIVER *** [Ad 8s Kd 5h][Td]
JV_Titan0 bets 0.04€
Samuelillo07 folds
Fried Berg calls 0.04€
*** SHOW DOWN ***
Fried Berg shows [Jh 8h] (One pair : 8)
JV_Titan0 shows [Qd As] (One pair : Aces)
JV_Titan0 collected 0.18€ from pot
*** SUMMARY ***
Total pot 0.18€ | Rake 0.02€
Board: [Ad 8s Kd 5h Td]
Seat 1: JV_Titan0 (small blind) showed [Qd As] and won 0.18€ with One pair : Aces
Seat 6: Fried Berg (button) showed [Jh 8h] and lost with One pair : 8


Winamax Poker - HOLD-UP "Colorado" - HandId: #19116069-787144-1701777466 - Holdem no limit (0.01€/0.02€) - 2023/12/05 11:57:46 UTC
Table: 'Colorado' 6-max (real money) Seat #6 is the button
Seat 1: Fcgb_2907 (0.27€)
Seat 2: slowreplay (2€)
Seat 3: Fried Berg (1.98€)
Seat 4: Redemption90 (2.06€)
Seat 5: XxTeamxX (2.16€)
Seat 6: Stimulus (4.11€)
*** ANTE/BLINDS ***
Fcgb_2907 posts small blind 0.01€
slowreplay posts big blind 0.02€
Dealt to Fried Berg [As 2s]
*** PRE-FLOP *** 
Fried Berg raises 0.02€ to 0.04€
Redemption90 folds
XxTeamxX calls 0.04€
Stimulus folds
Fcgb_2907 folds
slowreplay calls 0.02€
*** FLOP *** [3d Td 5d]
slowreplay checks
Fried Berg checks
XxTeamxX bets 0.05€
slowreplay calls 0.05€
Fried Berg folds
*** TURN *** [3d Td 5d][8h]
slowreplay bets 0.28€
XxTeamxX folds
slowreplay collected 0.49€ from pot
*** SUMMARY ***
Total pot 0.49€ | Rake 0.02€
Board: [3d Td 5d 8h]
Seat 2: slowreplay (big blind) won 0.49€


Winamax Poker - HOLD-UP "Colorado" - HandId: #19116069-787253-1701777516 - Holdem no limit (0.01€/0.02€) - 2023/12/05 11:58:36 UTC
Table: 'Colorado' 6-max (real money) Seat #6 is the button
Seat 1: Richard Reuk (2.67€)
Seat 2: Pocho7 (1.80€)
Seat 3: Zard.Oz (2.80€)
Seat 4: Fried Berg (1.94€)
Seat 5: Chanclaveloz (5.11€)
Seat 6: Jesperord98 (2.40€)
*** ANTE/BLINDS ***
Richard Reuk posts small blind 0.01€
Pocho7 posts big blind 0.02€
Dealt to Fried Berg [2c 3h]
*** PRE-FLOP *** 
Zard.Oz folds
Fried Berg folds
Chanclaveloz folds
Jesperord98 folds
Richard Reuk folds
Pocho7 collected 0.03€ from pot
*** SUMMARY ***
Total pot 0.03€ | No rake
Seat 2: Pocho7 (big blind) won 0.03€


Winamax Poker - HOLD-UP "Colorado" - HandId: #19116069-787257-1701777518 - Holdem no limit (0.01€/0.02€) - 2023/12/05 11:58:38 UTC
Table: 'Colorado' 6-max (real money) Seat #6 is the button
Seat 1: Fried Berg (1.94€)
Seat 2: ForasteroTT (4.02€)
Seat 3: Tofini (2€)
Seat 4: KON-2-PEUTE (3.59€)
Seat 5: JFSredbaron (2.02€)
Seat 6: Jacop0113 (0.47€)
*** ANTE/BLINDS ***
Fried Berg posts small blind 0.01€
ForasteroTT posts big blind 0.02€
Dealt to Fried Berg [6s 9c]
*** PRE-FLOP *** 
Tofini folds
KON-2-PEUTE folds
JFSredbaron folds
Jacop0113 calls 0.02€
Fried Berg folds
ForasteroTT checks
*** FLOP *** [Tc 2c Kd]
ForasteroTT checks
Jacop0113 checks
*** TURN *** [Tc 2c Kd][5c]
ForasteroTT bets 0.03€
Jacop0113 calls 0.03€
*** RIVER *** [Tc 2c Kd 5c][Qs]
ForasteroTT bets 0.07€
Jacop0113 folds
ForasteroTT collected 0.17€ from pot
*** SUMMARY ***
Total pot 0.17€ | Rake 0.01€
Board: [Tc 2c Kd 5c Qs]
Seat 2: ForasteroTT (big blind) won 0.17€


Winamax Poker - HOLD-UP "Colorado" - HandId: #19116069-787262-1701777520 - Holdem no limit (0.01€/0.02€) - 2023/12/05 11:58:40 UTC
Table: 'Colorado' 6-max (real money) Seat #6 is the button
Seat 1: S-aaron24 (2.01€)
Seat 2: joalbralo (4.04€)
Seat 3: Sniper2.0 (2.12€)
Seat 4: dadou13100 (1.43€)
Seat 5: Pierrof24 (1.59€)
Seat 6: Fried Berg (1.93€)
*** ANTE/BLINDS ***
S-aaron24 posts small blind 0.01€
joalbralo posts big blind 0.02€
Dealt to Fried Berg [8c 4h]
*** PRE-FLOP *** 
Sniper2.0 folds
dadou13100 folds
Pierrof24 folds
Fried Berg folds
S-aaron24 raises 0.03€ to 0.05€
joalbralo folds
S-aaron24 collected 0.07€ from pot
*** SUMMARY ***
Total pot 0.07€ | No rake
Seat 1: S-aaron24 (small blind) won 0.07€


Winamax Poker - HOLD-UP "Colorado" - HandId: #19116069-787267-1701777522 - Holdem no limit (0.01€/0.02€) - 2023/12/05 11:58:42 UTC
Table: 'Colorado' 6-max (real money) Seat #6 is the button
Seat 1: Samuelillo07 (2.02€)
Seat 2: Fried Berg (1.93€)
Seat 3: Kira17 (1.86€)
Seat 4: Pierrof24 (1.59€)
Seat 5: Chanclaveloz (5.11€)
Seat 6: FJM-MJF (1.53€)
*** ANTE/BLINDS ***
Samuelillo07 posts small blind 0.01€
Fried Berg posts big blind 0.02€
Dealt to Fried Berg [8h Tc]
*** PRE-FLOP *** 
Kira17 folds
Pierrof24 folds
Chanclaveloz raises 0.03€ to 0.05€
FJM-MJF folds
Samuelillo07 folds
Fried Berg folds
Chanclaveloz collected 0.08€ from pot
*** SUMMARY ***
Total pot 0.08€ | No rake
Seat 5: Chanclaveloz won 0.08€


Winamax Poker - HOLD-UP "Colorado" - HandId: #19116069-787282-1701777529 - Holdem no limit (0.01€/0.02€) - 2023/12/05 11:58:49 UTC
Table: 'Colorado' 6-max (real money) Seat #6 is the button
Seat 1: XxTeamxX (2.07€)
Seat 2: rogabi (2€)
Seat 3: Durantula_6 (2.36€)
Seat 4: nico033 (1.74€)
Seat 5: Dulcran (1.71€)
Seat 6: Fried Berg (1.91€)
*** ANTE/BLINDS ***
XxTeamxX posts small blind 0.01€
rogabi posts big blind 0.02€
Dealt to Fried Berg [3c 5h]
*** PRE-FLOP *** 
Durantula_6 folds
nico033 folds
Dulcran folds
Fried Berg folds
XxTeamxX calls 0.01€
rogabi checks
*** FLOP *** [7c Jc 8d]
XxTeamxX bets 0.03€
rogabi calls 0.03€
*** TURN *** [7c Jc 8d][Qd]
XxTeamxX bets 0.08€
rogabi folds
XxTeamxX collected 0.17€ from pot
*** SUMMARY ***
Total pot 0.17€ | Rake 0.01€
Board: [7c Jc 8d Qd]
Seat 1: XxTeamxX (small blind) won 0.17€


Winamax Poker - HOLD-UP "Colorado" - HandId: #19116069-787286-1701777532 - Holdem no limit (0.01€/0.02€) - 2023/12/05 11:58:52 UTC
Table: 'Colorado' 6-max (real money) Seat #6 is the button
Seat 1: Direct Oli (1.09€)
Seat 2: AMBM2729 (1.20€)
Seat 3: dadou13100 (1.43€)
Seat 4: Fried Berg (1.91€)
Seat 5: Raggamin (2.31€)
Seat 6: nico033 (1.74€)
*** ANTE/BLINDS ***
Direct Oli posts small blind 0.01€
AMBM2729 posts big blind 0.02€
Dealt to Fried Berg [9s 7s]
*** PRE-FLOP *** 
dadou13100 folds
Fried Berg folds
Raggamin folds
nico033 folds
Direct Oli calls 0.01€
AMBM2729 checks
*** FLOP *** [Qd Ks 2d]
Direct Oli checks
AMBM2729 bets 0.02€
Direct Oli calls 0.02€
*** TURN *** [Qd Ks 2d][3h]
Direct Oli checks
AMBM2729 checks
*** RIVER *** [Qd Ks 2d 3h][9h]
Direct Oli bets 0.03€
AMBM2729 folds
Direct Oli collected 0.10€ from pot
*** SUMMARY ***
Total pot 0.10€ | Rake 0.01€
Board: [Qd Ks 2d 3h 9h]
Seat 1: Direct Oli (small blind) won 0.10€


Winamax Poker - HOLD-UP "Colorado" - HandId: #19116069-787303-1701777541 - Holdem no limit (0.01€/0.02€) - 2023/12/05 11:59:01 UTC
Table: 'Colorado' 6-max (real money) Seat #6 is the button
Seat 1: lefraisier (8.15€)
Seat 2: Fried Berg (1.91€)
Seat 3: DaniRama (2€)
Seat 4: g8o8k8u (2.13€)
Seat 5: FisherManF (4.10€)
Seat 6: Mecdu9.4 (0.71€)
*** ANTE/BLINDS ***
lefraisier posts small blind 0.01€
Fried Berg posts big blind 0.02€
Dealt to Fried Berg [Tc Ac]
*** PRE-FLOP *** 
DaniRama folds
g8o8k8u folds
FisherManF folds
Mecdu9.4 folds
lefraisier calls 0.01€
Fried Berg raises 0.10€ to 0.12€
lefraisier folds
Fried Berg collected 0.14€ from pot
*** SUMMARY ***
Total pot 0.14€ | No rake
Seat 2: Fried Berg (big blind) won 0.14€


Winamax Poker - HOLD-UP "Colorado" - HandId: #19116069-787332-1701777556 - Holdem no limit (0.01€/0.02€) - 2023/12/05 11:59:16 UTC
Table: 'Colorado' 6-max (real money) Seat #6 is the button
Seat 1: DigBick99 (2.01€)
Seat 2: Marto69 (2.90€)
Seat 3: Joan009 (2.01€)
Seat 4: Raggamin (2.09€)
Seat 5: Fried Berg (1.93€)
Seat 6: slowreplay (2.40€)
*** ANTE/BLINDS ***
DigBick99 posts small blind 0.01€
Marto69 posts big blind 0.02€
Dealt to Fried Berg [9d 3s]
*** PRE-FLOP *** 
Joan009 folds
Raggamin folds
Fried Berg folds
slowreplay raises 0.04€ to 0.06€
DigBick99 folds
Marto69 folds
slowreplay collected 0.09€ from pot
*** SUMMARY ***
Total pot 0.09€ | No rake
Seat 6: slowreplay (button) won 0.09€


Winamax Poker - HOLD-UP "Colorado" - HandId: #19116069-787342-1701777562 - Holdem no limit (0.01€/0.02€) - 2023/12/05 11:59:22 UTC
Table: 'Colorado' 6-max (real money) Seat #6 is the button
Seat 1: Fried Berg (1.93€)
Seat 2: Br3izh_P0k3r (4.46€)
Seat 3: Jorj-X-McKie (2.04€)
Seat 4: Bennnnnn62 (2.08€)
Seat 5: Jesperord98 (2.35€)
Seat 6: g8o8k8u (2€)
*** ANTE/BLINDS ***
Fried Berg posts small blind 0.01€
Br3izh_P0k3r posts big blind 0.02€
Dealt to Fried Berg [Jc Ad]
*** PRE-FLOP *** 
Jorj-X-McKie folds
Bennnnnn62 folds
Jesperord98 folds
g8o8k8u folds
Fried Berg raises 0.02€ to 0.04€
Br3izh_P0k3r folds
Fried Berg collected 0.06€ from pot
*** SUMMARY ***
Total pot 0.06€ | No rake
Seat 1: Fried Berg (small blind) won 0.06€


Winamax Poker - HOLD-UP "Colorado" - HandId: #19116069-787385-1701777578 - Holdem no limit (0.01€/0.02€) - 2023/12/05 11:59:38 UTC
Table: 'Colorado' 6-max (real money) Seat #6 is the button
Seat 1: gitPush (2.28€)
Seat 2: Jimbiosis (4.59€)
Seat 3: metamex (2.08€)
Seat 4: dentelle13 (1.98€)
Seat 5: rogabi (2€)
Seat 6: Fried Berg (1.95€)
*** ANTE/BLINDS ***
gitPush posts small blind 0.01€
Jimbiosis posts big blind 0.02€
Dealt to Fried Berg [4d 8s]
*** PRE-FLOP *** 
metamex folds
dentelle13 folds
rogabi folds
Fried Berg folds
gitPush folds
Jimbiosis collected 0.03€ from pot
*** SUMMARY ***
Total pot 0.03€ | No rake
Seat 2: Jimbiosis (big blind) won 0.03€


Winamax Poker - HOLD-UP "Colorado" - HandId: #19116069-787400-1701777585 - Holdem no limit (0.01€/0.02€) - 2023/12/05 11:59:45 UTC
Table: 'Colorado' 6-max (real money) Seat #6 is the button
Seat 1: Chanclaveloz (3.50€)
Seat 2: DaniRama (2.05€)
Seat 3: Fried Berg (1.95€)
Seat 4: D_A_R_K_ (1.99€)
Seat 5: EB Matador72 (2.94€)
Seat 6: wax94 (0.36€)
*** ANTE/BLINDS ***
Chanclaveloz posts small blind 0.01€
DaniRama posts big blind 0.02€
Dealt to Fried Berg [2h 7h]
*** PRE-FLOP *** 
Fried Berg folds
D_A_R_K_ folds
EB Matador72 folds
wax94 folds
Chanclaveloz folds
DaniRama collected 0.03€ from pot
*** SUMMARY ***
Total pot 0.03€ | No rake
Seat 2: DaniRama (big blind) won 0.03€


Winamax Poker - HOLD-UP "Colorado" - HandId: #19116069-787404-1701777587 - Holdem no limit (0.01€/0.02€) - 2023/12/05 11:59:47 UTC
Table: 'Colorado' 6-max (real money) Seat #6 is the button
Seat 1: wax94 (0.36€)
Seat 2: Alexisdpp (2.69€)
Seat 3: Fried Berg (1.95€)
Seat 4: slowreplay (2.07€)
Seat 5: EB Matador72 (2.94€)
Seat 6: Chanclaveloz (3.49€)
*** ANTE/BLINDS ***
wax94 posts small blind 0.01€
Alexisdpp posts big blind 0.02€
Dealt to Fried Berg [Kh Qc]
*** PRE-FLOP *** 
Fried Berg raises 0.02€ to 0.04€
slowreplay folds
EB Matador72 folds
Chanclaveloz folds
wax94 folds
Alexisdpp folds
Fried Berg collected 0.07€ from pot
*** SUMMARY ***
Total pot 0.07€ | No rake
Seat 3: Fried Berg won 0.07€


Winamax Poker - HOLD-UP "Colorado" - HandId: #19116069-787442-1701777605 - Holdem no limit (0.01€/0.02€) - 2023/12/05 12:00:05 UTC
Table: 'Colorado' 6-max (real money) Seat #6 is the button
Seat 1: Fried Berg (1.98€)
Seat 2: Raggamin (2.26€)
Seat 3: JFSredbaron (2.02€)
Seat 4: Jorj-X-McKie (2.14€)
Seat 5: g8o8k8u (2.23€)
Seat 6: wax94 (0.33€)
*** ANTE/BLINDS ***
Fried Berg posts small blind 0.01€
Raggamin posts big blind 0.02€
Dealt to Fried Berg [5c 7s]
*** PRE-FLOP *** 
JFSredbaron raises 0.04€ to 0.06€
Jorj-X-McKie folds
g8o8k8u raises 0.12€ to 0.18€
wax94 folds
Fried Berg folds
Raggamin folds
JFSredbaron calls 0.12€
*** FLOP *** [Kc Js Kd]
JFSredbaron checks
g8o8k8u bets 0.20€
JFSredbaron folds
g8o8k8u collected 0.55€ from pot
*** SUMMARY ***
Total pot 0.55€ | Rake 0.04€
Board: [Kc Js Kd]
Seat 5: g8o8k8u won 0.55€


Winamax Poker - HOLD-UP "Colorado" - HandId: #19116069-787453-1701777609 - Holdem no limit (0.01€/0.02€) - 2023/12/05 12:00:09 UTC
Table: 'Colorado' 6-max (real money) Seat #6 is the button
Seat 1: joalbralo (3.81€)
Seat 2: Fried Berg (1.97€)
Seat 3: Finess28 (5.40€)
Seat 4: slowreplay (2.40€)
Seat 5: DigBick99 (2.28€)
Seat 6: RaulSuPapa (3.65€)
*** ANTE/BLINDS ***
joalbralo posts small blind 0.01€
Fried Berg posts big blind 0.02€
Dealt to Fried Berg [Kc 4h]
*** PRE-FLOP *** 
Finess28 raises 0.02€ to 0.04€
slowreplay folds
DigBick99 folds
RaulSuPapa folds
joalbralo folds
Fried Berg folds
Finess28 collected 0.07€ from pot
*** SUMMARY ***
Total pot 0.07€ | No rake
Seat 3: Finess28 won 0.07€


Winamax Poker - HOLD-UP "Colorado" - HandId: #19116069-787461-1701777615 - Holdem no limit (0.01€/0.02€) - 2023/12/05 12:00:15 UTC
Table: 'Colorado' 6-max (real money) Seat #6 is the button
Seat 1: AlexxTorres (5.23€)
Seat 2: Dulcran (1.57€)
Seat 3: Jorj-X-McKie (2.11€)
Seat 4: Fried Berg (1.95€)
Seat 5: ForasteroTT (2.53€)
Seat 6: FJM-MJF (1.68€)
*** ANTE/BLINDS ***
AlexxTorres posts small blind 0.01€
Dulcran posts big blind 0.02€
Dealt to Fried Berg [8s 3s]
*** PRE-FLOP *** 
Jorj-X-McKie raises 0.02€ to 0.04€
Fried Berg folds
ForasteroTT calls 0.04€
FJM-MJF folds
AlexxTorres raises 0.19€ to 0.23€
Dulcran folds
Jorj-X-McKie folds
ForasteroTT calls 0.19€
*** FLOP *** [Ac 3c 9s]
AlexxTorres bets 0.18€
ForasteroTT calls 0.18€
*** TURN *** [Ac 3c 9s][5h]
AlexxTorres checks
ForasteroTT bets 0.31€
AlexxTorres calls 0.31€
*** RIVER *** [Ac 3c 9s 5h][6s]
AlexxTorres checks
ForasteroTT bets 0.98€
AlexxTorres folds
ForasteroTT collected 2.33€ from pot
*** SUMMARY ***
Total pot 2.33€ | Rake 0.15€
Board: [Ac 3c 9s 5h 6s]
Seat 5: ForasteroTT won 2.33€


Winamax Poker - HOLD-UP "Colorado" - HandId: #19116069-787472-1701777622 - Holdem no limit (0.01€/0.02€) - 2023/12/05 12:00:22 UTC
Table: 'Colorado' 6-max (real money) Seat #6 is the button
Seat 1: rogabi (2.19€)
Seat 2: Finess28 (5.43€)
Seat 3: S-aaron24 (2€)
Seat 4: Dulcran (1.55€)
Seat 5: Fried Berg (1.95€)
Seat 6: Lumayou (2.73€)
*** ANTE/BLINDS ***
rogabi posts small blind 0.01€
Finess28 posts big blind 0.02€
Dealt to Fried Berg [2d Jh]
*** PRE-FLOP *** 
S-aaron24 folds
Dulcran folds
Fried Berg folds
Lumayou raises 0.03€ to 0.05€
rogabi folds
Finess28 folds
Lumayou collected 0.08€ from pot
*** SUMMARY ***
Total pot 0.08€ | No rake
Seat 6: Lumayou (button) won 0.08€


Winamax Poker - HOLD-UP "Colorado" - HandId: #19116069-787488-1701777631 - Holdem no limit (0.01€/0.02€) - 2023/12/05 12:00:31 UTC
Table: 'Colorado' 6-max (real money) Seat #6 is the button
Seat 1: KON-2-PEUTE (2.89€)
Seat 2: Redemption90 (2€)
Seat 3: Fried Berg (1.95€)
Seat 4: Le_zigauto (1.79€)
Seat 5: Chanclaveloz (2.11€)
Seat 6: Zard.Oz (13.23€)
Hold-up to Pot: total 0.10€
*** ANTE/BLINDS ***
KON-2-PEUTE posts small blind 0.01€
Redemption90 posts big blind 0.02€
Dealt to Fried Berg [As 9h]
*** PRE-FLOP *** 
Fried Berg raises 0.02€ to 0.04€
Le_zigauto folds
Chanclaveloz folds
Zard.Oz folds
KON-2-PEUTE folds
Redemption90 calls 0.02€
*** FLOP *** [Jh 9c 8s]
Redemption90 checks
Fried Berg bets 0.12€
Redemption90 calls 0.12€
*** TURN *** [Jh 9c 8s][2s]
Redemption90 checks
Fried Berg checks
*** RIVER *** [Jh 9c 8s 2s][5s]
Redemption90 bets 0.28€
Fried Berg calls 0.28€
*** SHOW DOWN ***
Redemption90 shows [Ah Ts] (High card : Ace)
Fried Berg shows [As 9h] (One pair : 9)
Fried Berg collected 0.90€ from pot
*** SUMMARY ***
Total pot 0.90€ | Rake 0.09€
Board: [Jh 9c 8s 2s 5s]
Seat 2: Redemption90 (big blind) showed [Ah Ts] and lost with High card : Ace
Seat 3: Fried Berg showed [As 9h] and won 0.90€ with One pair : 9


Winamax Poker - HOLD-UP "Colorado" - HandId: #19116069-787604-1701777697 - Holdem no limit (0.01€/0.02€) - 2023/12/05 12:01:37 UTC
Table: 'Colorado' 6-max (real money) Seat #6 is the button
Seat 1: Durantula_6 (3.84€)
Seat 2: ForasteroTT (3.94€)
Seat 3: kickerace59 (3.77€)
Seat 4: Ar gaouyat (2€)
Seat 5: Fried Berg (2.41€)
Seat 6: D_A_R_K_ (2.01€)
*** ANTE/BLINDS ***
Durantula_6 posts small blind 0.01€
ForasteroTT posts big blind 0.02€
Dealt to Fried Berg [Jc 6c]
*** PRE-FLOP *** 
kickerace59 folds
Ar gaouyat folds
Fried Berg raises 0.02€ to 0.04€
D_A_R_K_ folds
Durantula_6 folds
ForasteroTT folds
Fried Berg collected 0.07€ from pot
*** SUMMARY ***
Total pot 0.07€ | No rake
Seat 5: Fried Berg won 0.07€


Winamax Poker - HOLD-UP "Colorado" - HandId: #19116069-787659-1701777723 - Holdem no limit (0.01€/0.02€) - 2023/12/05 12:02:03 UTC
Table: 'Colorado' 6-max (real money) Seat #6 is the button
Seat 1: DaniRama (2.17€)
Seat 2: Fried Berg (2.44€)
Seat 3: Br3izh_P0k3r (4.48€)
Seat 4: mika9080 (1.92€)
Seat 5: rogabi (2.23€)
Seat 6: YellowStarVl (2.06€)
*** ANTE/BLINDS ***
DaniRama posts small blind 0.01€
Fried Berg posts big blind 0.02€
Dealt to Fried Berg [2s Kh]
*** PRE-FLOP *** 
Br3izh_P0k3r folds
mika9080 folds
rogabi folds
YellowStarVl folds
DaniRama folds
Fried Berg collected 0.03€ from pot
*** SUMMARY ***
Total pot 0.03€ | No rake
Seat 2: Fried Berg (big blind) won 0.03€


Winamax Poker - HOLD-UP "Colorado" - HandId: #19116069-787686-1701777738 - Holdem no limit (0.01€/0.02€) - 2023/12/05 12:02:18 UTC
Table: 'Colorado' 6-max (real money) Seat #6 is the button
Seat 1: _Sephi (1.68€)
Seat 2: Locrate83 (1.62€)
Seat 3: Pierrof24 (7.46€)
Seat 4: Fried Berg (2.45€)
Seat 5: Ertorko (3.74€)
Seat 6: sandrine1983 (0.45€)
*** ANTE/BLINDS ***
_Sephi posts small blind 0.01€
Locrate83 posts big blind 0.02€
Dealt to Fried Berg [Qs 8c]
*** PRE-FLOP *** 
Pierrof24 folds
Fried Berg folds
Ertorko raises 0.03€ to 0.05€
sandrine1983 calls 0.05€
_Sephi folds
Locrate83 calls 0.03€
*** FLOP *** [7c Th 5c]
Locrate83 checks
Ertorko checks
sandrine1983 checks
*** TURN *** [7c Th 5c][9c]
Locrate83 checks
Ertorko checks
sandrine1983 checks
*** RIVER *** [7c Th 5c 9c][Js]
Locrate83 checks
Ertorko checks
sandrine1983 checks
*** SHOW DOWN ***
Locrate83 shows [2s Ad] (High card : Ace)
sandrine1983 shows [3h 2h] (High card : Jack)
Ertorko shows [Kd 5d] (One pair : 5)
Ertorko collected 0.14€ from pot
*** SUMMARY ***
Total pot 0.14€ | Rake 0.02€
Board: [7c Th 5c 9c Js]
Seat 2: Locrate83 (big blind) showed [2s Ad] and lost with High card : Ace
Seat 5: Ertorko showed [Kd 5d] and won 0.14€ with One pair : 5
Seat 6: sandrine1983 (button) showed [3h 2h] and lost with High card : Jack


Winamax Poker - HOLD-UP "Colorado" - HandId: #19116069-787704-1701777750 - Holdem no limit (0.01€/0.02€) - 2023/12/05 12:02:30 UTC
Table: 'Colorado' 6-max (real money) Seat #6 is the button
Seat 1: antoniusivey (2.12€)
Seat 2: catstalents (2.15€)
Seat 3: kamoulox_93 (1.56€)
Seat 4: DigBick99 (2€)
Seat 5: EA_Stinger (0.98€)
Seat 6: Fried Berg (2.45€)
*** ANTE/BLINDS ***
antoniusivey posts small blind 0.01€
catstalents posts big blind 0.02€
Dealt to Fried Berg [Tc 9s]
*** PRE-FLOP *** 
kamoulox_93 folds
DigBick99 folds
EA_Stinger folds
Fried Berg folds
antoniusivey calls 0.01€
catstalents checks
*** FLOP *** [2d Qc Ah]
antoniusivey checks
catstalents checks
*** TURN *** [2d Qc Ah][8d]
antoniusivey checks
catstalents checks
*** RIVER *** [2d Qc Ah 8d][Kd]
antoniusivey checks
catstalents checks
*** SHOW DOWN ***
antoniusivey shows [3s 5c] (High card : Ace)
catstalents shows [4s 9d] (High card : Ace)
catstalents collected 0.04€ from pot
*** SUMMARY ***
Total pot 0.04€ | No rake
Board: [2d Qc Ah 8d Kd]
Seat 1: antoniusivey (small blind) showed [3s 5c] and lost with High card : Ace
Seat 2: catstalents (big blind) showed [4s 9d] and won 0.04€ with High card : Ace


Winamax Poker - HOLD-UP "Colorado" - HandId: #19116069-787730-1701777763 - Holdem no limit (0.01€/0.02€) - 2023/12/05 12:02:43 UTC
Table: 'Colorado' 6-max (real money) Seat #6 is the button
Seat 1: Jesperord98 (2.43€)
Seat 2: Br3izh_P0k3r (4.42€)
Seat 3: AarenC (2.02€)
Seat 4: A.Lafayette (1.69€)
Seat 5: Fried Berg (2.45€)
Seat 6: Alexisdpp (2.61€)
Hold-up to Pot: total 0.10€
*** ANTE/BLINDS ***
Jesperord98 posts small blind 0.01€
Br3izh_P0k3r posts big blind 0.02€
Dealt to Fried Berg [Jh 8c]
*** PRE-FLOP *** 
AarenC calls 0.02€
A.Lafayette raises 0.04€ to 0.06€
Fried Berg folds
Alexisdpp calls 0.06€
Jesperord98 folds
Br3izh_P0k3r folds
AarenC calls 0.04€
*** FLOP *** [Js Qh Kh]
AarenC checks
A.Lafayette bets 0.11€
Alexisdpp calls 0.11€
AarenC calls 0.11€
*** TURN *** [Js Qh Kh][3s]
AarenC checks
A.Lafayette bets 0.22€
Alexisdpp calls 0.22€
AarenC raises 1.63€ to 1.85€ and is all-in
A.Lafayette folds
Alexisdpp calls 1.63€
*** RIVER *** [Js Qh Kh 3s][2s]
*** SHOW DOWN ***
AarenC shows [3d Qd] (Two pairs : Queens and 3)
Alexisdpp shows [Ks 6s] (Flush King high)
Alexisdpp collected 4.11€ from pot
*** SUMMARY ***
Total pot 4.11€ | Rake 0.45€
Board: [Js Qh Kh 3s 2s]
Seat 3: AarenC showed [3d Qd] and lost with Two pairs : Queens and 3
Seat 6: Alexisdpp (button) showed [Ks 6s] and won 4.11€ with Flush King high


Winamax Poker - HOLD-UP "Colorado" - HandId: #19116069-787758-1701777782 - Holdem no limit (0.01€/0.02€) - 2023/12/05 12:03:02 UTC
Table: 'Colorado' 6-max (real money) Seat #6 is the button
Seat 1: Fried Berg (2.45€)
Seat 2: PIQSOU (2€)
Seat 3: _Sephi (1.62€)
Seat 4: Ar gaouyat (2€)
Seat 5: Kira17 (1.77€)
Seat 6: wax94 (0.56€)
*** ANTE/BLINDS ***
Fried Berg posts small blind 0.01€
PIQSOU posts big blind 0.02€
Dealt to Fried Berg [8d 9d]
*** PRE-FLOP *** 
_Sephi folds
Ar gaouyat raises 0.03€ to 0.05€
Kira17 calls 0.05€
wax94 raises 0.51€ to 0.56€ and is all-in
Fried Berg folds
PIQSOU folds
Ar gaouyat raises 1.44€ to 2€ and is all-in
Kira17 folds
*** FLOP *** [Qd 8h Ad]
*** TURN *** [Qd 8h Ad][2d]
*** RIVER *** [Qd 8h Ad 2d][4d]
*** SHOW DOWN ***
wax94 shows [Qc Qs] (Trips of Queens)
Ar gaouyat shows [7d 7s] (Flush Ace high)
Ar gaouyat collected 2.52€ from pot
*** SUMMARY ***
Total pot 2.52€ | Rake 0.12€
Board: [Qd 8h Ad 2d 4d]
Seat 4: Ar gaouyat showed [7d 7s] and won 2.52€ with Flush Ace high
Seat 6: wax94 (button) showed [Qc Qs] and lost with Trips of Queens


Winamax Poker - HOLD-UP "Colorado" - HandId: #19116069-787781-1701777797 - Holdem no limit (0.01€/0.02€) - 2023/12/05 12:03:17 UTC
Table: 'Colorado' 6-max (real money) Seat #6 is the button
Seat 1: Itashi.95 (2.75€)
Seat 2: G0R0N11 (5.63€)
Seat 3: Fried Berg (2.44€)
Seat 4: TuMensTanT (2€)
Seat 5: Raggamin (2.30€)
Seat 6: AlexxTorres (3.33€)
*** ANTE/BLINDS ***
Itashi.95 posts small blind 0.01€
G0R0N11 posts big blind 0.02€
Dealt to Fried Berg [5h 8h]
*** PRE-FLOP *** 
Fried Berg folds
TuMensTanT raises 0.03€ to 0.05€
Raggamin folds
AlexxTorres folds
Itashi.95 folds
G0R0N11 calls 0.03€
*** FLOP *** [4s 6c 9s]
G0R0N11 checks
TuMensTanT checks
*** TURN *** [4s 6c 9s][3h]
G0R0N11 checks
TuMensTanT checks
*** RIVER *** [4s 6c 9s 3h][6h]
G0R0N11 bets 0.06€
TuMensTanT folds
G0R0N11 collected 0.16€ from pot
*** SUMMARY ***
Total pot 0.16€ | Rake 0.01€
Board: [4s 6c 9s 3h 6h]
Seat 2: G0R0N11 (big blind) won 0.16€


Winamax Poker - HOLD-UP "Colorado" - HandId: #19116069-787785-1701777799 - Holdem no limit (0.01€/0.02€) - 2023/12/05 12:03:19 UTC
Table: 'Colorado' 6-max (real money) Seat #6 is the button
Seat 1: Itashi.95 (2.74€)
Seat 2: AlexxTorres (3.32€)
Seat 3: Samuelillo07 (2.37€)
Seat 4: Lebelours (3.61€)
Seat 5: YannSolo1 (0.79€)
Seat 6: Fried Berg (2.44€)
Hold-up to Pot: total 0.10€
*** ANTE/BLINDS ***
Itashi.95 posts small blind 0.01€
AlexxTorres posts big blind 0.02€
Dealt to Fried Berg [Ah 8h]
*** PRE-FLOP *** 
Samuelillo07 folds
Lebelours folds
YannSolo1 folds
Fried Berg raises 0.04€ to 0.06€
Itashi.95 folds
AlexxTorres folds
Fried Berg collected 0.19€ from pot
*** SUMMARY ***
Total pot 0.19€ | No rake
Seat 6: Fried Berg (button) won 0.19€


Winamax Poker - HOLD-UP "Colorado" - HandId: #19116069-787814-1701777814 - Holdem no limit (0.01€/0.02€) - 2023/12/05 12:03:34 UTC
Table: 'Colorado' 6-max (real money) Seat #6 is the button
Seat 1: kRaSsNy (1.50€)
Seat 2: Fried Berg (2.57€)
Seat 3: Hadji9 (1.59€)
Seat 4: g8o8k8u (2.11€)
Seat 5: Durantula_6 (3.32€)
Seat 6: Ertorko (3.79€)
*** ANTE/BLINDS ***
kRaSsNy posts small blind 0.01€
Fried Berg posts big blind 0.02€
Dealt to Fried Berg [3s Kd]
*** PRE-FLOP *** 
Hadji9 folds
g8o8k8u folds
Durantula_6 raises 0.03€ to 0.05€
Ertorko folds
kRaSsNy folds
Fried Berg folds
Durantula_6 collected 0.08€ from pot
*** SUMMARY ***
Total pot 0.08€ | No rake
Seat 5: Durantula_6 won 0.08€


Winamax Poker - HOLD-UP "Colorado" - HandId: #19116069-787842-1701777829 - Holdem no limit (0.01€/0.02€) - 2023/12/05 12:03:49 UTC
Table: 'Colorado' 6-max (real money) Seat #6 is the button
Seat 1: DaniRama (2.03€)
Seat 2: Le_zigauto (1.80€)
Seat 3: Itashi.95 (2.75€)
Seat 4: Fried Berg (2.55€)
Seat 5: FenderTolra (2€)
Seat 6: Jorj-X-McKie (2.15€)
*** ANTE/BLINDS ***
DaniRama posts small blind 0.01€
Le_zigauto posts big blind 0.02€
Dealt to Fried Berg [8d 5d]
*** PRE-FLOP *** 
Itashi.95 folds
Fried Berg folds
FenderTolra folds
Jorj-X-McKie folds
DaniRama folds
Le_zigauto collected 0.03€ from pot
*** SUMMARY ***
Total pot 0.03€ | No rake
Seat 2: Le_zigauto (big blind) won 0.03€


Winamax Poker - HOLD-UP "Colorado" - HandId: #19116069-787849-1701777833 - Holdem no limit (0.01€/0.02€) - 2023/12/05 12:03:53 UTC
Table: 'Colorado' 6-max (real money) Seat #6 is the button
Seat 1: Fried Berg (2.55€)
Seat 2: Fran1Oller (2€)
Seat 3: Niizumax (1.97€)
Seat 4: Stimulus (5.98€)
Seat 5: kRaSsNy (1.49€)
Seat 6: Durantula_6 (3.35€)
*** ANTE/BLINDS ***
Fried Berg posts small blind 0.01€
Fran1Oller posts big blind 0.02€
Dealt to Fried Berg [Td Ah]
*** PRE-FLOP *** 
Niizumax raises 0.03€ to 0.05€
Stimulus folds
kRaSsNy folds
Durantula_6 folds
Fried Berg calls 0.04€
Fran1Oller folds
*** FLOP *** [8d 8h 2d]
Fried Berg checks
Niizumax bets 0.04€
Fried Berg folds
Niizumax collected 0.15€ from pot
*** SUMMARY ***
Total pot 0.15€ | Rake 0.01€
Board: [8d 8h 2d]
Seat 3: Niizumax won 0.15€


Winamax Poker - HOLD-UP "Colorado" - HandId: #19116069-787931-1701777880 - Holdem no limit (0.01€/0.02€) - 2023/12/05 12:04:40 UTC
Table: 'Colorado' 6-max (real money) Seat #6 is the button
Seat 1: S-aaron24 (2.08€)
Seat 2: metamex (1.78€)
Seat 3: YellowStarVl (3.83€)
Seat 4: Yanmya33 (2.28€)
Seat 5: antoniusivey (3.49€)
Seat 6: Fried Berg (2.50€)
Hold-up to Pot: total 0.10€
*** ANTE/BLINDS ***
S-aaron24 posts small blind 0.01€
metamex posts big blind 0.02€
Dealt to Fried Berg [9c 9d]
*** PRE-FLOP *** 
YellowStarVl folds
Yanmya33 folds
antoniusivey calls 0.02€
Fried Berg raises 0.04€ to 0.06€
S-aaron24 folds
metamex calls 0.04€
antoniusivey calls 0.04€
*** FLOP *** [Ad 4c 5s]
metamex checks
antoniusivey checks
Fried Berg bets 0.16€
metamex folds
antoniusivey folds
Fried Berg collected 0.43€ from pot
*** SUMMARY ***
Total pot 0.43€ | Rake 0.02€
Board: [Ad 4c 5s]
Seat 6: Fried Berg (button) won 0.43€


Winamax Poker - HOLD-UP "Colorado" - HandId: #19116069-787992-1701777919 - Holdem no limit (0.01€/0.02€) - 2023/12/05 12:05:19 UTC
Table: 'Colorado' 6-max (real money) Seat #6 is the button
Seat 1: Fran1Oller (2.02€)
Seat 2: Jorj-X-McKie (2€)
Seat 3: Fried Berg (2.71€)
Seat 4: Dulcran (3.46€)
Seat 5: joalbralo (3.08€)
Seat 6: RaseOnYou (2.29€)
*** ANTE/BLINDS ***
Fran1Oller posts small blind 0.01€
Jorj-X-McKie posts big blind 0.02€
Dealt to Fried Berg [6c 4d]
*** PRE-FLOP *** 
Fried Berg folds
Dulcran folds
joalbralo raises 0.04€ to 0.06€
RaseOnYou raises 0.09€ to 0.15€
Fran1Oller folds
Jorj-X-McKie folds
joalbralo folds
RaseOnYou collected 0.24€ from pot
*** SUMMARY ***
Total pot 0.24€ | No rake
Seat 6: RaseOnYou (button) won 0.24€


Winamax Poker - HOLD-UP "Colorado" - HandId: #19116069-788006-1701777926 - Holdem no limit (0.01€/0.02€) - 2023/12/05 12:05:26 UTC
Table: 'Colorado' 6-max (real money) Seat #6 is the button
Seat 1: g8o8k8u (2.46€)
Seat 2: 77sam33 (2.11€)
Seat 3: Samuelillo07 (2.34€)
Seat 4: Fried Berg (2.71€)
Seat 5: G0R0N11 (5.58€)
Seat 6: Le_zigauto (1.93€)
*** ANTE/BLINDS ***
g8o8k8u posts small blind 0.01€
77sam33 posts big blind 0.02€
Dealt to Fried Berg [7h Kc]
*** PRE-FLOP *** 
Samuelillo07 folds
Fried Berg raises 0.02€ to 0.04€
G0R0N11 folds
Le_zigauto folds
g8o8k8u folds
77sam33 folds
Fried Berg collected 0.07€ from pot
*** SUMMARY ***
Total pot 0.07€ | No rake
Seat 4: Fried Berg won 0.07€


Winamax Poker - HOLD-UP "Colorado" - HandId: #19116069-788022-1701777935 - Holdem no limit (0.01€/0.02€) - 2023/12/05 12:05:35 UTC
Table: 'Colorado' 6-max (real money) Seat #6 is the button
Seat 1: Fried Berg (2.74€)
Seat 2: TuMensTanT (2.05€)
Seat 3: nico033 (1.62€)
Seat 4: FrappeLourde (0.50€)
Seat 5: DaniRama (2.09€)
Seat 6: EB Matador72 (2.49€)
*** ANTE/BLINDS ***
Fried Berg posts small blind 0.01€
TuMensTanT posts big blind 0.02€
Dealt to Fried Berg [2d 5c]
*** PRE-FLOP *** 
nico033 folds
FrappeLourde folds
DaniRama folds
EB Matador72 folds
Fried Berg folds
TuMensTanT collected 0.03€ from pot
*** SUMMARY ***
Total pot 0.03€ | No rake
Seat 2: TuMensTanT (big blind) won 0.03€


Winamax Poker - HOLD-UP "Colorado" - HandId: #19116069-788031-1701777939 - Holdem no limit (0.01€/0.02€) - 2023/12/05 12:05:39 UTC
Table: 'Colorado' 6-max (real money) Seat #6 is the button
Seat 1: Machiavel- (2€)
Seat 2: Jesperord98 (3.73€)
Seat 3: Samuelillo07 (2.45€)
Seat 4: KON-2-PEUTE (2.65€)
Seat 5: Roberfrk (1.63€)
Seat 6: Fried Berg (2.73€)
*** ANTE/BLINDS ***
Machiavel- posts small blind 0.01€
Jesperord98 posts big blind 0.02€
Dealt to Fried Berg [2d 6d]
*** PRE-FLOP *** 
Samuelillo07 folds
KON-2-PEUTE raises 0.03€ to 0.05€
Roberfrk folds
Fried Berg folds
Machiavel- folds
Jesperord98 folds
KON-2-PEUTE collected 0.08€ from pot
*** SUMMARY ***
Total pot 0.08€ | No rake
Seat 4: KON-2-PEUTE won 0.08€


Winamax Poker - HOLD-UP "Colorado" - HandId: #19116069-802831-1701785516 - Holdem no limit (0.01€/0.02€) - 2023/12/05 14:11:56 UTC
Table: 'Colorado' 6-max (real money) Seat #6 is the button
Seat 1: Brut2pok (2€)
Seat 2: Fried Berg (0.50€)
Seat 3: mea botellas (2.97€)
Seat 4: Tofini (2.07€)
Seat 5: Otb-RedBaron (3.81€)
Seat 6: slowreplay (2.12€)
*** ANTE/BLINDS ***
Brut2pok posts small blind 0.01€
Fried Berg posts big blind 0.02€
Dealt to Fried Berg [2s 5d]
*** PRE-FLOP *** 
mea botellas folds
Tofini folds
Otb-RedBaron raises 0.03€ to 0.05€
slowreplay folds
Brut2pok folds
Fried Berg folds
Otb-RedBaron collected 0.08€ from pot
*** SUMMARY ***
Total pot 0.08€ | No rake
Seat 5: Otb-RedBaron won 0.08€


Winamax Poker - HOLD-UP "Colorado" - HandId: #19116069-802853-1701785524 - Holdem no limit (0.01€/0.02€) - 2023/12/05 14:12:04 UTC
Table: 'Colorado' 6-max (real money) Seat #6 is the button
Seat 1: Fried Berg (0.48€)
Seat 2: Fripon_77201 (6.23€)
Seat 3: mangulon (2.09€)
Seat 4: WISHPITIL (4.35€)
Seat 5: g8o8k8u (2.01€)
Seat 6: Aggro Loser (2.05€)
*** ANTE/BLINDS ***
Fried Berg posts small blind 0.01€
Fripon_77201 posts big blind 0.02€
Dealt to Fried Berg [Ah 3c]
*** PRE-FLOP *** 
mangulon folds
WISHPITIL folds
g8o8k8u folds
Aggro Loser folds
Fried Berg raises 0.02€ to 0.04€
Fripon_77201 folds
Fried Berg collected 0.06€ from pot
*** SUMMARY ***
Total pot 0.06€ | No rake
Seat 1: Fried Berg (small blind) won 0.06€


Winamax Poker - HOLD-UP "Colorado" - HandId: #19116069-802901-1701785547 - Holdem no limit (0.01€/0.02€) - 2023/12/05 14:12:27 UTC
Table: 'Colorado' 6-max (real money) Seat #6 is the button
Seat 1: 77sam33 (2.74€)
Seat 2: coyoteuch (2€)
Seat 3: Fried Berg (0.50€)
Seat 4: mangulon (2.06€)
Seat 5: franrapid (2.34€)
Seat 6: Lino Miko (2.90€)
*** ANTE/BLINDS ***
77sam33 posts small blind 0.01€
coyoteuch posts big blind 0.02€
Dealt to Fried Berg [5d Ad]
*** PRE-FLOP *** 
Fried Berg raises 0.02€ to 0.04€
mangulon calls 0.04€
franrapid folds
Lino Miko calls 0.04€
77sam33 calls 0.03€
coyoteuch calls 0.02€
*** FLOP *** [Tc 9d 8d]
77sam33 checks
coyoteuch checks
Fried Berg checks
mangulon bets 0.11€
Lino Miko folds
77sam33 calls 0.11€
coyoteuch folds
Fried Berg calls 0.11€
*** TURN *** [Tc 9d 8d][Td]
77sam33 checks
Fried Berg bets 0.12€
mangulon calls 0.12€
77sam33 calls 0.12€
*** RIVER *** [Tc 9d 8d Td][5s]
77sam33 checks
Fried Berg checks
mangulon bets 0.58€
77sam33 folds
Fried Berg calls 0.23€ and is all-in
*** SHOW DOWN ***
Fried Berg shows [5d Ad] (Flush Ace high)
mangulon shows [Qd Jd] (Straight flush Queen)
mangulon collected 1.56€ from pot
*** SUMMARY ***
Total pot 1.56€ | Rake 0.14€
Board: [Tc 9d 8d Td 5s]
Seat 3: Fried Berg showed [5d Ad] and lost with Flush Ace high
Seat 4: mangulon showed [Qd Jd] and won 1.56€ with Straight flush Queen


