Winamax Poker - HOLD-UP "Colorado" - HandId: #19116069-310387-1701416904 - Holdem no limit (0.01€/0.02€) - 2023/12/01 07:48:24 UTC
Table: 'Colorado' 6-max (real money) Seat #6 is the button
Seat 1: l artiste ho (2.59€)
Seat 2: Fried Berg (0.50€)
Seat 3: jdeepenslip (2€)
Seat 4: matmyl (2.21€)
Seat 5: Jesperord98 (2.93€)
Seat 6: muespachois1 (1.22€)
*** ANTE/BLINDS ***
l artiste ho posts small blind 0.01€
Fried Berg posts big blind 0.02€
Dealt to Fried Berg [Qc 7s]
*** PRE-FLOP *** 
jdeepenslip folds
matmyl folds
Jesperord98 folds
muespachois1 folds
l artiste ho calls 0.01€
Fried Berg checks
*** FLOP *** [6d Js Th]
l artiste ho checks
Fried Berg checks
*** TURN *** [6d Js Th][6c]
l artiste ho checks
Fried Berg checks
*** RIVER *** [6d Js Th 6c][4s]
l artiste ho checks
Fried Berg checks
*** SHOW DOWN ***
l artiste ho shows [8s Qd] (One pair : 6)
Fried Berg shows [Qc 7s] (One pair : 6)
Fried Berg collected 0.02€ from pot
l artiste ho collected 0.02€ from pot
*** SUMMARY ***
Total pot 0.04€ | No rake
Board: [6d Js Th 6c 4s]
Seat 1: l artiste ho (small blind) showed [8s Qd] and won 0.02€ with One pair : 6
Seat 2: Fried Berg (big blind) showed [Qc 7s] and won 0.02€ with One pair : 6


Winamax Poker - HOLD-UP "Colorado" - HandId: #19116069-310408-1701416943 - Holdem no limit (0.01€/0.02€) - 2023/12/01 07:49:03 UTC
Table: 'Colorado' 6-max (real money) Seat #6 is the button
Seat 1: Fried Berg (0.50€)
Seat 2: l artiste ho (2.59€)
Seat 3: Pas 2 PeyroL (2.57€)
Seat 4: PIQSOU (2€)
Seat 5: Houarn (1.97€)
Seat 6: KKamarAAde (2.30€)
*** ANTE/BLINDS ***
Fried Berg posts small blind 0.01€
l artiste ho posts big blind 0.02€
Dealt to Fried Berg [4s 2c]
*** PRE-FLOP *** 
Pas 2 PeyroL folds
PIQSOU raises 0.03€ to 0.05€
Houarn folds
KKamarAAde folds
Fried Berg folds
l artiste ho calls 0.03€
*** FLOP *** [9s Qh 5h]
l artiste ho checks
PIQSOU checks
*** TURN *** [9s Qh 5h][Kh]
l artiste ho bets 0.06€
PIQSOU folds
l artiste ho collected 0.16€ from pot
*** SUMMARY ***
Total pot 0.16€ | Rake 0.01€
Board: [9s Qh 5h Kh]
Seat 2: l artiste ho (big blind) won 0.16€


Winamax Poker - HOLD-UP "Colorado" - HandId: #19116069-310415-1701416956 - Holdem no limit (0.01€/0.02€) - 2023/12/01 07:49:16 UTC
Table: 'Colorado' 6-max (real money) Seat #6 is the button
Seat 1: gagnejamais4 (2.99€)
Seat 2: Jesperord98 (4.13€)
Seat 3: Fried Berg (0.49€)
Seat 4: milgram (0.50€)
Seat 5: NHL13 (1.97€)
Seat 6: LAG0URMANDE (2.02€)
*** ANTE/BLINDS ***
gagnejamais4 posts small blind 0.01€
Jesperord98 posts big blind 0.02€
Dealt to Fried Berg [6s 3c]
*** PRE-FLOP *** 
Fried Berg folds
milgram folds
NHL13 raises 0.03€ to 0.05€
LAG0URMANDE folds
gagnejamais4 folds
Jesperord98 folds
NHL13 collected 0.08€ from pot
*** SUMMARY ***
Total pot 0.08€ | No rake
Seat 5: NHL13 won 0.08€


Winamax Poker - HOLD-UP "Colorado" - HandId: #19116069-310419-1701416961 - Holdem no limit (0.01€/0.02€) - 2023/12/01 07:49:21 UTC
Table: 'Colorado' 6-max (real money) Seat #6 is the button
Seat 1: Halmosthard (1.39€)
Seat 2: matmyl (2.24€)
Seat 3: Krudson1 (2.54€)
Seat 4: Fried Berg (0.49€)
Seat 5: Houarn (1.97€)
Seat 6: SashaTDouss (3.07€)
*** ANTE/BLINDS ***
Halmosthard posts small blind 0.01€
matmyl posts big blind 0.02€
Dealt to Fried Berg [Ad 2s]
*** PRE-FLOP *** 
Krudson1 folds
Fried Berg folds
Houarn folds
SashaTDouss raises 0.03€ to 0.05€
Halmosthard calls 0.04€
matmyl folds
*** FLOP *** [Ac Qh 2c]
Halmosthard checks
SashaTDouss bets 0.04€
Halmosthard calls 0.04€
*** TURN *** [Ac Qh 2c][Kc]
Halmosthard bets 0.07€
SashaTDouss folds
Halmosthard collected 0.25€ from pot
*** SUMMARY ***
Total pot 0.25€ | Rake 0.02€
Board: [Ac Qh 2c Kc]
Seat 1: Halmosthard (small blind) won 0.25€


Winamax Poker - HOLD-UP "Colorado" - HandId: #19116069-310424-1701416970 - Holdem no limit (0.01€/0.02€) - 2023/12/01 07:49:30 UTC
Table: 'Colorado' 6-max (real money) Seat #6 is the button
Seat 1: Mercuryllo (2€)
Seat 2: haamataraa (2.07€)
Seat 3: Houarn (1.96€)
Seat 4: Pas 2 PeyroL (3.02€)
Seat 5: Fried Berg (0.49€)
Seat 6: Prayade (2.38€)
*** ANTE/BLINDS ***
Mercuryllo posts small blind 0.01€
haamataraa posts big blind 0.02€
Dealt to Fried Berg [Qd Kc]
*** PRE-FLOP *** 
Houarn folds
Pas 2 PeyroL raises 0.03€ to 0.05€
Fried Berg calls 0.05€
Prayade folds
Mercuryllo folds
haamataraa calls 0.03€
*** FLOP *** [6h 3c 7c]
haamataraa checks
Pas 2 PeyroL checks
Fried Berg checks
*** TURN *** [6h 3c 7c][7d]
haamataraa checks
Pas 2 PeyroL checks
Fried Berg checks
*** RIVER *** [6h 3c 7c 7d][Qc]
haamataraa checks
Pas 2 PeyroL bets 0.04€
Fried Berg calls 0.04€
haamataraa folds
*** SHOW DOWN ***
Pas 2 PeyroL shows [Qh Jh] (Two pairs : Queens and 7)
Fried Berg shows [Qd Kc] (Two pairs : Queens and 7)
Fried Berg collected 0.22€ from pot
*** SUMMARY ***
Total pot 0.22€ | Rake 0.02€
Board: [6h 3c 7c 7d Qc]
Seat 4: Pas 2 PeyroL showed [Qh Jh] and lost with Two pairs : Queens and 7
Seat 5: Fried Berg showed [Qd Kc] and won 0.22€ with Two pairs : Queens and 7


Winamax Poker - HOLD-UP "Colorado" - HandId: #19116069-310475-1701417061 - Holdem no limit (0.01€/0.02€) - 2023/12/01 07:51:01 UTC
Table: 'Colorado' 6-max (real money) Seat #6 is the button
Seat 1: Pas 2 PeyroL (2.93€)
Seat 2: Mercuryllo (2.05€)
Seat 3: haamataraa (2.02€)
Seat 4: PIQSOU (2.41€)
Seat 5: KKamarAAde (1.87€)
Seat 6: Fried Berg (0.62€)
*** ANTE/BLINDS ***
Pas 2 PeyroL posts small blind 0.01€
Mercuryllo posts big blind 0.02€
Dealt to Fried Berg [Kd 6h]
*** PRE-FLOP *** 
haamataraa calls 0.02€
PIQSOU raises 0.06€ to 0.08€
KKamarAAde folds
Fried Berg folds
Pas 2 PeyroL calls 0.07€
Mercuryllo folds
haamataraa folds
*** FLOP *** [9h Kc Kh]
Pas 2 PeyroL checks
PIQSOU bets 0.07€
Pas 2 PeyroL folds
PIQSOU collected 0.25€ from pot
*** SUMMARY ***
Total pot 0.25€ | Rake 0.02€
Board: [9h Kc Kh]
Seat 4: PIQSOU won 0.25€


Winamax Poker - HOLD-UP "Colorado" - HandId: #19116069-310482-1701417082 - Holdem no limit (0.01€/0.02€) - 2023/12/01 07:51:22 UTC
Table: 'Colorado' 6-max (real money) Seat #6 is the button
Seat 1: AD-Genie8925 (0.78€)
Seat 2: tichettede3 (3.60€)
Seat 3: miguel07 (1.13€)
Seat 4: LAG0URMANDE (2.70€)
Seat 5: matmyl (2.81€)
Seat 6: Fried Berg (0.62€)
*** ANTE/BLINDS ***
AD-Genie8925 posts small blind 0.01€
tichettede3 posts big blind 0.02€
Dealt to Fried Berg [7h Ks]
*** PRE-FLOP *** 
miguel07 folds
LAG0URMANDE folds
matmyl folds
Fried Berg calls 0.02€
AD-Genie8925 calls 0.01€
tichettede3 checks
*** FLOP *** [3h 6s 7s]
AD-Genie8925 checks
tichettede3 checks
Fried Berg bets 0.02€
AD-Genie8925 calls 0.02€
tichettede3 folds
*** TURN *** [3h 6s 7s][3d]
AD-Genie8925 bets 0.03€
Fried Berg calls 0.03€
*** RIVER *** [3h 6s 7s 3d][Js]
AD-Genie8925 bets 0.06€
Fried Berg calls 0.06€
*** SHOW DOWN ***
AD-Genie8925 shows [5h 7d] (Two pairs : 7 and 3)
Fried Berg shows [7h Ks] (Two pairs : 7 and 3)
Fried Berg collected 0.25€ from pot
*** SUMMARY ***
Total pot 0.25€ | Rake 0.03€
Board: [3h 6s 7s 3d Js]
Seat 1: AD-Genie8925 (small blind) showed [5h 7d] and lost with Two pairs : 7 and 3
Seat 6: Fried Berg (button) showed [7h Ks] and won 0.25€ with Two pairs : 7 and 3


Winamax Poker - HOLD-UP "Colorado" - HandId: #19116069-310528-1701417148 - Holdem no limit (0.01€/0.02€) - 2023/12/01 07:52:28 UTC
Table: 'Colorado' 6-max (real money) Seat #6 is the button
Seat 1: Prayade (2.79€)
Seat 2: Fried Berg (0.74€)
Seat 3: DDDIEU33 (1.86€)
Seat 4: AD-Genie8925 (0.65€)
Seat 5: Jeje27 (2.97€)
Seat 6: l artiste ho (2.68€)
*** ANTE/BLINDS ***
Prayade posts small blind 0.01€
Fried Berg posts big blind 0.02€
Dealt to Fried Berg [6c Qc]
*** PRE-FLOP *** 
DDDIEU33 folds
AD-Genie8925 calls 0.02€
Jeje27 folds
l artiste ho folds
Prayade folds
Fried Berg checks
*** FLOP *** [Ts 3d 4c]
Fried Berg checks
AD-Genie8925 checks
*** TURN *** [Ts 3d 4c][Jc]
Fried Berg checks
AD-Genie8925 checks
*** RIVER *** [Ts 3d 4c Jc][9c]
Fried Berg bets 0.04€
AD-Genie8925 folds
Fried Berg collected 0.08€ from pot
*** SUMMARY ***
Total pot 0.08€ | Rake 0.01€
Board: [Ts 3d 4c Jc 9c]
Seat 2: Fried Berg (big blind) won 0.08€


Winamax Poker - HOLD-UP "Colorado" - HandId: #19116069-310548-1701417186 - Holdem no limit (0.01€/0.02€) - 2023/12/01 07:53:06 UTC
Table: 'Colorado' 6-max (real money) Seat #6 is the button
Seat 1: Fried Berg (0.76€)
Seat 2: Jeje27 (2.97€)
Seat 3: CB-Joker6274 (6.28€)
Seat 4: gagnejamais4 (4.72€)
Seat 5: tichettede3 (3.55€)
Seat 6: LAG0URMANDE (1.91€)
*** ANTE/BLINDS ***
Fried Berg posts small blind 0.01€
Jeje27 posts big blind 0.02€
Dealt to Fried Berg [Ad 4d]
*** PRE-FLOP *** 
CB-Joker6274 calls 0.02€
gagnejamais4 folds
tichettede3 folds
LAG0URMANDE raises 0.09€ to 0.11€
Fried Berg folds
Jeje27 folds
CB-Joker6274 calls 0.09€
*** FLOP *** [3c Jd Qc]
CB-Joker6274 checks
LAG0URMANDE bets 0.09€
CB-Joker6274 calls 0.09€
*** TURN *** [3c Jd Qc][8h]
CB-Joker6274 checks
LAG0URMANDE bets 0.34€
CB-Joker6274 folds
LAG0URMANDE collected 0.73€ from pot
*** SUMMARY ***
Total pot 0.73€ | Rake 0.04€
Board: [3c Jd Qc 8h]
Seat 6: LAG0URMANDE (button) won 0.73€


Winamax Poker - HOLD-UP "Colorado" - HandId: #19116069-310557-1701417201 - Holdem no limit (0.01€/0.02€) - 2023/12/01 07:53:21 UTC
Table: 'Colorado' 6-max (real money) Seat #6 is the button
Seat 1: Prayade (2.10€)
Seat 2: PIQSOU (2.52€)
Seat 3: Fried Berg (0.75€)
Seat 4: Pas 2 PeyroL (6.05€)
Seat 5: matmyl (3.27€)
Seat 6: g8o8k8u (2.87€)
*** ANTE/BLINDS ***
Prayade posts small blind 0.01€
PIQSOU posts big blind 0.02€
Dealt to Fried Berg [3s 7s]
*** PRE-FLOP *** 
Fried Berg folds
Pas 2 PeyroL folds
matmyl folds
g8o8k8u folds
Prayade raises 0.04€ to 0.06€
PIQSOU folds
Prayade collected 0.08€ from pot
*** SUMMARY ***
Total pot 0.08€ | No rake
Seat 1: Prayade (small blind) won 0.08€


Winamax Poker - HOLD-UP "Colorado" - HandId: #19116069-310561-1701417208 - Holdem no limit (0.01€/0.02€) - 2023/12/01 07:53:28 UTC
Table: 'Colorado' 6-max (real money) Seat #6 is the button
Seat 1: Jeje27 (2.95€)
Seat 2: Starbeckings (1.61€)
Seat 3: g8o8k8u (2.87€)
Seat 4: Fried Berg (0.75€)
Seat 5: KKamarAAde (2.66€)
Seat 6: EliotNesss (2.07€)
*** ANTE/BLINDS ***
Jeje27 posts small blind 0.01€
Starbeckings posts big blind 0.02€
Dealt to Fried Berg [6s Qs]
*** PRE-FLOP *** 
g8o8k8u folds
Fried Berg calls 0.02€
KKamarAAde folds
EliotNesss folds
Jeje27 calls 0.01€
Starbeckings checks
*** FLOP *** [Jd 6h 6c]
Jeje27 checks
Starbeckings checks
Fried Berg bets 0.02€
Jeje27 folds
Starbeckings folds
Fried Berg collected 0.07€ from pot
*** SUMMARY ***
Total pot 0.07€ | Rake 0.01€
Board: [Jd 6h 6c]
Seat 4: Fried Berg won 0.07€


Winamax Poker - HOLD-UP "Colorado" - HandId: #19116069-310597-1701417259 - Holdem no limit (0.01€/0.02€) - 2023/12/01 07:54:19 UTC
Table: 'Colorado' 6-max (real money) Seat #6 is the button
Seat 1: KKamarAAde (2.64€)
Seat 2: Halmosthard (4.36€)
Seat 3: tichettede3 (3.52€)
Seat 4: Pas 2 PeyroL (2.13€)
Seat 5: Fried Berg (0.78€)
Seat 6: Goblin 24509 (0.86€)
*** ANTE/BLINDS ***
KKamarAAde posts small blind 0.01€
Halmosthard posts big blind 0.02€
Dealt to Fried Berg [2s Kd]
*** PRE-FLOP *** 
tichettede3 folds
Pas 2 PeyroL folds
Fried Berg folds
Goblin 24509 raises 0.05€ to 0.07€
KKamarAAde folds
Halmosthard folds
Goblin 24509 collected 0.10€ from pot
*** SUMMARY ***
Total pot 0.10€ | No rake
Seat 6: Goblin 24509 (button) won 0.10€


Winamax Poker - HOLD-UP "Colorado" - HandId: #19116069-310600-1701417265 - Holdem no limit (0.01€/0.02€) - 2023/12/01 07:54:25 UTC
Table: 'Colorado' 6-max (real money) Seat #6 is the button
Seat 1: CB-Joker6274 (6.03€)
Seat 2: Manupoy (2.02€)
Seat 3: Fried Berg (0.78€)
Seat 4: PIQSOU (2.10€)
Seat 5: muespachois1 (0.75€)
Seat 6: matmyl (3.20€)
*** ANTE/BLINDS ***
CB-Joker6274 posts small blind 0.01€
Manupoy posts big blind 0.02€
Dealt to Fried Berg [Ah 2c]
*** PRE-FLOP *** 
Fried Berg folds
PIQSOU raises 0.03€ to 0.05€
muespachois1 calls 0.05€
matmyl folds
CB-Joker6274 folds
Manupoy folds
*** FLOP *** [Ts 9c 8c]
PIQSOU checks
muespachois1 checks
*** TURN *** [Ts 9c 8c][6h]
PIQSOU checks
muespachois1 checks
*** RIVER *** [Ts 9c 8c 6h][Ad]
PIQSOU checks
muespachois1 checks
*** SHOW DOWN ***
muespachois1 shows [Qh Kh] (High card : Ace)
PIQSOU shows [4s 6s] (One pair : 6)
PIQSOU collected 0.12€ from pot
*** SUMMARY ***
Total pot 0.12€ | Rake 0.01€
Board: [Ts 9c 8c 6h Ad]
Seat 4: PIQSOU showed [4s 6s] and won 0.12€ with One pair : 6
Seat 5: muespachois1 showed [Qh Kh] and lost with High card : Ace


Winamax Poker - HOLD-UP "Colorado" - HandId: #19116069-310602-1701417269 - Holdem no limit (0.01€/0.02€) - 2023/12/01 07:54:29 UTC
Table: 'Colorado' 6-max (real money) Seat #6 is the button
Seat 1: gagnejamais4 (5€)
Seat 2: Fried Berg (0.78€)
Seat 3: frenchstone4 (0.66€)
Seat 4: matmyl (3.20€)
Seat 5: CB-Joker6274 (6.02€)
Seat 6: Syphilis05 (3.59€)
*** ANTE/BLINDS ***
gagnejamais4 posts small blind 0.01€
Fried Berg posts big blind 0.02€
Dealt to Fried Berg [Qh 8s]
*** PRE-FLOP *** 
frenchstone4 calls 0.02€
matmyl folds
CB-Joker6274 folds
Syphilis05 folds
gagnejamais4 folds
Fried Berg checks
*** FLOP *** [9s As 2d]
Fried Berg checks
frenchstone4 checks
*** TURN *** [9s As 2d][2h]
Fried Berg checks
frenchstone4 checks
*** RIVER *** [9s As 2d 2h][6h]
Fried Berg checks
frenchstone4 checks
*** SHOW DOWN ***
frenchstone4 shows [8c 5c] (One pair : 2)
Fried Berg shows [Qh 8s] (One pair : 2)
Fried Berg collected 0.04€ from pot
*** SUMMARY ***
Total pot 0.04€ | Rake 0.01€
Board: [9s As 2d 2h 6h]
Seat 2: Fried Berg (big blind) showed [Qh 8s] and won 0.04€ with One pair : 2
Seat 3: frenchstone4 showed [8c 5c] and lost with One pair : 2


Winamax Poker - HOLD-UP "Colorado" - HandId: #19116069-310623-1701417297 - Holdem no limit (0.01€/0.02€) - 2023/12/01 07:54:57 UTC
Table: 'Colorado' 6-max (real money) Seat #6 is the button
Seat 1: Fried Berg (0.80€)
Seat 2: flymac (0.56€)
Seat 3: Manupoy (1.56€)
Seat 4: Jesperord98 (2€)
Seat 5: frenchstone4 (0.64€)
Seat 6: Zile741 (2€)
*** ANTE/BLINDS ***
Fried Berg posts small blind 0.01€
flymac posts big blind 0.02€
Dealt to Fried Berg [7s 8d]
*** PRE-FLOP *** 
Manupoy folds
Jesperord98 folds
frenchstone4 folds
Zile741 folds
Fried Berg raises 0.02€ to 0.04€
flymac folds
Fried Berg collected 0.06€ from pot
*** SUMMARY ***
Total pot 0.06€ | No rake
Seat 1: Fried Berg (small blind) won 0.06€


Winamax Poker - HOLD-UP "Colorado" - HandId: #19116069-310696-1701417417 - Holdem no limit (0.01€/0.02€) - 2023/12/01 07:56:57 UTC
Table: 'Colorado' 6-max (real money) Seat #6 is the button
Seat 1: KKamarAAde (2.56€)
Seat 2: DigBick99 (2.02€)
Seat 3: PIQSOU (2.08€)
Seat 4: Fried Berg (0.82€)
Seat 5: Prayade (2.17€)
Seat 6: Halmosthard (1.51€)
*** ANTE/BLINDS ***
KKamarAAde posts small blind 0.01€
DigBick99 posts big blind 0.02€
Dealt to Fried Berg [7s 9s]
*** PRE-FLOP *** 
PIQSOU folds
Fried Berg calls 0.02€
Prayade folds
Halmosthard calls 0.02€
KKamarAAde calls 0.01€
DigBick99 checks
*** FLOP *** [5h 5d 3h]
KKamarAAde checks
DigBick99 checks
Fried Berg checks
Halmosthard checks
*** TURN *** [5h 5d 3h][3c]
KKamarAAde checks
DigBick99 checks
Fried Berg checks
Halmosthard checks
*** RIVER *** [5h 5d 3h 3c][Ah]
KKamarAAde checks
DigBick99 checks
Fried Berg checks
Halmosthard checks
*** SHOW DOWN ***
KKamarAAde shows [6c Tc] (Two pairs : 5 and 3)
DigBick99 shows [4c Kd] (Two pairs : 5 and 3)
Fried Berg shows [7s 9s] (Two pairs : 5 and 3)
Halmosthard shows [Kc Th] (Two pairs : 5 and 3)
Halmosthard collected 0.02€ from pot
Fried Berg collected 0.02€ from pot
DigBick99 collected 0.02€ from pot
KKamarAAde collected 0.01€ from pot
*** SUMMARY ***
Total pot 0.07€ | Rake 0.01€
Board: [5h 5d 3h 3c Ah]
Seat 1: KKamarAAde (small blind) showed [6c Tc] and won 0.01€ with Two pairs : 5 and 3
Seat 2: DigBick99 (big blind) showed [4c Kd] and won 0.02€ with Two pairs : 5 and 3
Seat 4: Fried Berg showed [7s 9s] and won 0.02€ with Two pairs : 5 and 3
Seat 6: Halmosthard (button) showed [Kc Th] and won 0.02€ with Two pairs : 5 and 3


Winamax Poker - HOLD-UP "Colorado" - HandId: #19116069-310739-1701417486 - Holdem no limit (0.01€/0.02€) - 2023/12/01 07:58:06 UTC
Table: 'Colorado' 6-max (real money) Seat #6 is the button
Seat 1: Halmosthard (1.51€)
Seat 2: KKamarAAde (2.55€)
Seat 3: NHL13 (2.08€)
Seat 4: Zile741 (3.84€)
Seat 5: Fried Berg (0.82€)
Seat 6: _gonzai_ (2€)
*** ANTE/BLINDS ***
Halmosthard posts small blind 0.01€
KKamarAAde posts big blind 0.02€
Dealt to Fried Berg [2s Qd]
*** PRE-FLOP *** 
NHL13 folds
Zile741 raises 0.04€ to 0.06€
Fried Berg folds
_gonzai_ folds
Halmosthard calls 0.05€
KKamarAAde folds
*** FLOP *** [9s Ts 7d]
Halmosthard checks
Zile741 checks
*** TURN *** [9s Ts 7d][Qh]
Halmosthard bets 0.05€
Zile741 folds
Halmosthard collected 0.18€ from pot
*** SUMMARY ***
Total pot 0.18€ | Rake 0.01€
Board: [9s Ts 7d Qh]
Seat 1: Halmosthard (small blind) won 0.18€


Winamax Poker - HOLD-UP "Colorado" - HandId: #19116069-310744-1701417492 - Holdem no limit (0.01€/0.02€) - 2023/12/01 07:58:12 UTC
Table: 'Colorado' 6-max (real money) Seat #6 is the button
Seat 1: WKMage919121 (1.46€)
Seat 2: _gonzai_ (2€)
Seat 3: KKamarAAde (2.88€)
Seat 4: PIQSOU (2.25€)
Seat 5: Sebidu57 (1.93€)
Seat 6: Fried Berg (0.82€)
*** ANTE/BLINDS ***
WKMage919121 posts small blind 0.01€
_gonzai_ posts big blind 0.02€
Dealt to Fried Berg [9d 3s]
*** PRE-FLOP *** 
KKamarAAde folds
PIQSOU folds
Sebidu57 calls 0.02€
Fried Berg folds
WKMage919121 calls 0.01€
_gonzai_ checks
*** FLOP *** [Qh Jd 2s]
WKMage919121 checks
_gonzai_ checks
Sebidu57 bets 0.02€
WKMage919121 folds
_gonzai_ folds
Sebidu57 collected 0.07€ from pot
*** SUMMARY ***
Total pot 0.07€ | Rake 0.01€
Board: [Qh Jd 2s]
Seat 5: Sebidu57 won 0.07€


Winamax Poker - HOLD-UP "Colorado" - HandId: #19116069-310754-1701417509 - Holdem no limit (0.01€/0.02€) - 2023/12/01 07:58:29 UTC
Table: 'Colorado' 6-max (real money) Seat #6 is the button
Seat 1: EliotNesss (1.42€)
Seat 2: LAG0URMANDE (2.81€)
Seat 3: Jojo-andros5 (0.42€)
Seat 4: benoitbzh_x (0.84€)
Seat 5: Fried Berg (0.82€)
Seat 6: SirX (2.35€)
*** ANTE/BLINDS ***
EliotNesss posts small blind 0.01€
LAG0URMANDE posts big blind 0.02€
Dealt to Fried Berg [9d Jh]
*** PRE-FLOP *** 
Jojo-andros5 folds
benoitbzh_x folds
Fried Berg folds
SirX calls 0.02€
EliotNesss folds
LAG0URMANDE checks
*** FLOP *** [Ad Qs 3s]
LAG0URMANDE checks
SirX checks
*** TURN *** [Ad Qs 3s][7h]
LAG0URMANDE checks
SirX checks
*** RIVER *** [Ad Qs 3s 7h][3d]
LAG0URMANDE checks
SirX checks
*** SHOW DOWN ***
LAG0URMANDE shows [6d 2h] (One pair : 3)
SirX shows [6s Jd] (One pair : 3)
SirX collected 0.04€ from pot
*** SUMMARY ***
Total pot 0.04€ | Rake 0.01€
Board: [Ad Qs 3s 7h 3d]
Seat 2: LAG0URMANDE (big blind) showed [6d 2h] and lost with One pair : 3
Seat 6: SirX (button) showed [6s Jd] and won 0.04€ with One pair : 3


Winamax Poker - HOLD-UP "Colorado" - HandId: #19116069-310761-1701417522 - Holdem no limit (0.01€/0.02€) - 2023/12/01 07:58:42 UTC
Table: 'Colorado' 6-max (real money) Seat #6 is the button
Seat 1: Fried Berg (0.82€)
Seat 2: lucall-in (1.01€)
Seat 3: matmyl (3.23€)
Seat 4: tichettede3 (3.31€)
Seat 5: DDDIEU33 (1.56€)
Seat 6: bimach444 (2.03€)
*** ANTE/BLINDS ***
Fried Berg posts small blind 0.01€
lucall-in posts big blind 0.02€
Dealt to Fried Berg [Th Jd]
*** PRE-FLOP *** 
matmyl folds
tichettede3 folds
DDDIEU33 calls 0.02€
bimach444 folds
Fried Berg calls 0.01€
lucall-in checks
*** FLOP *** [9s Jc Ts]
Fried Berg bets 0.02€
lucall-in folds
DDDIEU33 calls 0.02€
*** TURN *** [9s Jc Ts][4c]
Fried Berg bets 0.02€
DDDIEU33 calls 0.02€
*** RIVER *** [9s Jc Ts 4c][Kd]
Fried Berg bets 0.05€
DDDIEU33 calls 0.05€
*** SHOW DOWN ***
Fried Berg shows [Th Jd] (Two pairs : Jacks and Tens)
DDDIEU33 shows [Js Ks] (Two pairs : Kings and Jacks)
DDDIEU33 collected 0.22€ from pot
*** SUMMARY ***
Total pot 0.22€ | Rake 0.02€
Board: [9s Jc Ts 4c Kd]
Seat 1: Fried Berg (small blind) showed [Th Jd] and lost with Two pairs : Jacks and Tens
Seat 5: DDDIEU33 showed [Js Ks] and won 0.22€ with Two pairs : Kings and Jacks


Winamax Poker - HOLD-UP "Colorado" - HandId: #19116069-310800-1701417576 - Holdem no limit (0.01€/0.02€) - 2023/12/01 07:59:36 UTC
Table: 'Colorado' 6-max (real money) Seat #6 is the button
Seat 1: PIQSOU (2.17€)
Seat 2: Fried Berg (0.71€)
Seat 3: DDDIEU33 (1.67€)
Seat 4: KKamarAAde (8.85€)
Seat 5: orzanco (1.24€)
Seat 6: DigBick99 (2€)
*** ANTE/BLINDS ***
PIQSOU posts small blind 0.01€
Fried Berg posts big blind 0.02€
Dealt to Fried Berg [Qs 3s]
*** PRE-FLOP *** 
DDDIEU33 calls 0.02€
KKamarAAde folds
orzanco folds
DigBick99 raises 0.06€ to 0.08€
PIQSOU folds
Fried Berg folds
DDDIEU33 calls 0.06€
*** FLOP *** [8c Ac Qd]
DDDIEU33 checks
DigBick99 bets 0.06€
DDDIEU33 calls 0.06€
*** TURN *** [8c Ac Qd][Ts]
DDDIEU33 checks
DigBick99 checks
*** RIVER *** [8c Ac Qd Ts][4s]
DDDIEU33 checks
DigBick99 checks
*** SHOW DOWN ***
DDDIEU33 shows [Td Jd] (One pair : Tens)
DigBick99 shows [Tc Jc] (One pair : Tens)
DigBick99 collected 0.14€ from pot
DDDIEU33 collected 0.14€ from pot
*** SUMMARY ***
Total pot 0.28€ | Rake 0.03€
Board: [8c Ac Qd Ts 4s]
Seat 3: DDDIEU33 showed [Td Jd] and won 0.14€ with One pair : Tens
Seat 6: DigBick99 (button) showed [Tc Jc] and won 0.14€ with One pair : Tens


Winamax Poker - HOLD-UP "Colorado" - HandId: #19116069-310812-1701417599 - Holdem no limit (0.01€/0.02€) - 2023/12/01 07:59:59 UTC
Table: 'Colorado' 6-max (real money) Seat #6 is the button
Seat 1: PIQSOU (2.02€)
Seat 2: Hagreed (2.02€)
Seat 3: Fried Berg (0.69€)
Seat 4: orzanco (1.24€)
Seat 5: EliotNesss (1.48€)
Seat 6: l artiste ho (2.83€)
*** ANTE/BLINDS ***
PIQSOU posts small blind 0.01€
Hagreed posts big blind 0.02€
Dealt to Fried Berg [2h Qd]
*** PRE-FLOP *** 
Fried Berg folds
orzanco folds
EliotNesss folds
l artiste ho raises 0.07€ to 0.09€
PIQSOU folds
Hagreed calls 0.07€
*** FLOP *** [7c 7s 3d]
Hagreed checks
l artiste ho bets 0.10€
Hagreed calls 0.10€
*** TURN *** [7c 7s 3d][6h]
Hagreed checks
l artiste ho checks
*** RIVER *** [7c 7s 3d 6h][8h]
Hagreed bets 0.14€
l artiste ho folds
Hagreed collected 0.49€ from pot
*** SUMMARY ***
Total pot 0.49€ | Rake 0.04€
Board: [7c 7s 3d 6h 8h]
Seat 2: Hagreed (big blind) won 0.49€


Winamax Poker - HOLD-UP "Colorado" - HandId: #19116069-310814-1701417603 - Holdem no limit (0.01€/0.02€) - 2023/12/01 08:00:03 UTC
Table: 'Colorado' 6-max (real money) Seat #6 is the button
Seat 1: _gonzai_ (2.01€)
Seat 2: Shark&Fish52 (1.78€)
Seat 3: Prayade (2.11€)
Seat 4: Fried Berg (0.69€)
Seat 5: Jesperord98 (4.05€)
Seat 6: orzanco (1.24€)
Hold-up to Pot: total 0.10€
*** ANTE/BLINDS ***
_gonzai_ posts small blind 0.01€
Shark&Fish52 posts big blind 0.02€
Dealt to Fried Berg [Ks 9h]
*** PRE-FLOP *** 
Prayade raises 0.04€ to 0.06€
Fried Berg folds
Jesperord98 folds
orzanco folds
_gonzai_ folds
Shark&Fish52 calls 0.04€
*** FLOP *** [2d Qd 8h]
Shark&Fish52 checks
Prayade checks
*** TURN *** [2d Qd 8h][Ad]
Shark&Fish52 checks
Prayade bets 0.08€
Shark&Fish52 calls 0.08€
*** RIVER *** [2d Qd 8h Ad][Qh]
Shark&Fish52 checks
Prayade checks
*** SHOW DOWN ***
Shark&Fish52 shows [As 9d] (Two pairs : Aces and Queens)
Prayade shows [Jc Ah] (Two pairs : Aces and Queens)
Prayade collected 0.36€ from pot
*** SUMMARY ***
Total pot 0.36€ | Rake 0.03€
Board: [2d Qd 8h Ad Qh]
Seat 2: Shark&Fish52 (big blind) showed [As 9d] and lost with Two pairs : Aces and Queens
Seat 3: Prayade showed [Jc Ah] and won 0.36€ with Two pairs : Aces and Queens


Winamax Poker - HOLD-UP "Colorado" - HandId: #19116069-310822-1701417618 - Holdem no limit (0.01€/0.02€) - 2023/12/01 08:00:18 UTC
Table: 'Colorado' 6-max (real money) Seat #6 is the button
Seat 1: KKamarAAde (2.84€)
Seat 2: _gonzai_ (2€)
Seat 3: Jojo-andros5 (0.59€)
Seat 4: SashaTDouss (2.92€)
Seat 5: orzanco (1.24€)
Seat 6: Fried Berg (0.69€)
*** ANTE/BLINDS ***
KKamarAAde posts small blind 0.01€
_gonzai_ posts big blind 0.02€
Dealt to Fried Berg [5d 5h]
*** PRE-FLOP *** 
Jojo-andros5 folds
SashaTDouss raises 0.03€ to 0.05€
orzanco folds
Fried Berg calls 0.05€
KKamarAAde folds
_gonzai_ folds
*** FLOP *** [Qd 9d 2d]
SashaTDouss checks
Fried Berg checks
*** TURN *** [Qd 9d 2d][Ah]
SashaTDouss bets 0.03€
Fried Berg calls 0.03€
*** RIVER *** [Qd 9d 2d Ah][As]
SashaTDouss bets 0.15€
Fried Berg folds
SashaTDouss collected 0.32€ from pot
*** SUMMARY ***
Total pot 0.32€ | Rake 0.02€
Board: [Qd 9d 2d Ah As]
Seat 4: SashaTDouss won 0.32€


Winamax Poker - HOLD-UP "Colorado" - HandId: #19116069-310878-1701417727 - Holdem no limit (0.01€/0.02€) - 2023/12/01 08:02:07 UTC
Table: 'Colorado' 6-max (real money) Seat #6 is the button
Seat 1: DDDIEU33 (1.07€)
Seat 2: La-CastafioR (1€)
Seat 3: KKamarAAde (2.37€)
Seat 4: Fried Berg (0.61€)
Seat 5: LilRun (2.07€)
Seat 6: NHL13 (1.74€)
*** ANTE/BLINDS ***
DDDIEU33 posts small blind 0.01€
La-CastafioR posts big blind 0.02€
Dealt to Fried Berg [Qc 8h]
*** PRE-FLOP *** 
KKamarAAde folds
Fried Berg folds
LilRun folds
NHL13 folds
DDDIEU33 calls 0.01€
La-CastafioR checks
*** FLOP *** [4c 8c 3c]
DDDIEU33 bets 0.04€
La-CastafioR folds
DDDIEU33 collected 0.08€ from pot
*** SUMMARY ***
Total pot 0.08€ | No rake
Board: [4c 8c 3c]
Seat 1: DDDIEU33 (small blind) won 0.08€


Winamax Poker - HOLD-UP "Colorado" - HandId: #19116069-310888-1701417746 - Holdem no limit (0.01€/0.02€) - 2023/12/01 08:02:26 UTC
Table: 'Colorado' 6-max (real money) Seat #6 is the button
Seat 1: LilRun (2.05€)
Seat 2: Fried Berg (0.61€)
Seat 3: jdeepenslip (4.86€)
Seat 4: KKamarAAde (2.37€)
Seat 5: SashaTDouss (3.01€)
Seat 6: bimach444 (2.02€)
*** ANTE/BLINDS ***
LilRun posts small blind 0.01€
Fried Berg posts big blind 0.02€
Dealt to Fried Berg [9s Jd]
*** PRE-FLOP *** 
jdeepenslip folds
KKamarAAde raises 0.04€ to 0.06€
SashaTDouss folds
bimach444 folds
LilRun folds
Fried Berg folds
KKamarAAde collected 0.09€ from pot
*** SUMMARY ***
Total pot 0.09€ | No rake
Seat 4: KKamarAAde won 0.09€


Winamax Poker - HOLD-UP "Colorado" - HandId: #19116069-310893-1701417756 - Holdem no limit (0.01€/0.02€) - 2023/12/01 08:02:36 UTC
Table: 'Colorado' 6-max (real money) Seat #6 is the button
Seat 1: La-CastafioR (0.98€)
Seat 2: NHL13 (1.70€)
Seat 3: Fried Berg (0.59€)
Seat 4: Manupoy (2.02€)
Seat 5: bimach444 (2€)
Seat 6: Jesperord98 (4.24€)
*** ANTE/BLINDS ***
La-CastafioR posts small blind 0.01€
NHL13 posts big blind 0.02€
Dealt to Fried Berg [Jc Ks]
*** PRE-FLOP *** 
Fried Berg raises 0.02€ to 0.04€
Manupoy calls 0.04€
bimach444 folds
Jesperord98 folds
La-CastafioR calls 0.03€
NHL13 folds
*** FLOP *** [Js Qc Qh]
La-CastafioR checks
Fried Berg checks
Manupoy bets 0.05€
La-CastafioR folds
Fried Berg calls 0.05€
*** TURN *** [Js Qc Qh][7d]
Fried Berg checks
Manupoy bets 0.02€
Fried Berg calls 0.02€
*** RIVER *** [Js Qc Qh 7d][9s]
Fried Berg checks
Manupoy checks
*** SHOW DOWN ***
Manupoy shows [Jh Ts] (Two pairs : Queens and Jacks)
Fried Berg shows [Jc Ks] (Two pairs : Queens and Jacks)
Fried Berg collected 0.25€ from pot
*** SUMMARY ***
Total pot 0.25€ | Rake 0.03€
Board: [Js Qc Qh 7d 9s]
Seat 3: Fried Berg showed [Jc Ks] and won 0.25€ with Two pairs : Queens and Jacks
Seat 4: Manupoy showed [Jh Ts] and lost with Two pairs : Queens and Jacks


Winamax Poker - HOLD-UP "Colorado" - HandId: #19116069-310918-1701417805 - Holdem no limit (0.01€/0.02€) - 2023/12/01 08:03:25 UTC
Table: 'Colorado' 6-max (real money) Seat #6 is the button
Seat 1: Fried Berg (0.73€)
Seat 2: matmyl (2.58€)
Seat 3: Jojo-andros5 (0.40€)
Seat 4: PIQSOU (2€)
Seat 5: Halmosthard (4.64€)
Seat 6: DDDIEU33 (1.07€)
Hold-up to Pot: total 0.10€
*** ANTE/BLINDS ***
Fried Berg posts small blind 0.01€
matmyl posts big blind 0.02€
Dealt to Fried Berg [6c 7c]
*** PRE-FLOP *** 
Jojo-andros5 raises 0.02€ to 0.04€
PIQSOU folds
Halmosthard calls 0.04€
DDDIEU33 folds
Fried Berg calls 0.03€
matmyl folds
*** FLOP *** [Qs Ac 7h]
Fried Berg checks
Jojo-andros5 bets 0.08€
Halmosthard folds
Fried Berg calls 0.08€
*** TURN *** [Qs Ac 7h][5s]
Fried Berg checks
Jojo-andros5 bets 0.28€ and is all-in
Fried Berg folds
Jojo-andros5 collected 0.65€ from pot
*** SUMMARY ***
Total pot 0.65€ | Rake 0.03€
Board: [Qs Ac 7h 5s]
Seat 3: Jojo-andros5 won 0.65€


Winamax Poker - HOLD-UP "Colorado" - HandId: #19116069-310950-1701417857 - Holdem no limit (0.01€/0.02€) - 2023/12/01 08:04:17 UTC
Table: 'Colorado' 6-max (real money) Seat #6 is the button
Seat 1: haouuum28 (2.01€)
Seat 2: tichettede3 (2.35€)
Seat 3: Sebidu57 (2.10€)
Seat 4: DigBick99 (2€)
Seat 5: Fried Berg (0.61€)
Seat 6: KKamarAAde (4.32€)
Hold-up to Pot: total 0.10€
*** ANTE/BLINDS ***
haouuum28 posts small blind 0.01€
tichettede3 posts big blind 0.02€
Dealt to Fried Berg [2s 2d]
*** PRE-FLOP *** 
Sebidu57 folds
DigBick99 folds
Fried Berg calls 0.02€
KKamarAAde folds
haouuum28 calls 0.01€
tichettede3 raises 0.16€ to 0.18€
Fried Berg folds
haouuum28 folds
tichettede3 collected 0.32€ from pot
*** SUMMARY ***
Total pot 0.32€ | No rake
Seat 2: tichettede3 (big blind) won 0.32€


Winamax Poker - HOLD-UP "Colorado" - HandId: #19116069-310969-1701417898 - Holdem no limit (0.01€/0.02€) - 2023/12/01 08:04:58 UTC
Table: 'Colorado' 6-max (real money) Seat #6 is the button
Seat 1: KKamarAAde (2.55€)
Seat 2: haouuum28 (1.94€)
Seat 3: jdeepenslip (9.25€)
Seat 4: bimach444 (2€)
Seat 5: WKMage919121 (2.31€)
Seat 6: Fried Berg (0.59€)
*** ANTE/BLINDS ***
KKamarAAde posts small blind 0.01€
haouuum28 posts big blind 0.02€
Dealt to Fried Berg [4s Js]
*** PRE-FLOP *** 
jdeepenslip folds
bimach444 raises 0.03€ to 0.05€
WKMage919121 calls 0.05€
Fried Berg folds
KKamarAAde folds
haouuum28 folds
*** FLOP *** [Th As Kc]
bimach444 checks
WKMage919121 checks
*** TURN *** [Th As Kc][Qh]
bimach444 bets 0.10€
WKMage919121 folds
bimach444 collected 0.22€ from pot
*** SUMMARY ***
Total pot 0.22€ | Rake 0.01€
Board: [Th As Kc Qh]
Seat 4: bimach444 won 0.22€


Winamax Poker - HOLD-UP "Colorado" - HandId: #19116069-310978-1701417914 - Holdem no limit (0.01€/0.02€) - 2023/12/01 08:05:14 UTC
Table: 'Colorado' 6-max (real money) Seat #6 is the button
Seat 1: KKamarAAde (2.45€)
Seat 2: Jojo-andros5 (0.63€)
Seat 3: tichettede3 (2.48€)
Seat 4: l artiste ho (2.74€)
Seat 5: Fried Berg (0.59€)
Seat 6: DigBick99 (2.25€)
*** ANTE/BLINDS ***
KKamarAAde posts small blind 0.01€
Jojo-andros5 posts big blind 0.02€
Dealt to Fried Berg [7d 2h]
*** PRE-FLOP *** 
tichettede3 folds
l artiste ho calls 0.02€
Fried Berg folds
DigBick99 raises 0.06€ to 0.08€
KKamarAAde calls 0.07€
Jojo-andros5 folds
l artiste ho calls 0.06€
*** FLOP *** [8d Ac 3d]
KKamarAAde checks
l artiste ho checks
DigBick99 bets 0.14€
KKamarAAde folds
l artiste ho folds
DigBick99 collected 0.37€ from pot
*** SUMMARY ***
Total pot 0.37€ | Rake 0.03€
Board: [8d Ac 3d]
Seat 6: DigBick99 (button) won 0.37€


Winamax Poker - HOLD-UP "Colorado" - HandId: #19116069-310982-1701417925 - Holdem no limit (0.01€/0.02€) - 2023/12/01 08:05:25 UTC
Table: 'Colorado' 6-max (real money) Seat #6 is the button
Seat 1: Manupoy (0.76€)
Seat 2: Fried Berg (0.59€)
Seat 3: PIQSOU (2.03€)
Seat 4: haouuum28 (1.91€)
Seat 5: tichettede3 (3.71€)
Seat 6: lucall-in (1.26€)
*** ANTE/BLINDS ***
Manupoy posts small blind 0.01€
Fried Berg posts big blind 0.02€
Dealt to Fried Berg [7h Ah]
*** PRE-FLOP *** 
PIQSOU raises 0.03€ to 0.05€
haouuum28 folds
tichettede3 folds
lucall-in folds
Manupoy folds
Fried Berg calls 0.03€
*** FLOP *** [7d Td 9c]
Fried Berg checks
PIQSOU bets 0.04€
Fried Berg calls 0.04€
*** TURN *** [7d Td 9c][2s]
Fried Berg checks
PIQSOU bets 0.19€
Fried Berg calls 0.19€
*** RIVER *** [7d Td 9c 2s][6h]
Fried Berg checks
PIQSOU bets 0.43€
Fried Berg calls 0.31€ and is all-in
*** SHOW DOWN ***
Fried Berg shows [7h Ah] (One pair : 7)
PIQSOU shows [Jh Jc] (One pair : Jacks)
PIQSOU collected 1.19€ from pot
*** SUMMARY ***
Total pot 1.19€ | Rake 0.12€
Board: [7d Td 9c 2s 6h]
Seat 2: Fried Berg (big blind) showed [7h Ah] and lost with One pair : 7
Seat 3: PIQSOU showed [Jh Jc] and won 1.19€ with One pair : Jacks


Winamax Poker - HOLD-UP "Colorado" - HandId: #19116069-311016-1701418006 - Holdem no limit (0.01€/0.02€) - 2023/12/01 08:06:46 UTC
Table: 'Colorado' 6-max (real money) Seat #6 is the button
Seat 1: Fried Berg (0.50€)
Seat 2: Halmosthard (1.46€)
Seat 3: Jojo-andros5 (0.57€)
Seat 4: tichettede3 (2.47€)
Seat 5: Shark&Fish52 (1.41€)
Seat 6: KKamarAAde (4.34€)
*** ANTE/BLINDS ***
Fried Berg posts small blind 0.01€
Halmosthard posts big blind 0.02€
Dealt to Fried Berg [7s Ac]
*** PRE-FLOP *** 
Jojo-andros5 folds
tichettede3 folds
Shark&Fish52 folds
KKamarAAde raises 0.04€ to 0.06€
Fried Berg folds
Halmosthard folds
KKamarAAde collected 0.09€ from pot
*** SUMMARY ***
Total pot 0.09€ | No rake
Seat 6: KKamarAAde (button) won 0.09€


Winamax Poker - HOLD-UP "Colorado" - HandId: #19116069-311025-1701418022 - Holdem no limit (0.01€/0.02€) - 2023/12/01 08:07:02 UTC
Table: 'Colorado' 6-max (real money) Seat #6 is the button
Seat 1: Halmosthard (1.44€)
Seat 2: haouuum28 (1.98€)
Seat 3: Fried Berg (0.49€)
Seat 4: Tontax78 (0.98€)
Seat 5: jdeepenslip (9.21€)
Seat 6: PIQSOU (2.17€)
*** ANTE/BLINDS ***
Halmosthard posts small blind 0.01€
haouuum28 posts big blind 0.02€
Dealt to Fried Berg [8s Ac]
*** PRE-FLOP *** 
Fried Berg raises 0.02€ to 0.04€
Tontax78 calls 0.04€
jdeepenslip folds
PIQSOU raises 0.12€ to 0.16€
Halmosthard folds
haouuum28 folds
Fried Berg folds
Tontax78 calls 0.12€
*** FLOP *** [Ks Qd 9d]
Tontax78 checks
PIQSOU bets 0.13€
Tontax78 calls 0.13€
*** TURN *** [Ks Qd 9d][5s]
Tontax78 checks
PIQSOU bets 0.49€
Tontax78 raises 0.20€ to 0.69€ and is all-in
PIQSOU calls 0.20€
*** RIVER *** [Ks Qd 9d 5s][3s]
*** SHOW DOWN ***
Tontax78 shows [Ah Jd] (High card : Ace)
PIQSOU shows [Kh As] (One pair : Kings)
PIQSOU collected 1.83€ from pot
*** SUMMARY ***
Total pot 1.83€ | Rake 0.20€
Board: [Ks Qd 9d 5s 3s]
Seat 4: Tontax78 showed [Ah Jd] and lost with High card : Ace
Seat 6: PIQSOU (button) showed [Kh As] and won 1.83€ with One pair : Kings


Winamax Poker - HOLD-UP "Colorado" - HandId: #19116069-311046-1701418070 - Holdem no limit (0.01€/0.02€) - 2023/12/01 08:07:50 UTC
Table: 'Colorado' 6-max (real money) Seat #6 is the button
Seat 1: jdeepenslip (9.13€)
Seat 2: Shark&Fish52 (1.47€)
Seat 3: Zile741 (3.74€)
Seat 4: Fried Berg (0.45€)
Seat 5: Tontax78 (2€)
Seat 6: PIQSOU (3.02€)
*** ANTE/BLINDS ***
jdeepenslip posts small blind 0.01€
Shark&Fish52 posts big blind 0.02€
Dealt to Fried Berg [Ah 5d]
*** PRE-FLOP *** 
Zile741 folds
Fried Berg folds
Tontax78 raises 0.05€ to 0.07€
PIQSOU folds
jdeepenslip folds
Shark&Fish52 folds
Tontax78 collected 0.10€ from pot
*** SUMMARY ***
Total pot 0.10€ | No rake
Seat 5: Tontax78 won 0.10€


Winamax Poker - HOLD-UP "Colorado" - HandId: #19116069-311048-1701418077 - Holdem no limit (0.01€/0.02€) - 2023/12/01 08:07:57 UTC
Table: 'Colorado' 6-max (real money) Seat #6 is the button
Seat 1: DigBick99 (2.77€)
Seat 2: Vergnaud16 (0.76€)
Seat 3: KKamarAAde (2.38€)
Seat 4: _gonzai_ (2.12€)
Seat 5: La-CastafioR (0.73€)
Seat 6: Fried Berg (0.45€)
*** ANTE/BLINDS ***
DigBick99 posts small blind 0.01€
Vergnaud16 posts big blind 0.02€
Dealt to Fried Berg [4d Td]
*** PRE-FLOP *** 
KKamarAAde folds
_gonzai_ folds
La-CastafioR folds
Fried Berg folds
DigBick99 folds
Vergnaud16 collected 0.03€ from pot
*** SUMMARY ***
Total pot 0.03€ | No rake
Seat 2: Vergnaud16 (big blind) won 0.03€


Winamax Poker - HOLD-UP "Colorado" - HandId: #19116069-311051-1701418083 - Holdem no limit (0.01€/0.02€) - 2023/12/01 08:08:03 UTC
Table: 'Colorado' 6-max (real money) Seat #6 is the button
Seat 1: Ewynner (2€)
Seat 2: jdeepenslip (9.12€)
Seat 3: cygoud (2€)
Seat 4: Fried Berg (0.45€)
Seat 5: Manupoy (0.70€)
Seat 6: KKamarAAde (2.48€)
*** ANTE/BLINDS ***
Ewynner posts small blind 0.01€
jdeepenslip posts big blind 0.02€
Dealt to Fried Berg [7s 5s]
*** PRE-FLOP *** 
cygoud folds
Fried Berg calls 0.02€
Manupoy calls 0.02€
KKamarAAde folds
Ewynner raises 0.03€ to 0.05€
jdeepenslip folds
Fried Berg calls 0.03€
Manupoy calls 0.03€
*** FLOP *** [Qd Jh 5h]
Ewynner checks
Fried Berg checks
Manupoy checks
*** TURN *** [Qd Jh 5h][8h]
Ewynner bets 0.11€
Fried Berg calls 0.11€
Manupoy folds
*** RIVER *** [Qd Jh 5h 8h][7h]
Ewynner bets 1.84€ and is all-in
Fried Berg folds
Ewynner collected 2.19€ from pot
*** SUMMARY ***
Total pot 2.19€ | Rake 0.04€
Board: [Qd Jh 5h 8h 7h]
Seat 1: Ewynner (small blind) won 2.19€


Winamax Poker - HOLD-UP "Colorado" - HandId: #19116069-311077-1701418137 - Holdem no limit (0.01€/0.02€) - 2023/12/01 08:08:57 UTC
Table: 'Colorado' 6-max (real money) Seat #6 is the button
Seat 1: haouuum28 (2.07€)
Seat 2: Fried Berg (0.29€)
Seat 3: Tontax78 (1.53€)
Seat 4: Sebidu57 (1.05€)
Seat 5: cygoud (2.16€)
Seat 6: PIQSOU (3€)
*** ANTE/BLINDS ***
haouuum28 posts small blind 0.01€
Fried Berg posts big blind 0.02€
Dealt to Fried Berg [6h Ts]
*** PRE-FLOP *** 
Tontax78 raises 0.04€ to 0.06€
Sebidu57 folds
cygoud folds
PIQSOU folds
haouuum28 raises 2.01€ to 2.07€ and is all-in
Fried Berg folds
Tontax78 calls 1.47€ and is all-in
*** FLOP *** [6d 6c As]
*** TURN *** [6d 6c As][4h]
*** RIVER *** [6d 6c As 4h][5d]
*** SHOW DOWN ***
Tontax78 shows [Qc Qh] (Two pairs : Queens and 6)
haouuum28 shows [Ac Kd] (Two pairs : Aces and 6)
haouuum28 collected 3.31€ from pot
*** SUMMARY ***
Total pot 3.31€ | Rake 0.31€
Board: [6d 6c As 4h 5d]
Seat 1: haouuum28 (small blind) showed [Ac Kd] and won 3.31€ with Two pairs : Aces and 6
Seat 3: Tontax78 showed [Qc Qh] and lost with Two pairs : Queens and 6


Winamax Poker - HOLD-UP "Colorado" - HandId: #19116069-311085-1701418147 - Holdem no limit (0.01€/0.02€) - 2023/12/01 08:09:07 UTC
Table: 'Colorado' 6-max (real money) Seat #6 is the button
Seat 1: Fried Berg (0.27€)
Seat 2: cygoud (2€)
Seat 3: gagnejamais4 (4.90€)
Seat 4: lucall-in (1.23€)
Seat 5: Halmosthard (4.79€)
Seat 6: GS Padrino84 (2.96€)
*** ANTE/BLINDS ***
Fried Berg posts small blind 0.01€
cygoud posts big blind 0.02€
Dealt to Fried Berg [9h 7h]
*** PRE-FLOP *** 
gagnejamais4 folds
lucall-in raises 0.04€ to 0.06€
Halmosthard folds
GS Padrino84 folds
Fried Berg folds
cygoud folds
lucall-in collected 0.09€ from pot
*** SUMMARY ***
Total pot 0.09€ | No rake
Seat 4: lucall-in won 0.09€


Winamax Poker - HOLD-UP "Colorado" - HandId: #19116069-311095-1701418165 - Holdem no limit (0.01€/0.02€) - 2023/12/01 08:09:25 UTC
Table: 'Colorado' 6-max (real money) Seat #6 is the button
Seat 1: KKamarAAde (2.39€)
Seat 2: SashaTDouss (2.51€)
Seat 3: LAG0URMANDE (2.10€)
Seat 4: tichettede3 (2€)
Seat 5: Fried Berg (0.26€)
Seat 6: l artiste ho (2.41€)
*** ANTE/BLINDS ***
KKamarAAde posts small blind 0.01€
SashaTDouss posts big blind 0.02€
Dealt to Fried Berg [Ad Tc]
*** PRE-FLOP *** 
LAG0URMANDE folds
tichettede3 folds
Fried Berg raises 0.02€ to 0.04€
l artiste ho folds
KKamarAAde folds
SashaTDouss calls 0.02€
*** FLOP *** [9s 8c 9d]
SashaTDouss checks
Fried Berg bets 0.06€
SashaTDouss raises 0.21€ to 0.27€
Fried Berg calls 0.16€ and is all-in
*** TURN *** [9s 8c 9d][6c]
*** RIVER *** [9s 8c 9d 6c][Js]
*** SHOW DOWN ***
Fried Berg shows [Ad Tc] (One pair : 9)
SashaTDouss shows [Td 9c] (Trips of 9)
SashaTDouss collected 0.53€ from pot
*** SUMMARY ***
Total pot 0.53€ | Rake 0.05€
Board: [9s 8c 9d 6c Js]
Seat 2: SashaTDouss (big blind) showed [Td 9c] and won 0.53€ with Trips of 9
Seat 5: Fried Berg showed [Ad Tc] and lost with One pair : 9


Winamax Poker - HOLD-UP "Colorado" - HandId: #19116069-311121-1701418224 - Holdem no limit (0.01€/0.02€) - 2023/12/01 08:10:24 UTC
Table: 'Colorado' 6-max (real money) Seat #6 is the button
Seat 1: Jeje27 (3.10€)
Seat 2: KKamarAAde (2.37€)
Seat 3: Fried Berg (0.50€)
Seat 4: l artiste ho (2.39€)
Seat 5: DigBick99 (2.01€)
Seat 6: cygoud (2.13€)
*** ANTE/BLINDS ***
Jeje27 posts small blind 0.01€
KKamarAAde posts big blind 0.02€
Dealt to Fried Berg [2c 3s]
*** PRE-FLOP *** 
Fried Berg folds
l artiste ho folds
DigBick99 folds
cygoud folds
Jeje27 folds
KKamarAAde collected 0.03€ from pot
*** SUMMARY ***
Total pot 0.03€ | No rake
Seat 2: KKamarAAde (big blind) won 0.03€


Winamax Poker - HOLD-UP "Colorado" - HandId: #19116069-311126-1701418230 - Holdem no limit (0.01€/0.02€) - 2023/12/01 08:10:30 UTC
Table: 'Colorado' 6-max (real money) Seat #6 is the button
Seat 1: tichettede3 (3.73€)
Seat 2: jdeepenslip (9.04€)
Seat 3: Polanskii (2€)
Seat 4: Zile741 (4.62€)
Seat 5: orzanco (1.43€)
Seat 6: Fried Berg (0.50€)
*** ANTE/BLINDS ***
tichettede3 posts small blind 0.01€
jdeepenslip posts big blind 0.02€
Dealt to Fried Berg [8s 8h]
*** PRE-FLOP *** 
Polanskii folds
Zile741 folds
orzanco folds
Fried Berg raises 0.02€ to 0.04€
tichettede3 calls 0.03€
jdeepenslip folds
*** FLOP *** [2h 3s 7s]
tichettede3 checks
Fried Berg bets 0.05€
tichettede3 raises 0.20€ to 0.25€
Fried Berg raises 0.21€ to 0.46€ and is all-in
tichettede3 calls 0.21€
*** TURN *** [2h 3s 7s][Ad]
*** RIVER *** [2h 3s 7s Ad][5c]
*** SHOW DOWN ***
tichettede3 shows [9h 7h] (One pair : 7)
Fried Berg shows [8s 8h] (One pair : 8)
Fried Berg collected 0.92€ from pot
*** SUMMARY ***
Total pot 0.92€ | Rake 0.10€
Board: [2h 3s 7s Ad 5c]
Seat 1: tichettede3 (small blind) showed [9h 7h] and lost with One pair : 7
Seat 6: Fried Berg (button) showed [8s 8h] and won 0.92€ with One pair : 8


Winamax Poker - HOLD-UP "Colorado" - HandId: #19116069-311161-1701418291 - Holdem no limit (0.01€/0.02€) - 2023/12/01 08:11:31 UTC
Table: 'Colorado' 6-max (real money) Seat #6 is the button
Seat 1: bimach444 (5.09€)
Seat 2: orzanco (1.43€)
Seat 3: tichettede3 (3.23€)
Seat 4: KKamarAAde (9.30€)
Seat 5: Fried Berg (0.92€)
Seat 6: cygoud (2.39€)
*** ANTE/BLINDS ***
bimach444 posts small blind 0.01€
orzanco posts big blind 0.02€
Dealt to Fried Berg [Qs 7h]
*** PRE-FLOP *** 
tichettede3 folds
KKamarAAde folds
Fried Berg folds
cygoud folds
bimach444 folds
orzanco collected 0.03€ from pot
*** SUMMARY ***
Total pot 0.03€ | No rake
Seat 2: orzanco (big blind) won 0.03€


Winamax Poker - HOLD-UP "Colorado" - HandId: #19116069-311170-1701418310 - Holdem no limit (0.01€/0.02€) - 2023/12/01 08:11:50 UTC
Table: 'Colorado' 6-max (real money) Seat #6 is the button
Seat 1: Fried Berg (0.92€)
Seat 2: Jojo-andros5 (0.44€)
Seat 3: KKamarAAde (2.01€)
Seat 4: PIQSOU (2.78€)
Seat 5: LAG0URMANDE (2.37€)
Seat 6: Kekoke (0.85€)
*** ANTE/BLINDS ***
Fried Berg posts small blind 0.01€
Jojo-andros5 posts big blind 0.02€
Dealt to Fried Berg [As 5h]
*** PRE-FLOP *** 
KKamarAAde folds
PIQSOU raises 0.03€ to 0.05€
LAG0URMANDE folds
Kekoke folds
Fried Berg folds
Jojo-andros5 calls 0.03€
*** FLOP *** [8d Qc Kd]
Jojo-andros5 bets 0.04€
PIQSOU calls 0.04€
*** TURN *** [8d Qc Kd][Qs]
Jojo-andros5 bets 0.07€
PIQSOU calls 0.07€
*** RIVER *** [8d Qc Kd Qs][Jh]
Jojo-andros5 bets 0.12€
PIQSOU calls 0.12€
*** SHOW DOWN ***
PIQSOU shows [5d Jd] (Two pairs : Queens and Jacks)
Jojo-andros5 shows [Td Ad] (Straight Ace high)
Jojo-andros5 collected 0.51€ from pot
*** SUMMARY ***
Total pot 0.51€ | Rake 0.06€
Board: [8d Qc Kd Qs Jh]
Seat 2: Jojo-andros5 (big blind) showed [Td Ad] and won 0.51€ with Straight Ace high
Seat 4: PIQSOU showed [5d Jd] and lost with Two pairs : Queens and Jacks


Winamax Poker - HOLD-UP "Colorado" - HandId: #19116069-311176-1701418324 - Holdem no limit (0.01€/0.02€) - 2023/12/01 08:12:04 UTC
Table: 'Colorado' 6-max (real money) Seat #6 is the button
Seat 1: _gonzai_ (2.05€)
Seat 2: cygoud (2.10€)
Seat 3: LAG0URMANDE (2.35€)
Seat 4: LilRun (1.63€)
Seat 5: CB-Joker6274 (8.41€)
Seat 6: Fried Berg (0.91€)
*** ANTE/BLINDS ***
_gonzai_ posts small blind 0.01€
cygoud posts big blind 0.02€
Dealt to Fried Berg [Ts 2d]
*** PRE-FLOP *** 
LAG0URMANDE folds
LilRun folds
CB-Joker6274 raises 0.04€ to 0.06€
Fried Berg folds
_gonzai_ folds
cygoud folds
CB-Joker6274 collected 0.09€ from pot
*** SUMMARY ***
Total pot 0.09€ | No rake
Seat 5: CB-Joker6274 won 0.09€


Winamax Poker - HOLD-UP "Colorado" - HandId: #19116069-311178-1701418327 - Holdem no limit (0.01€/0.02€) - 2023/12/01 08:12:07 UTC
Table: 'Colorado' 6-max (real money) Seat #6 is the button
Seat 1: _gonzai_ (2.04€)
Seat 2: LilRun (1.63€)
Seat 3: Sebidu57 (1.27€)
Seat 4: LAG0URMANDE (2.34€)
Seat 5: 1LEOPARDO (2.57€)
Seat 6: Fried Berg (0.91€)
*** ANTE/BLINDS ***
_gonzai_ posts small blind 0.01€
LilRun posts big blind 0.02€
Dealt to Fried Berg [7c 7h]
*** PRE-FLOP *** 
Sebidu57 raises 0.05€ to 0.07€
LAG0URMANDE folds
1LEOPARDO calls 0.07€
Fried Berg raises 0.14€ to 0.21€
_gonzai_ folds
LilRun folds
Sebidu57 folds
1LEOPARDO calls 0.14€
*** FLOP *** [5h 2c 8h]
1LEOPARDO checks
Fried Berg bets 0.42€
1LEOPARDO folds
Fried Berg collected 0.89€ from pot
*** SUMMARY ***
Total pot 0.89€ | Rake 0.05€
Board: [5h 2c 8h]
Seat 6: Fried Berg (button) won 0.89€


Winamax Poker - HOLD-UP "Colorado" - HandId: #19116069-311190-1701418361 - Holdem no limit (0.01€/0.02€) - 2023/12/01 08:12:41 UTC
Table: 'Colorado' 6-max (real money) Seat #6 is the button
Seat 1: vicieux59 (0.48€)
Seat 2: Fried Berg (1.17€)
Seat 3: DDDIEU33 (1.85€)
Seat 4: orzanco (1.44€)
Seat 5: Ewynner (2€)
Seat 6: LilRun (1.54€)
*** ANTE/BLINDS ***
vicieux59 posts small blind 0.01€
Fried Berg posts big blind 0.02€
Dealt to Fried Berg [3d Ts]
*** PRE-FLOP *** 
DDDIEU33 folds
orzanco folds
Ewynner folds
LilRun folds
vicieux59 folds
Fried Berg collected 0.03€ from pot
*** SUMMARY ***
Total pot 0.03€ | No rake
Seat 2: Fried Berg (big blind) won 0.03€


Winamax Poker - HOLD-UP "Colorado" - HandId: #19116069-311195-1701418368 - Holdem no limit (0.01€/0.02€) - 2023/12/01 08:12:48 UTC
Table: 'Colorado' 6-max (real money) Seat #6 is the button
Seat 1: bimach444 (2.39€)
Seat 2: PrimoRaged (1.92€)
Seat 3: Fried Berg (1.18€)
Seat 4: moussaillax (1.97€)
Seat 5: PIQSOU (3.05€)
Seat 6: _gonzai_ (2€)
*** ANTE/BLINDS ***
bimach444 posts small blind 0.01€
PrimoRaged posts big blind 0.02€
Dealt to Fried Berg [2h Jh]
*** PRE-FLOP *** 
Fried Berg folds
moussaillax raises 0.03€ to 0.05€
PIQSOU folds
_gonzai_ folds
bimach444 folds
PrimoRaged folds
moussaillax collected 0.08€ from pot
*** SUMMARY ***
Total pot 0.08€ | No rake
Seat 4: moussaillax won 0.08€


Winamax Poker - HOLD-UP "Colorado" - HandId: #19116069-311197-1701418370 - Holdem no limit (0.01€/0.02€) - 2023/12/01 08:12:50 UTC
Table: 'Colorado' 6-max (real money) Seat #6 is the button
Seat 1: orzanco (1.44€)
Seat 2: ZJER10 (3€)
Seat 3: Mercuryllo (2€)
Seat 4: Piiranha (2.73€)
Seat 5: Sebidu57 (1.11€)
Seat 6: Fried Berg (1.18€)
*** ANTE/BLINDS ***
orzanco posts small blind 0.01€
ZJER10 posts big blind 0.02€
Dealt to Fried Berg [Kd 5h]
*** PRE-FLOP *** 
Mercuryllo folds
Piiranha folds
Sebidu57 raises 0.04€ to 0.06€
Fried Berg folds
orzanco folds
ZJER10 calls 0.04€
*** FLOP *** [Qh 9s 7c]
ZJER10 checks
Sebidu57 bets 0.08€
ZJER10 calls 0.08€
*** TURN *** [Qh 9s 7c][Qc]
ZJER10 checks
Sebidu57 checks
*** RIVER *** [Qh 9s 7c Qc][4c]
ZJER10 bets 0.18€
Sebidu57 raises 0.36€ to 0.54€
ZJER10 folds
Sebidu57 collected 0.94€ from pot
*** SUMMARY ***
Total pot 0.94€ | Rake 0.07€
Board: [Qh 9s 7c Qc 4c]
Seat 5: Sebidu57 won 0.94€


Winamax Poker - HOLD-UP "Colorado" - HandId: #19116069-311204-1701418378 - Holdem no limit (0.01€/0.02€) - 2023/12/01 08:12:58 UTC
Table: 'Colorado' 6-max (real money) Seat #6 is the button
Seat 1: Fried Berg (1.18€)
Seat 2: cygoud (2€)
Seat 3: Piiranha (2.73€)
Seat 4: _gonzai_ (2€)
Seat 5: haouuum28 (1.99€)
Seat 6: jdeepenslip (9€)
*** ANTE/BLINDS ***
Fried Berg posts small blind 0.01€
cygoud posts big blind 0.02€
Dealt to Fried Berg [2s 3h]
*** PRE-FLOP *** 
Piiranha raises 0.04€ to 0.06€
_gonzai_ folds
haouuum28 folds
jdeepenslip folds
Fried Berg folds
cygoud raises 0.13€ to 0.19€
Piiranha calls 0.13€
*** FLOP *** [Qc Td Ad]
cygoud bets 0.29€
Piiranha calls 0.29€
*** TURN *** [Qc Td Ad][5c]
cygoud bets 1.52€ and is all-in
Piiranha calls 1.52€
*** RIVER *** [Qc Td Ad 5c][As]
*** SHOW DOWN ***
Piiranha shows [Jd Ah] (Trips of Aces)
cygoud shows [Qs Qh] (Full of Queens and Aces)
cygoud collected 3.61€ from pot
*** SUMMARY ***
Total pot 3.61€ | Rake 0.40€
Board: [Qc Td Ad 5c As]
Seat 2: cygoud (big blind) showed [Qs Qh] and won 3.61€ with Full of Queens and Aces
Seat 3: Piiranha showed [Jd Ah] and lost with Trips of Aces


Winamax Poker - HOLD-UP "Colorado" - HandId: #19116069-311213-1701418391 - Holdem no limit (0.01€/0.02€) - 2023/12/01 08:13:11 UTC
Table: 'Colorado' 6-max (real money) Seat #6 is the button
Seat 1: tichettede3 (2.38€)
Seat 2: Halmosthard (2.05€)
Seat 3: Fried Berg (1.17€)
Seat 4: Manupoy (2.06€)
Seat 5: Zile741 (4.34€)
Seat 6: KKamarAAde (1.96€)
*** ANTE/BLINDS ***
tichettede3 posts small blind 0.01€
Halmosthard posts big blind 0.02€
Dealt to Fried Berg [2s 3s]
*** PRE-FLOP *** 
Fried Berg calls 0.02€
Manupoy folds
Zile741 raises 0.07€ to 0.09€
KKamarAAde folds
tichettede3 folds
Halmosthard folds
Fried Berg folds
Zile741 collected 0.14€ from pot
*** SUMMARY ***
Total pot 0.14€ | No rake
Seat 5: Zile741 won 0.14€


Winamax Poker - HOLD-UP "Colorado" - HandId: #19116069-311224-1701418411 - Holdem no limit (0.01€/0.02€) - 2023/12/01 08:13:31 UTC
Table: 'Colorado' 6-max (real money) Seat #6 is the button
Seat 1: DigBick99 (2€)
Seat 2: Fried Berg (1.15€)
Seat 3: PIQSOU (2€)
Seat 4: Manupoy (3.72€)
Seat 5: KKamarAAde (4.36€)
Seat 6: haouuum28 (2.35€)
*** ANTE/BLINDS ***
DigBick99 posts small blind 0.01€
Fried Berg posts big blind 0.02€
Dealt to Fried Berg [5h Jh]
*** PRE-FLOP *** 
PIQSOU folds
Manupoy folds
KKamarAAde folds
haouuum28 raises 0.04€ to 0.06€
DigBick99 folds
Fried Berg calls 0.04€
*** FLOP *** [3h 9d 4h]
Fried Berg checks
haouuum28 bets 0.05€
Fried Berg calls 0.05€
*** TURN *** [3h 9d 4h][Ac]
Fried Berg checks
haouuum28 bets 0.18€
Fried Berg calls 0.18€
*** RIVER *** [3h 9d 4h Ac][6h]
Fried Berg checks
haouuum28 checks
*** SHOW DOWN ***
haouuum28 shows [Ah Kd] (One pair : Aces)
Fried Berg shows [5h Jh] (Flush Jack high)
Fried Berg collected 0.53€ from pot
*** SUMMARY ***
Total pot 0.53€ | Rake 0.06€
Board: [3h 9d 4h Ac 6h]
Seat 2: Fried Berg (big blind) showed [5h Jh] and won 0.53€ with Flush Jack high
Seat 6: haouuum28 (button) showed [Ah Kd] and lost with One pair : Aces


Winamax Poker - HOLD-UP "Colorado" - HandId: #19116069-311252-1701418475 - Holdem no limit (0.01€/0.02€) - 2023/12/01 08:14:35 UTC
Table: 'Colorado' 6-max (real money) Seat #6 is the button
Seat 1: Cejargordas (2€)
Seat 2: KKamarAAde (1.87€)
Seat 3: gagnejamais4 (4.96€)
Seat 4: Fried Berg (1.39€)
Seat 5: DigBick99 (2.14€)
Seat 6: tichettede3 (3.25€)
*** ANTE/BLINDS ***
Cejargordas posts small blind 0.01€
KKamarAAde posts big blind 0.02€
Dealt to Fried Berg [7d 2h]
*** PRE-FLOP *** 
gagnejamais4 folds
Fried Berg folds
DigBick99 folds
tichettede3 folds
Cejargordas raises 0.04€ to 0.06€
KKamarAAde calls 0.04€
*** FLOP *** [Jc 4d Th]
Cejargordas checks
KKamarAAde bets 0.08€
Cejargordas folds
KKamarAAde collected 0.19€ from pot
*** SUMMARY ***
Total pot 0.19€ | Rake 0.01€
Board: [Jc 4d Th]
Seat 2: KKamarAAde (big blind) won 0.19€


Winamax Poker - HOLD-UP "Colorado" - HandId: #19116069-311257-1701418484 - Holdem no limit (0.01€/0.02€) - 2023/12/01 08:14:44 UTC
Table: 'Colorado' 6-max (real money) Seat #6 is the button
Seat 1: tichettede3 (2.17€)
Seat 2: PIQSOU (5.54€)
Seat 3: Ewynner (2€)
Seat 4: Fried Berg (1.39€)
Seat 5: cygoud (3.03€)
Seat 6: Jeje27 (4.66€)
Hold-up to Pot: total 0.10€
*** ANTE/BLINDS ***
tichettede3 posts small blind 0.01€
PIQSOU posts big blind 0.02€
Dealt to Fried Berg [3h 7h]
*** PRE-FLOP *** 
Ewynner folds
Fried Berg folds
cygoud folds
Jeje27 calls 0.02€
tichettede3 folds
PIQSOU checks
*** FLOP *** [5s 3d Ac]
PIQSOU checks
Jeje27 checks
*** TURN *** [5s 3d Ac][Kd]
PIQSOU checks
Jeje27 bets 0.05€
PIQSOU folds
Jeje27 collected 0.19€ from pot
*** SUMMARY ***
Total pot 0.19€ | Rake 0.01€
Board: [5s 3d Ac Kd]
Seat 6: Jeje27 (button) won 0.19€


Winamax Poker - HOLD-UP "Colorado" - HandId: #19116069-311264-1701418499 - Holdem no limit (0.01€/0.02€) - 2023/12/01 08:14:59 UTC
Table: 'Colorado' 6-max (real money) Seat #6 is the button
Seat 1: tichettede3 (3.25€)
Seat 2: Halmosthard (2.02€)
Seat 3: CB-Joker6274 (7.91€)
Seat 4: Sebidu57 (1€)
Seat 5: Fried Berg (1.39€)
Seat 6: Manupoy (3.59€)
*** ANTE/BLINDS ***
tichettede3 posts small blind 0.01€
Halmosthard posts big blind 0.02€
Dealt to Fried Berg [Jh 3s]
*** PRE-FLOP *** 
CB-Joker6274 folds
Sebidu57 folds
Fried Berg folds
Manupoy calls 0.02€
tichettede3 folds
Halmosthard checks
*** FLOP *** [4s 2c 3h]
Halmosthard bets 0.02€
Manupoy folds
Halmosthard collected 0.06€ from pot
*** SUMMARY ***
Total pot 0.06€ | Rake 0.01€
Board: [4s 2c 3h]
Seat 2: Halmosthard (big blind) won 0.06€


Winamax Poker - HOLD-UP "Colorado" - HandId: #19116069-311270-1701418506 - Holdem no limit (0.01€/0.02€) - 2023/12/01 08:15:06 UTC
Table: 'Colorado' 6-max (real money) Seat #6 is the button
Seat 1: CB-Joker6274 (7.90€)
Seat 2: DDDIEU33 (1.76€)
Seat 3: Fried Berg (1.39€)
Seat 4: SashaTDouss (2.48€)
Seat 5: PrimoRaged (2.05€)
Seat 6: DigBick99 (2.76€)
*** ANTE/BLINDS ***
CB-Joker6274 posts small blind 0.01€
DDDIEU33 posts big blind 0.02€
Dealt to Fried Berg [7s Td]
*** PRE-FLOP *** 
Fried Berg folds
SashaTDouss folds
PrimoRaged folds
DigBick99 raises 0.03€ to 0.05€
CB-Joker6274 folds
DDDIEU33 folds
DigBick99 collected 0.08€ from pot
*** SUMMARY ***
Total pot 0.08€ | No rake
Seat 6: DigBick99 (button) won 0.08€


Winamax Poker - HOLD-UP "Colorado" - HandId: #19116069-311272-1701418508 - Holdem no limit (0.01€/0.02€) - 2023/12/01 08:15:08 UTC
Table: 'Colorado' 6-max (real money) Seat #6 is the button
Seat 1: Hagreed (1.94€)
Seat 2: PrimoRaged (2.05€)
Seat 3: cygoud (3.57€)
Seat 4: haouuum28 (2.04€)
Seat 5: Cejargordas (2€)
Seat 6: Fried Berg (1.39€)
*** ANTE/BLINDS ***
Hagreed posts small blind 0.01€
PrimoRaged posts big blind 0.02€
Dealt to Fried Berg [9s Kd]
*** PRE-FLOP *** 
cygoud folds
haouuum28 folds
Cejargordas folds
Fried Berg raises 0.02€ to 0.04€
Hagreed folds
PrimoRaged folds
Fried Berg collected 0.07€ from pot
*** SUMMARY ***
Total pot 0.07€ | No rake
Seat 6: Fried Berg (button) won 0.07€


Winamax Poker - HOLD-UP "Colorado" - HandId: #19116069-311278-1701418519 - Holdem no limit (0.01€/0.02€) - 2023/12/01 08:15:19 UTC
Table: 'Colorado' 6-max (real money) Seat #6 is the button
Seat 1: Fried Berg (1.42€)
Seat 2: Tontax78 (1.51€)
Seat 3: LAG0URMANDE (2€)
Seat 4: cygoud (3.01€)
Seat 5: jdeepenslip (8.97€)
Seat 6: lucall-in (2.09€)
*** ANTE/BLINDS ***
Fried Berg posts small blind 0.01€
Tontax78 posts big blind 0.02€
Dealt to Fried Berg [2h 3h]
*** PRE-FLOP *** 
LAG0URMANDE folds
cygoud folds
jdeepenslip folds
lucall-in folds
Fried Berg raises 0.02€ to 0.04€
Tontax78 folds
Fried Berg collected 0.06€ from pot
*** SUMMARY ***
Total pot 0.06€ | No rake
Seat 1: Fried Berg (small blind) won 0.06€


Winamax Poker - HOLD-UP "Colorado" - HandId: #19116069-311288-1701418539 - Holdem no limit (0.01€/0.02€) - 2023/12/01 08:15:39 UTC
Table: 'Colorado' 6-max (real money) Seat #6 is the button
Seat 1: PIQSOU (3.04€)
Seat 2: Cejargordas (2€)
Seat 3: Polanskii (2.08€)
Seat 4: KKamarAAde (2.41€)
Seat 5: Fried Berg (1.44€)
Seat 6: haouuum28 (2.29€)
*** ANTE/BLINDS ***
PIQSOU posts small blind 0.01€
Cejargordas posts big blind 0.02€
Dealt to Fried Berg [Kc 3c]
*** PRE-FLOP *** 
Polanskii folds
KKamarAAde raises 0.04€ to 0.06€
Fried Berg folds
haouuum28 calls 0.06€
PIQSOU folds
Cejargordas folds
*** FLOP *** [9s 7d Td]
KKamarAAde bets 0.10€
haouuum28 calls 0.10€
*** TURN *** [9s 7d Td][Ks]
KKamarAAde bets 0.23€
haouuum28 folds
KKamarAAde collected 0.54€ from pot
*** SUMMARY ***
Total pot 0.54€ | Rake 0.04€
Board: [9s 7d Td Ks]
Seat 4: KKamarAAde won 0.54€


Winamax Poker - HOLD-UP "Colorado" - HandId: #19116069-311296-1701418561 - Holdem no limit (0.01€/0.02€) - 2023/12/01 08:16:01 UTC
Table: 'Colorado' 6-max (real money) Seat #6 is the button
Seat 1: haamataraa (1.71€)
Seat 2: Fried Berg (1.44€)
Seat 3: DigBick99 (2.36€)
Seat 4: _RaiseMint_ (3.16€)
Seat 5: tichettede3 (2.23€)
Seat 6: Ewynner (2€)
*** ANTE/BLINDS ***
haamataraa posts small blind 0.01€
Fried Berg posts big blind 0.02€
Dealt to Fried Berg [Ts Th]
*** PRE-FLOP *** 
DigBick99 folds
_RaiseMint_ folds
tichettede3 folds
Ewynner folds
haamataraa raises 0.03€ to 0.05€
Fried Berg calls 0.03€
*** FLOP *** [3c Ah Jd]
haamataraa checks
Fried Berg bets 0.05€
haamataraa calls 0.05€
*** TURN *** [3c Ah Jd][5c]
haamataraa checks
Fried Berg checks
*** RIVER *** [3c Ah Jd 5c][Js]
haamataraa bets 0.02€
Fried Berg calls 0.02€
*** SHOW DOWN ***
Fried Berg shows [Ts Th] (Two pairs : Jacks and Tens)
haamataraa shows [6c Ad] (Two pairs : Aces and Jacks)
haamataraa collected 0.22€ from pot
*** SUMMARY ***
Total pot 0.22€ | Rake 0.02€
Board: [3c Ah Jd 5c Js]
Seat 1: haamataraa (small blind) showed [6c Ad] and won 0.22€ with Two pairs : Aces and Jacks
Seat 2: Fried Berg (big blind) showed [Ts Th] and lost with Two pairs : Jacks and Tens


Winamax Poker - HOLD-UP "Colorado" - HandId: #19116069-311322-1701418607 - Holdem no limit (0.01€/0.02€) - 2023/12/01 08:16:47 UTC
Table: 'Colorado' 6-max (real money) Seat #6 is the button
Seat 1: Fried Berg (1.32€)
Seat 2: tichettede3 (2.28€)
Seat 3: haamataraa (1.81€)
Seat 4: bimach444 (2.21€)
Seat 5: l artiste ho (2.15€)
Seat 6: SpeedMizno (2€)
*** ANTE/BLINDS ***
Fried Berg posts small blind 0.01€
tichettede3 posts big blind 0.02€
Dealt to Fried Berg [2d 8d]
*** PRE-FLOP *** 
haamataraa folds
bimach444 folds
l artiste ho folds
SpeedMizno folds
Fried Berg folds
tichettede3 collected 0.03€ from pot
*** SUMMARY ***
Total pot 0.03€ | No rake
Seat 2: tichettede3 (big blind) won 0.03€


Winamax Poker - HOLD-UP "Colorado" - HandId: #19116069-311327-1701418615 - Holdem no limit (0.01€/0.02€) - 2023/12/01 08:16:55 UTC
Table: 'Colorado' 6-max (real money) Seat #6 is the button
Seat 1: KKamarAAde (10.06€)
Seat 2: Fried Berg (1.31€)
Seat 3: strikeair (2€)
Seat 4: Cejargordas (2.03€)
Seat 5: Halmosthard (1.99€)
Seat 6: DigBick99 (2.20€)
*** ANTE/BLINDS ***
KKamarAAde posts small blind 0.01€
Fried Berg posts big blind 0.02€
Dealt to Fried Berg [3s Kd]
*** PRE-FLOP *** 
strikeair folds
Cejargordas raises 0.04€ to 0.06€
Halmosthard calls 0.06€
DigBick99 folds
KKamarAAde folds
Fried Berg folds
*** FLOP *** [Kh Qs Jh]
Cejargordas checks
Halmosthard checks
*** TURN *** [Kh Qs Jh][3h]
Cejargordas checks
Halmosthard checks
*** RIVER *** [Kh Qs Jh 3h][Jc]
Cejargordas checks
Halmosthard checks
*** SHOW DOWN ***
Halmosthard shows [8d Ah] (One pair : Jacks)
Cejargordas shows [Ac Kc] (Two pairs : Kings and Jacks)
Cejargordas collected 0.13€ from pot
*** SUMMARY ***
Total pot 0.13€ | Rake 0.02€
Board: [Kh Qs Jh 3h Jc]
Seat 4: Cejargordas showed [Ac Kc] and won 0.13€ with Two pairs : Kings and Jacks
Seat 5: Halmosthard showed [8d Ah] and lost with One pair : Jacks


Winamax Poker - HOLD-UP "Colorado" - HandId: #19116069-311338-1701418638 - Holdem no limit (0.01€/0.02€) - 2023/12/01 08:17:18 UTC
Table: 'Colorado' 6-max (real money) Seat #6 is the button
Seat 1: bizent (1.96€)
Seat 2: CB-Joker6274 (8.02€)
Seat 3: strikeair (2€)
Seat 4: Fried Berg (1.29€)
Seat 5: KKamarAAde (10.05€)
Seat 6: lucall-in (1.84€)
*** ANTE/BLINDS ***
bizent posts small blind 0.01€
CB-Joker6274 posts big blind 0.02€
Dealt to Fried Berg [Td 3s]
*** PRE-FLOP *** 
strikeair folds
Fried Berg folds
KKamarAAde folds
lucall-in folds
bizent folds
CB-Joker6274 collected 0.03€ from pot
*** SUMMARY ***
Total pot 0.03€ | No rake
Seat 2: CB-Joker6274 (big blind) won 0.03€


Winamax Poker - HOLD-UP "Colorado" - HandId: #19116069-311342-1701418642 - Holdem no limit (0.01€/0.02€) - 2023/12/01 08:17:22 UTC
Table: 'Colorado' 6-max (real money) Seat #6 is the button
Seat 1: sheep47 (3.28€)
Seat 2: haouuum28 (2.28€)
Seat 3: tichettede3 (2.81€)
Seat 4: strikeair (2€)
Seat 5: Fried Berg (1.29€)
Seat 6: PIQSOU (5.48€)
*** ANTE/BLINDS ***
sheep47 posts small blind 0.01€
haouuum28 posts big blind 0.02€
Dealt to Fried Berg [7h 5s]
*** PRE-FLOP *** 
tichettede3 raises 0.03€ to 0.05€
strikeair folds
Fried Berg folds
PIQSOU folds
sheep47 folds
haouuum28 folds
tichettede3 collected 0.08€ from pot
*** SUMMARY ***
Total pot 0.08€ | No rake
Seat 3: tichettede3 won 0.08€


Winamax Poker - HOLD-UP "Colorado" - HandId: #19116069-311346-1701418648 - Holdem no limit (0.01€/0.02€) - 2023/12/01 08:17:28 UTC
Table: 'Colorado' 6-max (real money) Seat #6 is the button
Seat 1: CB-Joker6274 (8.03€)
Seat 2: lucall-in (1.83€)
Seat 3: Fried Berg (1.29€)
Seat 4: Jojo-andros5 (0.28€)
Seat 5: KKamarAAde (10.05€)
Seat 6: strikeair (2€)
*** ANTE/BLINDS ***
CB-Joker6274 posts small blind 0.01€
lucall-in posts big blind 0.02€
Dealt to Fried Berg [7d Qh]
*** PRE-FLOP *** 
Fried Berg folds
Jojo-andros5 folds
KKamarAAde folds
strikeair folds
CB-Joker6274 folds
lucall-in collected 0.03€ from pot
*** SUMMARY ***
Total pot 0.03€ | No rake
Seat 2: lucall-in (big blind) won 0.03€


Winamax Poker - HOLD-UP "Colorado" - HandId: #19116069-311348-1701418652 - Holdem no limit (0.01€/0.02€) - 2023/12/01 08:17:32 UTC
Table: 'Colorado' 6-max (real money) Seat #6 is the button
Seat 1: CB-Joker6274 (8.02€)
Seat 2: Manupoy (3.51€)
Seat 3: bizent (1.95€)
Seat 4: Fried Berg (1.29€)
Seat 5: lut1dupoivre (0.47€)
Seat 6: strikeair (2€)
*** ANTE/BLINDS ***
CB-Joker6274 posts small blind 0.01€
Manupoy posts big blind 0.02€
Dealt to Fried Berg [Js 4h]
*** PRE-FLOP *** 
bizent raises 0.03€ to 0.05€
Fried Berg folds
lut1dupoivre folds
strikeair calls 0.05€
CB-Joker6274 folds
Manupoy folds
*** FLOP *** [7d Td 9d]
bizent bets 0.08€
strikeair folds
bizent collected 0.20€ from pot
*** SUMMARY ***
Total pot 0.20€ | Rake 0.01€
Board: [7d Td 9d]
Seat 3: bizent won 0.20€


Winamax Poker - HOLD-UP "Colorado" - HandId: #19116069-311351-1701418655 - Holdem no limit (0.01€/0.02€) - 2023/12/01 08:17:35 UTC
Table: 'Colorado' 6-max (real money) Seat #6 is the button
Seat 1: KKamarAAde (2.02€)
Seat 2: DigBick99 (2.20€)
Seat 3: Fried Berg (1.29€)
Seat 4: Ewynner (2.03€)
Seat 5: Jojo-andros5 (0.28€)
Seat 6: Piiranha (2€)
*** ANTE/BLINDS ***
KKamarAAde posts small blind 0.01€
DigBick99 posts big blind 0.02€
Dealt to Fried Berg [5s 2c]
*** PRE-FLOP *** 
Fried Berg folds
Ewynner folds
Jojo-andros5 raises 0.26€ to 0.28€ and is all-in
Piiranha folds
KKamarAAde folds
DigBick99 folds
Jojo-andros5 collected 0.31€ from pot
*** SUMMARY ***
Total pot 0.31€ | No rake
Seat 5: Jojo-andros5 won 0.31€


Winamax Poker - HOLD-UP "Colorado" - HandId: #19116069-311354-1701418658 - Holdem no limit (0.01€/0.02€) - 2023/12/01 08:17:38 UTC
Table: 'Colorado' 6-max (real money) Seat #6 is the button
Seat 1: PIQSOU (5.48€)
Seat 2: Shark&Fish52 (1.68€)
Seat 3: Piiranha (2€)
Seat 4: Fried Berg (1.29€)
Seat 5: lut1dupoivre (0.47€)
Seat 6: grut28 (2.18€)
*** ANTE/BLINDS ***
PIQSOU posts small blind 0.01€
Shark&Fish52 posts big blind 0.02€
Dealt to Fried Berg [8d Js]
*** PRE-FLOP *** 
Piiranha folds
Fried Berg folds
lut1dupoivre folds
grut28 folds
PIQSOU raises 0.03€ to 0.05€
Shark&Fish52 folds
PIQSOU collected 0.07€ from pot
*** SUMMARY ***
Total pot 0.07€ | No rake
Seat 1: PIQSOU (small blind) won 0.07€


Winamax Poker - HOLD-UP "Colorado" - HandId: #19116069-311359-1701418665 - Holdem no limit (0.01€/0.02€) - 2023/12/01 08:17:45 UTC
Table: 'Colorado' 6-max (real money) Seat #6 is the button
Seat 1: Fried Berg (1.29€)
Seat 2: Rue115 (1.75€)
Seat 3: Ewynner (2.02€)
Seat 4: lucall-in (1.84€)
Seat 5: Piiranha (2€)
Seat 6: l artiste ho (2.13€)
*** ANTE/BLINDS ***
Fried Berg posts small blind 0.01€
Rue115 posts big blind 0.02€
Dealt to Fried Berg [4d Qs]
*** PRE-FLOP *** 
Ewynner folds
lucall-in folds
Piiranha folds
l artiste ho folds
Fried Berg folds
Rue115 collected 0.03€ from pot
*** SUMMARY ***
Total pot 0.03€ | No rake
Seat 2: Rue115 (big blind) won 0.03€


Winamax Poker - HOLD-UP "Colorado" - HandId: #19116069-311365-1701418670 - Holdem no limit (0.01€/0.02€) - 2023/12/01 08:17:50 UTC
Table: 'Colorado' 6-max (real money) Seat #6 is the button
Seat 1: KKamarAAde (10.03€)
Seat 2: bizent (2.02€)
Seat 3: lut1dupoivre (0.44€)
Seat 4: Piiranha (2€)
Seat 5: DigBick99 (3.13€)
Seat 6: Fried Berg (1.28€)
Hold-up to Pot: total 0.10€
*** ANTE/BLINDS ***
KKamarAAde posts small blind 0.01€
bizent posts big blind 0.02€
Dealt to Fried Berg [3d 2d]
*** PRE-FLOP *** 
lut1dupoivre calls 0.02€
Piiranha folds
DigBick99 folds
Fried Berg calls 0.02€
KKamarAAde folds
bizent checks
*** FLOP *** [2c Qc 5h]
bizent checks
lut1dupoivre checks
Fried Berg checks
*** TURN *** [2c Qc 5h][Ts]
bizent checks
lut1dupoivre checks
Fried Berg checks
*** RIVER *** [2c Qc 5h Ts][2h]
bizent checks
lut1dupoivre checks
Fried Berg bets 0.06€
bizent folds
lut1dupoivre folds
Fried Berg collected 0.22€ from pot
*** SUMMARY ***
Total pot 0.22€ | Rake 0.01€
Board: [2c Qc 5h Ts 2h]
Seat 6: Fried Berg (button) won 0.22€


Winamax Poker - HOLD-UP "Colorado" - HandId: #19116069-311390-1701418706 - Holdem no limit (0.01€/0.02€) - 2023/12/01 08:18:26 UTC
Table: 'Colorado' 6-max (real money) Seat #6 is the button
Seat 1: jdeepenslip (8.65€)
Seat 2: Cejargordas (2.10€)
Seat 3: Fried Berg (1.42€)
Seat 4: grut28 (2.12€)
Seat 5: Polanskii (1.92€)
Seat 6: lut1dupoivre (0.42€)
*** ANTE/BLINDS ***
jdeepenslip posts small blind 0.01€
Cejargordas posts big blind 0.02€
Dealt to Fried Berg [6c Qc]
*** PRE-FLOP *** 
Fried Berg folds
grut28 folds
Polanskii folds
lut1dupoivre folds
jdeepenslip folds
Cejargordas collected 0.03€ from pot
*** SUMMARY ***
Total pot 0.03€ | No rake
Seat 2: Cejargordas (big blind) won 0.03€


Winamax Poker - HOLD-UP "Colorado" - HandId: #19116069-311394-1701418711 - Holdem no limit (0.01€/0.02€) - 2023/12/01 08:18:31 UTC
Table: 'Colorado' 6-max (real money) Seat #6 is the button
Seat 1: jdeepenslip (4.91€)
Seat 2: Fried Berg (1.42€)
Seat 3: Halmosthard (1.93€)
Seat 4: LAG0URMANDE (5.22€)
Seat 5: DigBick99 (2.69€)
Seat 6: haamataraa (1.88€)
*** ANTE/BLINDS ***
jdeepenslip posts small blind 0.01€
Fried Berg posts big blind 0.02€
Dealt to Fried Berg [7d 8d]
*** PRE-FLOP *** 
Halmosthard folds
LAG0URMANDE folds
DigBick99 folds
haamataraa raises 0.04€ to 0.06€
jdeepenslip folds
Fried Berg calls 0.04€
*** FLOP *** [Jd Td 4d]
Fried Berg checks
haamataraa checks
*** TURN *** [Jd Td 4d][9c]
Fried Berg checks
haamataraa bets 0.05€
Fried Berg calls 0.05€
*** RIVER *** [Jd Td 4d 9c][7c]
Fried Berg checks
haamataraa checks
*** SHOW DOWN ***
haamataraa shows [Ac Ts] (One pair : Tens)
Fried Berg shows [7d 8d] (Flush Jack high)
Fried Berg collected 0.21€ from pot
*** SUMMARY ***
Total pot 0.21€ | Rake 0.02€
Board: [Jd Td 4d 9c 7c]
Seat 2: Fried Berg (big blind) showed [7d 8d] and won 0.21€ with Flush Jack high
Seat 6: haamataraa (button) showed [Ac Ts] and lost with One pair : Tens


Winamax Poker - HOLD-UP "Colorado" - HandId: #19116069-311426-1701418760 - Holdem no limit (0.01€/0.02€) - 2023/12/01 08:19:20 UTC
Table: 'Colorado' 6-max (real money) Seat #6 is the button
Seat 1: KKamarAAde (2.47€)
Seat 2: haamataraa (1.77€)
Seat 3: Mercuryllo (2€)
Seat 4: Cejargordas (2€)
Seat 5: Fried Berg (1.52€)
Seat 6: tichettede3 (2.83€)
*** ANTE/BLINDS ***
KKamarAAde posts small blind 0.01€
haamataraa posts big blind 0.02€
Dealt to Fried Berg [4c 2c]
*** PRE-FLOP *** 
Mercuryllo folds
Cejargordas folds
Fried Berg folds
tichettede3 raises 0.03€ to 0.05€
KKamarAAde folds
haamataraa calls 0.03€
*** FLOP *** [3c 5c 7h]
haamataraa checks
tichettede3 bets 0.07€
haamataraa calls 0.07€
*** TURN *** [3c 5c 7h][8h]
haamataraa checks
tichettede3 checks
*** RIVER *** [3c 5c 7h 8h][Jh]
haamataraa bets 0.20€
tichettede3 calls 0.20€
*** SHOW DOWN ***
tichettede3 shows [Kc Jd] (One pair : Jacks)
haamataraa shows [Kh 5h] (Flush King high)
haamataraa collected 0.58€ from pot
*** SUMMARY ***
Total pot 0.58€ | Rake 0.07€
Board: [3c 5c 7h 8h Jh]
Seat 2: haamataraa (big blind) showed [Kh 5h] and won 0.58€ with Flush King high
Seat 6: tichettede3 (button) showed [Kc Jd] and lost with One pair : Jacks


Winamax Poker - HOLD-UP "Colorado" - HandId: #19116069-311433-1701418771 - Holdem no limit (0.01€/0.02€) - 2023/12/01 08:19:31 UTC
Table: 'Colorado' 6-max (real money) Seat #6 is the button
Seat 1: Manupoy (1.48€)
Seat 2: haouuum28 (2.42€)
Seat 3: PIQSOU (2.81€)
Seat 4: Fried Berg (1.52€)
Seat 5: bizent (2.49€)
Seat 6: Starbeckings (1.47€)
*** ANTE/BLINDS ***
Manupoy posts small blind 0.01€
haouuum28 posts big blind 0.02€
Dealt to Fried Berg [Qd 3s]
*** PRE-FLOP *** 
PIQSOU folds
Fried Berg folds
bizent raises 0.03€ to 0.05€
Starbeckings folds
Manupoy calls 0.04€
haouuum28 folds
*** FLOP *** [8c Ts 8s]
Manupoy checks
bizent bets 0.04€
Manupoy folds
bizent collected 0.15€ from pot
*** SUMMARY ***
Total pot 0.15€ | Rake 0.01€
Board: [8c Ts 8s]
Seat 5: bizent won 0.15€


Winamax Poker - HOLD-UP "Colorado" - HandId: #19116069-311436-1701418775 - Holdem no limit (0.01€/0.02€) - 2023/12/01 08:19:35 UTC
Table: 'Colorado' 6-max (real money) Seat #6 is the button
Seat 1: Itashi.95 (1.07€)
Seat 2: Fried Berg (1.52€)
Seat 3: strikeair (2.03€)
Seat 4: Cejargordas (2€)
Seat 5: PIQSOU (2.81€)
Seat 6: DigBick99 (3.27€)
*** ANTE/BLINDS ***
Itashi.95 posts small blind 0.01€
Fried Berg posts big blind 0.02€
Dealt to Fried Berg [Kd 3d]
*** PRE-FLOP *** 
strikeair folds
Cejargordas folds
PIQSOU raises 0.03€ to 0.05€
DigBick99 folds
Itashi.95 folds
Fried Berg folds
PIQSOU collected 0.08€ from pot
*** SUMMARY ***
Total pot 0.08€ | No rake
Seat 5: PIQSOU won 0.08€


Winamax Poker - HOLD-UP "Colorado" - HandId: #19116069-311442-1701418785 - Holdem no limit (0.01€/0.02€) - 2023/12/01 08:19:45 UTC
Table: 'Colorado' 6-max (real money) Seat #6 is the button
Seat 1: haouuum28 (2.01€)
Seat 2: SashaTDouss (2.05€)
Seat 3: Fried Berg (1.50€)
Seat 4: strikeair (2.10€)
Seat 5: Halmosthard (1.91€)
Seat 6: Cejargordas (2€)
*** ANTE/BLINDS ***
haouuum28 posts small blind 0.01€
SashaTDouss posts big blind 0.02€
Dealt to Fried Berg [Qd 8d]
*** PRE-FLOP *** 
Fried Berg raises 0.02€ to 0.04€
strikeair folds
Halmosthard calls 0.04€
Cejargordas folds
haouuum28 folds
SashaTDouss folds
*** FLOP *** [5s 5c Ad]
Fried Berg checks
Halmosthard checks
*** TURN *** [5s 5c Ad][Jh]
Fried Berg checks
Halmosthard checks
*** RIVER *** [5s 5c Ad Jh][9d]
Fried Berg checks
Halmosthard checks
*** SHOW DOWN ***
Halmosthard shows [7c 8h] (One pair : 5)
Fried Berg shows [Qd 8d] (One pair : 5)
Fried Berg collected 0.10€ from pot
*** SUMMARY ***
Total pot 0.10€ | Rake 0.01€
Board: [5s 5c Ad Jh 9d]
Seat 3: Fried Berg showed [Qd 8d] and won 0.10€ with One pair : 5
Seat 5: Halmosthard showed [7c 8h] and lost with One pair : 5


Winamax Poker - HOLD-UP "Colorado" - HandId: #19116069-311469-1701418838 - Holdem no limit (0.01€/0.02€) - 2023/12/01 08:20:38 UTC
Table: 'Colorado' 6-max (real money) Seat #6 is the button
Seat 1: Cejargordas (2.01€)
Seat 2: strikeair (2€)
Seat 3: Sebidu57 (1.56€)
Seat 4: Halmosthard (1.87€)
Seat 5: Fried Berg (1.56€)
Seat 6: KKamarAAde (2.01€)
*** ANTE/BLINDS ***
Cejargordas posts small blind 0.01€
strikeair posts big blind 0.02€
Dealt to Fried Berg [9d 8c]
*** PRE-FLOP *** 
Sebidu57 raises 0.04€ to 0.06€
Halmosthard folds
Fried Berg folds
KKamarAAde folds
Cejargordas folds
strikeair calls 0.04€
*** FLOP *** [3h As Js]
strikeair checks
Sebidu57 bets 0.05€
strikeair calls 0.05€
*** TURN *** [3h As Js][Ks]
strikeair checks
Sebidu57 bets 0.08€
strikeair calls 0.08€
*** RIVER *** [3h As Js Ks][7s]
strikeair checks
Sebidu57 checks
*** SHOW DOWN ***
Sebidu57 shows [9c Kc] (One pair : Kings)
strikeair shows [Jh Kh] (Two pairs : Kings and Jacks)
strikeair collected 0.35€ from pot
*** SUMMARY ***
Total pot 0.35€ | Rake 0.04€
Board: [3h As Js Ks 7s]
Seat 2: strikeair (big blind) showed [Jh Kh] and won 0.35€ with Two pairs : Kings and Jacks
Seat 3: Sebidu57 showed [9c Kc] and lost with One pair : Kings


Winamax Poker - HOLD-UP "Colorado" - HandId: #19116069-311481-1701418856 - Holdem no limit (0.01€/0.02€) - 2023/12/01 08:20:56 UTC
Table: 'Colorado' 6-max (real money) Seat #6 is the button
Seat 1: Fried Berg (1.56€)
Seat 2: KingSoto (1.94€)
Seat 3: Manupoy (3.57€)
Seat 4: LilRun (2.72€)
Seat 5: Jojo-andros5 (0.55€)
Seat 6: Starbeckings (1.54€)
*** ANTE/BLINDS ***
Fried Berg posts small blind 0.01€
KingSoto posts big blind 0.02€
Dealt to Fried Berg [7d 3d]
*** PRE-FLOP *** 
Manupoy folds
LilRun raises 0.04€ to 0.06€
Jojo-andros5 calls 0.06€
Starbeckings folds
Fried Berg folds
KingSoto folds
*** FLOP *** [Jc 9c 6c]
LilRun bets 0.05€
Jojo-andros5 calls 0.05€
*** TURN *** [Jc 9c 6c][7s]
LilRun checks
Jojo-andros5 bets 0.05€
LilRun calls 0.05€
*** RIVER *** [Jc 9c 6c 7s][9d]
LilRun checks
Jojo-andros5 bets 0.12€
LilRun calls 0.12€
*** SHOW DOWN ***
LilRun shows [6d 5d] (Two pairs : 9 and 6)
Jojo-andros5 shows [3c Ac] (Flush Ace high)
Jojo-andros5 collected 0.53€ from pot
*** SUMMARY ***
Total pot 0.53€ | Rake 0.06€
Board: [Jc 9c 6c 7s 9d]
Seat 4: LilRun showed [6d 5d] and lost with Two pairs : 9 and 6
Seat 5: Jojo-andros5 showed [3c Ac] and won 0.53€ with Flush Ace high


Winamax Poker - HOLD-UP "Colorado" - HandId: #19116069-311486-1701418866 - Holdem no limit (0.01€/0.02€) - 2023/12/01 08:21:06 UTC
Table: 'Colorado' 6-max (real money) Seat #6 is the button
Seat 1: Mercuryllo (2.37€)
Seat 2: SpeedMizno (2.05€)
Seat 3: KKamarAAde (4.39€)
Seat 4: KingSoto (1.92€)
Seat 5: Fried Berg (1.55€)
Seat 6: lucall-in (2.77€)
*** ANTE/BLINDS ***
Mercuryllo posts small blind 0.01€
SpeedMizno posts big blind 0.02€
Dealt to Fried Berg [8s Jd]
*** PRE-FLOP *** 
KKamarAAde folds
KingSoto folds
Fried Berg folds
lucall-in folds
Mercuryllo folds
SpeedMizno collected 0.03€ from pot
*** SUMMARY ***
Total pot 0.03€ | No rake
Seat 2: SpeedMizno (big blind) won 0.03€


Winamax Poker - HOLD-UP "Colorado" - HandId: #19116069-311488-1701418870 - Holdem no limit (0.01€/0.02€) - 2023/12/01 08:21:10 UTC
Table: 'Colorado' 6-max (real money) Seat #6 is the button
Seat 1: KingSoto (1.92€)
Seat 2: Polanskii (1.93€)
Seat 3: haouuum28 (3.12€)
Seat 4: Fried Berg (1.55€)
Seat 5: SashaTDouss (2.09€)
Seat 6: jdeepenslip (8.75€)
*** ANTE/BLINDS ***
KingSoto posts small blind 0.01€
Polanskii posts big blind 0.02€
Dealt to Fried Berg [5h 9d]
*** PRE-FLOP *** 
haouuum28 raises 0.04€ to 0.06€
Fried Berg folds
SashaTDouss folds
jdeepenslip folds
KingSoto folds
Polanskii folds
haouuum28 collected 0.09€ from pot
*** SUMMARY ***
Total pot 0.09€ | No rake
Seat 3: haouuum28 won 0.09€


Winamax Poker - HOLD-UP "Colorado" - HandId: #19116069-311489-1701418872 - Holdem no limit (0.01€/0.02€) - 2023/12/01 08:21:12 UTC
Table: 'Colorado' 6-max (real money) Seat #6 is the button
Seat 1: Starbeckings (1.52€)
Seat 2: Fried Berg (1.55€)
Seat 3: l artiste ho (2.18€)
Seat 4: KKamarAAde (10.01€)
Seat 5: KingSoto (1.91€)
Seat 6: SashaTDouss (2.09€)
*** ANTE/BLINDS ***
Starbeckings posts small blind 0.01€
Fried Berg posts big blind 0.02€
Dealt to Fried Berg [8d Kh]
*** PRE-FLOP *** 
l artiste ho folds
KKamarAAde folds
KingSoto folds
SashaTDouss folds
Starbeckings raises 0.03€ to 0.05€
Fried Berg folds
Starbeckings collected 0.07€ from pot
*** SUMMARY ***
Total pot 0.07€ | No rake
Seat 1: Starbeckings (small blind) won 0.07€


Winamax Poker - HOLD-UP "Colorado" - HandId: #19116069-311495-1701418881 - Holdem no limit (0.01€/0.02€) - 2023/12/01 08:21:21 UTC
Table: 'Colorado' 6-max (real money) Seat #6 is the button
Seat 1: Fried Berg (1.53€)
Seat 2: haouuum28 (3.15€)
Seat 3: SashaTDouss (2.09€)
Seat 4: LAG0URMANDE (2.04€)
Seat 5: gagnejamais4 (3.80€)
Seat 6: KingSoto (2€)
*** ANTE/BLINDS ***
Fried Berg posts small blind 0.01€
haouuum28 posts big blind 0.02€
Dealt to Fried Berg [Ah Ac]
*** PRE-FLOP *** 
SashaTDouss folds
LAG0URMANDE folds
gagnejamais4 folds
KingSoto folds
Fried Berg raises 0.04€ to 0.06€
haouuum28 calls 0.04€
*** FLOP *** [Jd 5s Ts]
Fried Berg bets 0.08€
haouuum28 calls 0.08€
*** TURN *** [Jd 5s Ts][Jc]
Fried Berg bets 0.10€
haouuum28 calls 0.10€
*** RIVER *** [Jd 5s Ts Jc][9s]
Fried Berg checks
haouuum28 checks
*** SHOW DOWN ***
haouuum28 shows [8d Td] (Two pairs : Jacks and Tens)
Fried Berg shows [Ah Ac] (Two pairs : Aces and Jacks)
Fried Berg collected 0.43€ from pot
*** SUMMARY ***
Total pot 0.43€ | Rake 0.05€
Board: [Jd 5s Ts Jc 9s]
Seat 1: Fried Berg (small blind) showed [Ah Ac] and won 0.43€ with Two pairs : Aces and Jacks
Seat 2: haouuum28 (big blind) showed [8d Td] and lost with Two pairs : Jacks and Tens


Winamax Poker - HOLD-UP "Colorado" - HandId: #19116069-311511-1701418919 - Holdem no limit (0.01€/0.02€) - 2023/12/01 08:21:59 UTC
Table: 'Colorado' 6-max (real money) Seat #6 is the button
Seat 1: KKamarAAde (2.43€)
Seat 2: PIQSOU (2.75€)
Seat 3: Fried Berg (1.72€)
Seat 4: strikeair (2.15€)
Seat 5: Itashi.95 (0.77€)
Seat 6: bizent (2.46€)
*** ANTE/BLINDS ***
KKamarAAde posts small blind 0.01€
PIQSOU posts big blind 0.02€
Dealt to Fried Berg [9h 4d]
*** PRE-FLOP *** 
Fried Berg folds
strikeair folds
Itashi.95 calls 0.02€
bizent folds
KKamarAAde folds
PIQSOU checks
*** FLOP *** [Jd Ks 5d]
PIQSOU checks
Itashi.95 bets 0.03€
PIQSOU folds
Itashi.95 collected 0.07€ from pot
*** SUMMARY ***
Total pot 0.07€ | Rake 0.01€
Board: [Jd Ks 5d]
Seat 5: Itashi.95 won 0.07€


Winamax Poker - HOLD-UP "Colorado" - HandId: #19116069-311518-1701418939 - Holdem no limit (0.01€/0.02€) - 2023/12/01 08:22:19 UTC
Table: 'Colorado' 6-max (real money) Seat #6 is the button
Seat 1: tichettede3 (2.01€)
Seat 2: CB-Joker6274 (7.97€)
Seat 3: grut28 (2.12€)
Seat 4: bizent (2.46€)
Seat 5: Cejargordas (2€)
Seat 6: Fried Berg (1.72€)
*** ANTE/BLINDS ***
tichettede3 posts small blind 0.01€
CB-Joker6274 posts big blind 0.02€
Dealt to Fried Berg [5h 9h]
*** PRE-FLOP *** 
grut28 folds
bizent folds
Cejargordas folds
Fried Berg folds
tichettede3 folds
CB-Joker6274 collected 0.03€ from pot
*** SUMMARY ***
Total pot 0.03€ | No rake
Seat 2: CB-Joker6274 (big blind) won 0.03€


Winamax Poker - HOLD-UP "Colorado" - HandId: #19116069-311526-1701418948 - Holdem no limit (0.01€/0.02€) - 2023/12/01 08:22:28 UTC
Table: 'Colorado' 6-max (real money) Seat #6 is the button
Seat 1: gagnejamais4 (2.99€)
Seat 2: Vic verga82 (1.30€)
Seat 3: Cejargordas (2.15€)
Seat 4: TERKOSS (2€)
Seat 5: Fried Berg (1.72€)
Seat 6: Suaterna207 (2€)
*** ANTE/BLINDS ***
gagnejamais4 posts small blind 0.01€
Vic verga82 posts big blind 0.02€
Dealt to Fried Berg [Jh 2c]
*** PRE-FLOP *** 
Cejargordas folds
TERKOSS folds
Fried Berg folds
Suaterna207 folds
gagnejamais4 folds
Vic verga82 collected 0.03€ from pot
*** SUMMARY ***
Total pot 0.03€ | No rake
Seat 2: Vic verga82 (big blind) won 0.03€


Winamax Poker - HOLD-UP "Colorado" - HandId: #19116069-311528-1701418951 - Holdem no limit (0.01€/0.02€) - 2023/12/01 08:22:31 UTC
Table: 'Colorado' 6-max (real money) Seat #6 is the button
Seat 1: jdeepenslip (4.70€)
Seat 2: Cejargordas (2€)
Seat 3: strikeair (2.07€)
Seat 4: Manupoy (3.54€)
Seat 5: TERKOSS (2€)
Seat 6: Fried Berg (1.72€)
*** ANTE/BLINDS ***
jdeepenslip posts small blind 0.01€
Cejargordas posts big blind 0.02€
Dealt to Fried Berg [6s 8h]
*** PRE-FLOP *** 
strikeair folds
Manupoy folds
TERKOSS calls 0.02€
Fried Berg folds
jdeepenslip folds
Cejargordas checks
*** FLOP *** [As 3h 4d]
Cejargordas checks
TERKOSS bets 0.05€
Cejargordas calls 0.05€
*** TURN *** [As 3h 4d][Ah]
Cejargordas checks
TERKOSS bets 0.05€
Cejargordas calls 0.05€
*** RIVER *** [As 3h 4d Ah][6c]
Cejargordas checks
TERKOSS checks
*** SHOW DOWN ***
Cejargordas shows [4s 5c] (Two pairs : Aces and 4)
TERKOSS shows [5d 5s] (Two pairs : Aces and 5)
TERKOSS collected 0.22€ from pot
*** SUMMARY ***
Total pot 0.22€ | Rake 0.03€
Board: [As 3h 4d Ah 6c]
Seat 2: Cejargordas (big blind) showed [4s 5c] and lost with Two pairs : Aces and 4
Seat 5: TERKOSS showed [5d 5s] and won 0.22€ with Two pairs : Aces and 5


Winamax Poker - HOLD-UP "Colorado" - HandId: #19116069-311535-1701418964 - Holdem no limit (0.01€/0.02€) - 2023/12/01 08:22:44 UTC
Table: 'Colorado' 6-max (real money) Seat #6 is the button
Seat 1: tichettede3 (2.34€)
Seat 2: Fried Berg (1.72€)
Seat 3: grut28 (2.10€)
Seat 4: jdeepenslip (4.69€)
Seat 5: haouuum28 (2.27€)
Seat 6: Manupoy (3.54€)
*** ANTE/BLINDS ***
tichettede3 posts small blind 0.01€
Fried Berg posts big blind 0.02€
Dealt to Fried Berg [Qc 8h]
*** PRE-FLOP *** 
grut28 folds
jdeepenslip folds
haouuum28 folds
Manupoy raises 0.02€ to 0.04€
tichettede3 folds
Fried Berg folds
Manupoy collected 0.07€ from pot
*** SUMMARY ***
Total pot 0.07€ | No rake
Seat 6: Manupoy (button) won 0.07€


Winamax Poker - HOLD-UP "Colorado" - HandId: #19116069-311540-1701418973 - Holdem no limit (0.01€/0.02€) - 2023/12/01 08:22:53 UTC
Table: 'Colorado' 6-max (real money) Seat #6 is the button
Seat 1: Fried Berg (1.70€)
Seat 2: KKamarAAde (2€)
Seat 3: DigBick99 (2.58€)
Seat 4: jdeepenslip (4.69€)
Seat 5: Suaterna207 (2.46€)
Seat 6: haouuum28 (2.27€)
*** ANTE/BLINDS ***
Fried Berg posts small blind 0.01€
KKamarAAde posts big blind 0.02€
Dealt to Fried Berg [5d Jd]
*** PRE-FLOP *** 
DigBick99 folds
jdeepenslip folds
Suaterna207 raises 0.04€ to 0.06€
haouuum28 folds
Fried Berg folds
KKamarAAde folds
Suaterna207 collected 0.09€ from pot
*** SUMMARY ***
Total pot 0.09€ | No rake
Seat 5: Suaterna207 won 0.09€


Winamax Poker - HOLD-UP "Colorado" - HandId: #19116069-311542-1701418979 - Holdem no limit (0.01€/0.02€) - 2023/12/01 08:22:59 UTC
Table: 'Colorado' 6-max (real money) Seat #6 is the button
Seat 1: PIQSOU (2.73€)
Seat 2: haouuum28 (2.27€)
Seat 3: Manupoy (3.57€)
Seat 4: Halmosthard (4.16€)
Seat 5: DigBick99 (3.38€)
Seat 6: Fried Berg (1.69€)
*** ANTE/BLINDS ***
PIQSOU posts small blind 0.01€
haouuum28 posts big blind 0.02€
Dealt to Fried Berg [9h Jc]
*** PRE-FLOP *** 
Manupoy calls 0.02€
Halmosthard calls 0.02€
DigBick99 folds
Fried Berg folds
PIQSOU folds
haouuum28 checks
*** FLOP *** [Qd 5h Ks]
haouuum28 checks
Manupoy checks
Halmosthard checks
*** TURN *** [Qd 5h Ks][4c]
haouuum28 checks
Manupoy checks
Halmosthard checks
*** RIVER *** [Qd 5h Ks 4c][4d]
haouuum28 checks
Manupoy checks
Halmosthard checks
*** SHOW DOWN ***
haouuum28 shows [Ad 3c] (One pair : 4)
Manupoy shows [Ac 6h] (One pair : 4)
Halmosthard shows [5c Ah] (Two pairs : 5 and 4)
Halmosthard collected 0.06€ from pot
*** SUMMARY ***
Total pot 0.06€ | Rake 0.01€
Board: [Qd 5h Ks 4c 4d]
Seat 2: haouuum28 (big blind) showed [Ad 3c] and lost with One pair : 4
Seat 3: Manupoy showed [Ac 6h] and lost with One pair : 4
Seat 4: Halmosthard showed [5c Ah] and won 0.06€ with Two pairs : 5 and 4


Winamax Poker - HOLD-UP "Colorado" - HandId: #19116069-311545-1701418982 - Holdem no limit (0.01€/0.02€) - 2023/12/01 08:23:02 UTC
Table: 'Colorado' 6-max (real money) Seat #6 is the button
Seat 1: Polanskii (2.01€)
Seat 2: SpeedMizno (2.05€)
Seat 3: tichettede3 (2.31€)
Seat 4: Fried Berg (1.69€)
Seat 5: Acabdabra (2.02€)
Seat 6: - ONZE - (2.77€)
*** ANTE/BLINDS ***
Polanskii posts small blind 0.01€
SpeedMizno posts big blind 0.02€
Dealt to Fried Berg [6d 2h]
*** PRE-FLOP *** 
tichettede3 folds
Fried Berg folds
Acabdabra raises 0.03€ to 0.05€
- ONZE - folds
Polanskii calls 0.04€
SpeedMizno calls 0.03€
*** FLOP *** [Tc Qd 4c]
Polanskii bets 0.10€
SpeedMizno folds
Acabdabra calls 0.10€
*** TURN *** [Tc Qd 4c][6c]
Polanskii bets 0.23€
Acabdabra calls 0.23€
*** RIVER *** [Tc Qd 4c 6c][9d]
Polanskii bets 1.63€ and is all-in
Acabdabra folds
Polanskii collected 2.36€ from pot
*** SUMMARY ***
Total pot 2.36€ | Rake 0.08€
Board: [Tc Qd 4c 6c 9d]
Seat 1: Polanskii (small blind) won 2.36€


Winamax Poker - HOLD-UP "Colorado" - HandId: #19116069-311546-1701418985 - Holdem no limit (0.01€/0.02€) - 2023/12/01 08:23:05 UTC
Table: 'Colorado' 6-max (real money) Seat #6 is the button
Seat 1: tichettede3 (2.31€)
Seat 2: jdeepenslip (4.69€)
Seat 3: lut1dupoivre (0.74€)
Seat 4: LilRun (2.39€)
Seat 5: KKamarAAde (1.98€)
Seat 6: Fried Berg (1.69€)
*** ANTE/BLINDS ***
tichettede3 posts small blind 0.01€
jdeepenslip posts big blind 0.02€
Dealt to Fried Berg [9h 7s]
*** PRE-FLOP *** 
lut1dupoivre folds
LilRun raises 0.04€ to 0.06€
KKamarAAde folds
Fried Berg folds
tichettede3 folds
jdeepenslip folds
LilRun collected 0.09€ from pot
*** SUMMARY ***
Total pot 0.09€ | No rake
Seat 4: LilRun won 0.09€


Winamax Poker - HOLD-UP "Colorado" - HandId: #19116069-311554-1701418997 - Holdem no limit (0.01€/0.02€) - 2023/12/01 08:23:17 UTC
Table: 'Colorado' 6-max (real money) Seat #6 is the button
Seat 1: Fried Berg (1.69€)
Seat 2: strikeair (2€)
Seat 3: DDDIEU33 (4.42€)
Seat 4: Piiranha (2.18€)
Seat 5: LAG0URMANDE (2€)
Seat 6: DigBick99 (3.38€)
*** ANTE/BLINDS ***
Fried Berg posts small blind 0.01€
strikeair posts big blind 0.02€
Dealt to Fried Berg [6d Jd]
*** PRE-FLOP *** 
DDDIEU33 folds
Piiranha folds
LAG0URMANDE raises 0.03€ to 0.05€
DigBick99 folds
Fried Berg calls 0.04€
strikeair folds
*** FLOP *** [Jh 8h 5s]
Fried Berg checks
LAG0URMANDE bets 0.08€
Fried Berg calls 0.08€
*** TURN *** [Jh 8h 5s][Jc]
Fried Berg checks
LAG0URMANDE bets 0.18€
Fried Berg calls 0.18€
*** RIVER *** [Jh 8h 5s Jc][Kd]
Fried Berg checks
LAG0URMANDE bets 1.69€ and is all-in
Fried Berg calls 1.38€ and is all-in
*** SHOW DOWN ***
Fried Berg shows [6d Jd] (Trips of Jacks)
LAG0URMANDE shows [7d 6s] (One pair : Jacks)
LAG0URMANDE collected 0.31€ from side pot 1
Fried Berg collected 3.06€ from main pot
*** SUMMARY ***
Total pot 3.37€ | Rake 0.34€
Board: [Jh 8h 5s Jc Kd]
Seat 1: Fried Berg (small blind) showed [6d Jd] and won 3.06€ with Trips of Jacks
Seat 5: LAG0URMANDE showed [7d 6s] and won 0.31€ with One pair : Jacks


Winamax Poker - HOLD-UP "Colorado" - HandId: #19116069-311580-1701419043 - Holdem no limit (0.01€/0.02€) - 2023/12/01 08:24:03 UTC
Table: 'Colorado' 6-max (real money) Seat #6 is the button
Seat 1: Johndrog (2.20€)
Seat 2: LAG0URMANDE (2€)
Seat 3: Fried Berg (3.06€)
Seat 4: - ONZE - (2.74€)
Seat 5: Cejargordas (2.15€)
Seat 6: SpeedMizno (2€)
*** ANTE/BLINDS ***
Johndrog posts small blind 0.01€
LAG0URMANDE posts big blind 0.02€
Dealt to Fried Berg [2c 4s]
*** PRE-FLOP *** 
Fried Berg folds
- ONZE - folds
Cejargordas folds
SpeedMizno folds
Johndrog folds
LAG0URMANDE collected 0.03€ from pot
*** SUMMARY ***
Total pot 0.03€ | No rake
Seat 2: LAG0URMANDE (big blind) won 0.03€


Winamax Poker - HOLD-UP "Colorado" - HandId: #19116069-311584-1701419054 - Holdem no limit (0.01€/0.02€) - 2023/12/01 08:24:14 UTC
Table: 'Colorado' 6-max (real money) Seat #6 is the button
Seat 1: Suaterna207 (2.41€)
Seat 2: - ONZE - (2.74€)
Seat 3: strikeair (2€)
Seat 4: Goldinher (2.01€)
Seat 5: Fried Berg (3.06€)
Seat 6: gagnejamais4 (2.65€)
*** ANTE/BLINDS ***
Suaterna207 posts small blind 0.01€
- ONZE - posts big blind 0.02€
Dealt to Fried Berg [2c 4s]
*** PRE-FLOP *** 
strikeair folds
Goldinher calls 0.02€
Fried Berg folds
gagnejamais4 folds
Suaterna207 folds
- ONZE - checks
*** FLOP *** [Jd Kc Qd]
- ONZE - checks
Goldinher checks
*** TURN *** [Jd Kc Qd][As]
- ONZE - checks
Goldinher checks
*** RIVER *** [Jd Kc Qd As][3c]
- ONZE - checks
Goldinher checks
*** SHOW DOWN ***
- ONZE - shows [Js 4d] (One pair : Jacks)
Goldinher shows [Jh Ac] (Two pairs : Aces and Jacks)
Goldinher collected 0.04€ from pot
*** SUMMARY ***
Total pot 0.04€ | Rake 0.01€
Board: [Jd Kc Qd As 3c]
Seat 2: - ONZE - (big blind) showed [Js 4d] and lost with One pair : Jacks
Seat 4: Goldinher showed [Jh Ac] and won 0.04€ with Two pairs : Aces and Jacks


Winamax Poker - HOLD-UP "Colorado" - HandId: #19116069-311606-1701419087 - Holdem no limit (0.01€/0.02€) - 2023/12/01 08:24:47 UTC
Table: 'Colorado' 6-max (real money) Seat #6 is the button
Seat 1: CB-Joker6274 (7.99€)
Seat 2: Suaterna207 (5.50€)
Seat 3: KKamarAAde (4.35€)
Seat 4: Fried Berg (3.06€)
Seat 5: DigBick99 (2.44€)
Seat 6: jdeepenslip (8.82€)
*** ANTE/BLINDS ***
CB-Joker6274 posts small blind 0.01€
Suaterna207 posts big blind 0.02€
Dealt to Fried Berg [Js 8s]
*** PRE-FLOP *** 
KKamarAAde folds
Fried Berg raises 0.02€ to 0.04€
DigBick99 folds
jdeepenslip folds
CB-Joker6274 folds
Suaterna207 folds
Fried Berg collected 0.07€ from pot
*** SUMMARY ***
Total pot 0.07€ | No rake
Seat 4: Fried Berg won 0.07€


Winamax Poker - HOLD-UP "Colorado" - HandId: #19116069-311896-1701419469 - Holdem no limit (0.01€/0.02€) - 2023/12/01 08:31:09 UTC
Table: 'Colorado' 6-max (real money) Seat #6 is the button
Seat 1: Coolax3019 (2€)
Seat 2: Fried Berg (0.50€)
Seat 3: humnz (2.01€)
Seat 4: DigBick99 (2.48€)
Seat 5: strikeair (2€)
Seat 6: Mercuryllo (2.33€)
*** ANTE/BLINDS ***
Coolax3019 posts small blind 0.01€
Fried Berg posts big blind 0.02€
Dealt to Fried Berg [4h 7s]
*** PRE-FLOP *** 
humnz folds
DigBick99 folds
strikeair folds
Mercuryllo raises 0.04€ to 0.06€
Coolax3019 folds
Fried Berg folds
Mercuryllo collected 0.09€ from pot
*** SUMMARY ***
Total pot 0.09€ | No rake
Seat 6: Mercuryllo (button) won 0.09€


Winamax Poker - HOLD-UP "Colorado" - HandId: #19116069-311914-1701419492 - Holdem no limit (0.01€/0.02€) - 2023/12/01 08:31:32 UTC
Table: 'Colorado' 6-max (real money) Seat #6 is the button
Seat 1: Ju89400 (1.98€)
Seat 2: Halmosthard (1.67€)
Seat 3: Fried Berg (0.48€)
Seat 4: haouuum28 (2.34€)
Seat 5: LimpDoud (2.19€)
Seat 6: Cejargordas (2.02€)
*** ANTE/BLINDS ***
Ju89400 posts small blind 0.01€
Halmosthard posts big blind 0.02€
Dealt to Fried Berg [5h Qd]
*** PRE-FLOP *** 
Fried Berg folds
haouuum28 folds
LimpDoud raises 0.03€ to 0.05€
Cejargordas raises 0.13€ to 0.18€
Ju89400 calls 0.17€
Halmosthard folds
LimpDoud folds
*** FLOP *** [4s Jh 8h]
Ju89400 checks
Cejargordas bets 0.15€
Ju89400 folds
Cejargordas collected 0.54€ from pot
*** SUMMARY ***
Total pot 0.54€ | Rake 0.04€
Board: [4s Jh 8h]
Seat 6: Cejargordas (button) won 0.54€


Winamax Poker - HOLD-UP "Colorado" - HandId: #19116069-311916-1701419494 - Holdem no limit (0.01€/0.02€) - 2023/12/01 08:31:34 UTC
Table: 'Colorado' 6-max (real money) Seat #6 is the button
Seat 1: Fried Berg (0.48€)
Seat 2: DDDIEU33 (4.29€)
Seat 3: Jojo-andros5 (0.46€)
Seat 4: Suaterna207 (2.01€)
Seat 5: BrokBroken (1.81€)
Seat 6: Manupoy (2.75€)
*** ANTE/BLINDS ***
Fried Berg posts small blind 0.01€
DDDIEU33 posts big blind 0.02€
Dealt to Fried Berg [8d 9s]
*** PRE-FLOP *** 
Jojo-andros5 folds
Suaterna207 folds
BrokBroken folds
Manupoy raises 0.04€ to 0.06€
Fried Berg folds
DDDIEU33 folds
Manupoy collected 0.09€ from pot
*** SUMMARY ***
Total pot 0.09€ | No rake
Seat 6: Manupoy (button) won 0.09€


Winamax Poker - HOLD-UP "Colorado" - HandId: #19116069-311938-1701419524 - Holdem no limit (0.01€/0.02€) - 2023/12/01 08:32:04 UTC
Table: 'Colorado' 6-max (real money) Seat #6 is the button
Seat 1: Baston57 (2.34€)
Seat 2: Coolax3019 (1.56€)
Seat 3: LimpDoud (4.93€)
Seat 4: Fried Berg (0.47€)
Seat 5: strikeair (2€)
Seat 6: haouuum28 (2.62€)
*** ANTE/BLINDS ***
Baston57 posts small blind 0.01€
Coolax3019 posts big blind 0.02€
Dealt to Fried Berg [2c As]
*** PRE-FLOP *** 
LimpDoud raises 0.03€ to 0.05€
Fried Berg folds
strikeair folds
haouuum28 folds
Baston57 folds
Coolax3019 folds
LimpDoud collected 0.08€ from pot
*** SUMMARY ***
Total pot 0.08€ | No rake
Seat 3: LimpDoud won 0.08€


Winamax Poker - HOLD-UP "Colorado" - HandId: #19116069-311941-1701419527 - Holdem no limit (0.01€/0.02€) - 2023/12/01 08:32:07 UTC
Table: 'Colorado' 6-max (real money) Seat #6 is the button
Seat 1: cygoud (2.01€)
Seat 2: bizent (2.44€)
Seat 3: jdeepenslip (9.77€)
Seat 4: Piiranha (2.06€)
Seat 5: Fried Berg (0.47€)
Seat 6: PIQSOU (3.81€)
*** ANTE/BLINDS ***
cygoud posts small blind 0.01€
bizent posts big blind 0.02€
Dealt to Fried Berg [Jd 7h]
*** PRE-FLOP *** 
jdeepenslip folds
Piiranha folds
Fried Berg folds
PIQSOU raises 0.03€ to 0.05€
cygoud folds
bizent calls 0.03€
*** FLOP *** [8d 9c 4c]
bizent bets 0.07€
PIQSOU raises 0.17€ to 0.24€
bizent calls 0.17€
*** TURN *** [8d 9c 4c][5d]
bizent bets 0.59€
PIQSOU raises 2.93€ to 3.52€ and is all-in
bizent calls 1.56€ and is all-in
*** RIVER *** [8d 9c 4c 5d][Ah]
*** SHOW DOWN ***
bizent shows [Kc 9d] (One pair : 9)
PIQSOU shows [Qh Qs] (One pair : Queens)
PIQSOU collected 5.77€ from pot
*** SUMMARY ***
Total pot 5.77€ | Rake 0.49€
Board: [8d 9c 4c 5d Ah]
Seat 2: bizent (big blind) showed [Kc 9d] and lost with One pair : 9
Seat 6: PIQSOU (button) showed [Qh Qs] and won 5.77€ with One pair : Queens


Winamax Poker - HOLD-UP "Colorado" - HandId: #19116069-311944-1701419532 - Holdem no limit (0.01€/0.02€) - 2023/12/01 08:32:12 UTC
Table: 'Colorado' 6-max (real money) Seat #6 is the button
Seat 1: jdeepenslip (5.25€)
Seat 2: Baston57 (2.33€)
Seat 3: frenchcore73 (0.50€)
Seat 4: haouuum28 (2.62€)
Seat 5: Suaterna207 (5.29€)
Seat 6: Fried Berg (0.47€)
*** ANTE/BLINDS ***
jdeepenslip posts small blind 0.01€
Baston57 posts big blind 0.02€
Dealt to Fried Berg [Qh 8s]
*** PRE-FLOP *** 
frenchcore73 raises 0.05€ to 0.07€
haouuum28 calls 0.07€
Suaterna207 folds
Fried Berg folds
jdeepenslip folds
Baston57 folds
*** FLOP *** [3d Td 5d]
frenchcore73 checks
haouuum28 checks
*** TURN *** [3d Td 5d][5c]
frenchcore73 checks
haouuum28 checks
*** RIVER *** [3d Td 5d 5c][8c]
frenchcore73 checks
haouuum28 checks
*** SHOW DOWN ***
frenchcore73 shows [9s Qs] (One pair : 5)
haouuum28 shows [6h 6s] (Two pairs : 6 and 5)
haouuum28 collected 0.15€ from pot
*** SUMMARY ***
Total pot 0.15€ | Rake 0.02€
Board: [3d Td 5d 5c 8c]
Seat 3: frenchcore73 showed [9s Qs] and lost with One pair : 5
Seat 4: haouuum28 showed [6h 6s] and won 0.15€ with Two pairs : 6 and 5


Winamax Poker - HOLD-UP "Colorado" - HandId: #19116069-311948-1701419537 - Holdem no limit (0.01€/0.02€) - 2023/12/01 08:32:17 UTC
Table: 'Colorado' 6-max (real money) Seat #6 is the button
Seat 1: tichettede3 (2.30€)
Seat 2: Justo_170382 (0.50€)
Seat 3: Baston57 (2.31€)
Seat 4: LimpDoud (2.11€)
Seat 5: cygoud (2€)
Seat 6: Fried Berg (0.47€)
*** ANTE/BLINDS ***
tichettede3 posts small blind 0.01€
Justo_170382 posts big blind 0.02€
Dealt to Fried Berg [6d Ac]
*** PRE-FLOP *** 
Baston57 folds
LimpDoud folds
cygoud folds
Fried Berg raises 0.02€ to 0.04€
tichettede3 folds
Justo_170382 folds
Fried Berg collected 0.07€ from pot
*** SUMMARY ***
Total pot 0.07€ | No rake
Seat 6: Fried Berg (button) won 0.07€


Winamax Poker - HOLD-UP "Colorado" - HandId: #19116069-311962-1701419556 - Holdem no limit (0.01€/0.02€) - 2023/12/01 08:32:36 UTC
Table: 'Colorado' 6-max (real money) Seat #6 is the button
Seat 1: Baston57 (2.32€)
Seat 2: Fried Berg (0.50€)
Seat 3: haamataraa (0.19€)
Seat 4: Cejargordas (2.23€)
Seat 5: solver (2.07€)
Seat 6: DigBick99 (2.87€)
*** ANTE/BLINDS ***
Baston57 posts small blind 0.01€
Fried Berg posts big blind 0.02€
Dealt to Fried Berg [Kc Th]
*** PRE-FLOP *** 
haamataraa folds
Cejargordas raises 0.03€ to 0.05€
solver folds
DigBick99 folds
Baston57 folds
Fried Berg calls 0.03€
*** FLOP *** [7h 2s Kh]
Fried Berg checks
Cejargordas checks
*** TURN *** [7h 2s Kh][Ad]
Fried Berg checks
Cejargordas checks
*** RIVER *** [7h 2s Kh Ad][Ks]
Fried Berg bets 0.03€
Cejargordas calls 0.03€
*** SHOW DOWN ***
Cejargordas shows [4h 4c] (Two pairs : Kings and 4)
Fried Berg shows [Kc Th] (Trips of Kings)
Fried Berg collected 0.15€ from pot
*** SUMMARY ***
Total pot 0.15€ | Rake 0.02€
Board: [7h 2s Kh Ad Ks]
Seat 2: Fried Berg (big blind) showed [Kc Th] and won 0.15€ with Trips of Kings
Seat 4: Cejargordas showed [4h 4c] and lost with Two pairs : Kings and 4


Winamax Poker - HOLD-UP "Colorado" - HandId: #19116069-312026-1701419646 - Holdem no limit (0.01€/0.02€) - 2023/12/01 08:34:06 UTC
Table: 'Colorado' 6-max (real money) Seat #6 is the button
Seat 1: Fried Berg (0.57€)
Seat 2: Jeje27 (3.99€)
Seat 3: l artiste ho (1.66€)
Seat 4: cygoud (2€)
Seat 5: Suaterna207 (2.05€)
Seat 6: Cejargordas (2.15€)
*** ANTE/BLINDS ***
Fried Berg posts small blind 0.01€
Jeje27 posts big blind 0.02€
Dealt to Fried Berg [9d 3h]
*** PRE-FLOP *** 
l artiste ho folds
cygoud raises 0.04€ to 0.06€
Suaterna207 folds
Cejargordas raises 0.14€ to 0.20€
Fried Berg folds
Jeje27 folds
cygoud folds
Cejargordas collected 0.29€ from pot
*** SUMMARY ***
Total pot 0.29€ | No rake
Seat 6: Cejargordas (button) won 0.29€


Winamax Poker - HOLD-UP "Colorado" - HandId: #19116069-312055-1701419684 - Holdem no limit (0.01€/0.02€) - 2023/12/01 08:34:44 UTC
Table: 'Colorado' 6-max (real money) Seat #6 is the button
Seat 1: aalleix888 (0.71€)
Seat 2: grut28 (2.94€)
Seat 3: Fried Berg (0.56€)
Seat 4: DigBick99 (2.58€)
Seat 5: 77boy77 (0.50€)
Seat 6: SashaTDouss (2.81€)
*** ANTE/BLINDS ***
aalleix888 posts small blind 0.01€
grut28 posts big blind 0.02€
Dealt to Fried Berg [8d 4c]
*** PRE-FLOP *** 
Fried Berg folds
DigBick99 folds
77boy77 folds
SashaTDouss folds
aalleix888 calls 0.01€
grut28 checks
*** FLOP *** [9c Kh Ks]
aalleix888 checks
grut28 checks
*** TURN *** [9c Kh Ks][4s]
aalleix888 bets 0.04€
grut28 folds
aalleix888 collected 0.08€ from pot
*** SUMMARY ***
Total pot 0.08€ | No rake
Board: [9c Kh Ks 4s]
Seat 1: aalleix888 (small blind) won 0.08€


Winamax Poker - HOLD-UP "Colorado" - HandId: #19116069-312059-1701419688 - Holdem no limit (0.01€/0.02€) - 2023/12/01 08:34:48 UTC
Table: 'Colorado' 6-max (real money) Seat #6 is the button
Seat 1: SashaTDouss (2.81€)
Seat 2: pelouseverte (0.85€)
Seat 3: gagnejamais4 (3.09€)
Seat 4: Fried Berg (0.56€)
Seat 5: Jojo-andros5 (0.41€)
Seat 6: ninoujacou (0.90€)
*** ANTE/BLINDS ***
SashaTDouss posts small blind 0.01€
pelouseverte posts big blind 0.02€
Dealt to Fried Berg [9s Ad]
*** PRE-FLOP *** 
gagnejamais4 raises 0.04€ to 0.06€
Fried Berg folds
Jojo-andros5 folds
ninoujacou folds
SashaTDouss folds
pelouseverte folds
gagnejamais4 collected 0.09€ from pot
*** SUMMARY ***
Total pot 0.09€ | No rake
Seat 3: gagnejamais4 won 0.09€


Winamax Poker - HOLD-UP "Colorado" - HandId: #19116069-312062-1701419696 - Holdem no limit (0.01€/0.02€) - 2023/12/01 08:34:56 UTC
Table: 'Colorado' 6-max (real money) Seat #6 is the button
Seat 1: PaitOn (2.11€)
Seat 2: Jeje27 (3.97€)
Seat 3: H4bet (2€)
Seat 4: LimpDoud (4.09€)
Seat 5: Fried Berg (0.56€)
Seat 6: papashark14 (1.88€)
*** ANTE/BLINDS ***
PaitOn posts small blind 0.01€
Jeje27 posts big blind 0.02€
Dealt to Fried Berg [Js Ac]
*** PRE-FLOP *** 
H4bet folds
LimpDoud folds
Fried Berg raises 0.02€ to 0.04€
papashark14 folds
PaitOn calls 0.03€
Jeje27 folds
*** FLOP *** [8c 3s 2d]
PaitOn bets 0.07€
Fried Berg calls 0.07€
*** TURN *** [8c 3s 2d][7d]
PaitOn bets 0.12€
Fried Berg calls 0.12€
*** RIVER *** [8c 3s 2d 7d][8s]
PaitOn checks
Fried Berg checks
*** SHOW DOWN ***
PaitOn shows [Ah Td] (One pair : 8)
Fried Berg shows [Js Ac] (One pair : 8)
Fried Berg collected 0.43€ from pot
*** SUMMARY ***
Total pot 0.43€ | Rake 0.05€
Board: [8c 3s 2d 7d 8s]
Seat 1: PaitOn (small blind) showed [Ah Td] and lost with One pair : 8
Seat 5: Fried Berg showed [Js Ac] and won 0.43€ with One pair : 8


Winamax Poker - HOLD-UP "Colorado" - HandId: #19116069-312115-1701419768 - Holdem no limit (0.01€/0.02€) - 2023/12/01 08:36:08 UTC
Table: 'Colorado' 6-max (real money) Seat #6 is the button
Seat 1: gagnejamais4 (1.36€)
Seat 2: Coolax3019 (3.91€)
Seat 3: PaitOn (1.88€)
Seat 4: Fried Berg (0.76€)
Seat 5: Cejargordas (2.28€)
Seat 6: Effray (2€)
*** ANTE/BLINDS ***
gagnejamais4 posts small blind 0.01€
Coolax3019 posts big blind 0.02€
Dealt to Fried Berg [5d 5h]
*** PRE-FLOP *** 
PaitOn folds
Fried Berg calls 0.02€
Cejargordas folds
Effray folds
gagnejamais4 folds
Coolax3019 checks
*** FLOP *** [9d Ks Ad]
Coolax3019 checks
Fried Berg checks
*** TURN *** [9d Ks Ad][Qc]
Coolax3019 checks
Fried Berg checks
*** RIVER *** [9d Ks Ad Qc][6c]
Coolax3019 checks
Fried Berg checks
*** SHOW DOWN ***
Fried Berg shows [5d 5h] (One pair : 5)
Coolax3019 shows [4s Qd] (One pair : Queens)
Coolax3019 collected 0.04€ from pot
*** SUMMARY ***
Total pot 0.04€ | Rake 0.01€
Board: [9d Ks Ad Qc 6c]
Seat 2: Coolax3019 (big blind) showed [4s Qd] and won 0.04€ with One pair : Queens
Seat 4: Fried Berg showed [5d 5h] and lost with One pair : 5


Winamax Poker - HOLD-UP "Colorado" - HandId: #19116069-312146-1701419812 - Holdem no limit (0.01€/0.02€) - 2023/12/01 08:36:52 UTC
Table: 'Colorado' 6-max (real money) Seat #6 is the button
Seat 1: aalleix888 (1€)
Seat 2: CTMieuxAvant (2€)
Seat 3: Fried Berg (0.74€)
Seat 4: haouuum28 (2.75€)
Seat 5: Coolax3019 (3.93€)
Seat 6: Suaterna207 (2.19€)
*** ANTE/BLINDS ***
aalleix888 posts small blind 0.01€
CTMieuxAvant posts big blind 0.02€
Dealt to Fried Berg [9c 6h]
*** PRE-FLOP *** 
Fried Berg folds
haouuum28 raises 0.02€ to 0.04€
Coolax3019 folds
Suaterna207 folds
aalleix888 calls 0.03€
CTMieuxAvant calls 0.02€
*** FLOP *** [5c 9d Tc]
aalleix888 checks
CTMieuxAvant checks
haouuum28 checks
*** TURN *** [5c 9d Tc][Th]
aalleix888 checks
CTMieuxAvant bets 0.02€
haouuum28 folds
aalleix888 calls 0.02€
*** RIVER *** [5c 9d Tc Th][2c]
aalleix888 checks
CTMieuxAvant bets 0.08€
aalleix888 calls 0.08€
*** SHOW DOWN ***
aalleix888 shows [Qd Kh] (One pair : Tens)
CTMieuxAvant shows [9h 2h] (Two pairs : Tens and 9)
CTMieuxAvant collected 0.29€ from pot
*** SUMMARY ***
Total pot 0.29€ | Rake 0.03€
Board: [5c 9d Tc Th 2c]
Seat 1: aalleix888 (small blind) showed [Qd Kh] and lost with One pair : Tens
Seat 2: CTMieuxAvant (big blind) showed [9h 2h] and won 0.29€ with Two pairs : Tens and 9


Winamax Poker - HOLD-UP "Colorado" - HandId: #19116069-312153-1701419825 - Holdem no limit (0.01€/0.02€) - 2023/12/01 08:37:05 UTC
Table: 'Colorado' 6-max (real money) Seat #6 is the button
Seat 1: Coolax3019 (3.93€)
Seat 2: Fried Berg (0.74€)
Seat 3: KKamarAAde (2.13€)
Seat 4: - ONZE - (2.29€)
Seat 5: grut28 (0.78€)
Seat 6: Suaterna207 (2.19€)
*** ANTE/BLINDS ***
Coolax3019 posts small blind 0.01€
Fried Berg posts big blind 0.02€
Dealt to Fried Berg [Ts 6s]
*** PRE-FLOP *** 
KKamarAAde folds
- ONZE - folds
grut28 folds
Suaterna207 folds
Coolax3019 folds
Fried Berg collected 0.03€ from pot
*** SUMMARY ***
Total pot 0.03€ | No rake
Seat 2: Fried Berg (big blind) won 0.03€


Winamax Poker - HOLD-UP "Colorado" - HandId: #19116069-312175-1701419854 - Holdem no limit (0.01€/0.02€) - 2023/12/01 08:37:34 UTC
Table: 'Colorado' 6-max (real money) Seat #6 is the button
Seat 1: Fried Berg (0.75€)
Seat 2: Coolax3019 (3.39€)
Seat 3: Cejargordas (3.23€)
Seat 4: Sebidu57 (1.48€)
Seat 5: nico033 (2.18€)
Seat 6: Tiken04 (2.03€)
*** ANTE/BLINDS ***
Fried Berg posts small blind 0.01€
Coolax3019 posts big blind 0.02€
Dealt to Fried Berg [9d 7s]
*** PRE-FLOP *** 
Cejargordas folds
Sebidu57 raises 0.05€ to 0.07€
nico033 folds
Tiken04 folds
Fried Berg folds
Coolax3019 folds
Sebidu57 collected 0.10€ from pot
*** SUMMARY ***
Total pot 0.10€ | No rake
Seat 4: Sebidu57 won 0.10€


Winamax Poker - HOLD-UP "Colorado" - HandId: #19116069-312180-1701419862 - Holdem no limit (0.01€/0.02€) - 2023/12/01 08:37:42 UTC
Table: 'Colorado' 6-max (real money) Seat #6 is the button
Seat 1: ninoujacou (0.87€)
Seat 2: Cejargordas (3.23€)
Seat 3: KKamarAAde (2.27€)
Seat 4: PIQSOU (6.77€)
Seat 5: Fried Berg (0.74€)
Seat 6: gagnejamais4 (1.36€)
*** ANTE/BLINDS ***
ninoujacou posts small blind 0.01€
Cejargordas posts big blind 0.02€
Dealt to Fried Berg [6s Qd]
*** PRE-FLOP *** 
KKamarAAde folds
PIQSOU folds
Fried Berg folds
gagnejamais4 folds
ninoujacou calls 0.01€
Cejargordas raises 0.08€ to 0.10€
ninoujacou folds
Cejargordas collected 0.12€ from pot
*** SUMMARY ***
Total pot 0.12€ | No rake
Seat 2: Cejargordas (big blind) won 0.12€


Winamax Poker - HOLD-UP "Colorado" - HandId: #19116069-312182-1701419863 - Holdem no limit (0.01€/0.02€) - 2023/12/01 08:37:43 UTC
Table: 'Colorado' 6-max (real money) Seat #6 is the button
Seat 1: haouuum28 (2.05€)
Seat 2: Piiranha (2.08€)
Seat 3: humnz (2.37€)
Seat 4: gagnejamais4 (1.36€)
Seat 5: lut1dupoivre (0.64€)
Seat 6: Fried Berg (0.74€)
*** ANTE/BLINDS ***
haouuum28 posts small blind 0.01€
Piiranha posts big blind 0.02€
Dealt to Fried Berg [3d 3s]
*** PRE-FLOP *** 
humnz folds
gagnejamais4 folds
lut1dupoivre folds
Fried Berg raises 0.02€ to 0.04€
haouuum28 folds
Piiranha calls 0.02€
*** FLOP *** [Ks 4s 4d]
Piiranha checks
Fried Berg checks
*** TURN *** [Ks 4s 4d][5s]
Piiranha bets 0.06€
Fried Berg calls 0.06€
*** RIVER *** [Ks 4s 4d 5s][6c]
Piiranha bets 0.21€
Fried Berg calls 0.21€
*** SHOW DOWN ***
Piiranha shows [Js Qd] (One pair : 4)
Fried Berg shows [3d 3s] (Two pairs : 4 and 3)
Fried Berg collected 0.57€ from pot
*** SUMMARY ***
Total pot 0.57€ | Rake 0.06€
Board: [Ks 4s 4d 5s 6c]
Seat 2: Piiranha (big blind) showed [Js Qd] and lost with One pair : 4
Seat 6: Fried Berg (button) showed [3d 3s] and won 0.57€ with Two pairs : 4 and 3


Winamax Poker - HOLD-UP "Colorado" - HandId: #19116069-312225-1701419915 - Holdem no limit (0.01€/0.02€) - 2023/12/01 08:38:35 UTC
Table: 'Colorado' 6-max (real money) Seat #6 is the button
Seat 1: lucall-in (2.22€)
Seat 2: Dovisclaire (0.91€)
Seat 3: ninoujacou (0.75€)
Seat 4: Jojo-andros5 (0.51€)
Seat 5: papashark14 (1.73€)
Seat 6: Fried Berg (1€)
*** ANTE/BLINDS ***
lucall-in posts small blind 0.01€
Dovisclaire posts big blind 0.02€
Dealt to Fried Berg [9h 2h]
*** PRE-FLOP *** 
ninoujacou folds
Jojo-andros5 calls 0.02€
papashark14 folds
Fried Berg folds
lucall-in folds
Dovisclaire raises 0.03€ to 0.05€
Jojo-andros5 calls 0.03€
*** FLOP *** [As Qs 6d]
Dovisclaire checks
Jojo-andros5 checks
*** TURN *** [As Qs 6d][Jh]
Dovisclaire checks
Jojo-andros5 bets 0.07€
Dovisclaire folds
Jojo-andros5 collected 0.17€ from pot
*** SUMMARY ***
Total pot 0.17€ | Rake 0.01€
Board: [As Qs 6d Jh]
Seat 4: Jojo-andros5 won 0.17€


Winamax Poker - HOLD-UP "Colorado" - HandId: #19116069-312234-1701419925 - Holdem no limit (0.01€/0.02€) - 2023/12/01 08:38:45 UTC
Table: 'Colorado' 6-max (real money) Seat #6 is the button
Seat 1: l artiste ho (1.88€)
Seat 2: Fried Berg (1€)
Seat 3: Cejargordas (2.44€)
Seat 4: Sebidu57 (1.75€)
Seat 5: Effray (2€)
Seat 6: tichettede3 (2.36€)
*** ANTE/BLINDS ***
l artiste ho posts small blind 0.01€
Fried Berg posts big blind 0.02€
Dealt to Fried Berg [5c 6s]
*** PRE-FLOP *** 
Cejargordas raises 0.04€ to 0.06€
Sebidu57 folds
Effray folds
tichettede3 folds
l artiste ho folds
Fried Berg folds
Cejargordas collected 0.09€ from pot
*** SUMMARY ***
Total pot 0.09€ | No rake
Seat 3: Cejargordas won 0.09€


Winamax Poker - HOLD-UP "Colorado" - HandId: #19116069-312246-1701419937 - Holdem no limit (0.01€/0.02€) - 2023/12/01 08:38:57 UTC
Table: 'Colorado' 6-max (real money) Seat #6 is the button
Seat 1: Fried Berg (0.98€)
Seat 2: KingSoto (2.71€)
Seat 3: jdeepenslip (5.15€)
Seat 4: Suaterna207 (2.32€)
Seat 5: tichettede3 (2.34€)
Seat 6: LimpDoud (3.98€)
*** ANTE/BLINDS ***
Fried Berg posts small blind 0.01€
KingSoto posts big blind 0.02€
Dealt to Fried Berg [6h 3s]
*** PRE-FLOP *** 
jdeepenslip folds
Suaterna207 folds
tichettede3 folds
LimpDoud folds
Fried Berg folds
KingSoto collected 0.03€ from pot
*** SUMMARY ***
Total pot 0.03€ | No rake
Seat 2: KingSoto (big blind) won 0.03€


Winamax Poker - HOLD-UP "Colorado" - HandId: #19116069-312249-1701419941 - Holdem no limit (0.01€/0.02€) - 2023/12/01 08:39:01 UTC
Table: 'Colorado' 6-max (real money) Seat #6 is the button
Seat 1: H4bet (2€)
Seat 2: DigBick99 (2.73€)
Seat 3: Fried Berg (0.97€)
Seat 4: LimpDoud (2.38€)
Seat 5: jdeepenslip (9.58€)
Seat 6: l artiste ho (1.87€)
*** ANTE/BLINDS ***
H4bet posts small blind 0.01€
DigBick99 posts big blind 0.02€
Dealt to Fried Berg [9s Kd]
*** PRE-FLOP *** 
Fried Berg folds
LimpDoud folds
jdeepenslip raises 0.03€ to 0.05€
l artiste ho calls 0.05€
H4bet folds
DigBick99 folds
*** FLOP *** [4s Ah 8d]
jdeepenslip bets 0.05€
l artiste ho calls 0.05€
*** TURN *** [4s Ah 8d][Jd]
jdeepenslip checks
l artiste ho bets 0.12€
jdeepenslip folds
l artiste ho collected 0.33€ from pot
*** SUMMARY ***
Total pot 0.33€ | Rake 0.02€
Board: [4s Ah 8d Jd]
Seat 6: l artiste ho (button) won 0.33€


Winamax Poker - HOLD-UP "Colorado" - HandId: #19116069-312253-1701419944 - Holdem no limit (0.01€/0.02€) - 2023/12/01 08:39:04 UTC
Table: 'Colorado' 6-max (real money) Seat #6 is the button
Seat 1: LimpDoud (2.38€)
Seat 2: PIQSOU (4.06€)
Seat 3: Manupoy (2.33€)
Seat 4: Tompahmax (1.97€)
Seat 5: Fried Berg (0.97€)
Seat 6: vicieux59 (0.70€)
Hold-up to Pot: total 0.10€
*** ANTE/BLINDS ***
LimpDoud posts small blind 0.01€
PIQSOU posts big blind 0.02€
Dealt to Fried Berg [Jd 4c]
*** PRE-FLOP *** 
Manupoy folds
Tompahmax folds
Fried Berg folds
vicieux59 folds
LimpDoud folds
PIQSOU collected 0.13€ from pot
*** SUMMARY ***
Total pot 0.13€ | No rake
Seat 2: PIQSOU (big blind) won 0.13€


Winamax Poker - HOLD-UP "Colorado" - HandId: #19116069-312263-1701419955 - Holdem no limit (0.01€/0.02€) - 2023/12/01 08:39:15 UTC
Table: 'Colorado' 6-max (real money) Seat #6 is the button
Seat 1: 77boy77 (0.50€)
Seat 2: nico033 (2.13€)
Seat 3: Cejargordas (2.66€)
Seat 4: Fried Berg (0.97€)
Seat 5: Coolax3019 (0.47€)
Seat 6: Suaterna207 (3.33€)
*** ANTE/BLINDS ***
77boy77 posts small blind 0.01€
nico033 posts big blind 0.02€
Dealt to Fried Berg [9h 9s]
*** PRE-FLOP *** 
Cejargordas folds
Fried Berg raises 0.02€ to 0.04€
Coolax3019 folds
Suaterna207 calls 0.04€
77boy77 folds
nico033 calls 0.02€
*** FLOP *** [7d 6c 3h]
nico033 checks
Fried Berg bets 0.02€
Suaterna207 calls 0.02€
nico033 calls 0.02€
*** TURN *** [7d 6c 3h][3c]
nico033 checks
Fried Berg bets 0.07€
Suaterna207 folds
nico033 folds
Fried Berg collected 0.24€ from pot
*** SUMMARY ***
Total pot 0.24€ | Rake 0.02€
Board: [7d 6c 3h 3c]
Seat 4: Fried Berg won 0.24€


Winamax Poker - HOLD-UP "Colorado" - HandId: #19116069-312313-1701420007 - Holdem no limit (0.01€/0.02€) - 2023/12/01 08:40:07 UTC
Table: 'Colorado' 6-max (real money) Seat #6 is the button
Seat 1: solver (2.49€)
Seat 2: Fried Berg (1.08€)
Seat 3: Suaterna207 (2.35€)
Seat 4: LimpDoud (3.79€)
Seat 5: lucall-in (2.26€)
Seat 6: Tompahmax (1.93€)
*** ANTE/BLINDS ***
solver posts small blind 0.01€
Fried Berg posts big blind 0.02€
Dealt to Fried Berg [4s 9s]
*** PRE-FLOP *** 
Suaterna207 folds
LimpDoud folds
lucall-in calls 0.02€
Tompahmax folds
solver folds
Fried Berg checks
*** FLOP *** [3s As 6h]
Fried Berg checks
lucall-in checks
*** TURN *** [3s As 6h][9d]
Fried Berg checks
lucall-in bets 0.03€
Fried Berg calls 0.03€
*** RIVER *** [3s As 6h 9d][7d]
Fried Berg checks
lucall-in checks
*** SHOW DOWN ***
lucall-in shows [5c 5h] (One pair : 5)
Fried Berg shows [4s 9s] (One pair : 9)
Fried Berg collected 0.10€ from pot
*** SUMMARY ***
Total pot 0.10€ | Rake 0.01€
Board: [3s As 6h 9d 7d]
Seat 2: Fried Berg (big blind) showed [4s 9s] and won 0.10€ with One pair : 9
Seat 5: lucall-in showed [5c 5h] and lost with One pair : 5


Winamax Poker - HOLD-UP "Colorado" - HandId: #19116069-312351-1701420049 - Holdem no limit (0.01€/0.02€) - 2023/12/01 08:40:49 UTC
Table: 'Colorado' 6-max (real money) Seat #6 is the button
Seat 1: Fried Berg (1.13€)
Seat 2: nico033 (1.92€)
Seat 3: LimpDoud (2.09€)
Seat 4: haouuum28 (3.12€)
Seat 5: lucall-in (2.21€)
Seat 6: Ju89400 (3.47€)
*** ANTE/BLINDS ***
Fried Berg posts small blind 0.01€
nico033 posts big blind 0.02€
Dealt to Fried Berg [3d 4c]
*** PRE-FLOP *** 
LimpDoud folds
haouuum28 raises 0.04€ to 0.06€
lucall-in folds
Ju89400 folds
Fried Berg folds
nico033 folds
haouuum28 collected 0.09€ from pot
*** SUMMARY ***
Total pot 0.09€ | No rake
Seat 4: haouuum28 won 0.09€


Winamax Poker - HOLD-UP "Colorado" - HandId: #19116069-312358-1701420057 - Holdem no limit (0.01€/0.02€) - 2023/12/01 08:40:57 UTC
Table: 'Colorado' 6-max (real money) Seat #6 is the button
Seat 1: jdeepenslip (9.47€)
Seat 2: aalleix888 (1.45€)
Seat 3: Fried Berg (1.12€)
Seat 4: solver (2.57€)
Seat 5: LimpDoud (2.19€)
Seat 6: l artiste ho (1.93€)
*** ANTE/BLINDS ***
jdeepenslip posts small blind 0.01€
aalleix888 posts big blind 0.02€
Dealt to Fried Berg [7d 9d]
*** PRE-FLOP *** 
Fried Berg folds
solver folds
LimpDoud folds
l artiste ho folds
jdeepenslip folds
aalleix888 collected 0.03€ from pot
*** SUMMARY ***
Total pot 0.03€ | No rake
Seat 2: aalleix888 (big blind) won 0.03€


Winamax Poker - HOLD-UP "Colorado" - HandId: #19116069-312365-1701420067 - Holdem no limit (0.01€/0.02€) - 2023/12/01 08:41:07 UTC
Table: 'Colorado' 6-max (real money) Seat #6 is the button
Seat 1: karma- (2.19€)
Seat 2: Halmosthard (1.69€)
Seat 3: KingSoto (3.36€)
Seat 4: Fried Berg (1.12€)
Seat 5: Manupoy (2.92€)
Seat 6: DigBick99 (3.19€)
*** ANTE/BLINDS ***
karma- posts small blind 0.01€
Halmosthard posts big blind 0.02€
Dealt to Fried Berg [Ts 9c]
*** PRE-FLOP *** 
KingSoto folds
Fried Berg calls 0.02€
Manupoy folds
DigBick99 folds
karma- calls 0.01€
Halmosthard checks
*** FLOP *** [8h Th Ac]
karma- checks
Halmosthard checks
Fried Berg checks
*** TURN *** [8h Th Ac][3s]
karma- bets 0.03€
Halmosthard folds
Fried Berg calls 0.03€
*** RIVER *** [8h Th Ac 3s][8d]
karma- bets 0.06€
Fried Berg calls 0.06€
*** SHOW DOWN ***
Fried Berg shows [Ts 9c] (Two pairs : Tens and 8)
karma- shows [As 3h] (Two pairs : Aces and 8)
karma- collected 0.22€ from pot
*** SUMMARY ***
Total pot 0.22€ | Rake 0.02€
Board: [8h Th Ac 3s 8d]
Seat 1: karma- (small blind) showed [As 3h] and won 0.22€ with Two pairs : Aces and 8
Seat 4: Fried Berg showed [Ts 9c] and lost with Two pairs : Tens and 8


Winamax Poker - HOLD-UP "Colorado" - HandId: #19116069-312420-1701420127 - Holdem no limit (0.01€/0.02€) - 2023/12/01 08:42:07 UTC
Table: 'Colorado' 6-max (real money) Seat #6 is the button
Seat 1: DigBick99 (2.55€)
Seat 2: VashtaNerada (2€)
Seat 3: Cejargordas (2.61€)
Seat 4: Effray (2€)
Seat 5: Fried Berg (1.01€)
Seat 6: LimpDoud (3.96€)
*** ANTE/BLINDS ***
DigBick99 posts small blind 0.01€
VashtaNerada posts big blind 0.02€
Dealt to Fried Berg [9d 8c]
*** PRE-FLOP *** 
Cejargordas raises 0.04€ to 0.06€
Effray folds
Fried Berg folds
LimpDoud folds
DigBick99 folds
VashtaNerada folds
Cejargordas collected 0.09€ from pot
*** SUMMARY ***
Total pot 0.09€ | No rake
Seat 3: Cejargordas won 0.09€


Winamax Poker - HOLD-UP "Colorado" - HandId: #19116069-312428-1701420135 - Holdem no limit (0.01€/0.02€) - 2023/12/01 08:42:15 UTC
Table: 'Colorado' 6-max (real money) Seat #6 is the button
Seat 1: LimpDoud (2.23€)
Seat 2: gagnejamais4 (2.20€)
Seat 3: 39Maitre (0.47€)
Seat 4: Fried Berg (1.01€)
Seat 5: Effray (2€)
Seat 6: BrokBroken (2.39€)
*** ANTE/BLINDS ***
LimpDoud posts small blind 0.01€
gagnejamais4 posts big blind 0.02€
Dealt to Fried Berg [Qh 6h]
*** PRE-FLOP *** 
39Maitre calls 0.02€
Fried Berg calls 0.02€
Effray calls 0.02€
BrokBroken raises 0.04€ to 0.06€
LimpDoud folds
gagnejamais4 calls 0.04€
39Maitre calls 0.04€
Fried Berg calls 0.04€
Effray calls 0.04€
*** FLOP *** [Qd 2d Ac]
gagnejamais4 checks
39Maitre checks
Fried Berg bets 0.04€
Effray folds
BrokBroken folds
gagnejamais4 calls 0.04€
39Maitre folds
*** TURN *** [Qd 2d Ac][4c]
gagnejamais4 checks
Fried Berg checks
*** RIVER *** [Qd 2d Ac 4c][Kc]
gagnejamais4 checks
Fried Berg checks
*** SHOW DOWN ***
gagnejamais4 shows [7d 7h] (One pair : 7)
Fried Berg shows [Qh 6h] (One pair : Queens)
Fried Berg collected 0.35€ from pot
*** SUMMARY ***
Total pot 0.35€ | Rake 0.04€
Board: [Qd 2d Ac 4c Kc]
Seat 2: gagnejamais4 (big blind) showed [7d 7h] and lost with One pair : 7
Seat 4: Fried Berg showed [Qh 6h] and won 0.35€ with One pair : Queens


Winamax Poker - HOLD-UP "Colorado" - HandId: #19116069-312508-1701420227 - Holdem no limit (0.01€/0.02€) - 2023/12/01 08:43:47 UTC
Table: 'Colorado' 6-max (real money) Seat #6 is the button
Seat 1: DDDIEU33 (3.59€)
Seat 2: LimpDoud (3.91€)
Seat 3: H4bet (3.51€)
Seat 4: gagnejamais4 (2.10€)
Seat 5: Suaterna207 (3.03€)
Seat 6: Fried Berg (1.26€)
*** ANTE/BLINDS ***
DDDIEU33 posts small blind 0.01€
LimpDoud posts big blind 0.02€
Dealt to Fried Berg [6d Qd]
*** PRE-FLOP *** 
H4bet folds
gagnejamais4 folds
Suaterna207 folds
Fried Berg folds
DDDIEU33 folds
LimpDoud collected 0.03€ from pot
*** SUMMARY ***
Total pot 0.03€ | No rake
Seat 2: LimpDoud (big blind) won 0.03€


Winamax Poker - HOLD-UP "Colorado" - HandId: #19116069-312514-1701420232 - Holdem no limit (0.01€/0.02€) - 2023/12/01 08:43:52 UTC
Table: 'Colorado' 6-max (real money) Seat #6 is the button
Seat 1: Dovisclaire (1.25€)
Seat 2: Tiken04 (2€)
Seat 3: Fried Berg (1.26€)
Seat 4: CTMieuxAvant (2.45€)
Seat 5: PIQSOU (2.51€)
Seat 6: lucall-in (2.24€)
*** ANTE/BLINDS ***
Dovisclaire posts small blind 0.01€
Tiken04 posts big blind 0.02€
Dealt to Fried Berg [6d Td]
*** PRE-FLOP *** 
Fried Berg folds
CTMieuxAvant folds
PIQSOU raises 0.03€ to 0.05€
lucall-in folds
Dovisclaire folds
Tiken04 folds
PIQSOU collected 0.08€ from pot
*** SUMMARY ***
Total pot 0.08€ | No rake
Seat 5: PIQSOU won 0.08€


Winamax Poker - HOLD-UP "Colorado" - HandId: #19116069-312516-1701420234 - Holdem no limit (0.01€/0.02€) - 2023/12/01 08:43:54 UTC
Table: 'Colorado' 6-max (real money) Seat #6 is the button
Seat 1: Fried Berg (1.26€)
Seat 2: BrokBroken (2€)
Seat 3: Coolax3019 (2.58€)
Seat 4: CB-Joker6274 (4.22€)
Seat 5: Suaterna207 (6.78€)
Seat 6: haamataraa (2€)
*** ANTE/BLINDS ***
Fried Berg posts small blind 0.01€
BrokBroken posts big blind 0.02€
Dealt to Fried Berg [Qs As]
*** PRE-FLOP *** 
Coolax3019 calls 0.02€
CB-Joker6274 calls 0.02€
Suaterna207 folds
haamataraa calls 0.02€
Fried Berg raises 0.14€ to 0.16€
BrokBroken folds
Coolax3019 calls 0.14€
CB-Joker6274 calls 0.14€
haamataraa calls 0.14€
*** FLOP *** [Jc 7h Kd]
Fried Berg checks
Coolax3019 checks
CB-Joker6274 bets 0.23€
haamataraa folds
Fried Berg calls 0.23€
Coolax3019 folds
*** TURN *** [Jc 7h Kd][9d]
Fried Berg checks
CB-Joker6274 bets 0.39€
Fried Berg calls 0.39€
*** RIVER *** [Jc 7h Kd 9d][Td]
Fried Berg checks
CB-Joker6274 bets 1.90€
Fried Berg calls 0.48€ and is all-in
*** SHOW DOWN ***
Fried Berg shows [Qs As] (Straight Ace high)
CB-Joker6274 shows [Jh Qd] (Straight King high)
CB-Joker6274 collected 1.42€ from side pot 1
Fried Berg collected 2.57€ from main pot
*** SUMMARY ***
Total pot 3.99€ | Rake 0.29€
Board: [Jc 7h Kd 9d Td]
Seat 1: Fried Berg (small blind) showed [Qs As] and won 2.57€ with Straight Ace high
Seat 4: CB-Joker6274 showed [Jh Qd] and won 1.42€ with Straight King high


Winamax Poker - HOLD-UP "Colorado" - HandId: #19116069-312656-1701420364 - Holdem no limit (0.01€/0.02€) - 2023/12/01 08:46:04 UTC
Table: 'Colorado' 6-max (real money) Seat #6 is the button
Seat 1: kamclo (2.17€)
Seat 2: Japut (2.79€)
Seat 3: CB-Joker6274 (2.96€)
Seat 4: LimpDoud (4.15€)
Seat 5: Fried Berg (2.57€)
Seat 6: aalleix888 (1.35€)
Hold-up to Pot: total 0.10€
*** ANTE/BLINDS ***
kamclo posts small blind 0.01€
Japut posts big blind 0.02€
Dealt to Fried Berg [3d Js]
*** PRE-FLOP *** 
CB-Joker6274 folds
LimpDoud raises 0.03€ to 0.05€
Fried Berg folds
aalleix888 folds
kamclo folds
Japut folds
LimpDoud collected 0.18€ from pot
*** SUMMARY ***
Total pot 0.18€ | No rake
Seat 4: LimpDoud won 0.18€


Winamax Poker - HOLD-UP "Colorado" - HandId: #19116069-312666-1701420377 - Holdem no limit (0.01€/0.02€) - 2023/12/01 08:46:17 UTC
Table: 'Colorado' 6-max (real money) Seat #6 is the button
Seat 1: Coolax3019 (0.36€)
Seat 2: Fried Berg (2.57€)
Seat 3: hello7585 (2.58€)
Seat 4: oliveponcar (3.20€)
Seat 5: Davut 18 (0.50€)
Seat 6: DigBick99 (3.87€)
Hold-up to Pot: total 0.10€
*** ANTE/BLINDS ***
Coolax3019 posts small blind 0.01€
Fried Berg posts big blind 0.02€
Dealt to Fried Berg [5d Ac]
*** PRE-FLOP *** 
hello7585 folds
oliveponcar folds
Davut 18 folds
DigBick99 folds
Coolax3019 calls 0.01€
Fried Berg checks
*** FLOP *** [Qs 6d Ks]
Coolax3019 checks
Fried Berg bets 0.05€
Coolax3019 calls 0.05€
*** TURN *** [Qs 6d Ks][4d]
Coolax3019 checks
Fried Berg checks
*** RIVER *** [Qs 6d Ks 4d][7c]
Coolax3019 checks
Fried Berg checks
*** SHOW DOWN ***
Fried Berg shows [5d Ac] (High card : Ace)
Coolax3019 shows [9d 9s] (One pair : 9)
Coolax3019 collected 0.23€ from pot
*** SUMMARY ***
Total pot 0.23€ | Rake 0.01€
Board: [Qs 6d Ks 4d 7c]
Seat 1: Coolax3019 (small blind) showed [9d 9s] and won 0.23€ with One pair : 9
Seat 2: Fried Berg (big blind) showed [5d Ac] and lost with High card : Ace


Winamax Poker - HOLD-UP "Colorado" - HandId: #19116069-312712-1701420419 - Holdem no limit (0.01€/0.02€) - 2023/12/01 08:46:59 UTC
Table: 'Colorado' 6-max (real money) Seat #6 is the button
Seat 1: pivert 83 (1.95€)
Seat 2: Brut2pok (2€)
Seat 3: solver (2.89€)
Seat 4: Coolax3019 (0.52€)
Seat 5: Binkks AAnks (2.24€)
Seat 6: Fried Berg (2.50€)
*** ANTE/BLINDS ***
pivert 83 posts small blind 0.01€
Brut2pok posts big blind 0.02€
Dealt to Fried Berg [2d Qh]
*** PRE-FLOP *** 
solver folds
Coolax3019 calls 0.02€
Binkks AAnks calls 0.02€
Fried Berg folds
pivert 83 folds
Brut2pok checks
*** FLOP *** [2h Qs Kc]
Brut2pok checks
Coolax3019 checks
Binkks AAnks bets 0.05€
Brut2pok folds
Coolax3019 calls 0.05€
*** TURN *** [2h Qs Kc][7h]
Coolax3019 checks
Binkks AAnks bets 0.11€
Coolax3019 calls 0.11€
*** RIVER *** [2h Qs Kc 7h][Ac]
Coolax3019 checks
Binkks AAnks checks
*** SHOW DOWN ***
Coolax3019 shows [5c 2c] (One pair : 2)
Binkks AAnks shows [Ah 6h] (One pair : Aces)
Binkks AAnks collected 0.35€ from pot
*** SUMMARY ***
Total pot 0.35€ | Rake 0.04€
Board: [2h Qs Kc 7h Ac]
Seat 4: Coolax3019 showed [5c 2c] and lost with One pair : 2
Seat 5: Binkks AAnks showed [Ah 6h] and won 0.35€ with One pair : Aces


Winamax Poker - HOLD-UP "Colorado" - HandId: #19116069-312727-1701420431 - Holdem no limit (0.01€/0.02€) - 2023/12/01 08:47:11 UTC
Table: 'Colorado' 6-max (real money) Seat #6 is the button
Seat 1: gagnejamais4 (1.69€)
Seat 2: DDDIEU33 (3.21€)
Seat 3: chrisgtapoks (2.44€)
Seat 4: Fried Berg (2.50€)
Seat 5: SashaTDouss (2.29€)
Seat 6: H4bet (3.82€)
*** ANTE/BLINDS ***
gagnejamais4 posts small blind 0.01€
DDDIEU33 posts big blind 0.02€
Dealt to Fried Berg [7d 6c]
*** PRE-FLOP *** 
chrisgtapoks folds
Fried Berg folds
SashaTDouss folds
H4bet folds
gagnejamais4 raises 0.04€ to 0.06€
DDDIEU33 calls 0.04€
*** FLOP *** [Kh 6h Js]
gagnejamais4 checks
DDDIEU33 checks
*** TURN *** [Kh 6h Js][As]
gagnejamais4 bets 0.06€
DDDIEU33 calls 0.06€
*** RIVER *** [Kh 6h Js As][4d]
gagnejamais4 bets 0.12€
DDDIEU33 folds
gagnejamais4 collected 0.34€ from pot
*** SUMMARY ***
Total pot 0.34€ | Rake 0.02€
Board: [Kh 6h Js As 4d]
Seat 1: gagnejamais4 (small blind) won 0.34€


Winamax Poker - HOLD-UP "Colorado" - HandId: #19116069-312736-1701420438 - Holdem no limit (0.01€/0.02€) - 2023/12/01 08:47:18 UTC
Table: 'Colorado' 6-max (real money) Seat #6 is the button
Seat 1: Dovisclaire (1.15€)
Seat 2: Fried Berg (2.50€)
Seat 3: pivert 83 (1.83€)
Seat 4: Tompahmax (2.51€)
Seat 5: hello7585 (2.58€)
Seat 6: H4bet (3.82€)
*** ANTE/BLINDS ***
Dovisclaire posts small blind 0.01€
Fried Berg posts big blind 0.02€
Dealt to Fried Berg [3h 8s]
*** PRE-FLOP *** 
pivert 83 folds
Tompahmax folds
hello7585 folds
H4bet raises 0.03€ to 0.05€
Dovisclaire calls 0.04€
Fried Berg folds
*** FLOP *** [Jh Td 4c]
Dovisclaire bets 0.04€
H4bet calls 0.04€
*** TURN *** [Jh Td 4c][6h]
Dovisclaire checks
H4bet bets 0.10€
Dovisclaire folds
H4bet collected 0.28€ from pot
*** SUMMARY ***
Total pot 0.28€ | Rake 0.02€
Board: [Jh Td 4c 6h]
Seat 6: H4bet (button) won 0.28€


Winamax Poker - HOLD-UP "Colorado" - HandId: #19116069-312745-1701420446 - Holdem no limit (0.01€/0.02€) - 2023/12/01 08:47:26 UTC
Table: 'Colorado' 6-max (real money) Seat #6 is the button
Seat 1: Fried Berg (2.48€)
Seat 2: lut1dupoivre (0.35€)
Seat 3: LimpDoud (2.77€)
Seat 4: KKamarAAde (9.76€)
Seat 5: karma- (2.13€)
Seat 6: oliveponcar (3.13€)
*** ANTE/BLINDS ***
Fried Berg posts small blind 0.01€
lut1dupoivre posts big blind 0.02€
Dealt to Fried Berg [9s 5h]
*** PRE-FLOP *** 
LimpDoud folds
KKamarAAde folds
karma- folds
oliveponcar folds
Fried Berg folds
lut1dupoivre collected 0.03€ from pot
*** SUMMARY ***
Total pot 0.03€ | No rake
Seat 2: lut1dupoivre (big blind) won 0.03€


Winamax Poker - HOLD-UP "Colorado" - HandId: #19116069-312748-1701420448 - Holdem no limit (0.01€/0.02€) - 2023/12/01 08:47:28 UTC
Table: 'Colorado' 6-max (real money) Seat #6 is the button
Seat 1: CTMieuxAvant (2.40€)
Seat 2: KKamarAAde (9.76€)
Seat 3: Fried Berg (2.47€)
Seat 4: Halmosthard (2.09€)
Seat 5: karma- (2.13€)
Seat 6: Manupoy (2.33€)
*** ANTE/BLINDS ***
CTMieuxAvant posts small blind 0.01€
KKamarAAde posts big blind 0.02€
Dealt to Fried Berg [Ts Js]
*** PRE-FLOP *** 
Fried Berg raises 0.02€ to 0.04€
Halmosthard calls 0.04€
karma- calls 0.04€
Manupoy folds
CTMieuxAvant folds
KKamarAAde folds
*** FLOP *** [5s Qs 4c]
Fried Berg checks
Halmosthard checks
karma- checks
*** TURN *** [5s Qs 4c][Qh]
Fried Berg checks
Halmosthard checks
karma- bets 0.05€
Fried Berg calls 0.05€
Halmosthard folds
*** RIVER *** [5s Qs 4c Qh][2s]
Fried Berg checks
karma- bets 0.20€
Fried Berg calls 0.20€
*** SHOW DOWN ***
Fried Berg shows [Ts Js] (Flush Queen high)
karma- shows [4h 4d] (Full of 4 and Queens)
karma- collected 0.58€ from pot
*** SUMMARY ***
Total pot 0.58€ | Rake 0.07€
Board: [5s Qs 4c Qh 2s]
Seat 3: Fried Berg showed [Ts Js] and lost with Flush Queen high
Seat 5: karma- showed [4h 4d] and won 0.58€ with Full of 4 and Queens


Winamax Poker - HOLD-UP "Colorado" - HandId: #19116069-312875-1701420563 - Holdem no limit (0.01€/0.02€) - 2023/12/01 08:49:23 UTC
Table: 'Colorado' 6-max (real money) Seat #6 is the button
Seat 1: LilRun (1.96€)
Seat 2: g8o8k8u (2.21€)
Seat 3: Brut2pok (2.04€)
Seat 4: pivert 83 (1.93€)
Seat 5: hello7585 (1.81€)
Seat 6: Fried Berg (2.18€)
*** ANTE/BLINDS ***
LilRun posts small blind 0.01€
g8o8k8u posts big blind 0.02€
Dealt to Fried Berg [4s 9d]
*** PRE-FLOP *** 
Brut2pok folds
pivert 83 raises 0.04€ to 0.06€
hello7585 folds
Fried Berg folds
LilRun folds
g8o8k8u raises 0.18€ to 0.24€
pivert 83 folds
g8o8k8u collected 0.31€ from pot
*** SUMMARY ***
Total pot 0.31€ | No rake
Seat 2: g8o8k8u (big blind) won 0.31€


Winamax Poker - HOLD-UP "Colorado" - HandId: #19116069-312899-1701420596 - Holdem no limit (0.01€/0.02€) - 2023/12/01 08:49:56 UTC
Table: 'Colorado' 6-max (real money) Seat #6 is the button
Seat 1: LimpDoud (2.71€)
Seat 2: MoneyGrowing (2.06€)
Seat 3: Coolax3019 (2.53€)
Seat 4: karma- (3.32€)
Seat 5: Fried Berg (2.18€)
Seat 6: CTMieuxAvant (2.10€)
Hold-up to Pot: total 0.10€
*** ANTE/BLINDS ***
LimpDoud posts small blind 0.01€
MoneyGrowing posts big blind 0.02€
Dealt to Fried Berg [6s Ts]
*** PRE-FLOP *** 
Coolax3019 folds
karma- calls 0.02€
Fried Berg calls 0.02€
CTMieuxAvant folds
LimpDoud folds
MoneyGrowing checks
*** FLOP *** [8s 4c Kd]
MoneyGrowing checks
karma- bets 0.06€
Fried Berg folds
MoneyGrowing folds
karma- collected 0.22€ from pot
*** SUMMARY ***
Total pot 0.22€ | Rake 0.01€
Board: [8s 4c Kd]
Seat 4: karma- won 0.22€


Winamax Poker - HOLD-UP "Colorado" - HandId: #19116069-312924-1701420624 - Holdem no limit (0.01€/0.02€) - 2023/12/01 08:50:24 UTC
Table: 'Colorado' 6-max (real money) Seat #6 is the button
Seat 1: Halmosthard (1.46€)
Seat 2: Goldinher (0.80€)
Seat 3: Fried Berg (2.16€)
Seat 4: Dovisclaire (0.86€)
Seat 5: BrokBroken (2€)
Seat 6: H4bet (3.92€)
*** ANTE/BLINDS ***
Halmosthard posts small blind 0.01€
Goldinher posts big blind 0.02€
Dealt to Fried Berg [8s Kd]
*** PRE-FLOP *** 
Fried Berg folds
Dovisclaire folds
BrokBroken raises 0.04€ to 0.06€
H4bet folds
Halmosthard folds
Goldinher folds
BrokBroken collected 0.09€ from pot
*** SUMMARY ***
Total pot 0.09€ | No rake
Seat 5: BrokBroken won 0.09€


Winamax Poker - HOLD-UP "Colorado" - HandId: #19116069-312927-1701420626 - Holdem no limit (0.01€/0.02€) - 2023/12/01 08:50:26 UTC
Table: 'Colorado' 6-max (real money) Seat #6 is the button
Seat 1: LimpDoud (2€)
Seat 2: Lolo_Baff (0.46€)
Seat 3: DigBick99 (2.60€)
Seat 4: Tompahmax (2.48€)
Seat 5: Fried Berg (2.16€)
Seat 6: CTMieuxAvant (2.34€)
*** ANTE/BLINDS ***
LimpDoud posts small blind 0.01€
Lolo_Baff posts big blind 0.02€
Dealt to Fried Berg [Qs Qh]
*** PRE-FLOP *** 
DigBick99 folds
Tompahmax folds
Fried Berg raises 0.04€ to 0.06€
CTMieuxAvant folds
LimpDoud folds
Lolo_Baff folds
Fried Berg collected 0.09€ from pot
*** SUMMARY ***
Total pot 0.09€ | No rake
Seat 5: Fried Berg won 0.09€


Winamax Poker - HOLD-UP "Colorado" - HandId: #19116069-312939-1701420640 - Holdem no limit (0.01€/0.02€) - 2023/12/01 08:50:40 UTC
Table: 'Colorado' 6-max (real money) Seat #6 is the button
Seat 1: nico033 (3.53€)
Seat 2: Fried Berg (2.19€)
Seat 3: LimpDoud (2.70€)
Seat 4: Cejargordas (2.09€)
Seat 5: SirX (4.11€)
Seat 6: Tompahmax (1.50€)
*** ANTE/BLINDS ***
nico033 posts small blind 0.01€
Fried Berg posts big blind 0.02€
Dealt to Fried Berg [Jc 2h]
*** PRE-FLOP *** 
LimpDoud folds
Cejargordas folds
SirX raises 0.04€ to 0.06€
Tompahmax folds
nico033 folds
Fried Berg folds
SirX collected 0.09€ from pot
*** SUMMARY ***
Total pot 0.09€ | No rake
Seat 5: SirX won 0.09€


Winamax Poker - HOLD-UP "Colorado" - HandId: #19116069-312950-1701420648 - Holdem no limit (0.01€/0.02€) - 2023/12/01 08:50:48 UTC
Table: 'Colorado' 6-max (real money) Seat #6 is the button
Seat 1: Fried Berg (2.17€)
Seat 2: SashaTDouss (2€)
Seat 3: DigBick99 (4.01€)
Seat 4: Cejargordas (2.07€)
Seat 5: Japut (2.69€)
Seat 6: DoNPaPaMaSS (2.05€)
*** ANTE/BLINDS ***
Fried Berg posts small blind 0.01€
SashaTDouss posts big blind 0.02€
Dealt to Fried Berg [Qc 8s]
*** PRE-FLOP *** 
DigBick99 folds
Cejargordas folds
Japut folds
DoNPaPaMaSS folds
Fried Berg raises 0.02€ to 0.04€
SashaTDouss calls 0.02€
*** FLOP *** [4c 4h Qh]
Fried Berg checks
SashaTDouss checks
*** TURN *** [4c 4h Qh][Qd]
Fried Berg checks
SashaTDouss checks
*** RIVER *** [4c 4h Qh Qd][Kd]
Fried Berg bets 0.08€
SashaTDouss folds
Fried Berg collected 0.15€ from pot
*** SUMMARY ***
Total pot 0.15€ | Rake 0.01€
Board: [4c 4h Qh Qd Kd]
Seat 1: Fried Berg (small blind) won 0.15€


Winamax Poker - HOLD-UP "Colorado" - HandId: #19116069-312988-1701420691 - Holdem no limit (0.01€/0.02€) - 2023/12/01 08:51:31 UTC
Table: 'Colorado' 6-max (real money) Seat #6 is the button
Seat 1: tichettede3 (2.11€)
Seat 2: KKamarAAde (2.99€)
Seat 3: Coolax3019 (0.44€)
Seat 4: Fried Berg (2.20€)
Seat 5: DigBick99 (2.78€)
Seat 6: BrokBroken (3.99€)
*** ANTE/BLINDS ***
tichettede3 posts small blind 0.01€
KKamarAAde posts big blind 0.02€
Dealt to Fried Berg [3h 9s]
*** PRE-FLOP *** 
Coolax3019 folds
Fried Berg folds
DigBick99 raises 0.04€ to 0.06€
BrokBroken folds
tichettede3 folds
KKamarAAde calls 0.04€
*** FLOP *** [As 3s Qc]
KKamarAAde checks
DigBick99 bets 0.07€
KKamarAAde folds
DigBick99 collected 0.19€ from pot
*** SUMMARY ***
Total pot 0.19€ | Rake 0.01€
Board: [As 3s Qc]
Seat 5: DigBick99 won 0.19€


Winamax Poker - HOLD-UP "Colorado" - HandId: #19116069-312993-1701420697 - Holdem no limit (0.01€/0.02€) - 2023/12/01 08:51:37 UTC
Table: 'Colorado' 6-max (real money) Seat #6 is the button
Seat 1: Lolo_Baff (0.45€)
Seat 2: sopra61 (1.31€)
Seat 3: gagnejamais4 (1.79€)
Seat 4: CTMieuxAvant (2.28€)
Seat 5: corm973 (1.95€)
Seat 6: Fried Berg (2.20€)
*** ANTE/BLINDS ***
Lolo_Baff posts small blind 0.01€
sopra61 posts big blind 0.02€
Dealt to Fried Berg [7d 4s]
*** PRE-FLOP *** 
gagnejamais4 folds
CTMieuxAvant folds
corm973 folds
Fried Berg folds
Lolo_Baff calls 0.01€
sopra61 checks
*** FLOP *** [2s 3h 7h]
Lolo_Baff bets 0.03€
sopra61 calls 0.03€
*** TURN *** [2s 3h 7h][5h]
Lolo_Baff bets 0.07€
sopra61 calls 0.07€
*** RIVER *** [2s 3h 7h 5h][2h]
Lolo_Baff bets 0.08€
sopra61 calls 0.08€
*** SHOW DOWN ***
sopra61 shows [7c Qs] (Two pairs : 7 and 2)
Lolo_Baff shows [6h 7s] (Flush 7 high)
Lolo_Baff collected 0.36€ from pot
*** SUMMARY ***
Total pot 0.36€ | Rake 0.04€
Board: [2s 3h 7h 5h 2h]
Seat 1: Lolo_Baff (small blind) showed [6h 7s] and won 0.36€ with Flush 7 high
Seat 2: sopra61 (big blind) showed [7c Qs] and lost with Two pairs : 7 and 2


Winamax Poker - HOLD-UP "Colorado" - HandId: #19116069-312996-1701420701 - Holdem no limit (0.01€/0.02€) - 2023/12/01 08:51:41 UTC
Table: 'Colorado' 6-max (real money) Seat #6 is the button
Seat 1: solver (2.19€)
Seat 2: lut1dupoivre (0.39€)
Seat 3: Fried Berg (2.20€)
Seat 4: Binkks AAnks (2.40€)
Seat 5: gagnejamais4 (1.79€)
Seat 6: Tompahmax (1.36€)
*** ANTE/BLINDS ***
solver posts small blind 0.01€
lut1dupoivre posts big blind 0.02€
Dealt to Fried Berg [Qs 3d]
*** PRE-FLOP *** 
Fried Berg folds
Binkks AAnks raises 0.03€ to 0.05€
gagnejamais4 folds
Tompahmax folds
solver folds
lut1dupoivre calls 0.03€
*** FLOP *** [Td Kc 6d]
lut1dupoivre checks
Binkks AAnks bets 0.07€
lut1dupoivre calls 0.07€
*** TURN *** [Td Kc 6d][5s]
lut1dupoivre checks
Binkks AAnks bets 0.09€
lut1dupoivre calls 0.09€
*** RIVER *** [Td Kc 6d 5s][7c]
lut1dupoivre checks
Binkks AAnks checks
*** SHOW DOWN ***
Binkks AAnks shows [Jd Ad] (High card : Ace)
lut1dupoivre shows [9h Th] (One pair : Tens)
lut1dupoivre collected 0.39€ from pot
*** SUMMARY ***
Total pot 0.39€ | Rake 0.04€
Board: [Td Kc 6d 5s 7c]
Seat 2: lut1dupoivre (big blind) showed [9h Th] and won 0.39€ with One pair : Tens
Seat 4: Binkks AAnks showed [Jd Ad] and lost with High card : Ace


Winamax Poker - HOLD-UP "Colorado" - HandId: #19116069-312999-1701420702 - Holdem no limit (0.01€/0.02€) - 2023/12/01 08:51:42 UTC
Table: 'Colorado' 6-max (real money) Seat #6 is the button
Seat 1: aalleix888 (1.96€)
Seat 2: Fried Berg (2.20€)
Seat 3: MoneyGrowing (2.20€)
Seat 4: solver (2.18€)
Seat 5: gagnejamais4 (1.79€)
Seat 6: Baston57 (2.58€)
*** ANTE/BLINDS ***
aalleix888 posts small blind 0.01€
Fried Berg posts big blind 0.02€
Dealt to Fried Berg [9s 3d]
*** PRE-FLOP *** 
MoneyGrowing folds
solver raises 0.04€ to 0.06€
gagnejamais4 calls 0.06€
Baston57 folds
aalleix888 folds
Fried Berg folds
*** FLOP *** [4d Jh 5s]
solver checks
gagnejamais4 bets 0.10€
solver calls 0.10€
*** TURN *** [4d Jh 5s][3s]
solver checks
gagnejamais4 bets 0.12€
solver calls 0.12€
*** RIVER *** [4d Jh 5s 3s][5h]
solver checks
gagnejamais4 checks
*** SHOW DOWN ***
solver shows [Kh As] (One pair : 5)
gagnejamais4 shows [Js Qh] (Two pairs : Jacks and 5)
gagnejamais4 collected 0.53€ from pot
*** SUMMARY ***
Total pot 0.53€ | Rake 0.06€
Board: [4d Jh 5s 3s 5h]
Seat 4: solver showed [Kh As] and lost with One pair : 5
Seat 5: gagnejamais4 showed [Js Qh] and won 0.53€ with Two pairs : Jacks and 5


Winamax Poker - HOLD-UP "Colorado" - HandId: #19116069-313002-1701420705 - Holdem no limit (0.01€/0.02€) - 2023/12/01 08:51:45 UTC
Table: 'Colorado' 6-max (real money) Seat #6 is the button
Seat 1: Fried Berg (2.18€)
Seat 2: Tompahmax (1.36€)
Seat 3: Cejargordas (2.04€)
Seat 4: karma- (3.39€)
Seat 5: Baston57 (2.58€)
Seat 6: BrokBroken (3.99€)
*** ANTE/BLINDS ***
Fried Berg posts small blind 0.01€
Tompahmax posts big blind 0.02€
Dealt to Fried Berg [3s 6d]
*** PRE-FLOP *** 
Cejargordas folds
karma- raises 0.03€ to 0.05€
Baston57 calls 0.05€
BrokBroken calls 0.05€
Fried Berg folds
Tompahmax calls 0.03€
*** FLOP *** [9c 5s Kd]
Tompahmax checks
karma- bets 0.11€
Baston57 calls 0.11€
BrokBroken calls 0.11€
Tompahmax calls 0.11€
*** TURN *** [9c 5s Kd][5h]
Tompahmax checks
karma- bets 0.33€
Baston57 calls 0.33€
BrokBroken folds
Tompahmax folds
*** RIVER *** [9c 5s Kd 5h][6c]
karma- bets 0.50€
Baston57 calls 0.50€
*** SHOW DOWN ***
karma- shows [Kh Jh] (Two pairs : Kings and 5)
Baston57 shows [Kc Jd] (Two pairs : Kings and 5)
Baston57 collected 1.04€ from pot
karma- collected 1.04€ from pot
*** SUMMARY ***
Total pot 2.08€ | Rake 0.23€
Board: [9c 5s Kd 5h 6c]
Seat 4: karma- showed [Kh Jh] and won 1.04€ with Two pairs : Kings and 5
Seat 5: Baston57 showed [Kc Jd] and won 1.04€ with Two pairs : Kings and 5


Winamax Poker - HOLD-UP "Colorado" - HandId: #19116069-313003-1701420707 - Holdem no limit (0.01€/0.02€) - 2023/12/01 08:51:47 UTC
Table: 'Colorado' 6-max (real money) Seat #6 is the button
Seat 1: Cejargordas (2.04€)
Seat 2: vicieux59 (0.50€)
Seat 3: Justo_170382 (0.57€)
Seat 4: Fried Berg (2.17€)
Seat 5: CTMieuxAvant (2.27€)
Seat 6: oliveponcar (2.08€)
*** ANTE/BLINDS ***
Cejargordas posts small blind 0.01€
vicieux59 posts big blind 0.02€
Dealt to Fried Berg [2s Kh]
*** PRE-FLOP *** 
Justo_170382 folds
Fried Berg folds
CTMieuxAvant folds
oliveponcar folds
Cejargordas raises 0.02€ to 0.04€
vicieux59 calls 0.02€
*** FLOP *** [Qd 4s 8c]
Cejargordas checks
vicieux59 bets 0.08€
Cejargordas calls 0.08€
*** TURN *** [Qd 4s 8c][3s]
Cejargordas checks
vicieux59 bets 0.24€
Cejargordas raises 0.24€ to 0.48€
vicieux59 calls 0.14€ and is all-in
*** RIVER *** [Qd 4s 8c 3s][Ac]
*** SHOW DOWN ***
vicieux59 shows [4d 5d] (One pair : 4)
Cejargordas shows [Qh Kc] (One pair : Queens)
Cejargordas collected 1€ from pot
*** SUMMARY ***
Total pot 1€ | Rake 0.10€
Board: [Qd 4s 8c 3s Ac]
Seat 1: Cejargordas (small blind) showed [Qh Kc] and won 1€ with One pair : Queens
Seat 2: vicieux59 (big blind) showed [4d 5d] and lost with One pair : 4


Winamax Poker - HOLD-UP "Colorado" - HandId: #19116069-313008-1701420711 - Holdem no limit (0.01€/0.02€) - 2023/12/01 08:51:51 UTC
Table: 'Colorado' 6-max (real money) Seat #6 is the button
Seat 1: Dovisclaire (0.69€)
Seat 2: oliveponcar (2.08€)
Seat 3: CTMieuxAvant (2.27€)
Seat 4: haamataraa (2.25€)
Seat 5: Davut 18 (0.66€)
Seat 6: Fried Berg (2.17€)
*** ANTE/BLINDS ***
Dovisclaire posts small blind 0.01€
oliveponcar posts big blind 0.02€
Dealt to Fried Berg [8d Kh]
*** PRE-FLOP *** 
CTMieuxAvant folds
haamataraa folds
Davut 18 folds
Fried Berg raises 0.02€ to 0.04€
Dovisclaire calls 0.03€
oliveponcar folds
*** FLOP *** [4h 7h 7d]
Dovisclaire bets 0.03€
Fried Berg calls 0.03€
*** TURN *** [4h 7h 7d][Ts]
Dovisclaire checks
Fried Berg checks
*** RIVER *** [4h 7h 7d Ts][Jd]
Dovisclaire bets 0.06€
Fried Berg folds
Dovisclaire collected 0.20€ from pot
*** SUMMARY ***
Total pot 0.20€ | Rake 0.02€
Board: [4h 7h 7d Ts Jd]
Seat 1: Dovisclaire (small blind) won 0.20€


Winamax Poker - HOLD-UP "Colorado" - HandId: #19116069-313052-1701420776 - Holdem no limit (0.01€/0.02€) - 2023/12/01 08:52:56 UTC
Table: 'Colorado' 6-max (real money) Seat #6 is the button
Seat 1: DDDIEU33 (2.90€)
Seat 2: LimpDoud (3.91€)
Seat 3: Cejargordas (3.32€)
Seat 4: Aggro Loser (2€)
Seat 5: Fried Berg (2.10€)
Seat 6: lut1dupoivre (0.54€)
*** ANTE/BLINDS ***
DDDIEU33 posts small blind 0.01€
LimpDoud posts big blind 0.02€
Dealt to Fried Berg [7s 3s]
*** PRE-FLOP *** 
Cejargordas folds
Aggro Loser folds
Fried Berg folds
lut1dupoivre folds
DDDIEU33 folds
LimpDoud collected 0.03€ from pot
*** SUMMARY ***
Total pot 0.03€ | No rake
Seat 2: LimpDoud (big blind) won 0.03€


Winamax Poker - HOLD-UP "Colorado" - HandId: #19116069-313056-1701420780 - Holdem no limit (0.01€/0.02€) - 2023/12/01 08:53:00 UTC
Table: 'Colorado' 6-max (real money) Seat #6 is the button
Seat 1: Cejargordas (3.32€)
Seat 2: KON-2-PEUTE (2€)
Seat 3: fxuscvl21 (1.91€)
Seat 4: lut1dupoivre (0.54€)
Seat 5: Fried Berg (2.10€)
Seat 6: Goldinher (1.37€)
*** ANTE/BLINDS ***
Cejargordas posts small blind 0.01€
KON-2-PEUTE posts big blind 0.02€
Dealt to Fried Berg [Th 8d]
*** PRE-FLOP *** 
fxuscvl21 calls 0.02€
lut1dupoivre folds
Fried Berg folds
Goldinher folds
Cejargordas raises 0.07€ to 0.09€
KON-2-PEUTE calls 0.07€
fxuscvl21 calls 0.07€
*** FLOP *** [4c Jh 4s]
Cejargordas bets 0.14€
KON-2-PEUTE folds
fxuscvl21 folds
Cejargordas collected 0.38€ from pot
*** SUMMARY ***
Total pot 0.38€ | Rake 0.03€
Board: [4c Jh 4s]
Seat 1: Cejargordas (small blind) won 0.38€


Winamax Poker - HOLD-UP "Colorado" - HandId: #19116069-313061-1701420786 - Holdem no limit (0.01€/0.02€) - 2023/12/01 08:53:06 UTC
Table: 'Colorado' 6-max (real money) Seat #6 is the button
Seat 1: Fried Berg (2.10€)
Seat 2: KKamarAAde (2.64€)
Seat 3: PaitOn (3.63€)
Seat 4: DDDIEU33 (2.87€)
Seat 5: BrokBroken (2€)
Seat 6: lut1dupoivre (0.53€)
*** ANTE/BLINDS ***
Fried Berg posts small blind 0.01€
KKamarAAde posts big blind 0.02€
Dealt to Fried Berg [Qs 7h]
*** PRE-FLOP *** 
PaitOn folds
DDDIEU33 calls 0.02€
BrokBroken folds
lut1dupoivre folds
Fried Berg folds
KKamarAAde checks
*** FLOP *** [Ah Kh 7d]
KKamarAAde checks
DDDIEU33 checks
*** TURN *** [Ah Kh 7d][Ad]
KKamarAAde checks
DDDIEU33 checks
*** RIVER *** [Ah Kh 7d Ad][2s]
KKamarAAde checks
DDDIEU33 checks
*** SHOW DOWN ***
KKamarAAde shows [3c 9h] (One pair : Aces)
DDDIEU33 shows [4h 4d] (Two pairs : Aces and 4)
DDDIEU33 collected 0.04€ from pot
*** SUMMARY ***
Total pot 0.04€ | Rake 0.01€
Board: [Ah Kh 7d Ad 2s]
Seat 2: KKamarAAde (big blind) showed [3c 9h] and lost with One pair : Aces
Seat 4: DDDIEU33 showed [4h 4d] and won 0.04€ with Two pairs : Aces and 4


Winamax Poker - HOLD-UP "Colorado" - HandId: #19116069-313068-1701420795 - Holdem no limit (0.01€/0.02€) - 2023/12/01 08:53:15 UTC
Table: 'Colorado' 6-max (real money) Seat #6 is the button
Seat 1: Odette1948 (0.51€)
Seat 2: Fried Berg (2.09€)
Seat 3: DigBick99 (3.98€)
Seat 4: vicieux59 (0.50€)
Seat 5: pivert 83 (1.62€)
Seat 6: corm973 (1.88€)
*** ANTE/BLINDS ***
Odette1948 posts small blind 0.01€
Fried Berg posts big blind 0.02€
Dealt to Fried Berg [Jc 5s]
*** PRE-FLOP *** 
DigBick99 folds
vicieux59 raises 0.03€ to 0.05€
pivert 83 folds
corm973 folds
Odette1948 folds
Fried Berg folds
vicieux59 collected 0.08€ from pot
*** SUMMARY ***
Total pot 0.08€ | No rake
Seat 4: vicieux59 won 0.08€


Winamax Poker - HOLD-UP "Colorado" - HandId: #19116069-313071-1701420798 - Holdem no limit (0.01€/0.02€) - 2023/12/01 08:53:18 UTC
Table: 'Colorado' 6-max (real money) Seat #6 is the button
Seat 1: Baston57 (2.63€)
Seat 2: karma- (3.44€)
Seat 3: Aggro Loser (2€)
Seat 4: Fried Berg (2.07€)
Seat 5: Tompahmax (2.41€)
Seat 6: DigBick99 (3.98€)
*** ANTE/BLINDS ***
Baston57 posts small blind 0.01€
karma- posts big blind 0.02€
Dealt to Fried Berg [Qh 6h]
*** PRE-FLOP *** 
Aggro Loser folds
Fried Berg folds
Tompahmax folds
DigBick99 folds
Baston57 folds
karma- collected 0.03€ from pot
*** SUMMARY ***
Total pot 0.03€ | No rake
Seat 2: karma- (big blind) won 0.03€


Winamax Poker - HOLD-UP "Colorado" - HandId: #19116069-313075-1701420802 - Holdem no limit (0.01€/0.02€) - 2023/12/01 08:53:22 UTC
Table: 'Colorado' 6-max (real money) Seat #6 is the button
Seat 1: DigBick99 (3.06€)
Seat 2: corm973 (1.88€)
Seat 3: Fried Berg (2.07€)
Seat 4: Odette1948 (0.50€)
Seat 5: Aggro Loser (2€)
Seat 6: Baston57 (2.62€)
*** ANTE/BLINDS ***
DigBick99 posts small blind 0.01€
corm973 posts big blind 0.02€
Dealt to Fried Berg [Td 4d]
*** PRE-FLOP *** 
Fried Berg folds
Odette1948 folds
Aggro Loser folds
Baston57 folds
DigBick99 raises 0.04€ to 0.06€
corm973 folds
DigBick99 collected 0.08€ from pot
*** SUMMARY ***
Total pot 0.08€ | No rake
Seat 1: DigBick99 (small blind) won 0.08€


Winamax Poker - HOLD-UP "Colorado" - HandId: #19116069-313078-1701420805 - Holdem no limit (0.01€/0.02€) - 2023/12/01 08:53:25 UTC
Table: 'Colorado' 6-max (real money) Seat #6 is the button
Seat 1: stuart79 (2.36€)
Seat 2: Baston57 (2.62€)
Seat 3: karma- (3.45€)
Seat 4: Tiken04 (2.03€)
Seat 5: Odette1948 (0.50€)
Seat 6: Fried Berg (2.07€)
*** ANTE/BLINDS ***
stuart79 posts small blind 0.01€
Baston57 posts big blind 0.02€
Dealt to Fried Berg [Tc 9s]
*** PRE-FLOP *** 
karma- folds
Tiken04 folds
Odette1948 folds
Fried Berg raises 0.02€ to 0.04€
stuart79 calls 0.03€
Baston57 folds
*** FLOP *** [2c 7h 8d]
stuart79 checks
Fried Berg checks
*** TURN *** [2c 7h 8d][Ts]
stuart79 checks
Fried Berg checks
*** RIVER *** [2c 7h 8d Ts][Kh]
stuart79 bets 0.03€
Fried Berg calls 0.03€
*** SHOW DOWN ***
stuart79 shows [Ah Qs] (High card : Ace)
Fried Berg shows [Tc 9s] (One pair : Tens)
Fried Berg collected 0.14€ from pot
*** SUMMARY ***
Total pot 0.14€ | Rake 0.02€
Board: [2c 7h 8d Ts Kh]
Seat 1: stuart79 (small blind) showed [Ah Qs] and lost with High card : Ace
Seat 6: Fried Berg (button) showed [Tc 9s] and won 0.14€ with One pair : Tens


Winamax Poker - HOLD-UP "Colorado" - HandId: #19116069-313101-1701420836 - Holdem no limit (0.01€/0.02€) - 2023/12/01 08:53:56 UTC
Table: 'Colorado' 6-max (real money) Seat #6 is the button
Seat 1: Coolax3019 (1.97€)
Seat 2: PIQSOU (2€)
Seat 3: Fried Berg (2.14€)
Seat 4: stuart79 (2.29€)
Seat 5: Cejargordas (3.48€)
Seat 6: oliveponcar (2.02€)
*** ANTE/BLINDS ***
Coolax3019 posts small blind 0.01€
PIQSOU posts big blind 0.02€
Dealt to Fried Berg [Qc 3c]
*** PRE-FLOP *** 
Fried Berg folds
stuart79 folds
Cejargordas raises 0.04€ to 0.06€
oliveponcar calls 0.06€
Coolax3019 raises 1.91€ to 1.97€ and is all-in
PIQSOU folds
Cejargordas folds
oliveponcar folds
Coolax3019 collected 2.11€ from pot
*** SUMMARY ***
Total pot 2.11€ | No rake
Seat 1: Coolax3019 (small blind) won 2.11€


Winamax Poker - HOLD-UP "Colorado" - HandId: #19116069-313105-1701420840 - Holdem no limit (0.01€/0.02€) - 2023/12/01 08:54:00 UTC
Table: 'Colorado' 6-max (real money) Seat #6 is the button
Seat 1: Fried Berg (2.14€)
Seat 2: BrokBroken (2.23€)
Seat 3: DigBick99 (3.08€)
Seat 4: Ju89400 (2.77€)
Seat 5: tichettede3 (2€)
Seat 6: stuart79 (2.29€)
*** ANTE/BLINDS ***
Fried Berg posts small blind 0.01€
BrokBroken posts big blind 0.02€
Dealt to Fried Berg [Qd As]
*** PRE-FLOP *** 
DigBick99 folds
Ju89400 folds
tichettede3 folds
stuart79 folds
Fried Berg raises 0.02€ to 0.04€
BrokBroken folds
Fried Berg collected 0.06€ from pot
*** SUMMARY ***
Total pot 0.06€ | No rake
Seat 1: Fried Berg (small blind) won 0.06€


Winamax Poker - HOLD-UP "Colorado" - HandId: #19116069-313116-1701420857 - Holdem no limit (0.01€/0.02€) - 2023/12/01 08:54:17 UTC
Table: 'Colorado' 6-max (real money) Seat #6 is the button
Seat 1: Tiken04 (2€)
Seat 2: Aggro Loser (2€)
Seat 3: corm973 (1.77€)
Seat 4: BrokBroken (2.21€)
Seat 5: Fried Berg (2.16€)
Seat 6: KKamarAAde (2.54€)
*** ANTE/BLINDS ***
Tiken04 posts small blind 0.01€
Aggro Loser posts big blind 0.02€
Dealt to Fried Berg [Qd Jc]
*** PRE-FLOP *** 
corm973 folds
BrokBroken folds
Fried Berg raises 0.04€ to 0.06€
KKamarAAde folds
Tiken04 folds
Aggro Loser folds
Fried Berg collected 0.09€ from pot
*** SUMMARY ***
Total pot 0.09€ | No rake
Seat 5: Fried Berg won 0.09€


Winamax Poker - HOLD-UP "Colorado" - HandId: #19116069-313129-1701420871 - Holdem no limit (0.01€/0.02€) - 2023/12/01 08:54:31 UTC
Table: 'Colorado' 6-max (real money) Seat #6 is the button
Seat 1: Aggro Loser (2€)
Seat 2: Fried Berg (2.19€)
Seat 3: _Lilli Rush (2.98€)
Seat 4: KKamarAAde (2.71€)
Seat 5: corm973 (1.64€)
Seat 6: Halmosthard (2.01€)
*** ANTE/BLINDS ***
Aggro Loser posts small blind 0.01€
Fried Berg posts big blind 0.02€
Dealt to Fried Berg [7s 5c]
*** PRE-FLOP *** 
_Lilli Rush folds
KKamarAAde folds
corm973 folds
Halmosthard folds
Aggro Loser folds
Fried Berg collected 0.03€ from pot
*** SUMMARY ***
Total pot 0.03€ | No rake
Seat 2: Fried Berg (big blind) won 0.03€


Winamax Poker - HOLD-UP "Colorado" - HandId: #19116069-313143-1701420885 - Holdem no limit (0.01€/0.02€) - 2023/12/01 08:54:45 UTC
Table: 'Colorado' 6-max (real money) Seat #6 is the button
Seat 1: tichettede3 (3.01€)
Seat 2: Aggro Loser (2€)
Seat 3: LilRun (1.56€)
Seat 4: Fried Berg (2.20€)
Seat 5: SashaTDouss (2.68€)
Seat 6: KKamarAAde (2.53€)
*** ANTE/BLINDS ***
tichettede3 posts small blind 0.01€
Aggro Loser posts big blind 0.02€
Dealt to Fried Berg [3d 3h]
*** PRE-FLOP *** 
LilRun raises 0.04€ to 0.06€
Fried Berg folds
SashaTDouss folds
KKamarAAde folds
tichettede3 calls 0.05€
Aggro Loser folds
*** FLOP *** [Th 9h Tc]
tichettede3 checks
LilRun bets 0.05€
tichettede3 calls 0.05€
*** TURN *** [Th 9h Tc][8h]
tichettede3 checks
LilRun bets 0.08€
tichettede3 folds
LilRun collected 0.30€ from pot
*** SUMMARY ***
Total pot 0.30€ | Rake 0.02€
Board: [Th 9h Tc 8h]
Seat 3: LilRun won 0.30€


Winamax Poker - HOLD-UP "Colorado" - HandId: #19116069-313147-1701420890 - Holdem no limit (0.01€/0.02€) - 2023/12/01 08:54:50 UTC
Table: 'Colorado' 6-max (real money) Seat #6 is the button
Seat 1: Davut 18 (1.02€)
Seat 2: oliveponcar (3.44€)
Seat 3: SashaTDouss (2.68€)
Seat 4: corm973 (1.84€)
Seat 5: haouuum28 (1.05€)
Seat 6: Fried Berg (2.20€)
*** ANTE/BLINDS ***
Davut 18 posts small blind 0.01€
oliveponcar posts big blind 0.02€
Dealt to Fried Berg [Ks Ah]
*** PRE-FLOP *** 
SashaTDouss folds
corm973 folds
haouuum28 folds
Fried Berg raises 0.02€ to 0.04€
Davut 18 calls 0.03€
oliveponcar folds
*** FLOP *** [4h As Tc]
Davut 18 checks
Fried Berg checks
*** TURN *** [4h As Tc][Kc]
Davut 18 checks
Fried Berg bets 0.02€
Davut 18 calls 0.02€
*** RIVER *** [4h As Tc Kc][6s]
Davut 18 bets 0.09€
Fried Berg calls 0.09€
*** SHOW DOWN ***
Fried Berg shows [Ks Ah] (Two pairs : Aces and Kings)
Davut 18 shows [Js Qc] (Straight Ace high)
Davut 18 collected 0.29€ from pot
*** SUMMARY ***
Total pot 0.29€ | Rake 0.03€
Board: [4h As Tc Kc 6s]
Seat 1: Davut 18 (small blind) showed [Js Qc] and won 0.29€ with Straight Ace high
Seat 6: Fried Berg (button) showed [Ks Ah] and lost with Two pairs : Aces and Kings


Winamax Poker - HOLD-UP "Colorado" - HandId: #19116069-313184-1701420944 - Holdem no limit (0.01€/0.02€) - 2023/12/01 08:55:44 UTC
Table: 'Colorado' 6-max (real money) Seat #6 is the button
Seat 1: l artiste ho (1.82€)
Seat 2: pivert 83 (1.47€)
Seat 3: Davut 18 (1.16€)
Seat 4: oliveponcar (4.60€)
Seat 5: Fried Berg (2.05€)
Seat 6: KKamarAAde (9.76€)
*** ANTE/BLINDS ***
l artiste ho posts small blind 0.01€
pivert 83 posts big blind 0.02€
Dealt to Fried Berg [9h 4c]
*** PRE-FLOP *** 
Davut 18 folds
oliveponcar folds
Fried Berg folds
KKamarAAde folds
l artiste ho folds
pivert 83 collected 0.03€ from pot
*** SUMMARY ***
Total pot 0.03€ | No rake
Seat 2: pivert 83 (big blind) won 0.03€


Winamax Poker - HOLD-UP "Colorado" - HandId: #19116069-313187-1701420950 - Holdem no limit (0.01€/0.02€) - 2023/12/01 08:55:50 UTC
Table: 'Colorado' 6-max (real money) Seat #6 is the button
Seat 1: Fried Berg (2.05€)
Seat 2: oliveponcar (4.60€)
Seat 3: KKamarAAde (9.76€)
Seat 4: stuart79 (2.43€)
Seat 5: adela7386 (0.39€)
Seat 6: Remy_Lord265 (0.37€)
*** ANTE/BLINDS ***
Fried Berg posts small blind 0.01€
oliveponcar posts big blind 0.02€
Dealt to Fried Berg [Ts 6d]
*** PRE-FLOP *** 
KKamarAAde folds
stuart79 folds
adela7386 raises 0.03€ to 0.05€
Remy_Lord265 folds
Fried Berg folds
oliveponcar raises 4.55€ to 4.60€ and is all-in
adela7386 calls 0.34€ and is all-in
*** FLOP *** [4c 8c 5s]
*** TURN *** [4c 8c 5s][4h]
*** RIVER *** [4c 8c 5s 4h][7d]
*** SHOW DOWN ***
adela7386 shows [Qh Tc] (One pair : 4)
oliveponcar shows [Ks Kc] (Two pairs : Kings and 4)
oliveponcar collected 4.92€ from pot
*** SUMMARY ***
Total pot 4.92€ | Rake 0.08€
Board: [4c 8c 5s 4h 7d]
Seat 2: oliveponcar (big blind) showed [Ks Kc] and won 4.92€ with Two pairs : Kings and 4
Seat 5: adela7386 showed [Qh Tc] and lost with One pair : 4


Winamax Poker - HOLD-UP "Colorado" - HandId: #19116069-313195-1701420958 - Holdem no limit (0.01€/0.02€) - 2023/12/01 08:55:58 UTC
Table: 'Colorado' 6-max (real money) Seat #6 is the button
Seat 1: pivert 83 (1.48€)
Seat 2: PIQSOU (2€)
Seat 3: Fried Berg (2.04€)
Seat 4: DigBick99 (3.12€)
Seat 5: KKamarAAde (9.76€)
Seat 6: roneward (1.17€)
*** ANTE/BLINDS ***
pivert 83 posts small blind 0.01€
PIQSOU posts big blind 0.02€
Dealt to Fried Berg [4h 6s]
*** PRE-FLOP *** 
Fried Berg folds
DigBick99 folds
KKamarAAde folds
roneward calls 0.02€
pivert 83 folds
PIQSOU checks
*** FLOP *** [3d 7c Qd]
PIQSOU checks
roneward checks
*** TURN *** [3d 7c Qd][Ks]
PIQSOU checks
roneward checks
*** RIVER *** [3d 7c Qd Ks][9d]
PIQSOU checks
roneward checks
*** SHOW DOWN ***
PIQSOU shows [Ts 4d] (High card : King)
roneward shows [Ac 3c] (One pair : 3)
roneward collected 0.04€ from pot
*** SUMMARY ***
Total pot 0.04€ | Rake 0.01€
Board: [3d 7c Qd Ks 9d]
Seat 2: PIQSOU (big blind) showed [Ts 4d] and lost with High card : King
Seat 6: roneward (button) showed [Ac 3c] and won 0.04€ with One pair : 3


Winamax Poker - HOLD-UP "Colorado" - HandId: #19116069-313199-1701420961 - Holdem no limit (0.01€/0.02€) - 2023/12/01 08:56:01 UTC
Table: 'Colorado' 6-max (real money) Seat #6 is the button
Seat 1: KKamarAAde (9.76€)
Seat 2: Fried Berg (2.04€)
Seat 3: MoneyGrowing (2.50€)
Seat 4: pivert 83 (1.47€)
Seat 5: KingSoto (2€)
Seat 6: DigBick99 (3.12€)
*** ANTE/BLINDS ***
KKamarAAde posts small blind 0.01€
Fried Berg posts big blind 0.02€
Dealt to Fried Berg [7s Qs]
*** PRE-FLOP *** 
MoneyGrowing folds
pivert 83 folds
KingSoto raises 0.04€ to 0.06€
DigBick99 folds
KKamarAAde folds
Fried Berg calls 0.04€
*** FLOP *** [4h Kd Ad]
Fried Berg checks
KingSoto bets 0.13€
Fried Berg folds
KingSoto collected 0.25€ from pot
*** SUMMARY ***
Total pot 0.25€ | Rake 0.01€
Board: [4h Kd Ad]
Seat 5: KingSoto won 0.25€


Winamax Poker - HOLD-UP "Colorado" - HandId: #19116069-313221-1701420984 - Holdem no limit (0.01€/0.02€) - 2023/12/01 08:56:24 UTC
Table: 'Colorado' 6-max (real money) Seat #6 is the button
Seat 1: KKamarAAde (4.22€)
Seat 2: gagnejamais4 (2€)
Seat 3: Baston57 (2.58€)
Seat 4: DoNPaPaMaSS (4.46€)
Seat 5: LilRun (1.59€)
Seat 6: Fried Berg (1.98€)
Hold-up to Pot: total 0.10€
*** ANTE/BLINDS ***
KKamarAAde posts small blind 0.01€
gagnejamais4 posts big blind 0.02€
Dealt to Fried Berg [Qd 2d]
*** PRE-FLOP *** 
Baston57 raises 0.03€ to 0.05€
DoNPaPaMaSS folds
LilRun folds
Fried Berg calls 0.05€
KKamarAAde folds
gagnejamais4 raises 0.10€ to 0.15€
Baston57 calls 0.10€
Fried Berg folds
*** FLOP *** [6s 6c 7c]
gagnejamais4 bets 0.30€
Baston57 calls 0.30€
*** TURN *** [6s 6c 7c][9h]
gagnejamais4 checks
Baston57 bets 0.37€
gagnejamais4 calls 0.37€
*** RIVER *** [6s 6c 7c 9h][Tc]
gagnejamais4 checks
Baston57 bets 1.76€ and is all-in
gagnejamais4 folds
Baston57 collected 3.39€ from pot
*** SUMMARY ***
Total pot 3.39€ | Rake 0.17€
Board: [6s 6c 7c 9h Tc]
Seat 3: Baston57 won 3.39€


Winamax Poker - HOLD-UP "Colorado" - HandId: #19116069-313271-1701421035 - Holdem no limit (0.01€/0.02€) - 2023/12/01 08:57:15 UTC
Table: 'Colorado' 6-max (real money) Seat #6 is the button
Seat 1: KKamarAAde (2.31€)
Seat 2: haouuum28 (4.57€)
Seat 3: Baston57 (3.39€)
Seat 4: Aggro Loser (2€)
Seat 5: Fried Berg (1.93€)
Seat 6: Hydramist (2.10€)
*** ANTE/BLINDS ***
KKamarAAde posts small blind 0.01€
haouuum28 posts big blind 0.02€
Dealt to Fried Berg [Jc Jh]
*** PRE-FLOP *** 
Baston57 folds
Aggro Loser raises 0.03€ to 0.05€
Fried Berg raises 0.03€ to 0.08€
Hydramist folds
KKamarAAde folds
haouuum28 folds
Aggro Loser raises 0.12€ to 0.20€
Fried Berg calls 0.12€
*** FLOP *** [8d 3d 8s]
Aggro Loser bets 0.11€
Fried Berg calls 0.11€
*** TURN *** [8d 3d 8s][4c]
Aggro Loser checks
Fried Berg checks
*** RIVER *** [8d 3d 8s 4c][6d]
Aggro Loser checks
Fried Berg checks
*** SHOW DOWN ***
Aggro Loser shows [Ks Ac] (One pair : 8)
Fried Berg shows [Jc Jh] (Two pairs : Jacks and 8)
Fried Berg collected 0.58€ from pot
*** SUMMARY ***
Total pot 0.58€ | Rake 0.07€
Board: [8d 3d 8s 4c 6d]
Seat 4: Aggro Loser showed [Ks Ac] and lost with One pair : 8
Seat 5: Fried Berg showed [Jc Jh] and won 0.58€ with Two pairs : Jacks and 8


Winamax Poker - HOLD-UP "Colorado" - HandId: #19116069-313318-1701421085 - Holdem no limit (0.01€/0.02€) - 2023/12/01 08:58:05 UTC
Table: 'Colorado' 6-max (real money) Seat #6 is the button
Seat 1: pivert 83 (1.42€)
Seat 2: Baston57 (3.39€)
Seat 3: Fried Berg (2.20€)
Seat 4: Goldinher (1€)
Seat 5: PIQSOU (2€)
Seat 6: VashtaNerada (5.93€)
Hold-up to Pot: total 0.10€
*** ANTE/BLINDS ***
pivert 83 posts small blind 0.01€
Baston57 posts big blind 0.02€
Dealt to Fried Berg [Kh 3h]
*** PRE-FLOP *** 
Fried Berg folds
Goldinher calls 0.02€
PIQSOU folds
VashtaNerada folds
pivert 83 calls 0.01€
Baston57 checks
*** FLOP *** [9h As 5c]
pivert 83 checks
Baston57 bets 0.10€
Goldinher folds
pivert 83 folds
Baston57 collected 0.25€ from pot
*** SUMMARY ***
Total pot 0.25€ | Rake 0.01€
Board: [9h As 5c]
Seat 2: Baston57 (big blind) won 0.25€


Winamax Poker - HOLD-UP "Colorado" - HandId: #19116069-313326-1701421092 - Holdem no limit (0.01€/0.02€) - 2023/12/01 08:58:12 UTC
Table: 'Colorado' 6-max (real money) Seat #6 is the button
Seat 1: Aggro Loser (2€)
Seat 2: _Lilli Rush (2.61€)
Seat 3: l artiste ho (1.54€)
Seat 4: Fried Berg (2.20€)
Seat 5: KKamarAAde (2.69€)
Seat 6: Tompahmax (1.61€)
*** ANTE/BLINDS ***
Aggro Loser posts small blind 0.01€
_Lilli Rush posts big blind 0.02€
Dealt to Fried Berg [6h 2c]
*** PRE-FLOP *** 
l artiste ho folds
Fried Berg folds
KKamarAAde raises 0.04€ to 0.06€
Tompahmax folds
Aggro Loser folds
_Lilli Rush calls 0.04€
*** FLOP *** [6d 4d 7d]
_Lilli Rush checks
KKamarAAde checks
*** TURN *** [6d 4d 7d][Ah]
_Lilli Rush checks
KKamarAAde checks
*** RIVER *** [6d 4d 7d Ah][Jd]
_Lilli Rush checks
KKamarAAde checks
*** SHOW DOWN ***
_Lilli Rush shows [8s Kh] (High card : Ace)
KKamarAAde shows [Qc Jc] (One pair : Jacks)
KKamarAAde collected 0.12€ from pot
*** SUMMARY ***
Total pot 0.12€ | Rake 0.01€
Board: [6d 4d 7d Ah Jd]
Seat 2: _Lilli Rush (big blind) showed [8s Kh] and lost with High card : Ace
Seat 5: KKamarAAde showed [Qc Jc] and won 0.12€ with One pair : Jacks


Winamax Poker - HOLD-UP "Colorado" - HandId: #19116069-313333-1701421095 - Holdem no limit (0.01€/0.02€) - 2023/12/01 08:58:15 UTC
Table: 'Colorado' 6-max (real money) Seat #6 is the button
Seat 1: Fried Berg (2.20€)
Seat 2: haouuum28 (1.14€)
Seat 3: Tompahmax (1.61€)
Seat 4: KON-2-PEUTE (2.14€)
Seat 5: oliveponcar (2.28€)
Seat 6: stuart79 (2.68€)
Hold-up to Pot: total 0.20€
*** ANTE/BLINDS ***
Fried Berg posts small blind 0.01€
haouuum28 posts big blind 0.02€
Dealt to Fried Berg [7c 9s]
*** PRE-FLOP *** 
Tompahmax folds
KON-2-PEUTE raises 0.03€ to 0.05€
oliveponcar calls 0.05€
stuart79 calls 0.05€
Fried Berg calls 0.04€
haouuum28 calls 0.03€
*** FLOP *** [8c 5c 2c]
Fried Berg checks
haouuum28 checks
KON-2-PEUTE checks
oliveponcar bets 0.29€
stuart79 raises 0.29€ to 0.58€
Fried Berg folds
haouuum28 folds
KON-2-PEUTE folds
oliveponcar calls 0.29€
*** TURN *** [8c 5c 2c][Ah]
oliveponcar checks
stuart79 bets 0.56€
oliveponcar calls 0.56€
*** RIVER *** [8c 5c 2c Ah][6h]
oliveponcar checks
stuart79 bets 1.49€ and is all-in
oliveponcar calls 1.09€ and is all-in
*** SHOW DOWN ***
oliveponcar shows [2h 2s] (Trips of 2)
stuart79 shows [6c Ac] (Flush Ace high)
stuart79 collected 4.84€ from pot
*** SUMMARY ***
Total pot 4.84€ | Rake 0.47€
Board: [8c 5c 2c Ah 6h]
Seat 5: oliveponcar showed [2h 2s] and lost with Trips of 2
Seat 6: stuart79 (button) showed [6c Ac] and won 4.84€ with Flush Ace high


Winamax Poker - HOLD-UP "Colorado" - HandId: #19116069-313409-1701421186 - Holdem no limit (0.01€/0.02€) - 2023/12/01 08:59:46 UTC
Table: 'Colorado' 6-max (real money) Seat #6 is the button
Seat 1: Halmosthard (3.47€)
Seat 2: Fried Berg (2.15€)
Seat 3: Elyotony57 (0.50€)
Seat 4: stuart79 (4.84€)
Seat 5: oliveponcar (2€)
Seat 6: KKamarAAde (3.16€)
*** ANTE/BLINDS ***
Halmosthard posts small blind 0.01€
Fried Berg posts big blind 0.02€
Dealt to Fried Berg [As Kd]
*** PRE-FLOP *** 
Elyotony57 folds
stuart79 raises 0.04€ to 0.06€
oliveponcar folds
KKamarAAde folds
Halmosthard calls 0.05€
Fried Berg calls 0.04€
*** FLOP *** [9s 4h 4s]
Halmosthard checks
Fried Berg checks
stuart79 bets 0.06€
Halmosthard folds
Fried Berg calls 0.06€
*** TURN *** [9s 4h 4s][Jc]
Fried Berg checks
stuart79 bets 0.11€
Fried Berg calls 0.11€
*** RIVER *** [9s 4h 4s Jc][Ts]
Fried Berg checks
stuart79 checks
*** SHOW DOWN ***
Fried Berg shows [As Kd] (One pair : 4)
stuart79 shows [8c 8h] (Two pairs : 8 and 4)
stuart79 collected 0.47€ from pot
*** SUMMARY ***
Total pot 0.47€ | Rake 0.05€
Board: [9s 4h 4s Jc Ts]
Seat 2: Fried Berg (big blind) showed [As Kd] and lost with One pair : 4
Seat 4: stuart79 showed [8c 8h] and won 0.47€ with Two pairs : 8 and 4


Winamax Poker - HOLD-UP "Colorado" - HandId: #19116069-313456-1701421234 - Holdem no limit (0.01€/0.02€) - 2023/12/01 09:00:34 UTC
Table: 'Colorado' 6-max (real money) Seat #6 is the button
Seat 1: Hydramist (2.27€)
Seat 2: timePLZ (2.05€)
Seat 3: Polanskii (3.05€)
Seat 4: Fried Berg (1.92€)
Seat 5: MoneyGrowing (2.51€)
Seat 6: KKamarAAde (2.85€)
*** ANTE/BLINDS ***
Hydramist posts small blind 0.01€
timePLZ posts big blind 0.02€
Dealt to Fried Berg [9s Th]
*** PRE-FLOP *** 
Polanskii folds
Fried Berg folds
MoneyGrowing folds
KKamarAAde folds
Hydramist folds
timePLZ collected 0.03€ from pot
*** SUMMARY ***
Total pot 0.03€ | No rake
Seat 2: timePLZ (big blind) won 0.03€


Winamax Poker - HOLD-UP "Colorado" - HandId: #19116069-313462-1701421238 - Holdem no limit (0.01€/0.02€) - 2023/12/01 09:00:38 UTC
Table: 'Colorado' 6-max (real money) Seat #6 is the button
Seat 1: 1LEOPARDO (1.92€)
Seat 2: stuart79 (5.07€)
Seat 3: Halmosthard (2.30€)
Seat 4: VashtaNerada (5.99€)
Seat 5: Berig (1.95€)
Seat 6: Fried Berg (1.92€)
*** ANTE/BLINDS ***
1LEOPARDO posts small blind 0.01€
stuart79 posts big blind 0.02€
Dealt to Fried Berg [Jc Jd]
*** PRE-FLOP *** 
Halmosthard folds
VashtaNerada folds
Berig folds
Fried Berg raises 0.04€ to 0.06€
1LEOPARDO folds
stuart79 folds
Fried Berg collected 0.09€ from pot
*** SUMMARY ***
Total pot 0.09€ | No rake
Seat 6: Fried Berg (button) won 0.09€


Winamax Poker - HOLD-UP "Colorado" - HandId: #19116069-313483-1701421268 - Holdem no limit (0.01€/0.02€) - 2023/12/01 09:01:08 UTC
Table: 'Colorado' 6-max (real money) Seat #6 is the button
Seat 1: edfcain (2€)
Seat 2: Hydramist (2€)
Seat 3: pivert 83 (1.04€)
Seat 4: PaitOn (3.74€)
Seat 5: LilRun (3.92€)
Seat 6: Fried Berg (1.95€)
*** ANTE/BLINDS ***
edfcain posts small blind 0.01€
Hydramist posts big blind 0.02€
Dealt to Fried Berg [2d Jc]
*** PRE-FLOP *** 
pivert 83 folds
PaitOn raises 0.03€ to 0.05€
LilRun folds
Fried Berg folds
edfcain folds
Hydramist folds
PaitOn collected 0.08€ from pot
*** SUMMARY ***
Total pot 0.08€ | No rake
Seat 4: PaitOn won 0.08€


Winamax Poker - HOLD-UP "Colorado" - HandId: #19116069-313495-1701421285 - Holdem no limit (0.01€/0.02€) - 2023/12/01 09:01:25 UTC
Table: 'Colorado' 6-max (real money) Seat #6 is the button
Seat 1: KON-2-PEUTE (2.18€)
Seat 2: Tompahmax (1.77€)
Seat 3: Mercuryllo (3.21€)
Seat 4: Fried Berg (1.95€)
Seat 5: PIQSOU (2.05€)
Seat 6: KKamarAAde (3.15€)
*** ANTE/BLINDS ***
KON-2-PEUTE posts small blind 0.01€
Tompahmax posts big blind 0.02€
Dealt to Fried Berg [Jh 8h]
*** PRE-FLOP *** 
Mercuryllo folds
Fried Berg folds
PIQSOU folds
KKamarAAde folds
KON-2-PEUTE raises 0.03€ to 0.05€
Tompahmax calls 0.03€
*** FLOP *** [5c Jd Qd]
KON-2-PEUTE checks
Tompahmax checks
*** TURN *** [5c Jd Qd][4c]
KON-2-PEUTE checks
Tompahmax checks
*** RIVER *** [5c Jd Qd 4c][8c]
KON-2-PEUTE checks
Tompahmax checks
*** SHOW DOWN ***
Tompahmax shows [Ac 9h] (High card : Ace)
KON-2-PEUTE shows [Ks Ad] (High card : Ace)
KON-2-PEUTE collected 0.09€ from pot
*** SUMMARY ***
Total pot 0.09€ | Rake 0.01€
Board: [5c Jd Qd 4c 8c]
Seat 1: KON-2-PEUTE (small blind) showed [Ks Ad] and won 0.09€ with High card : Ace
Seat 2: Tompahmax (big blind) showed [Ac 9h] and lost with High card : Ace


Winamax Poker - HOLD-UP "Colorado" - HandId: #19116069-313503-1701421292 - Holdem no limit (0.01€/0.02€) - 2023/12/01 09:01:32 UTC
Table: 'Colorado' 6-max (real money) Seat #6 is the button
Seat 1: MoneyGrowing (2.48€)
Seat 2: alban158 (2€)
Seat 3: stuart79 (5.05€)
Seat 4: tichettede3 (3.43€)
Seat 5: Fried Berg (1.95€)
Seat 6: Gauthh7 (2.13€)
Hold-up to Pot: total 0.10€
*** ANTE/BLINDS ***
MoneyGrowing posts small blind 0.01€
alban158 posts big blind 0.02€
Dealt to Fried Berg [Kh Ad]
*** PRE-FLOP *** 
stuart79 folds
tichettede3 folds
Fried Berg raises 0.10€ to 0.12€
Gauthh7 raises 0.24€ to 0.36€
MoneyGrowing folds
alban158 folds
Fried Berg calls 0.24€
*** FLOP *** [8h 6d 7h]
Fried Berg checks
Gauthh7 bets 0.55€
Fried Berg calls 0.55€
*** TURN *** [8h 6d 7h][Kc]
Fried Berg checks
Gauthh7 checks
*** RIVER *** [8h 6d 7h Kc][Jc]
Fried Berg checks
Gauthh7 checks
*** SHOW DOWN ***
Gauthh7 shows [Jd Qs] (One pair : Jacks)
Fried Berg shows [Kh Ad] (One pair : Kings)
Fried Berg collected 1.76€ from pot
*** SUMMARY ***
Total pot 1.76€ | Rake 0.19€
Board: [8h 6d 7h Kc Jc]
Seat 5: Fried Berg showed [Kh Ad] and won 1.76€ with One pair : Kings
Seat 6: Gauthh7 (button) showed [Jd Qs] and lost with One pair : Jacks


Winamax Poker - HOLD-UP "Colorado" - HandId: #19116069-313567-1701421364 - Holdem no limit (0.01€/0.02€) - 2023/12/01 09:02:44 UTC
Table: 'Colorado' 6-max (real money) Seat #6 is the button
Seat 1: _Croute_ (2.91€)
Seat 2: Fried Berg (2.80€)
Seat 3: haouuum28 (1.30€)
Seat 4: Cejargordas (3.90€)
Seat 5: Manupoy (1.63€)
Seat 6: PIQSOU (2.01€)
*** ANTE/BLINDS ***
_Croute_ posts small blind 0.01€
Fried Berg posts big blind 0.02€
Dealt to Fried Berg [Qd Td]
*** PRE-FLOP *** 
haouuum28 folds
Cejargordas raises 0.04€ to 0.06€
Manupoy folds
PIQSOU calls 0.06€
_Croute_ folds
Fried Berg calls 0.04€
*** FLOP *** [3h 8h 3c]
Fried Berg checks
Cejargordas checks
PIQSOU bets 0.06€
Fried Berg calls 0.06€
Cejargordas folds
*** TURN *** [3h 8h 3c][8s]
Fried Berg checks
PIQSOU bets 0.23€
Fried Berg folds
PIQSOU collected 0.51€ from pot
*** SUMMARY ***
Total pot 0.51€ | Rake 0.03€
Board: [3h 8h 3c 8s]
Seat 6: PIQSOU (button) won 0.51€


Winamax Poker - HOLD-UP "Colorado" - HandId: #19116069-313641-1701421461 - Holdem no limit (0.01€/0.02€) - 2023/12/01 09:04:21 UTC
Table: 'Colorado' 6-max (real money) Seat #6 is the button
Seat 1: g8o8k8u (2.19€)
Seat 2: le-chartreux (2.07€)
Seat 3: Homer14510 (1.94€)
Seat 4: Lolo_Baff (0.47€)
Seat 5: Fried Berg (2.68€)
Seat 6: Manupoy (1.60€)
*** ANTE/BLINDS ***
g8o8k8u posts small blind 0.01€
le-chartreux posts big blind 0.02€
Dealt to Fried Berg [6d 4h]
*** PRE-FLOP *** 
Homer14510 folds
Lolo_Baff folds
Fried Berg folds
Manupoy calls 0.02€
g8o8k8u folds
le-chartreux checks
*** FLOP *** [7d 5d 4s]
le-chartreux checks
Manupoy bets 0.05€
le-chartreux calls 0.05€
*** TURN *** [7d 5d 4s][2c]
le-chartreux checks
Manupoy bets 0.05€
le-chartreux calls 0.05€
*** RIVER *** [7d 5d 4s 2c][As]
le-chartreux bets 0.13€
Manupoy calls 0.13€
*** SHOW DOWN ***
Manupoy shows [7s Ah] (Two pairs : Aces and 7)
le-chartreux shows [3d 9d] (Straight 5 high)
le-chartreux collected 0.46€ from pot
*** SUMMARY ***
Total pot 0.46€ | Rake 0.05€
Board: [7d 5d 4s 2c As]
Seat 2: le-chartreux (big blind) showed [3d 9d] and won 0.46€ with Straight 5 high
Seat 6: Manupoy (button) showed [7s Ah] and lost with Two pairs : Aces and 7


Winamax Poker - HOLD-UP "Colorado" - HandId: #19116069-313647-1701421466 - Holdem no limit (0.01€/0.02€) - 2023/12/01 09:04:26 UTC
Table: 'Colorado' 6-max (real money) Seat #6 is the button
Seat 1: Fried Berg (2.68€)
Seat 2: timePLZ (2.88€)
Seat 3: MoneyGrowing (2.50€)
Seat 4: g8o8k8u (2.18€)
Seat 5: Homer14510 (1.94€)
Seat 6: Jeje27 (6.54€)
*** ANTE/BLINDS ***
Fried Berg posts small blind 0.01€
timePLZ posts big blind 0.02€
Dealt to Fried Berg [Kd 4c]
*** PRE-FLOP *** 
MoneyGrowing raises 0.04€ to 0.06€
g8o8k8u folds
Homer14510 raises 0.09€ to 0.15€
Jeje27 folds
Fried Berg folds
timePLZ folds
MoneyGrowing folds
Homer14510 collected 0.24€ from pot
*** SUMMARY ***
Total pot 0.24€ | No rake
Seat 5: Homer14510 won 0.24€


Winamax Poker - HOLD-UP "Colorado" - HandId: #19116069-313670-1701421493 - Holdem no limit (0.01€/0.02€) - 2023/12/01 09:04:53 UTC
Table: 'Colorado' 6-max (real money) Seat #6 is the button
Seat 1: Lolo_Baff (0.45€)
Seat 2: KingSoto (2.44€)
Seat 3: Fried Berg (2.67€)
Seat 4: ninoujacou (1.58€)
Seat 5: PavuPapy87 (0.29€)
Seat 6: 1LEOPARDO (3.18€)
*** ANTE/BLINDS ***
Lolo_Baff posts small blind 0.01€
KingSoto posts big blind 0.02€
Dealt to Fried Berg [Th 6s]
*** PRE-FLOP *** 
Fried Berg folds
ninoujacou folds
PavuPapy87 calls 0.02€
1LEOPARDO raises 0.03€ to 0.05€
Lolo_Baff folds
KingSoto folds
PavuPapy87 calls 0.03€
*** FLOP *** [Kd 4h 5c]
PavuPapy87 bets 0.24€ and is all-in
1LEOPARDO calls 0.24€
*** TURN *** [Kd 4h 5c][Tc]
*** RIVER *** [Kd 4h 5c Tc][2h]
*** SHOW DOWN ***
PavuPapy87 shows [Jd Kc] (One pair : Kings)
1LEOPARDO shows [3c Ac] (Straight 5 high)
1LEOPARDO collected 0.55€ from pot
*** SUMMARY ***
Total pot 0.55€ | Rake 0.06€
Board: [Kd 4h 5c Tc 2h]
Seat 5: PavuPapy87 showed [Jd Kc] and lost with One pair : Kings
Seat 6: 1LEOPARDO (button) showed [3c Ac] and won 0.55€ with Straight 5 high


Winamax Poker - HOLD-UP "Colorado" - HandId: #19116069-313671-1701421495 - Holdem no limit (0.01€/0.02€) - 2023/12/01 09:04:55 UTC
Table: 'Colorado' 6-max (real money) Seat #6 is the button
Seat 1: Aggro Loser (2.01€)
Seat 2: haouuum28 (2.58€)
Seat 3: Baston57 (3.47€)
Seat 4: Fried Berg (2.67€)
Seat 5: oliveponcar (2.29€)
Seat 6: Tiken04 (2.57€)
*** ANTE/BLINDS ***
Aggro Loser posts small blind 0.01€
haouuum28 posts big blind 0.02€
Dealt to Fried Berg [As 3h]
*** PRE-FLOP *** 
Baston57 folds
Fried Berg folds
oliveponcar folds
Tiken04 raises 0.04€ to 0.06€
Aggro Loser folds
haouuum28 folds
Tiken04 collected 0.09€ from pot
*** SUMMARY ***
Total pot 0.09€ | No rake
Seat 6: Tiken04 (button) won 0.09€


Winamax Poker - HOLD-UP "Colorado" - HandId: #19116069-313676-1701421501 - Holdem no limit (0.01€/0.02€) - 2023/12/01 09:05:01 UTC
Table: 'Colorado' 6-max (real money) Seat #6 is the button
Seat 1: le-chartreux (2.28€)
Seat 2: Fried Berg (2.67€)
Seat 3: karma- (2.89€)
Seat 4: Baston57 (3.46€)
Seat 5: Aggro Loser (2€)
Seat 6: Hydramist (2€)
*** ANTE/BLINDS ***
le-chartreux posts small blind 0.01€
Fried Berg posts big blind 0.02€
Dealt to Fried Berg [As 8d]
*** PRE-FLOP *** 
karma- folds
Baston57 folds
Aggro Loser folds
Hydramist folds
le-chartreux folds
Fried Berg collected 0.03€ from pot
*** SUMMARY ***
Total pot 0.03€ | No rake
Seat 2: Fried Berg (big blind) won 0.03€


Winamax Poker - HOLD-UP "Colorado" - HandId: #19116069-313690-1701421517 - Holdem no limit (0.01€/0.02€) - 2023/12/01 09:05:17 UTC
Table: 'Colorado' 6-max (real money) Seat #6 is the button
Seat 1: le-chartreux (1.90€)
Seat 2: PIQSOU (2.13€)
Seat 3: Fried Berg (2.68€)
Seat 4: Polanskii (3.20€)
Seat 5: LilRun (3.03€)
Seat 6: karma- (5.06€)
*** ANTE/BLINDS ***
le-chartreux posts small blind 0.01€
PIQSOU posts big blind 0.02€
Dealt to Fried Berg [3c 4s]
*** PRE-FLOP *** 
Fried Berg folds
Polanskii raises 0.04€ to 0.06€
LilRun folds
karma- folds
le-chartreux folds
PIQSOU folds
Polanskii collected 0.09€ from pot
*** SUMMARY ***
Total pot 0.09€ | No rake
Seat 4: Polanskii won 0.09€


Winamax Poker - HOLD-UP "Colorado" - HandId: #19116069-313693-1701421519 - Holdem no limit (0.01€/0.02€) - 2023/12/01 09:05:19 UTC
Table: 'Colorado' 6-max (real money) Seat #6 is the button
Seat 1: Fried Berg (2.68€)
Seat 2: Tompahmax (1.49€)
Seat 3: TheRealWill (2€)
Seat 4: oliveponcar (5.17€)
Seat 5: LilRun (3.03€)
Seat 6: pivert 83 (1.66€)
*** ANTE/BLINDS ***
Fried Berg posts small blind 0.01€
Tompahmax posts big blind 0.02€
Dealt to Fried Berg [3c 8s]
*** PRE-FLOP *** 
TheRealWill raises 0.04€ to 0.06€
oliveponcar folds
LilRun calls 0.06€
pivert 83 calls 0.06€
Fried Berg folds
Tompahmax calls 0.04€
*** FLOP *** [4c 5h Qd]
Tompahmax checks
TheRealWill checks
LilRun checks
pivert 83 bets 0.25€
Tompahmax folds
TheRealWill folds
LilRun folds
pivert 83 collected 0.47€ from pot
*** SUMMARY ***
Total pot 0.47€ | Rake 0.03€
Board: [4c 5h Qd]
Seat 6: pivert 83 (button) won 0.47€


Winamax Poker - HOLD-UP "Colorado" - HandId: #19116069-313698-1701421523 - Holdem no limit (0.01€/0.02€) - 2023/12/01 09:05:23 UTC
Table: 'Colorado' 6-max (real money) Seat #6 is the button
Seat 1: pelouseverte (0.72€)
Seat 2: DonKmillo (2.08€)
Seat 3: Tiken04 (2.60€)
Seat 4: oliveponcar (5.17€)
Seat 5: g8o8k8u (2.18€)
Seat 6: Fried Berg (2.67€)
Hold-up to Pot: total 0.10€
*** ANTE/BLINDS ***
pelouseverte posts small blind 0.01€
DonKmillo posts big blind 0.02€
Dealt to Fried Berg [2h 9s]
*** PRE-FLOP *** 
Tiken04 folds
oliveponcar folds
g8o8k8u folds
Fried Berg folds
pelouseverte calls 0.01€
DonKmillo checks
*** FLOP *** [Ac 4c Ts]
pelouseverte checks
DonKmillo checks
*** TURN *** [Ac 4c Ts][2c]
pelouseverte checks
DonKmillo checks
*** RIVER *** [Ac 4c Ts 2c][2s]
pelouseverte bets 0.14€
DonKmillo folds
pelouseverte collected 0.28€ from pot
*** SUMMARY ***
Total pot 0.28€ | No rake
Board: [Ac 4c Ts 2c 2s]
Seat 1: pelouseverte (small blind) won 0.28€


Winamax Poker - HOLD-UP "Colorado" - HandId: #19116069-313705-1701421533 - Holdem no limit (0.01€/0.02€) - 2023/12/01 09:05:33 UTC
Table: 'Colorado' 6-max (real money) Seat #6 is the button
Seat 1: Baston57 (3.44€)
Seat 2: oliveponcar (5.75€)
Seat 3: Cejargordas (5.91€)
Seat 4: DDDIEU33 (0.74€)
Seat 5: MoneyGrowing (2.46€)
Seat 6: Fried Berg (2.67€)
*** ANTE/BLINDS ***
Baston57 posts small blind 0.01€
oliveponcar posts big blind 0.02€
Dealt to Fried Berg [Ad 9h]
*** PRE-FLOP *** 
Cejargordas raises 0.04€ to 0.06€
DDDIEU33 folds
MoneyGrowing folds
Fried Berg calls 0.06€
Baston57 folds
oliveponcar folds
*** FLOP *** [7h 8c Js]
Cejargordas checks
Fried Berg bets 0.04€
Cejargordas calls 0.04€
*** TURN *** [7h 8c Js][Kc]
Cejargordas checks
Fried Berg checks
*** RIVER *** [7h 8c Js Kc][Tc]
Cejargordas bets 0.06€
Fried Berg calls 0.06€
*** SHOW DOWN ***
Cejargordas shows [As Kd] (One pair : Kings)
Fried Berg shows [Ad 9h] (Straight Jack high)
Fried Berg collected 0.31€ from pot
*** SUMMARY ***
Total pot 0.31€ | Rake 0.04€
Board: [7h 8c Js Kc Tc]
Seat 3: Cejargordas showed [As Kd] and lost with One pair : Kings
Seat 6: Fried Berg (button) showed [Ad 9h] and won 0.31€ with Straight Jack high


Winamax Poker - HOLD-UP "Colorado" - HandId: #19116069-313754-1701421591 - Holdem no limit (0.01€/0.02€) - 2023/12/01 09:06:31 UTC
Table: 'Colorado' 6-max (real money) Seat #6 is the button
Seat 1: papashark14 (1.98€)
Seat 2: PIQSOU (2.04€)
Seat 3: pivert 83 (1.82€)
Seat 4: Fried Berg (2.82€)
Seat 5: Hydramist (2.78€)
Seat 6: Patufet29 (1.77€)
*** ANTE/BLINDS ***
papashark14 posts small blind 0.01€
PIQSOU posts big blind 0.02€
Dealt to Fried Berg [4s 7h]
*** PRE-FLOP *** 
pivert 83 folds
Fried Berg folds
Hydramist raises 0.03€ to 0.05€
Patufet29 folds
papashark14 calls 0.04€
PIQSOU folds
*** FLOP *** [Jh Js 3h]
papashark14 checks
Hydramist checks
*** TURN *** [Jh Js 3h][4h]
papashark14 checks
Hydramist checks
*** RIVER *** [Jh Js 3h 4h][5h]
papashark14 checks
Hydramist checks
*** SHOW DOWN ***
Hydramist shows [Ts Qs] (One pair : Jacks)
papashark14 shows [Ad 8s] (One pair : Jacks)
papashark14 collected 0.11€ from pot
*** SUMMARY ***
Total pot 0.11€ | Rake 0.01€
Board: [Jh Js 3h 4h 5h]
Seat 1: papashark14 (small blind) showed [Ad 8s] and won 0.11€ with One pair : Jacks
Seat 5: Hydramist showed [Ts Qs] and lost with One pair : Jacks


Winamax Poker - HOLD-UP "Colorado" - HandId: #19116069-313764-1701421599 - Holdem no limit (0.01€/0.02€) - 2023/12/01 09:06:39 UTC
Table: 'Colorado' 6-max (real money) Seat #6 is the button
Seat 1: Fried Berg (2.82€)
Seat 2: KingSoto (2.27€)
Seat 3: KKamarAAde (2.57€)
Seat 4: pelouseverte (1.23€)
Seat 5: haamataraa (1.87€)
Seat 6: DoNPaPaMaSS (3.94€)
*** ANTE/BLINDS ***
Fried Berg posts small blind 0.01€
KingSoto posts big blind 0.02€
Dealt to Fried Berg [2d 3c]
*** PRE-FLOP *** 
KKamarAAde folds
pelouseverte folds
haamataraa raises 0.08€ to 0.10€
DoNPaPaMaSS folds
Fried Berg folds
KingSoto folds
haamataraa collected 0.13€ from pot
*** SUMMARY ***
Total pot 0.13€ | No rake
Seat 5: haamataraa won 0.13€


Winamax Poker - HOLD-UP "Colorado" - HandId: #19116069-313765-1701421601 - Holdem no limit (0.01€/0.02€) - 2023/12/01 09:06:41 UTC
Table: 'Colorado' 6-max (real money) Seat #6 is the button
Seat 1: Patufet29 (1.75€)
Seat 2: TheRealWill (2.11€)
Seat 3: Fried Berg (2.81€)
Seat 4: DDDIEU33 (0.75€)
Seat 5: Aggro Loser (2.22€)
Seat 6: Furka08 (0.47€)
*** ANTE/BLINDS ***
Patufet29 posts small blind 0.01€
TheRealWill posts big blind 0.02€
Dealt to Fried Berg [Ah 8c]
*** PRE-FLOP *** 
Fried Berg raises 0.02€ to 0.04€
DDDIEU33 folds
Aggro Loser folds
Furka08 folds
Patufet29 folds
TheRealWill folds
Fried Berg collected 0.07€ from pot
*** SUMMARY ***
Total pot 0.07€ | No rake
Seat 3: Fried Berg won 0.07€


Winamax Poker - HOLD-UP "Colorado" - HandId: #19116069-313779-1701421615 - Holdem no limit (0.01€/0.02€) - 2023/12/01 09:06:55 UTC
Table: 'Colorado' 6-max (real money) Seat #6 is the button
Seat 1: Patufet29 (1.72€)
Seat 2: timePLZ (2.64€)
Seat 3: caarloosgb (5.37€)
Seat 4: KKamarAAde (3.32€)
Seat 5: Fried Berg (2.84€)
Seat 6: PavuPapy87 (0.47€)
*** ANTE/BLINDS ***
Patufet29 posts small blind 0.01€
timePLZ posts big blind 0.02€
Dealt to Fried Berg [8d 2c]
*** PRE-FLOP *** 
caarloosgb calls 0.02€
KKamarAAde folds
Fried Berg folds
PavuPapy87 calls 0.02€
Patufet29 calls 0.01€
timePLZ checks
*** FLOP *** [8c As 9s]
Patufet29 checks
timePLZ checks
caarloosgb checks
PavuPapy87 checks
*** TURN *** [8c As 9s][7h]
Patufet29 checks
timePLZ checks
caarloosgb checks
PavuPapy87 checks
*** RIVER *** [8c As 9s 7h][Jh]
Patufet29 bets 0.03€
timePLZ folds
caarloosgb calls 0.03€
PavuPapy87 folds
*** SHOW DOWN ***
caarloosgb shows [Kh Jc] (One pair : Jacks)
Patufet29 shows [4d Ah] (One pair : Aces)
Patufet29 collected 0.13€ from pot
*** SUMMARY ***
Total pot 0.13€ | Rake 0.01€
Board: [8c As 9s 7h Jh]
Seat 1: Patufet29 (small blind) showed [4d Ah] and won 0.13€ with One pair : Aces
Seat 3: caarloosgb showed [Kh Jc] and lost with One pair : Jacks


Winamax Poker - HOLD-UP "Colorado" - HandId: #19116069-313782-1701421618 - Holdem no limit (0.01€/0.02€) - 2023/12/01 09:06:58 UTC
Table: 'Colorado' 6-max (real money) Seat #6 is the button
Seat 1: nico033 (3.50€)
Seat 2: Fried Berg (2.84€)
Seat 3: karma- (2.85€)
Seat 4: haamataraa (1.90€)
Seat 5: haouuum28 (1.61€)
Seat 6: Toon89 (3.95€)
*** ANTE/BLINDS ***
nico033 posts small blind 0.01€
Fried Berg posts big blind 0.02€
Dealt to Fried Berg [6c Ts]
*** PRE-FLOP *** 
karma- folds
haamataraa raises 0.08€ to 0.10€
haouuum28 calls 0.10€
Toon89 folds
nico033 folds
Fried Berg folds
*** FLOP *** [5c 2c 8d]
haamataraa checks
haouuum28 checks
*** TURN *** [5c 2c 8d][Tc]
haamataraa bets 0.23€
haouuum28 folds
haamataraa collected 0.44€ from pot
*** SUMMARY ***
Total pot 0.44€ | Rake 0.02€
Board: [5c 2c 8d Tc]
Seat 4: haamataraa won 0.44€


Winamax Poker - HOLD-UP "Colorado" - HandId: #19116069-313791-1701421626 - Holdem no limit (0.01€/0.02€) - 2023/12/01 09:07:06 UTC
Table: 'Colorado' 6-max (real money) Seat #6 is the button
Seat 1: Polanskii (3.33€)
Seat 2: Furka08 (0.44€)
Seat 3: tichettede3 (2.29€)
Seat 4: MoneyGrowing (2.46€)
Seat 5: TheRealWill (2.08€)
Seat 6: Fried Berg (2.82€)
*** ANTE/BLINDS ***
Polanskii posts small blind 0.01€
Furka08 posts big blind 0.02€
Dealt to Fried Berg [Qd Qh]
*** PRE-FLOP *** 
tichettede3 raises 0.03€ to 0.05€
MoneyGrowing folds
TheRealWill folds
Fried Berg raises 0.11€ to 0.16€
Polanskii folds
Furka08 folds
tichettede3 calls 0.11€
*** FLOP *** [Ad Kc 2c]
tichettede3 checks
Fried Berg checks
*** TURN *** [Ad Kc 2c][Qs]
tichettede3 checks
Fried Berg checks
*** RIVER *** [Ad Kc 2c Qs][Jh]
tichettede3 bets 0.23€
Fried Berg calls 0.23€
*** SHOW DOWN ***
tichettede3 shows [4c 6c] (High card : Ace)
Fried Berg shows [Qd Qh] (Trips of Queens)
Fried Berg collected 0.73€ from pot
*** SUMMARY ***
Total pot 0.73€ | Rake 0.08€
Board: [Ad Kc 2c Qs Jh]
Seat 3: tichettede3 showed [4c 6c] and lost with High card : Ace
Seat 6: Fried Berg (button) showed [Qd Qh] and won 0.73€ with Trips of Queens


Winamax Poker - HOLD-UP "Colorado" - HandId: #19116069-313843-1701421679 - Holdem no limit (0.01€/0.02€) - 2023/12/01 09:07:59 UTC
Table: 'Colorado' 6-max (real money) Seat #6 is the button
Seat 1: KON-2-PEUTE (2.52€)
Seat 2: BetQuiMonte (2.29€)
Seat 3: Fried Berg (3.16€)
Seat 4: Dovisclaire (1.07€)
Seat 5: LilRun (4.65€)
Seat 6: _Croute_ (2.78€)
*** ANTE/BLINDS ***
KON-2-PEUTE posts small blind 0.01€
BetQuiMonte posts big blind 0.02€
Dealt to Fried Berg [7c Ad]
*** PRE-FLOP *** 
Fried Berg folds
Dovisclaire folds
LilRun raises 0.04€ to 0.06€
_Croute_ calls 0.06€
KON-2-PEUTE folds
BetQuiMonte calls 0.04€
*** FLOP *** [8c 6s 2s]
BetQuiMonte checks
LilRun bets 0.07€
_Croute_ folds
BetQuiMonte folds
LilRun collected 0.24€ from pot
*** SUMMARY ***
Total pot 0.24€ | Rake 0.02€
Board: [8c 6s 2s]
Seat 5: LilRun won 0.24€


Winamax Poker - HOLD-UP "Colorado" - HandId: #19116069-313848-1701421683 - Holdem no limit (0.01€/0.02€) - 2023/12/01 09:08:03 UTC
Table: 'Colorado' 6-max (real money) Seat #6 is the button
Seat 1: PavuPapy87 (0.43€)
Seat 2: Dovisclaire (1.06€)
Seat 3: g8o8k8u (2€)
Seat 4: Manupoy (1.10€)
Seat 5: Fried Berg (3.16€)
Seat 6: DonKmillo (2€)
*** ANTE/BLINDS ***
PavuPapy87 posts small blind 0.01€
Dovisclaire posts big blind 0.02€
Dealt to Fried Berg [Ad Jc]
*** PRE-FLOP *** 
g8o8k8u folds
Manupoy folds
Fried Berg raises 0.04€ to 0.06€
DonKmillo folds
PavuPapy87 folds
Dovisclaire folds
Fried Berg collected 0.09€ from pot
*** SUMMARY ***
Total pot 0.09€ | No rake
Seat 5: Fried Berg won 0.09€


Winamax Poker - HOLD-UP "Colorado" - HandId: #19116069-313875-1701421708 - Holdem no limit (0.01€/0.02€) - 2023/12/01 09:08:28 UTC
Table: 'Colorado' 6-max (real money) Seat #6 is the button
Seat 1: Fried Berg (3.19€)
Seat 2: KingSoto (2.27€)
Seat 3: oliveponcar (6.39€)
Seat 4: DigBick99 (3.50€)
Seat 5: PEPEKA (0.44€)
Seat 6: Aggro Loser (2.28€)
*** ANTE/BLINDS ***
Fried Berg posts small blind 0.01€
KingSoto posts big blind 0.02€
Dealt to Fried Berg [6h Ac]
*** PRE-FLOP *** 
oliveponcar folds
DigBick99 folds
PEPEKA folds
Aggro Loser raises 0.03€ to 0.05€
Fried Berg calls 0.04€
KingSoto raises 0.10€ to 0.15€
Aggro Loser calls 0.10€
Fried Berg folds
*** FLOP *** [9s 7h Jc]
KingSoto checks
Aggro Loser checks
*** TURN *** [9s 7h Jc][6d]
KingSoto bets 0.35€
Aggro Loser calls 0.35€
*** RIVER *** [9s 7h Jc 6d][3d]
KingSoto bets 1.05€
Aggro Loser folds
KingSoto collected 1.99€ from pot
*** SUMMARY ***
Total pot 1.99€ | Rake 0.11€
Board: [9s 7h Jc 6d 3d]
Seat 2: KingSoto (big blind) won 1.99€


Winamax Poker - HOLD-UP "Colorado" - HandId: #19116069-313895-1701421729 - Holdem no limit (0.01€/0.02€) - 2023/12/01 09:08:49 UTC
Table: 'Colorado' 6-max (real money) Seat #6 is the button
Seat 1: papashark14 (1.86€)
Seat 2: Lolo_Baff (0.50€)
Seat 3: caarloosgb (5.29€)
Seat 4: TheRealWill (3.97€)
Seat 5: Fried Berg (3.14€)
Seat 6: Toon89 (3.79€)
*** ANTE/BLINDS ***
papashark14 posts small blind 0.01€
Lolo_Baff posts big blind 0.02€
Dealt to Fried Berg [Ks 8c]
*** PRE-FLOP *** 
caarloosgb calls 0.02€
TheRealWill folds
Fried Berg raises 0.02€ to 0.04€
Toon89 folds
papashark14 folds
Lolo_Baff folds
caarloosgb calls 0.02€
*** FLOP *** [2c 2d 9h]
caarloosgb checks
Fried Berg checks
*** TURN *** [2c 2d 9h][9d]
caarloosgb bets 0.07€
Fried Berg folds
caarloosgb collected 0.17€ from pot
*** SUMMARY ***
Total pot 0.17€ | Rake 0.01€
Board: [2c 2d 9h 9d]
Seat 3: caarloosgb won 0.17€


Winamax Poker - HOLD-UP "Colorado" - HandId: #19116069-313981-1701421838 - Holdem no limit (0.01€/0.02€) - 2023/12/01 09:10:38 UTC
Table: 'Colorado' 6-max (real money) Seat #6 is the button
Seat 1: PIQSOU (2.18€)
Seat 2: Fried Berg (3.10€)
Seat 3: Manupoy (1.03€)
Seat 4: LilRun (4.45€)
Seat 5: KON-2-PEUTE (3.09€)
Seat 6: whiteclover (1.74€)
*** ANTE/BLINDS ***
PIQSOU posts small blind 0.01€
Fried Berg posts big blind 0.02€
Dealt to Fried Berg [3d 2d]
*** PRE-FLOP *** 
Manupoy folds
LilRun folds
KON-2-PEUTE folds
whiteclover raises 0.04€ to 0.06€
PIQSOU folds
Fried Berg calls 0.04€
*** FLOP *** [3h 6c Qc]
Fried Berg checks
whiteclover checks
*** TURN *** [3h 6c Qc][2c]
Fried Berg bets 0.02€
whiteclover raises 0.05€ to 0.07€
Fried Berg calls 0.05€
*** RIVER *** [3h 6c Qc 2c][7c]
Fried Berg checks
whiteclover checks
*** SHOW DOWN ***
Fried Berg shows [3d 2d] (Two pairs : 3 and 2)
whiteclover shows [Tc Ts] (Flush Queen high)
whiteclover collected 0.24€ from pot
*** SUMMARY ***
Total pot 0.24€ | Rake 0.03€
Board: [3h 6c Qc 2c 7c]
Seat 2: Fried Berg (big blind) showed [3d 2d] and lost with Two pairs : 3 and 2
Seat 6: whiteclover (button) showed [Tc Ts] and won 0.24€ with Flush Queen high


Winamax Poker - HOLD-UP "Colorado" - HandId: #19116069-314021-1701421877 - Holdem no limit (0.01€/0.02€) - 2023/12/01 09:11:17 UTC
Table: 'Colorado' 6-max (real money) Seat #6 is the button
Seat 1: curiouz dje (2.01€)
Seat 2: Tiken04 (2.68€)
Seat 3: Fried Berg (2.97€)
Seat 4: oliveponcar (2.02€)
Seat 5: whiteclover (1.85€)
Seat 6: Toon89 (5.15€)
*** ANTE/BLINDS ***
curiouz dje posts small blind 0.01€
Tiken04 posts big blind 0.02€
Dealt to Fried Berg [Qs 9d]
*** PRE-FLOP *** 
Fried Berg folds
oliveponcar folds
whiteclover folds
Toon89 raises 0.04€ to 0.06€
curiouz dje folds
Tiken04 calls 0.04€
*** FLOP *** [Jh 6h 7c]
Tiken04 checks
Toon89 bets 0.08€
Tiken04 folds
Toon89 collected 0.20€ from pot
*** SUMMARY ***
Total pot 0.20€ | Rake 0.01€
Board: [Jh 6h 7c]
Seat 6: Toon89 (button) won 0.20€


Winamax Poker - HOLD-UP "Colorado" - HandId: #19116069-314035-1701421890 - Holdem no limit (0.01€/0.02€) - 2023/12/01 09:11:30 UTC
Table: 'Colorado' 6-max (real money) Seat #6 is the button
Seat 1: tichettede3 (2.19€)
Seat 2: _Croute_ (2.85€)
Seat 3: Perf-31 (2.03€)
Seat 4: caarloosgb (5.33€)
Seat 5: TheRealWill (2.08€)
Seat 6: Fried Berg (2.97€)
*** ANTE/BLINDS ***
tichettede3 posts small blind 0.01€
_Croute_ posts big blind 0.02€
Dealt to Fried Berg [5d Qs]
*** PRE-FLOP *** 
Perf-31 folds
caarloosgb folds
TheRealWill folds
Fried Berg folds
tichettede3 raises 0.03€ to 0.05€
_Croute_ folds
tichettede3 collected 0.07€ from pot
*** SUMMARY ***
Total pot 0.07€ | No rake
Seat 1: tichettede3 (small blind) won 0.07€


Winamax Poker - HOLD-UP "Colorado" - HandId: #19116069-314042-1701421896 - Holdem no limit (0.01€/0.02€) - 2023/12/01 09:11:36 UTC
Table: 'Colorado' 6-max (real money) Seat #6 is the button
Seat 1: KassKhrane76 (2.01€)
Seat 2: papashark14 (2€)
Seat 3: BMW-Z4 (2€)
Seat 4: Fried Berg (2.97€)
Seat 5: fumseck59 (0.64€)
Seat 6: g8o8k8u (2.02€)
*** ANTE/BLINDS ***
KassKhrane76 posts small blind 0.01€
papashark14 posts big blind 0.02€
Dealt to Fried Berg [5c 5h]
*** PRE-FLOP *** 
BMW-Z4 folds
Fried Berg raises 0.02€ to 0.04€
fumseck59 calls 0.04€
g8o8k8u folds
KassKhrane76 calls 0.03€
papashark14 calls 0.02€
*** FLOP *** [3c Qs 3d]
KassKhrane76 checks
papashark14 checks
Fried Berg checks
fumseck59 checks
*** TURN *** [3c Qs 3d][7c]
KassKhrane76 checks
papashark14 checks
Fried Berg checks
fumseck59 checks
*** RIVER *** [3c Qs 3d 7c][6d]
KassKhrane76 bets 0.16€
papashark14 folds
Fried Berg calls 0.16€
fumseck59 folds
*** SHOW DOWN ***
Fried Berg shows [5c 5h] (Two pairs : 5 and 3)
KassKhrane76 shows [4d 5d] (Straight 7 high)
KassKhrane76 collected 0.43€ from pot
*** SUMMARY ***
Total pot 0.43€ | Rake 0.05€
Board: [3c Qs 3d 7c 6d]
Seat 1: KassKhrane76 (small blind) showed [4d 5d] and won 0.43€ with Straight 7 high
Seat 4: Fried Berg showed [5c 5h] and lost with Two pairs : 5 and 3


Winamax Poker - HOLD-UP "Colorado" - HandId: #19116069-314088-1701421949 - Holdem no limit (0.01€/0.02€) - 2023/12/01 09:12:29 UTC
Table: 'Colorado' 6-max (real money) Seat #6 is the button
Seat 1: las210qt (0.70€)
Seat 2: Aggro Loser (2.71€)
Seat 3: KassKhrane76 (2.24€)
Seat 4: Fried Berg (2.77€)
Seat 5: Tompahmax (1.60€)
Seat 6: Hydramist (3.69€)
Hold-up to Pot: total 0.10€
*** ANTE/BLINDS ***
las210qt posts small blind 0.01€
Aggro Loser posts big blind 0.02€
Dealt to Fried Berg [Ks 9d]
*** PRE-FLOP *** 
KassKhrane76 folds
Fried Berg folds
Tompahmax raises 0.02€ to 0.04€
Hydramist calls 0.04€
las210qt calls 0.03€
Aggro Loser folds
*** FLOP *** [Ac 4h 6h]
las210qt checks
Tompahmax checks
Hydramist bets 0.16€
las210qt folds
Tompahmax folds
Hydramist collected 0.39€ from pot
*** SUMMARY ***
Total pot 0.39€ | Rake 0.01€
Board: [Ac 4h 6h]
Seat 6: Hydramist (button) won 0.39€


Winamax Poker - HOLD-UP "Colorado" - HandId: #19116069-314094-1701421954 - Holdem no limit (0.01€/0.02€) - 2023/12/01 09:12:34 UTC
Table: 'Colorado' 6-max (real money) Seat #6 is the button
Seat 1: Fried Berg (2.77€)
Seat 2: toutoazar (2€)
Seat 3: PaitOn (3.68€)
Seat 4: KassKhrane76 (2.24€)
Seat 5: curiouz dje (2€)
Seat 6: KON-2-PEUTE (3.13€)
*** ANTE/BLINDS ***
Fried Berg posts small blind 0.01€
toutoazar posts big blind 0.02€
Dealt to Fried Berg [2h 8c]
*** PRE-FLOP *** 
PaitOn folds
KassKhrane76 folds
curiouz dje folds
KON-2-PEUTE raises 0.03€ to 0.05€
Fried Berg folds
toutoazar calls 0.03€
*** FLOP *** [Qs 3s 4h]
toutoazar checks
KON-2-PEUTE checks
*** TURN *** [Qs 3s 4h][Tc]
toutoazar checks
KON-2-PEUTE checks
*** RIVER *** [Qs 3s 4h Tc][Kd]
toutoazar bets 0.06€
KON-2-PEUTE folds
toutoazar collected 0.16€ from pot
*** SUMMARY ***
Total pot 0.16€ | Rake 0.01€
Board: [Qs 3s 4h Tc Kd]
Seat 2: toutoazar (big blind) won 0.16€


Winamax Poker - HOLD-UP "Colorado" - HandId: #19116069-314099-1701421959 - Holdem no limit (0.01€/0.02€) - 2023/12/01 09:12:39 UTC
Table: 'Colorado' 6-max (real money) Seat #6 is the button
Seat 1: MoneyGrowing (2.08€)
Seat 2: Fried Berg (2.76€)
Seat 3: KKamarAAde (3.66€)
Seat 4: Leanath (2€)
Seat 5: KassKhrane76 (2.24€)
Seat 6: timePLZ (2€)
*** ANTE/BLINDS ***
MoneyGrowing posts small blind 0.01€
Fried Berg posts big blind 0.02€
Dealt to Fried Berg [5s 2c]
*** PRE-FLOP *** 
KKamarAAde folds
Leanath folds
KassKhrane76 raises 0.04€ to 0.06€
timePLZ folds
MoneyGrowing folds
Fried Berg folds
KassKhrane76 collected 0.09€ from pot
*** SUMMARY ***
Total pot 0.09€ | No rake
Seat 5: KassKhrane76 won 0.09€


Winamax Poker - HOLD-UP "Colorado" - HandId: #19116069-314110-1701421967 - Holdem no limit (0.01€/0.02€) - 2023/12/01 09:12:47 UTC
Table: 'Colorado' 6-max (real money) Seat #6 is the button
Seat 1: KingSoto (2.45€)
Seat 2: PEPEKA (0.88€)
Seat 3: MoneyGrowing (2.05€)
Seat 4: Fried Berg (2.74€)
Seat 5: Mercuryllo (2.10€)
Seat 6: Emotif-Lion4 (2.08€)
*** ANTE/BLINDS ***
KingSoto posts small blind 0.01€
PEPEKA posts big blind 0.02€
Dealt to Fried Berg [8c 9c]
*** PRE-FLOP *** 
MoneyGrowing folds
Fried Berg raises 0.02€ to 0.04€
Mercuryllo folds
Emotif-Lion4 folds
KingSoto folds
PEPEKA folds
Fried Berg collected 0.07€ from pot
*** SUMMARY ***
Total pot 0.07€ | No rake
Seat 4: Fried Berg won 0.07€


Winamax Poker - HOLD-UP "Colorado" - HandId: #19116069-314127-1701421984 - Holdem no limit (0.01€/0.02€) - 2023/12/01 09:13:04 UTC
Table: 'Colorado' 6-max (real money) Seat #6 is the button
Seat 1: _Croute_ (2.78€)
Seat 2: FC_Ghost1 (2€)
Seat 3: curiouz dje (2€)
Seat 4: whiteclover (1.87€)
Seat 5: Fried Berg (2.77€)
Seat 6: KKamarAAde (3.67€)
*** ANTE/BLINDS ***
_Croute_ posts small blind 0.01€
FC_Ghost1 posts big blind 0.02€
Dealt to Fried Berg [Ks 3d]
*** PRE-FLOP *** 
curiouz dje folds
whiteclover folds
Fried Berg folds
KKamarAAde folds
_Croute_ folds
FC_Ghost1 collected 0.03€ from pot
*** SUMMARY ***
Total pot 0.03€ | No rake
Seat 2: FC_Ghost1 (big blind) won 0.03€


Winamax Poker - HOLD-UP "Colorado" - HandId: #19116069-314131-1701421989 - Holdem no limit (0.01€/0.02€) - 2023/12/01 09:13:09 UTC
Table: 'Colorado' 6-max (real money) Seat #6 is the button
Seat 1: PEPEKA (0.85€)
Seat 2: whiteclover (1.87€)
Seat 3: Fried Berg (2.77€)
Seat 4: Perf-31 (2.03€)
Seat 5: Mercuryllo (2.13€)
Seat 6: Cejargordas (4.86€)
*** ANTE/BLINDS ***
PEPEKA posts small blind 0.01€
whiteclover posts big blind 0.02€
Dealt to Fried Berg [3c 4s]
*** PRE-FLOP *** 
Fried Berg folds
Perf-31 folds
Mercuryllo folds
Cejargordas folds
PEPEKA raises 0.83€ to 0.85€ and is all-in
whiteclover folds
PEPEKA collected 0.87€ from pot
*** SUMMARY ***
Total pot 0.87€ | No rake
Seat 1: PEPEKA (small blind) won 0.87€


Winamax Poker - HOLD-UP "Colorado" - HandId: #19116069-314134-1701421992 - Holdem no limit (0.01€/0.02€) - 2023/12/01 09:13:12 UTC
Table: 'Colorado' 6-max (real money) Seat #6 is the button
Seat 1: pivert 83 (1.75€)
Seat 2: Fried Berg (2.77€)
Seat 3: Aggro Loser (2.68€)
Seat 4: _Lilli Rush (2.21€)
Seat 5: Manupoy (1.94€)
Seat 6: Patufet29 (2.57€)
*** ANTE/BLINDS ***
pivert 83 posts small blind 0.01€
Fried Berg posts big blind 0.02€
Dealt to Fried Berg [2d 6h]
*** PRE-FLOP *** 
Aggro Loser folds
_Lilli Rush raises 0.02€ to 0.04€
Manupoy folds
Patufet29 folds
pivert 83 folds
Fried Berg folds
_Lilli Rush collected 0.07€ from pot
*** SUMMARY ***
Total pot 0.07€ | No rake
Seat 4: _Lilli Rush won 0.07€


Winamax Poker - HOLD-UP "Colorado" - HandId: #19116069-314149-1701422005 - Holdem no limit (0.01€/0.02€) - 2023/12/01 09:13:25 UTC
Table: 'Colorado' 6-max (real money) Seat #6 is the button
Seat 1: Fried Berg (2.75€)
Seat 2: jdeepenslip (2€)
Seat 3: KON-2-PEUTE (3.06€)
Seat 4: Patufet29 (2.54€)
Seat 5: Dovisclaire (0.95€)
Seat 6: Aggro Loser (2.17€)
*** ANTE/BLINDS ***
Fried Berg posts small blind 0.01€
jdeepenslip posts big blind 0.02€
Dealt to Fried Berg [Qh 6d]
*** PRE-FLOP *** 
KON-2-PEUTE raises 0.03€ to 0.05€
Patufet29 folds
Dovisclaire folds
Aggro Loser calls 0.05€
Fried Berg folds
jdeepenslip folds
*** FLOP *** [4s Qc 7c]
KON-2-PEUTE checks
Aggro Loser checks
*** TURN *** [4s Qc 7c][Th]
KON-2-PEUTE checks
Aggro Loser bets 0.11€
KON-2-PEUTE folds
Aggro Loser collected 0.23€ from pot
*** SUMMARY ***
Total pot 0.23€ | Rake 0.01€
Board: [4s Qc 7c Th]
Seat 6: Aggro Loser (button) won 0.23€


Winamax Poker - HOLD-UP "Colorado" - HandId: #19116069-314171-1701422028 - Holdem no limit (0.01€/0.02€) - 2023/12/01 09:13:48 UTC
Table: 'Colorado' 6-max (real money) Seat #6 is the button
Seat 1: KKamarAAde (2.71€)
Seat 2: oliveponcar (6.39€)
Seat 3: pirifpafin (3.16€)
Seat 4: edfcain (2.42€)
Seat 5: Fried Berg (2.74€)
Seat 6: lavacalola96 (0.66€)
*** ANTE/BLINDS ***
KKamarAAde posts small blind 0.01€
oliveponcar posts big blind 0.02€
Dealt to Fried Berg [Qd 5s]
*** PRE-FLOP *** 
pirifpafin folds
edfcain folds
Fried Berg folds
lavacalola96 folds
KKamarAAde folds
oliveponcar collected 0.03€ from pot
*** SUMMARY ***
Total pot 0.03€ | No rake
Seat 2: oliveponcar (big blind) won 0.03€


Winamax Poker - HOLD-UP "Colorado" - HandId: #19116069-314176-1701422033 - Holdem no limit (0.01€/0.02€) - 2023/12/01 09:13:53 UTC
Table: 'Colorado' 6-max (real money) Seat #6 is the button
Seat 1: Tompahmax (1.32€)
Seat 2: pivert 83 (1.39€)
Seat 3: BMW-Z4 (2.17€)
Seat 4: Fried Berg (2.74€)
Seat 5: MoneyGrowing (2.72€)
Seat 6: pelouseverte (0.72€)
*** ANTE/BLINDS ***
Tompahmax posts small blind 0.01€
pivert 83 posts big blind 0.02€
Dealt to Fried Berg [5s Tc]
*** PRE-FLOP *** 
BMW-Z4 folds
Fried Berg folds
MoneyGrowing raises 0.04€ to 0.06€
pelouseverte folds
Tompahmax folds
pivert 83 folds
MoneyGrowing collected 0.09€ from pot
*** SUMMARY ***
Total pot 0.09€ | No rake
Seat 5: MoneyGrowing won 0.09€


Winamax Poker - HOLD-UP "Colorado" - HandId: #19116069-314178-1701422035 - Holdem no limit (0.01€/0.02€) - 2023/12/01 09:13:55 UTC
Table: 'Colorado' 6-max (real money) Seat #6 is the button
Seat 1: Fried Berg (2.74€)
Seat 2: haouuum28 (2€)
Seat 3: lavacalola96 (0.66€)
Seat 4: curiouz dje (2.10€)
Seat 5: BMW-Z4 (2.17€)
Seat 6: FC_Ghost1 (2.10€)
*** ANTE/BLINDS ***
Fried Berg posts small blind 0.01€
haouuum28 posts big blind 0.02€
Dealt to Fried Berg [3s Tc]
*** PRE-FLOP *** 
lavacalola96 folds
curiouz dje raises 0.03€ to 0.05€
BMW-Z4 folds
FC_Ghost1 calls 0.05€
Fried Berg folds
haouuum28 folds
*** FLOP *** [Ac Td 6d]
curiouz dje bets 0.05€
FC_Ghost1 folds
curiouz dje collected 0.17€ from pot
*** SUMMARY ***
Total pot 0.17€ | Rake 0.01€
Board: [Ac Td 6d]
Seat 4: curiouz dje won 0.17€


Winamax Poker - HOLD-UP "Colorado" - HandId: #19116069-314182-1701422037 - Holdem no limit (0.01€/0.02€) - 2023/12/01 09:13:57 UTC
Table: 'Colorado' 6-max (real money) Seat #6 is the button
Seat 1: TheRealWill (2.14€)
Seat 2: edfcain (2.41€)
Seat 3: Patufet29 (2.51€)
Seat 4: pelouseverte (0.72€)
Seat 5: Fried Berg (2.73€)
Seat 6: Cejargordas (4.84€)
*** ANTE/BLINDS ***
TheRealWill posts small blind 0.01€
edfcain posts big blind 0.02€
Dealt to Fried Berg [Qd 7d]
*** PRE-FLOP *** 
Patufet29 folds
pelouseverte folds
Fried Berg raises 0.02€ to 0.04€
Cejargordas raises 0.11€ to 0.15€
TheRealWill folds
edfcain folds
Fried Berg calls 0.11€
*** FLOP *** [2c 4s Ad]
Fried Berg checks
Cejargordas bets 0.08€
Fried Berg calls 0.08€
*** TURN *** [2c 4s Ad][Jh]
Fried Berg checks
Cejargordas checks
*** RIVER *** [2c 4s Ad Jh][Tc]
Fried Berg checks
Cejargordas checks
*** SHOW DOWN ***
Fried Berg shows [Qd 7d] (High card : Ace)
Cejargordas shows [Qc Jc] (One pair : Jacks)
Cejargordas collected 0.44€ from pot
*** SUMMARY ***
Total pot 0.44€ | Rake 0.05€
Board: [2c 4s Ad Jh Tc]
Seat 5: Fried Berg showed [Qd 7d] and lost with High card : Ace
Seat 6: Cejargordas (button) showed [Qc Jc] and won 0.44€ with One pair : Jacks


Winamax Poker - HOLD-UP "Colorado" - HandId: #19116069-314258-1701422117 - Holdem no limit (0.01€/0.02€) - 2023/12/01 09:15:17 UTC
Table: 'Colorado' 6-max (real money) Seat #6 is the button
Seat 1: PEPEKA (0.91€)
Seat 2: curiouz dje (2.69€)
Seat 3: Fried Berg (2.50€)
Seat 4: BMW-Z4 (2€)
Seat 5: Leanath (2.10€)
Seat 6: Cejargordas (5.05€)
*** ANTE/BLINDS ***
PEPEKA posts small blind 0.01€
curiouz dje posts big blind 0.02€
Dealt to Fried Berg [5h 2d]
*** PRE-FLOP *** 
Fried Berg folds
BMW-Z4 folds
Leanath raises 0.04€ to 0.06€
Cejargordas folds
PEPEKA folds
curiouz dje folds
Leanath collected 0.09€ from pot
*** SUMMARY ***
Total pot 0.09€ | No rake
Seat 5: Leanath won 0.09€


Winamax Poker - HOLD-UP "Colorado" - HandId: #19116069-314262-1701422123 - Holdem no limit (0.01€/0.02€) - 2023/12/01 09:15:23 UTC
Table: 'Colorado' 6-max (real money) Seat #6 is the button
Seat 1: pivert 83 (0.21€)
Seat 2: jjakpour (2€)
Seat 3: PokerDede (0.68€)
Seat 4: oliveponcar (5.18€)
Seat 5: Fried Berg (2.50€)
Seat 6: PACS 024 (1.87€)
*** ANTE/BLINDS ***
pivert 83 posts small blind 0.01€
jjakpour posts big blind 0.02€
Dealt to Fried Berg [7d Qd]
*** PRE-FLOP *** 
PokerDede calls 0.02€
oliveponcar raises 0.04€ to 0.06€
Fried Berg folds
PACS 024 folds
pivert 83 folds
jjakpour folds
PokerDede folds
oliveponcar collected 0.11€ from pot
*** SUMMARY ***
Total pot 0.11€ | No rake
Seat 4: oliveponcar won 0.11€


Winamax Poker - HOLD-UP "Colorado" - HandId: #19116069-314280-1701422144 - Holdem no limit (0.01€/0.02€) - 2023/12/01 09:15:44 UTC
Table: 'Colorado' 6-max (real money) Seat #6 is the button
Seat 1: yann_Lord590 (2.12€)
Seat 2: Fried Berg (2.50€)
Seat 3: l artiste ho (1.46€)
Seat 4: jjakpour (1.97€)
Seat 5: FC_Ghost1 (2.10€)
Seat 6: lavacalola96 (0.65€)
*** ANTE/BLINDS ***
yann_Lord590 posts small blind 0.01€
Fried Berg posts big blind 0.02€
Dealt to Fried Berg [Kd 4s]
*** PRE-FLOP *** 
l artiste ho folds
jjakpour calls 0.02€
FC_Ghost1 folds
lavacalola96 calls 0.02€
yann_Lord590 folds
Fried Berg checks
*** FLOP *** [3c 5s 8h]
Fried Berg checks
jjakpour checks
lavacalola96 checks
*** TURN *** [3c 5s 8h][Kc]
Fried Berg bets 0.02€
jjakpour folds
lavacalola96 folds
Fried Berg collected 0.08€ from pot
*** SUMMARY ***
Total pot 0.08€ | Rake 0.01€
Board: [3c 5s 8h Kc]
Seat 2: Fried Berg (big blind) won 0.08€


Winamax Poker - HOLD-UP "Colorado" - HandId: #19116069-314305-1701422168 - Holdem no limit (0.01€/0.02€) - 2023/12/01 09:16:08 UTC
Table: 'Colorado' 6-max (real money) Seat #6 is the button
Seat 1: TheRealWill (2€)
Seat 2: pivert 83 (0.20€)
Seat 3: haouuum28 (1.93€)
Seat 4: PokerDede (0.63€)
Seat 5: papashark14 (1.65€)
Seat 6: Fried Berg (2.54€)
*** ANTE/BLINDS ***
TheRealWill posts small blind 0.01€
pivert 83 posts big blind 0.02€
Dealt to Fried Berg [Kd Qc]
*** PRE-FLOP *** 
haouuum28 folds
PokerDede raises 0.02€ to 0.04€
papashark14 folds
Fried Berg raises 0.02€ to 0.06€
TheRealWill folds
pivert 83 folds
PokerDede calls 0.02€
*** FLOP *** [Kh 4c Th]
PokerDede checks
Fried Berg bets 0.04€
PokerDede calls 0.04€
*** TURN *** [Kh 4c Th][Qh]
PokerDede checks
Fried Berg bets 0.12€
PokerDede calls 0.12€
*** RIVER *** [Kh 4c Th Qh][7s]
PokerDede checks
Fried Berg bets 0.23€
PokerDede calls 0.23€
*** SHOW DOWN ***
Fried Berg shows [Kd Qc] (Two pairs : Kings and Queens)
PokerDede shows [Js Ah] (Straight Ace high)
PokerDede collected 0.84€ from pot
*** SUMMARY ***
Total pot 0.84€ | Rake 0.09€
Board: [Kh 4c Th Qh 7s]
Seat 4: PokerDede showed [Js Ah] and won 0.84€ with Straight Ace high
Seat 6: Fried Berg (button) showed [Kd Qc] and lost with Two pairs : Kings and Queens


Winamax Poker - HOLD-UP "Colorado" - HandId: #19116069-314354-1701422222 - Holdem no limit (0.01€/0.02€) - 2023/12/01 09:17:02 UTC
Table: 'Colorado' 6-max (real money) Seat #6 is the button
Seat 1: Fried Berg (2.09€)
Seat 2: PEPEKA (0.91€)
Seat 3: PaitOn (3.30€)
Seat 4: Leanath (2.21€)
Seat 5: PokerDede (1.02€)
Seat 6: Hydramist (3.81€)
*** ANTE/BLINDS ***
Fried Berg posts small blind 0.01€
PEPEKA posts big blind 0.02€
Dealt to Fried Berg [Qh 2c]
*** PRE-FLOP *** 
PaitOn folds
Leanath folds
PokerDede folds
Hydramist folds
Fried Berg folds
PEPEKA collected 0.03€ from pot
*** SUMMARY ***
Total pot 0.03€ | No rake
Seat 2: PEPEKA (big blind) won 0.03€


Winamax Poker - HOLD-UP "Colorado" - HandId: #19116069-314369-1701422238 - Holdem no limit (0.01€/0.02€) - 2023/12/01 09:17:18 UTC
Table: 'Colorado' 6-max (real money) Seat #6 is the button
Seat 1: curiouz dje (2.25€)
Seat 2: haamataraa (2.31€)
Seat 3: jdeepenslip (2.15€)
Seat 4: Fried Berg (2.08€)
Seat 5: SirX (2€)
Seat 6: KON-2-PEUTE (3.07€)
*** ANTE/BLINDS ***
curiouz dje posts small blind 0.01€
haamataraa posts big blind 0.02€
Dealt to Fried Berg [Ac Kh]
*** PRE-FLOP *** 
jdeepenslip folds
Fried Berg raises 0.02€ to 0.04€
SirX calls 0.04€
KON-2-PEUTE folds
curiouz dje folds
haamataraa calls 0.02€
*** FLOP *** [4h Jh 2s]
haamataraa checks
Fried Berg checks
SirX checks
*** TURN *** [4h Jh 2s][8h]
haamataraa bets 0.02€
Fried Berg calls 0.02€
SirX raises 0.12€ to 0.14€
haamataraa folds
Fried Berg folds
SirX collected 0.29€ from pot
*** SUMMARY ***
Total pot 0.29€ | Rake 0.02€
Board: [4h Jh 2s 8h]
Seat 5: SirX won 0.29€


Winamax Poker - HOLD-UP "Colorado" - HandId: #19116069-314395-1701422271 - Holdem no limit (0.01€/0.02€) - 2023/12/01 09:17:51 UTC
Table: 'Colorado' 6-max (real money) Seat #6 is the button
Seat 1: curiouz dje (2€)
Seat 2: LilRun (4.60€)
Seat 3: Fried Berg (2.02€)
Seat 4: slowreplay (2€)
Seat 5: Tompahmax (1.45€)
Seat 6: okay Ninja85 (0.88€)
*** ANTE/BLINDS ***
curiouz dje posts small blind 0.01€
LilRun posts big blind 0.02€
Dealt to Fried Berg [Tc 7h]
*** PRE-FLOP *** 
Fried Berg folds
slowreplay folds
Tompahmax raises 0.02€ to 0.04€
okay Ninja85 folds
curiouz dje folds
LilRun folds
Tompahmax collected 0.07€ from pot
*** SUMMARY ***
Total pot 0.07€ | No rake
Seat 5: Tompahmax won 0.07€


Winamax Poker - HOLD-UP "Colorado" - HandId: #19116069-314399-1701422275 - Holdem no limit (0.01€/0.02€) - 2023/12/01 09:17:55 UTC
Table: 'Colorado' 6-max (real money) Seat #6 is the button
Seat 1: Cejargordas (4.84€)
Seat 2: Fried Berg (2.02€)
Seat 3: sopra61 (1.25€)
Seat 4: Joueur-15405 (1.81€)
Seat 5: Nicoo49003 (2.11€)
Seat 6: PffffUuuu (0.47€)
*** ANTE/BLINDS ***
Cejargordas posts small blind 0.01€
Fried Berg posts big blind 0.02€
Dealt to Fried Berg [7c 9h]
*** PRE-FLOP *** 
sopra61 folds
Joueur-15405 folds
Nicoo49003 calls 0.02€
PffffUuuu folds
Cejargordas folds
Fried Berg checks
*** FLOP *** [Ts 6d 5h]
Fried Berg checks
Nicoo49003 checks
*** TURN *** [Ts 6d 5h][Ks]
Fried Berg checks
Nicoo49003 bets 0.02€
Fried Berg calls 0.02€
*** RIVER *** [Ts 6d 5h Ks][Tc]
Fried Berg checks
Nicoo49003 bets 0.06€
Fried Berg folds
Nicoo49003 collected 0.14€ from pot
*** SUMMARY ***
Total pot 0.14€ | Rake 0.01€
Board: [Ts 6d 5h Ks Tc]
Seat 5: Nicoo49003 won 0.14€


Winamax Poker - HOLD-UP "Colorado" - HandId: #19116069-314433-1701422306 - Holdem no limit (0.01€/0.02€) - 2023/12/01 09:18:26 UTC
Table: 'Colorado' 6-max (real money) Seat #6 is the button
Seat 1: PaitOn (3.41€)
Seat 2: Dovisclaire (1.05€)
Seat 3: KON-2-PEUTE (2.07€)
Seat 4: Cejargordas (5.50€)
Seat 5: HumAftAll (2€)
Seat 6: Fried Berg (1.98€)
Hold-up to Pot: total 0.10€
*** ANTE/BLINDS ***
PaitOn posts small blind 0.01€
Dovisclaire posts big blind 0.02€
Dealt to Fried Berg [Td Ah]
*** PRE-FLOP *** 
KON-2-PEUTE raises 0.03€ to 0.05€
Cejargordas raises 0.10€ to 0.15€
HumAftAll folds
Fried Berg calls 0.15€
PaitOn folds
Dovisclaire folds
KON-2-PEUTE calls 0.10€
*** FLOP *** [As 3d 4d]
KON-2-PEUTE checks
Cejargordas bets 0.29€
Fried Berg calls 0.29€
KON-2-PEUTE folds
*** TURN *** [As 3d 4d][9d]
Cejargordas bets 5.06€ and is all-in
Fried Berg calls 1.54€ and is all-in
*** RIVER *** [As 3d 4d 9d][9h]
*** SHOW DOWN ***
Fried Berg shows [Td Ah] (Two pairs : Aces and 9)
Cejargordas shows [Ad Kc] (Two pairs : Aces and 9)
Cejargordas collected 7.35€ from pot
*** SUMMARY ***
Total pot 7.35€ | Rake 0.41€
Board: [As 3d 4d 9d 9h]
Seat 4: Cejargordas showed [Ad Kc] and won 7.35€ with Two pairs : Aces and 9
Seat 6: Fried Berg (button) showed [Td Ah] and lost with Two pairs : Aces and 9


Winamax Poker - HOLD-UP "Colorado" - HandId: #19116069-314480-1701422358 - Holdem no limit (0.01€/0.02€) - 2023/12/01 09:19:18 UTC
Table: 'Colorado' 6-max (real money) Seat #6 is the button
Seat 1: Fried Berg (0.50€)
Seat 2: Cejargordas (7.35€)
Seat 3: jdeepenslip (2.08€)
Seat 4: PACS 024 (1.87€)
Seat 5: g8o8k8u (2.06€)
Seat 6: slowreplay (2€)
*** ANTE/BLINDS ***
Fried Berg posts small blind 0.01€
Cejargordas posts big blind 0.02€
Dealt to Fried Berg [Ks 7d]
*** PRE-FLOP *** 
jdeepenslip raises 0.03€ to 0.05€
PACS 024 folds
g8o8k8u folds
slowreplay calls 0.05€
Fried Berg folds
Cejargordas folds
*** FLOP *** [Kc 7h 6s]
jdeepenslip checks
slowreplay checks
*** TURN *** [Kc 7h 6s][5s]
jdeepenslip checks
slowreplay bets 0.08€
jdeepenslip folds
slowreplay collected 0.20€ from pot
*** SUMMARY ***
Total pot 0.20€ | Rake 0.01€
Board: [Kc 7h 6s 5s]
Seat 6: slowreplay (button) won 0.20€


Winamax Poker - HOLD-UP "Colorado" - HandId: #19116069-314519-1701422399 - Holdem no limit (0.01€/0.02€) - 2023/12/01 09:19:59 UTC
Table: 'Colorado' 6-max (real money) Seat #6 is the button
Seat 1: curiouz dje (2.22€)
Seat 2: Perf-31 (2.23€)
Seat 3: Fried Berg (0.49€)
Seat 4: pelouseverte (0.72€)
Seat 5: okay Ninja85 (0.71€)
Seat 6: pivert 83 (1.87€)
*** ANTE/BLINDS ***
curiouz dje posts small blind 0.01€
Perf-31 posts big blind 0.02€
Dealt to Fried Berg [7h 4h]
*** PRE-FLOP *** 
Fried Berg folds
pelouseverte folds
okay Ninja85 folds
pivert 83 folds
curiouz dje folds
Perf-31 collected 0.03€ from pot
*** SUMMARY ***
Total pot 0.03€ | No rake
Seat 2: Perf-31 (big blind) won 0.03€


Winamax Poker - HOLD-UP "Colorado" - HandId: #19116069-314527-1701422410 - Holdem no limit (0.01€/0.02€) - 2023/12/01 09:20:10 UTC
Table: 'Colorado' 6-max (real money) Seat #6 is the button
Seat 1: Zanghief068 (2.10€)
Seat 2: okay Ninja85 (0.74€)
Seat 3: TheRealWill (2€)
Seat 4: Fried Berg (0.49€)
Seat 5: Tompahmax (2.02€)
Seat 6: KON-2-PEUTE (3.03€)
*** ANTE/BLINDS ***
Zanghief068 posts small blind 0.01€
okay Ninja85 posts big blind 0.02€
Dealt to Fried Berg [5d Kd]
*** PRE-FLOP *** 
TheRealWill folds
Fried Berg folds
Tompahmax raises 0.04€ to 0.06€
KON-2-PEUTE folds
Zanghief068 folds
okay Ninja85 folds
Tompahmax collected 0.09€ from pot
*** SUMMARY ***
Total pot 0.09€ | No rake
Seat 5: Tompahmax won 0.09€


Winamax Poker - HOLD-UP "Colorado" - HandId: #19116069-314533-1701422417 - Holdem no limit (0.01€/0.02€) - 2023/12/01 09:20:17 UTC
Table: 'Colorado' 6-max (real money) Seat #6 is the button
Seat 1: Jimmy91lenny (2.01€)
Seat 2: jdeepenslip (2.03€)
Seat 3: curiouz dje (2€)
Seat 4: MeR2GPa1rOnd (2€)
Seat 5: Hydramist (6.25€)
Seat 6: Fried Berg (0.49€)
*** ANTE/BLINDS ***
Jimmy91lenny posts small blind 0.01€
jdeepenslip posts big blind 0.02€
Dealt to Fried Berg [Jd As]
*** PRE-FLOP *** 
curiouz dje folds
MeR2GPa1rOnd folds
Hydramist folds
Fried Berg raises 0.04€ to 0.06€
Jimmy91lenny calls 0.05€
jdeepenslip folds
*** FLOP *** [3d Qc 5c]
Jimmy91lenny checks
Fried Berg checks
*** TURN *** [3d Qc 5c][9s]
Jimmy91lenny bets 0.14€
Fried Berg folds
Jimmy91lenny collected 0.27€ from pot
*** SUMMARY ***
Total pot 0.27€ | Rake 0.01€
Board: [3d Qc 5c 9s]
Seat 1: Jimmy91lenny (small blind) won 0.27€


Winamax Poker - HOLD-UP "Colorado" - HandId: #19116069-314560-1701422446 - Holdem no limit (0.01€/0.02€) - 2023/12/01 09:20:46 UTC
Table: 'Colorado' 6-max (real money) Seat #6 is the button
Seat 1: BetQuiMonte (4.16€)
Seat 2: Fried Berg (0.43€)
Seat 3: HumAftAll (2.18€)
Seat 4: Whale-1600 (2€)
Seat 5: jdeepenslip (2€)
Seat 6: pivert 83 (1.57€)
*** ANTE/BLINDS ***
BetQuiMonte posts small blind 0.01€
Fried Berg posts big blind 0.02€
Dealt to Fried Berg [7c As]
*** PRE-FLOP *** 
HumAftAll raises 0.04€ to 0.06€
Whale-1600 folds
jdeepenslip folds
pivert 83 folds
BetQuiMonte calls 0.05€
Fried Berg folds
*** FLOP *** [2s 2h 6h]
BetQuiMonte checks
HumAftAll bets 0.05€
BetQuiMonte folds
HumAftAll collected 0.18€ from pot
*** SUMMARY ***
Total pot 0.18€ | Rake 0.01€
Board: [2s 2h 6h]
Seat 3: HumAftAll won 0.18€


Winamax Poker - HOLD-UP "Colorado" - HandId: #19116069-314562-1701422449 - Holdem no limit (0.01€/0.02€) - 2023/12/01 09:20:49 UTC
Table: 'Colorado' 6-max (real money) Seat #6 is the button
Seat 1: KON-2-PEUTE (2€)
Seat 2: pivert 83 (1.57€)
Seat 3: Jimmy91lenny (2.08€)
Seat 4: jdeepenslip (2€)
Seat 5: Fried Berg (0.41€)
Seat 6: Perf-31 (2.22€)
*** ANTE/BLINDS ***
KON-2-PEUTE posts small blind 0.01€
pivert 83 posts big blind 0.02€
Dealt to Fried Berg [6h 2s]
*** PRE-FLOP *** 
Jimmy91lenny calls 0.02€
jdeepenslip raises 0.06€ to 0.08€
Fried Berg folds
Perf-31 folds
KON-2-PEUTE calls 0.07€
pivert 83 folds
Jimmy91lenny calls 0.06€
*** FLOP *** [4d Jh Th]
KON-2-PEUTE checks
Jimmy91lenny checks
jdeepenslip checks
*** TURN *** [4d Jh Th][5s]
KON-2-PEUTE checks
Jimmy91lenny bets 0.17€
jdeepenslip folds
KON-2-PEUTE folds
Jimmy91lenny collected 0.40€ from pot
*** SUMMARY ***
Total pot 0.40€ | Rake 0.03€
Board: [4d Jh Th 5s]
Seat 3: Jimmy91lenny won 0.40€


Winamax Poker - HOLD-UP "Colorado" - HandId: #19116069-314565-1701422454 - Holdem no limit (0.01€/0.02€) - 2023/12/01 09:20:54 UTC
Table: 'Colorado' 6-max (real money) Seat #6 is the button
Seat 1: Fried Berg (0.41€)
Seat 2: Tompahmax (3.17€)
Seat 3: haouuum28 (2.38€)
Seat 4: Okapi_Poli29 (1.96€)
Seat 5: curiouz dje (2€)
Seat 6: pivert 83 (1.55€)
Hold-up to Pot: total 0.10€
*** ANTE/BLINDS ***
Fried Berg posts small blind 0.01€
Tompahmax posts big blind 0.02€
Dealt to Fried Berg [3c 5c]
*** PRE-FLOP *** 
haouuum28 folds
Okapi_Poli29 folds
curiouz dje raises 0.04€ to 0.06€
pivert 83 folds
Fried Berg calls 0.05€
Tompahmax folds
*** FLOP *** [Kc 5d 7c]
Fried Berg checks
curiouz dje bets 0.12€
Fried Berg calls 0.12€
*** TURN *** [Kc 5d 7c][8s]
Fried Berg checks
curiouz dje checks
*** RIVER *** [Kc 5d 7c 8s][8c]
Fried Berg bets 0.23€ and is all-in
curiouz dje folds
Fried Berg collected 0.67€ from pot
*** SUMMARY ***
Total pot 0.67€ | Rake 0.04€
Board: [Kc 5d 7c 8s 8c]
Seat 1: Fried Berg (small blind) won 0.67€


Winamax Poker - HOLD-UP "Colorado" - HandId: #19116069-314612-1701422509 - Holdem no limit (0.01€/0.02€) - 2023/12/01 09:21:49 UTC
Table: 'Colorado' 6-max (real money) Seat #6 is the button
Seat 1: PokerDede (1.11€)
Seat 2: Cejargordas (7.28€)
Seat 3: Fried Berg (0.67€)
Seat 4: FILTONFLOUSE (2€)
Seat 5: pivert 83 (1.54€)
Seat 6: curiouz dje (2€)
*** ANTE/BLINDS ***
PokerDede posts small blind 0.01€
Cejargordas posts big blind 0.02€
Dealt to Fried Berg [9h Kd]
*** PRE-FLOP *** 
Fried Berg folds
FILTONFLOUSE raises 0.04€ to 0.06€
pivert 83 folds
curiouz dje folds
PokerDede calls 0.05€
Cejargordas folds
*** FLOP *** [9d Qh 7s]
PokerDede checks
FILTONFLOUSE checks
*** TURN *** [9d Qh 7s][2s]
PokerDede checks
FILTONFLOUSE checks
*** RIVER *** [9d Qh 7s 2s][Ad]
PokerDede bets 0.05€
FILTONFLOUSE raises 0.05€ to 0.10€
PokerDede calls 0.05€
*** SHOW DOWN ***
PokerDede shows [8c Ac] (One pair : Aces)
FILTONFLOUSE shows [Kh As] (One pair : Aces)
FILTONFLOUSE collected 0.31€ from pot
*** SUMMARY ***
Total pot 0.31€ | Rake 0.03€
Board: [9d Qh 7s 2s Ad]
Seat 1: PokerDede (small blind) showed [8c Ac] and lost with One pair : Aces
Seat 4: FILTONFLOUSE showed [Kh As] and won 0.31€ with One pair : Aces


Winamax Poker - HOLD-UP "Colorado" - HandId: #19116069-314618-1701422513 - Holdem no limit (0.01€/0.02€) - 2023/12/01 09:21:53 UTC
Table: 'Colorado' 6-max (real money) Seat #6 is the button
Seat 1: Tompahmax (2.06€)
Seat 2: curiouz dje (2.26€)
Seat 3: Dovisclaire (0.98€)
Seat 4: Tiken04 (2.17€)
Seat 5: Fried Berg (0.67€)
Seat 6: karma- (5.72€)
*** ANTE/BLINDS ***
Tompahmax posts small blind 0.01€
curiouz dje posts big blind 0.02€
Dealt to Fried Berg [9d 2h]
*** PRE-FLOP *** 
Dovisclaire folds
Tiken04 folds
Fried Berg folds
karma- folds
Tompahmax calls 0.01€
curiouz dje checks
*** FLOP *** [9h 5c 4s]
Tompahmax checks
curiouz dje bets 0.03€
Tompahmax folds
curiouz dje collected 0.07€ from pot
*** SUMMARY ***
Total pot 0.07€ | No rake
Board: [9h 5c 4s]
Seat 2: curiouz dje (big blind) won 0.07€


Winamax Poker - HOLD-UP "Colorado" - HandId: #19116069-314623-1701422517 - Holdem no limit (0.01€/0.02€) - 2023/12/01 09:21:57 UTC
Table: 'Colorado' 6-max (real money) Seat #6 is the button
Seat 1: karma- (5.72€)
Seat 2: Joueur-15405 (1.74€)
Seat 3: TheRealWill (2€)
Seat 4: Okapi_Poli29 (1.99€)
Seat 5: tichettede3 (2€)
Seat 6: Fried Berg (0.67€)
*** ANTE/BLINDS ***
karma- posts small blind 0.01€
Joueur-15405 posts big blind 0.02€
Dealt to Fried Berg [7h 5c]
*** PRE-FLOP *** 
TheRealWill folds
Okapi_Poli29 raises 0.03€ to 0.05€
tichettede3 folds
Fried Berg folds
karma- folds
Joueur-15405 folds
Okapi_Poli29 collected 0.08€ from pot
*** SUMMARY ***
Total pot 0.08€ | No rake
Seat 4: Okapi_Poli29 won 0.08€


Winamax Poker - HOLD-UP "Colorado" - HandId: #19116069-314625-1701422519 - Holdem no limit (0.01€/0.02€) - 2023/12/01 09:21:59 UTC
Table: 'Colorado' 6-max (real money) Seat #6 is the button
Seat 1: Toon89 (4.42€)
Seat 2: DoNPaPaMaSS (4.14€)
Seat 3: Fried Berg (0.67€)
Seat 4: Dovisclaire (0.98€)
Seat 5: MaryCandies (1.38€)
Seat 6: Hagreed (2.15€)
*** ANTE/BLINDS ***
Toon89 posts small blind 0.01€
DoNPaPaMaSS posts big blind 0.02€
Dealt to Fried Berg [8s 3s]
*** PRE-FLOP *** 
Fried Berg folds
Dovisclaire folds
MaryCandies folds
Hagreed folds
Toon89 calls 0.01€
DoNPaPaMaSS checks
*** FLOP *** [3c 9d 2d]
Toon89 checks
DoNPaPaMaSS bets 0.05€
Toon89 folds
DoNPaPaMaSS collected 0.09€ from pot
*** SUMMARY ***
Total pot 0.09€ | No rake
Board: [3c 9d 2d]
Seat 2: DoNPaPaMaSS (big blind) won 0.09€


Winamax Poker - HOLD-UP "Colorado" - HandId: #19116069-314628-1701422523 - Holdem no limit (0.01€/0.02€) - 2023/12/01 09:22:03 UTC
Table: 'Colorado' 6-max (real money) Seat #6 is the button
Seat 1: MCGHansen (2€)
Seat 2: Fried Berg (0.67€)
Seat 3: slowreplay (2.12€)
Seat 4: TheRealWill (2€)
Seat 5: PffffUuuu (0.69€)
Seat 6: PEPEKA (2.13€)
*** ANTE/BLINDS ***
MCGHansen posts small blind 0.01€
Fried Berg posts big blind 0.02€
Dealt to Fried Berg [Kd Qd]
*** PRE-FLOP *** 
slowreplay folds
TheRealWill raises 0.04€ to 0.06€
PffffUuuu folds
PEPEKA folds
MCGHansen folds
Fried Berg raises 0.12€ to 0.18€
TheRealWill folds
Fried Berg collected 0.25€ from pot
*** SUMMARY ***
Total pot 0.25€ | No rake
Seat 2: Fried Berg (big blind) won 0.25€


Winamax Poker - HOLD-UP "Colorado" - HandId: #19116069-314666-1701422565 - Holdem no limit (0.01€/0.02€) - 2023/12/01 09:22:45 UTC
Table: 'Colorado' 6-max (real money) Seat #6 is the button
Seat 1: Tiken04 (2.21€)
Seat 2: DoNPaPaMaSS (4.15€)
Seat 3: PokerDede (0.93€)
Seat 4: Fried Berg (0.74€)
Seat 5: HumAftAll (2.73€)
Seat 6: Hydramist (6.24€)
*** ANTE/BLINDS ***
Tiken04 posts small blind 0.01€
DoNPaPaMaSS posts big blind 0.02€
Dealt to Fried Berg [Kc Jd]
*** PRE-FLOP *** 
PokerDede folds
Fried Berg raises 0.04€ to 0.06€
HumAftAll folds
Hydramist folds
Tiken04 calls 0.05€
DoNPaPaMaSS folds
*** FLOP *** [3c Qh 5c]
Tiken04 checks
Fried Berg checks
*** TURN *** [3c Qh 5c][9d]
Tiken04 checks
Fried Berg checks
*** RIVER *** [3c Qh 5c 9d][As]
Tiken04 checks
Fried Berg checks
*** SHOW DOWN ***
Fried Berg shows [Kc Jd] (High card : Ace)
Tiken04 shows [4c 4d] (One pair : 4)
Tiken04 collected 0.13€ from pot
*** SUMMARY ***
Total pot 0.13€ | Rake 0.01€
Board: [3c Qh 5c 9d As]
Seat 1: Tiken04 (small blind) showed [4c 4d] and won 0.13€ with One pair : 4
Seat 4: Fried Berg showed [Kc Jd] and lost with High card : Ace


Winamax Poker - HOLD-UP "Colorado" - HandId: #19116069-314693-1701422596 - Holdem no limit (0.01€/0.02€) - 2023/12/01 09:23:16 UTC
Table: 'Colorado' 6-max (real money) Seat #6 is the button
Seat 1: pelouseverte (0.98€)
Seat 2: FILTONFLOUSE (2.17€)
Seat 3: Hydramist (6.21€)
Seat 4: PACS 024 (1.98€)
Seat 5: Tiken04 (2.28€)
Seat 6: Fried Berg (0.68€)
Hold-up to Pot: total 0.20€
*** ANTE/BLINDS ***
pelouseverte posts small blind 0.01€
FILTONFLOUSE posts big blind 0.02€
Dealt to Fried Berg [3h 5h]
*** PRE-FLOP *** 
Hydramist folds
PACS 024 raises 0.04€ to 0.06€
Tiken04 raises 0.35€ to 0.41€
Fried Berg folds
pelouseverte folds
FILTONFLOUSE folds
PACS 024 calls 0.35€
*** FLOP *** [Ks Ah 6d]
PACS 024 checks
Tiken04 bets 0.26€
PACS 024 calls 0.26€
*** TURN *** [Ks Ah 6d][6c]
PACS 024 checks
Tiken04 checks
*** RIVER *** [Ks Ah 6d 6c][3c]
PACS 024 bets 1.31€ and is all-in
Tiken04 folds
PACS 024 collected 2.74€ from pot
*** SUMMARY ***
Total pot 2.74€ | Rake 0.14€
Board: [Ks Ah 6d 6c 3c]
Seat 4: PACS 024 won 2.74€


Winamax Poker - HOLD-UP "Colorado" - HandId: #19116069-314722-1701422633 - Holdem no limit (0.01€/0.02€) - 2023/12/01 09:23:53 UTC
Table: 'Colorado' 6-max (real money) Seat #6 is the button
Seat 1: curiouz dje (2€)
Seat 2: slowreplay (2.07€)
Seat 3: whiteclover (1.92€)
Seat 4: FILTONFLOUSE (2.15€)
Seat 5: jdeepenslip (2€)
Seat 6: Fried Berg (0.68€)
*** ANTE/BLINDS ***
curiouz dje posts small blind 0.01€
slowreplay posts big blind 0.02€
Dealt to Fried Berg [Tc Jc]
*** PRE-FLOP *** 
whiteclover folds
FILTONFLOUSE folds
jdeepenslip folds
Fried Berg raises 0.04€ to 0.06€
curiouz dje folds
slowreplay folds
Fried Berg collected 0.09€ from pot
*** SUMMARY ***
Total pot 0.09€ | No rake
Seat 6: Fried Berg (button) won 0.09€


Winamax Poker - HOLD-UP "Colorado" - HandId: #19116069-314734-1701422644 - Holdem no limit (0.01€/0.02€) - 2023/12/01 09:24:04 UTC
Table: 'Colorado' 6-max (real money) Seat #6 is the button
Seat 1: PEPEKA (2.20€)
Seat 2: Fried Berg (0.71€)
Seat 3: DoNPaPaMaSS (4.03€)
Seat 4: Okapi_Poli29 (2.15€)
Seat 5: haouuum28 (1.94€)
Seat 6: FILTONFLOUSE (2.58€)
Hold-up to Pot: total 0.10€
*** ANTE/BLINDS ***
PEPEKA posts small blind 0.01€
Fried Berg posts big blind 0.02€
Dealt to Fried Berg [9c 7c]
*** PRE-FLOP *** 
DoNPaPaMaSS folds
Okapi_Poli29 raises 0.03€ to 0.05€
haouuum28 folds
FILTONFLOUSE folds
PEPEKA calls 0.04€
Fried Berg calls 0.03€
*** FLOP *** [Kh 3h 6d]
PEPEKA checks
Fried Berg checks
Okapi_Poli29 checks
*** TURN *** [Kh 3h 6d][7h]
PEPEKA checks
Fried Berg checks
Okapi_Poli29 checks
*** RIVER *** [Kh 3h 6d 7h][Ad]
PEPEKA checks
Fried Berg checks
Okapi_Poli29 checks
*** SHOW DOWN ***
PEPEKA shows [Qc Td] (High card : Ace)
Okapi_Poli29 shows [Js 2s] (High card : Ace)
Fried Berg shows [9c 7c] (One pair : 7)
Fried Berg collected 0.23€ from pot
*** SUMMARY ***
Total pot 0.23€ | Rake 0.02€
Board: [Kh 3h 6d 7h Ad]
Seat 1: PEPEKA (small blind) showed [Qc Td] and lost with High card : Ace
Seat 2: Fried Berg (big blind) showed [9c 7c] and won 0.23€ with One pair : 7
Seat 4: Okapi_Poli29 showed [Js 2s] and lost with High card : Ace


Winamax Poker - HOLD-UP "Colorado" - HandId: #19116069-314770-1701422682 - Holdem no limit (0.01€/0.02€) - 2023/12/01 09:24:42 UTC
Table: 'Colorado' 6-max (real money) Seat #6 is the button
Seat 1: Fried Berg (0.89€)
Seat 2: FILTONFLOUSE (2.11€)
Seat 3: tequilaaaa (2.14€)
Seat 4: slowreplay (2.04€)
Seat 5: Okapi_Poli29 (2.10€)
Seat 6: jdeepenslip (2.67€)
*** ANTE/BLINDS ***
Fried Berg posts small blind 0.01€
FILTONFLOUSE posts big blind 0.02€
Dealt to Fried Berg [4h 3d]
*** PRE-FLOP *** 
tequilaaaa folds
slowreplay folds
Okapi_Poli29 folds
jdeepenslip folds
Fried Berg folds
FILTONFLOUSE collected 0.03€ from pot
*** SUMMARY ***
Total pot 0.03€ | No rake
Seat 2: FILTONFLOUSE (big blind) won 0.03€


Winamax Poker - HOLD-UP "Colorado" - HandId: #19116069-314779-1701422689 - Holdem no limit (0.01€/0.02€) - 2023/12/01 09:24:49 UTC
Table: 'Colorado' 6-max (real money) Seat #6 is the button
Seat 1: Patufet29 (2.39€)
Seat 2: Tompahmax (2.46€)
Seat 3: BMW-Z4 (3.32€)
Seat 4: Fried Berg (0.88€)
Seat 5: Tiken04 (2.15€)
Seat 6: Hydramist (6.14€)
*** ANTE/BLINDS ***
Patufet29 posts small blind 0.01€
Tompahmax posts big blind 0.02€
Dealt to Fried Berg [6h 6d]
*** PRE-FLOP *** 
BMW-Z4 raises 0.04€ to 0.06€
Fried Berg folds
Tiken04 folds
Hydramist folds
Patufet29 folds
Tompahmax folds
BMW-Z4 collected 0.09€ from pot
*** SUMMARY ***
Total pot 0.09€ | No rake
Seat 3: BMW-Z4 won 0.09€


Winamax Poker - HOLD-UP "Colorado" - HandId: #19116069-314791-1701422700 - Holdem no limit (0.01€/0.02€) - 2023/12/01 09:25:00 UTC
Table: 'Colorado' 6-max (real money) Seat #6 is the button
Seat 1: PokerDede (1.04€)
Seat 2: Fried Berg (0.88€)
Seat 3: Whale-1600 (2€)
Seat 4: slowreplay (2.13€)
Seat 5: curiouz dje (2.14€)
Seat 6: tequilaaaa (2.11€)
*** ANTE/BLINDS ***
PokerDede posts small blind 0.01€
Fried Berg posts big blind 0.02€
Dealt to Fried Berg [8d 9h]
*** PRE-FLOP *** 
Whale-1600 folds
slowreplay folds
curiouz dje raises 0.03€ to 0.05€
tequilaaaa folds
PokerDede folds
Fried Berg folds
curiouz dje collected 0.08€ from pot
*** SUMMARY ***
Total pot 0.08€ | No rake
Seat 5: curiouz dje won 0.08€


Winamax Poker - HOLD-UP "Colorado" - HandId: #19116069-314811-1701422720 - Holdem no limit (0.01€/0.02€) - 2023/12/01 09:25:20 UTC
Table: 'Colorado' 6-max (real money) Seat #6 is the button
Seat 1: haouuum28 (1.66€)
Seat 2: slowreplay (2.05€)
Seat 3: momoiheb (0.20€)
Seat 4: Nicoo49003 (2.05€)
Seat 5: Fried Berg (0.86€)
Seat 6: Tompahmax (2.40€)
*** ANTE/BLINDS ***
haouuum28 posts small blind 0.01€
slowreplay posts big blind 0.02€
Dealt to Fried Berg [Jd 6h]
*** PRE-FLOP *** 
momoiheb folds
Nicoo49003 calls 0.02€
Fried Berg folds
Tompahmax folds
haouuum28 folds
slowreplay checks
*** FLOP *** [8c 5s Kh]
slowreplay checks
Nicoo49003 bets 0.03€
slowreplay folds
Nicoo49003 collected 0.07€ from pot
*** SUMMARY ***
Total pot 0.07€ | Rake 0.01€
Board: [8c 5s Kh]
Seat 4: Nicoo49003 won 0.07€


Winamax Poker - HOLD-UP "Colorado" - HandId: #19116069-314819-1701422725 - Holdem no limit (0.01€/0.02€) - 2023/12/01 09:25:25 UTC
Table: 'Colorado' 6-max (real money) Seat #6 is the button
Seat 1: Hydramist (3.62€)
Seat 2: TheRealWill (3.22€)
Seat 3: Tompahmax (2.38€)
Seat 4: Manupoy (0.96€)
Seat 5: haouuum28 (1.65€)
Seat 6: Fried Berg (0.86€)
*** ANTE/BLINDS ***
Hydramist posts small blind 0.01€
TheRealWill posts big blind 0.02€
Dealt to Fried Berg [Td 4s]
*** PRE-FLOP *** 
Tompahmax folds
Manupoy raises 0.03€ to 0.05€
haouuum28 folds
Fried Berg folds
Hydramist folds
TheRealWill folds
Manupoy collected 0.08€ from pot
*** SUMMARY ***
Total pot 0.08€ | No rake
Seat 4: Manupoy won 0.08€


Winamax Poker - HOLD-UP "Colorado" - HandId: #19116069-314820-1701422728 - Holdem no limit (0.01€/0.02€) - 2023/12/01 09:25:28 UTC
Table: 'Colorado' 6-max (real money) Seat #6 is the button
Seat 1: Bacardi34 (2.93€)
Seat 2: DDDIEU33 (1.54€)
Seat 3: Adrianohhhh (2.16€)
Seat 4: Fried Berg (0.86€)
Seat 5: haouuum28 (1.65€)
Seat 6: Tompahmax (2.38€)
*** ANTE/BLINDS ***
Bacardi34 posts small blind 0.01€
DDDIEU33 posts big blind 0.02€
Dealt to Fried Berg [Jc 8c]
*** PRE-FLOP *** 
Adrianohhhh folds
Fried Berg calls 0.02€
haouuum28 folds
Tompahmax folds
Bacardi34 raises 0.02€ to 0.04€
DDDIEU33 calls 0.02€
Fried Berg calls 0.02€
*** FLOP *** [As 8s 9c]
Bacardi34 checks
DDDIEU33 checks
Fried Berg checks
*** TURN *** [As 8s 9c][2s]
Bacardi34 bets 0.08€
DDDIEU33 folds
Fried Berg calls 0.08€
*** RIVER *** [As 8s 9c 2s][Ts]
Bacardi34 checks
Fried Berg checks
*** SHOW DOWN ***
Fried Berg shows [Jc 8c] (One pair : 8)
Bacardi34 shows [2d 2h] (Trips of 2)
Bacardi34 collected 0.25€ from pot
*** SUMMARY ***
Total pot 0.25€ | Rake 0.03€
Board: [As 8s 9c 2s Ts]
Seat 1: Bacardi34 (small blind) showed [2d 2h] and won 0.25€ with Trips of 2
Seat 4: Fried Berg showed [Jc 8c] and lost with One pair : 8


Winamax Poker - HOLD-UP "Colorado" - HandId: #19116069-314857-1701422765 - Holdem no limit (0.01€/0.02€) - 2023/12/01 09:26:05 UTC
Table: 'Colorado' 6-max (real money) Seat #6 is the button
Seat 1: MeR2GPa1rOnd (2.36€)
Seat 2: Cejargordas (5.44€)
Seat 3: Bacardi34 (3.06€)
Seat 4: DonKmillo (1.61€)
Seat 5: Fried Berg (0.74€)
Seat 6: fifi2308 (1.95€)
*** ANTE/BLINDS ***
MeR2GPa1rOnd posts small blind 0.01€
Cejargordas posts big blind 0.02€
Dealt to Fried Berg [Qs 5d]
*** PRE-FLOP *** 
Bacardi34 calls 0.02€
DonKmillo folds
Fried Berg folds
fifi2308 folds
MeR2GPa1rOnd folds
Cejargordas checks
*** FLOP *** [3s Jh Ah]
Cejargordas checks
Bacardi34 bets 0.02€
Cejargordas calls 0.02€
*** TURN *** [3s Jh Ah][8d]
Cejargordas checks
Bacardi34 bets 0.06€
Cejargordas folds
Bacardi34 collected 0.14€ from pot
*** SUMMARY ***
Total pot 0.14€ | Rake 0.01€
Board: [3s Jh Ah 8d]
Seat 3: Bacardi34 won 0.14€


Winamax Poker - HOLD-UP "Colorado" - HandId: #19116069-314878-1701422787 - Holdem no limit (0.01€/0.02€) - 2023/12/01 09:26:27 UTC
Table: 'Colorado' 6-max (real money) Seat #6 is the button
Seat 1: symons_d2z (1.59€)
Seat 2: curiouz dje (2.45€)
Seat 3: Zanghief068 (2.03€)
Seat 4: KON-2-PEUTE (2€)
Seat 5: slowreplay (2.17€)
Seat 6: Fried Berg (0.74€)
*** ANTE/BLINDS ***
symons_d2z posts small blind 0.01€
curiouz dje posts big blind 0.02€
Dealt to Fried Berg [Kd 5c]
*** PRE-FLOP *** 
Zanghief068 calls 0.02€
KON-2-PEUTE folds
slowreplay folds
Fried Berg folds
symons_d2z folds
curiouz dje checks
*** FLOP *** [7s 7d 2d]
curiouz dje bets 0.05€
Zanghief068 folds
curiouz dje collected 0.09€ from pot
*** SUMMARY ***
Total pot 0.09€ | Rake 0.01€
Board: [7s 7d 2d]
Seat 2: curiouz dje (big blind) won 0.09€


Winamax Poker - HOLD-UP "Colorado" - HandId: #19116069-314902-1701422812 - Holdem no limit (0.01€/0.02€) - 2023/12/01 09:26:52 UTC
Table: 'Colorado' 6-max (real money) Seat #6 is the button
Seat 1: tequilaaaa (2.04€)
Seat 2: jdeepenslip (2.76€)
Seat 3: Hydramist (6.20€)
Seat 4: magicfido (0.93€)
Seat 5: Cejargordas (7.29€)
Seat 6: Fried Berg (0.74€)
*** ANTE/BLINDS ***
tequilaaaa posts small blind 0.01€
jdeepenslip posts big blind 0.02€
Dealt to Fried Berg [9h Tc]
*** PRE-FLOP *** 
Hydramist folds
magicfido folds
Cejargordas folds
Fried Berg raises 0.02€ to 0.04€
tequilaaaa folds
jdeepenslip folds
Fried Berg collected 0.07€ from pot
*** SUMMARY ***
Total pot 0.07€ | No rake
Seat 6: Fried Berg (button) won 0.07€


Winamax Poker - HOLD-UP "Colorado" - HandId: #19116069-314918-1701422831 - Holdem no limit (0.01€/0.02€) - 2023/12/01 09:27:11 UTC
Table: 'Colorado' 6-max (real money) Seat #6 is the button
Seat 1: Fried Berg (0.77€)
Seat 2: Titine543 (1.18€)
Seat 3: tequilaaaa (2.03€)
Seat 4: jdeepenslip (2.74€)
Seat 5: AfgaBoBpoKer (0.59€)
Seat 6: BIGDEAL63 (1.03€)
*** ANTE/BLINDS ***
Fried Berg posts small blind 0.01€
Titine543 posts big blind 0.02€
Dealt to Fried Berg [Td Ad]
*** PRE-FLOP *** 
tequilaaaa folds
jdeepenslip folds
AfgaBoBpoKer calls 0.02€
BIGDEAL63 raises 0.04€ to 0.06€
Fried Berg calls 0.05€
Titine543 folds
AfgaBoBpoKer calls 0.04€
*** FLOP *** [Ts Kd 8h]
Fried Berg checks
AfgaBoBpoKer bets 0.02€
BIGDEAL63 folds
Fried Berg calls 0.02€
*** TURN *** [Ts Kd 8h][Jd]
Fried Berg checks
AfgaBoBpoKer bets 0.16€
Fried Berg calls 0.16€
*** RIVER *** [Ts Kd 8h Jd][4d]
Fried Berg checks
AfgaBoBpoKer checks
*** SHOW DOWN ***
AfgaBoBpoKer shows [Tc 4c] (Two pairs : Tens and 4)
Fried Berg shows [Td Ad] (Flush Ace high)
Fried Berg collected 0.50€ from pot
*** SUMMARY ***
Total pot 0.50€ | Rake 0.06€
Board: [Ts Kd 8h Jd 4d]
Seat 1: Fried Berg (small blind) showed [Td Ad] and won 0.50€ with Flush Ace high
Seat 5: AfgaBoBpoKer showed [Tc 4c] and lost with Two pairs : Tens and 4


Winamax Poker - HOLD-UP "Colorado" - HandId: #19116069-314962-1701422890 - Holdem no limit (0.01€/0.02€) - 2023/12/01 09:28:10 UTC
Table: 'Colorado' 6-max (real money) Seat #6 is the button
Seat 1: Okapi_Poli29 (1.67€)
Seat 2: AfgaBoBpoKer (0.35€)
Seat 3: BIGDEAL63 (0.97€)
Seat 4: slowreplay (2€)
Seat 5: SirX (2.95€)
Seat 6: Fried Berg (1.03€)
*** ANTE/BLINDS ***
Okapi_Poli29 posts small blind 0.01€
AfgaBoBpoKer posts big blind 0.02€
Dealt to Fried Berg [7s Qd]
*** PRE-FLOP *** 
BIGDEAL63 raises 0.05€ to 0.07€
slowreplay folds
SirX calls 0.07€
Fried Berg folds
Okapi_Poli29 folds
AfgaBoBpoKer folds
*** FLOP *** [Jh Js 2d]
BIGDEAL63 checks
SirX checks
*** TURN *** [Jh Js 2d][6h]
BIGDEAL63 bets 0.17€
SirX calls 0.17€
*** RIVER *** [Jh Js 2d 6h][9c]
BIGDEAL63 bets 0.33€
SirX calls 0.33€
*** SHOW DOWN ***
BIGDEAL63 shows [7h Qh] (One pair : Jacks)
SirX shows [5h Jc] (Trips of Jacks)
SirX collected 1.05€ from pot
*** SUMMARY ***
Total pot 1.05€ | Rake 0.12€
Board: [Jh Js 2d 6h 9c]
Seat 3: BIGDEAL63 showed [7h Qh] and lost with One pair : Jacks
Seat 5: SirX showed [5h Jc] and won 1.05€ with Trips of Jacks


Winamax Poker - HOLD-UP "Colorado" - HandId: #19116069-314974-1701422905 - Holdem no limit (0.01€/0.02€) - 2023/12/01 09:28:25 UTC
Table: 'Colorado' 6-max (real money) Seat #6 is the button
Seat 1: Stelenox (2€)
Seat 2: Cejargordas (4.13€)
Seat 3: Fried Berg (1.03€)
Seat 4: Thequeen1205 (2€)
Seat 5: Jimmy91lenny (2.14€)
Seat 6: yann_Lord590 (5.39€)
*** ANTE/BLINDS ***
Stelenox posts small blind 0.01€
Cejargordas posts big blind 0.02€
Dealt to Fried Berg [6c 2d]
*** PRE-FLOP *** 
Fried Berg folds
Thequeen1205 folds
Jimmy91lenny calls 0.02€
yann_Lord590 calls 0.02€
Stelenox calls 0.01€
Cejargordas checks
*** FLOP *** [5h 6s 2s]
Stelenox checks
Cejargordas checks
Jimmy91lenny checks
yann_Lord590 bets 0.05€
Stelenox folds
Cejargordas folds
Jimmy91lenny folds
yann_Lord590 collected 0.12€ from pot
*** SUMMARY ***
Total pot 0.12€ | Rake 0.01€
Board: [5h 6s 2s]
Seat 6: yann_Lord590 (button) won 0.12€


Winamax Poker - HOLD-UP "Colorado" - HandId: #19116069-314979-1701422909 - Holdem no limit (0.01€/0.02€) - 2023/12/01 09:28:29 UTC
Table: 'Colorado' 6-max (real money) Seat #6 is the button
Seat 1: potard62 (1.94€)
Seat 2: Neferusobek (2€)
Seat 3: Okapi_Poli29 (1.66€)
Seat 4: Fried Berg (1.03€)
Seat 5: MeR2GPa1rOnd (2.93€)
Seat 6: Hydramist (2.04€)
*** ANTE/BLINDS ***
potard62 posts small blind 0.01€
Neferusobek posts big blind 0.02€
Dealt to Fried Berg [2d 3c]
*** PRE-FLOP *** 
Okapi_Poli29 raises 0.04€ to 0.06€
Fried Berg folds
MeR2GPa1rOnd folds
Hydramist calls 0.06€
potard62 folds
Neferusobek folds
*** FLOP *** [3d Qs 7c]
Okapi_Poli29 checks
Hydramist bets 0.05€
Okapi_Poli29 calls 0.05€
*** TURN *** [3d Qs 7c][Td]
Okapi_Poli29 checks
Hydramist bets 0.16€
Okapi_Poli29 folds
Hydramist collected 0.38€ from pot
*** SUMMARY ***
Total pot 0.38€ | Rake 0.03€
Board: [3d Qs 7c Td]
Seat 6: Hydramist (button) won 0.38€


Winamax Poker - HOLD-UP "Colorado" - HandId: #19116069-314985-1701422919 - Holdem no limit (0.01€/0.02€) - 2023/12/01 09:28:39 UTC
Table: 'Colorado' 6-max (real money) Seat #6 is the button
Seat 1: curiouz dje (2.98€)
Seat 2: Fried Berg (1.03€)
Seat 3: Neferusobek (2€)
Seat 4: DonKmillo (1.50€)
Seat 5: cygoud (2€)
Seat 6: KON-2-PEUTE (2.07€)
*** ANTE/BLINDS ***
curiouz dje posts small blind 0.01€
Fried Berg posts big blind 0.02€
Dealt to Fried Berg [Ks Ts]
*** PRE-FLOP *** 
Neferusobek folds
DonKmillo folds
cygoud folds
KON-2-PEUTE folds
curiouz dje folds
Fried Berg collected 0.03€ from pot
*** SUMMARY ***
Total pot 0.03€ | No rake
Seat 2: Fried Berg (big blind) won 0.03€


Winamax Poker - HOLD-UP "Colorado" - HandId: #19116069-314995-1701422930 - Holdem no limit (0.01€/0.02€) - 2023/12/01 09:28:50 UTC
Table: 'Colorado' 6-max (real money) Seat #6 is the button
Seat 1: Fried Berg (1.04€)
Seat 2: Emotif-Lion4 (2.37€)
Seat 3: sopra61 (1.06€)
Seat 4: PEPEKA (2.41€)
Seat 5: curiouz dje (2.97€)
Seat 6: Thequeen1205 (2€)
*** ANTE/BLINDS ***
Fried Berg posts small blind 0.01€
Emotif-Lion4 posts big blind 0.02€
Dealt to Fried Berg [Ad Ah]
*** PRE-FLOP *** 
sopra61 folds
PEPEKA folds
curiouz dje folds
Thequeen1205 folds
Fried Berg raises 0.04€ to 0.06€
Emotif-Lion4 calls 0.04€
*** FLOP *** [Ts 4c Jh]
Fried Berg bets 0.04€
Emotif-Lion4 folds
Fried Berg collected 0.15€ from pot
*** SUMMARY ***
Total pot 0.15€ | Rake 0.01€
Board: [Ts 4c Jh]
Seat 1: Fried Berg (small blind) won 0.15€


Winamax Poker - HOLD-UP "Colorado" - HandId: #19116069-315023-1701422969 - Holdem no limit (0.01€/0.02€) - 2023/12/01 09:29:29 UTC
Table: 'Colorado' 6-max (real money) Seat #6 is the button
Seat 1: cygoud (2.01€)
Seat 2: Fried Berg (1.09€)
Seat 3: Hydramist (3.60€)
Seat 4: PokerDede (0.96€)
Seat 5: Neferusobek (2€)
Seat 6: Justo_170382 (0.45€)
*** ANTE/BLINDS ***
cygoud posts small blind 0.01€
Fried Berg posts big blind 0.02€
Dealt to Fried Berg [9c 5c]
*** PRE-FLOP *** 
Hydramist folds
PokerDede folds
Neferusobek folds
Justo_170382 folds
cygoud folds
Fried Berg collected 0.03€ from pot
*** SUMMARY ***
Total pot 0.03€ | No rake
Seat 2: Fried Berg (big blind) won 0.03€


Winamax Poker - HOLD-UP "Colorado" - HandId: #19116069-315042-1701422989 - Holdem no limit (0.01€/0.02€) - 2023/12/01 09:29:49 UTC
Table: 'Colorado' 6-max (real money) Seat #6 is the button
Seat 1: LilRun (5.15€)
Seat 2: TheRealWill (3.44€)
Seat 3: Fried Berg (1.10€)
Seat 4: tichettede3 (3€)
Seat 5: Mercuryllo (2€)
Seat 6: Nicoo49003 (2.60€)
*** ANTE/BLINDS ***
LilRun posts small blind 0.01€
TheRealWill posts big blind 0.02€
Dealt to Fried Berg [Tc 6c]
*** PRE-FLOP *** 
Fried Berg calls 0.02€
tichettede3 folds
Mercuryllo folds
Nicoo49003 raises 0.07€ to 0.09€
LilRun calls 0.08€
TheRealWill folds
Fried Berg folds
*** FLOP *** [2c 7h 8h]
LilRun checks
Nicoo49003 bets 0.14€
LilRun folds
Nicoo49003 collected 0.34€ from pot
*** SUMMARY ***
Total pot 0.34€ | Rake 0.02€
Board: [2c 7h 8h]
Seat 6: Nicoo49003 (button) won 0.34€


Winamax Poker - HOLD-UP "Colorado" - HandId: #19116069-315060-1701423011 - Holdem no limit (0.01€/0.02€) - 2023/12/01 09:30:11 UTC
Table: 'Colorado' 6-max (real money) Seat #6 is the button
Seat 1: PACS 024 (2.43€)
Seat 2: Hydramist (2.26€)
Seat 3: MeR2GPa1rOnd (2.72€)
Seat 4: Fried Berg (1.08€)
Seat 5: slowreplay (2.64€)
Seat 6: cygoud (2€)
*** ANTE/BLINDS ***
PACS 024 posts small blind 0.01€
Hydramist posts big blind 0.02€
Dealt to Fried Berg [2s 8c]
*** PRE-FLOP *** 
MeR2GPa1rOnd folds
Fried Berg folds
slowreplay folds
cygoud folds
PACS 024 raises 0.04€ to 0.06€
Hydramist calls 0.04€
*** FLOP *** [Jd 3s 7h]
PACS 024 checks
Hydramist checks
*** TURN *** [Jd 3s 7h][Qs]
PACS 024 checks
Hydramist checks
*** RIVER *** [Jd 3s 7h Qs][6c]
PACS 024 bets 0.12€
Hydramist calls 0.12€
*** SHOW DOWN ***
Hydramist shows [As 7s] (One pair : 7)
PACS 024 shows [Qh Qd] (Trips of Queens)
PACS 024 collected 0.32€ from pot
*** SUMMARY ***
Total pot 0.32€ | Rake 0.04€
Board: [Jd 3s 7h Qs 6c]
Seat 1: PACS 024 (small blind) showed [Qh Qd] and won 0.32€ with Trips of Queens
Seat 2: Hydramist (big blind) showed [As 7s] and lost with One pair : 7


Winamax Poker - HOLD-UP "Colorado" - HandId: #19116069-315064-1701423016 - Holdem no limit (0.01€/0.02€) - 2023/12/01 09:30:16 UTC
Table: 'Colorado' 6-max (real money) Seat #6 is the button
Seat 1: cygoud (2€)
Seat 2: FabWest (2€)
Seat 3: Fried Berg (1.08€)
Seat 4: Emotif-Lion4 (2.31€)
Seat 5: TheRealWill (2.95€)
Seat 6: Neferusobek (2.19€)
*** ANTE/BLINDS ***
cygoud posts small blind 0.01€
FabWest posts big blind 0.02€
Dealt to Fried Berg [Ad 2s]
*** PRE-FLOP *** 
Fried Berg folds
Emotif-Lion4 calls 0.02€
TheRealWill folds
Neferusobek folds
cygoud folds
FabWest checks
*** FLOP *** [6s 5h Td]
FabWest checks
Emotif-Lion4 checks
*** TURN *** [6s 5h Td][4h]
FabWest checks
Emotif-Lion4 checks
*** RIVER *** [6s 5h Td 4h][3c]
FabWest checks
Emotif-Lion4 checks
*** SHOW DOWN ***
FabWest shows [Ah Jd] (High card : Ace)
Emotif-Lion4 shows [As Qd] (High card : Ace)
Emotif-Lion4 collected 0.04€ from pot
*** SUMMARY ***
Total pot 0.04€ | Rake 0.01€
Board: [6s 5h Td 4h 3c]
Seat 2: FabWest (big blind) showed [Ah Jd] and lost with High card : Ace
Seat 4: Emotif-Lion4 showed [As Qd] and won 0.04€ with High card : Ace


Winamax Poker - HOLD-UP "Colorado" - HandId: #19116069-315072-1701423024 - Holdem no limit (0.01€/0.02€) - 2023/12/01 09:30:24 UTC
Table: 'Colorado' 6-max (real money) Seat #6 is the button
Seat 1: Justo_170382 (0.43€)
Seat 2: Nicoo49003 (2.71€)
Seat 3: Fried Berg (1.08€)
Seat 4: jdeepenslip (2.68€)
Seat 5: _Croute_ (3.19€)
Seat 6: cygoud (2.04€)
*** ANTE/BLINDS ***
Justo_170382 posts small blind 0.01€
Nicoo49003 posts big blind 0.02€
Dealt to Fried Berg [As 8h]
*** PRE-FLOP *** 
Fried Berg raises 0.02€ to 0.04€
jdeepenslip folds
_Croute_ calls 0.04€
cygoud folds
Justo_170382 folds
Nicoo49003 calls 0.02€
*** FLOP *** [7d Td 2d]
Nicoo49003 checks
Fried Berg checks
_Croute_ bets 0.08€
Nicoo49003 folds
Fried Berg folds
_Croute_ collected 0.20€ from pot
*** SUMMARY ***
Total pot 0.20€ | Rake 0.01€
Board: [7d Td 2d]
Seat 5: _Croute_ won 0.20€


Winamax Poker - HOLD-UP "Colorado" - HandId: #19116069-315100-1701423056 - Holdem no limit (0.01€/0.02€) - 2023/12/01 09:30:56 UTC
Table: 'Colorado' 6-max (real money) Seat #6 is the button
Seat 1: slowreplay (2.09€)
Seat 2: curiouz dje (2.01€)
Seat 3: Never_Giv_UP (2€)
Seat 4: KON-2-PEUTE (2.01€)
Seat 5: tequilaaaa (2.19€)
Seat 6: Fried Berg (1.04€)
*** ANTE/BLINDS ***
slowreplay posts small blind 0.01€
curiouz dje posts big blind 0.02€
Dealt to Fried Berg [6c Kh]
*** PRE-FLOP *** 
Never_Giv_UP folds
KON-2-PEUTE folds
tequilaaaa folds
Fried Berg folds
slowreplay folds
curiouz dje collected 0.03€ from pot
*** SUMMARY ***
Total pot 0.03€ | No rake
Seat 2: curiouz dje (big blind) won 0.03€


Winamax Poker - HOLD-UP "Colorado" - HandId: #19116069-315110-1701423065 - Holdem no limit (0.01€/0.02€) - 2023/12/01 09:31:05 UTC
Table: 'Colorado' 6-max (real money) Seat #6 is the button
Seat 1: Fried Berg (1.04€)
Seat 2: DUCHE80 (0.50€)
Seat 3: PEPEKA (1.95€)
Seat 4: slowreplay (2.08€)
Seat 5: haouuum28 (1.81€)
Seat 6: pelouseverte (1.32€)
*** ANTE/BLINDS ***
Fried Berg posts small blind 0.01€
DUCHE80 posts big blind 0.02€
Dealt to Fried Berg [4d 9h]
*** PRE-FLOP *** 
PEPEKA folds
slowreplay folds
haouuum28 raises 0.02€ to 0.04€
pelouseverte folds
Fried Berg folds
DUCHE80 folds
haouuum28 collected 0.07€ from pot
*** SUMMARY ***
Total pot 0.07€ | No rake
Seat 5: haouuum28 won 0.07€


Winamax Poker - HOLD-UP "Colorado" - HandId: #19116069-315128-1701423082 - Holdem no limit (0.01€/0.02€) - 2023/12/01 09:31:22 UTC
Table: 'Colorado' 6-max (real money) Seat #6 is the button
Seat 1: Neferusobek (2.08€)
Seat 2: Tompahmax (2.28€)
Seat 3: Manupoy (1.32€)
Seat 4: FILTONFLOUSE (3.39€)
Seat 5: Fried Berg (1.03€)
Seat 6: pelouseverte (1.32€)
*** ANTE/BLINDS ***
Neferusobek posts small blind 0.01€
Tompahmax posts big blind 0.02€
Dealt to Fried Berg [8c 5d]
*** PRE-FLOP *** 
Manupoy folds
FILTONFLOUSE folds
Fried Berg folds
pelouseverte folds
Neferusobek folds
Tompahmax collected 0.03€ from pot
*** SUMMARY ***
Total pot 0.03€ | No rake
Seat 2: Tompahmax (big blind) won 0.03€


Winamax Poker - HOLD-UP "Colorado" - HandId: #19116069-315131-1701423084 - Holdem no limit (0.01€/0.02€) - 2023/12/01 09:31:24 UTC
Table: 'Colorado' 6-max (real money) Seat #6 is the button
Seat 1: cygoud (3.05€)
Seat 2: Patufet29 (2€)
Seat 3: Hydramist (2.08€)
Seat 4: Fried Berg (1.03€)
Seat 5: Max134Max (2.10€)
Seat 6: Manupoy (1.32€)
*** ANTE/BLINDS ***
cygoud posts small blind 0.01€
Patufet29 posts big blind 0.02€
Dealt to Fried Berg [8h Qd]
*** PRE-FLOP *** 
Hydramist folds
Fried Berg folds
Max134Max folds
Manupoy folds
cygoud folds
Patufet29 collected 0.03€ from pot
*** SUMMARY ***
Total pot 0.03€ | No rake
Seat 2: Patufet29 (big blind) won 0.03€


Winamax Poker - HOLD-UP "Colorado" - HandId: #19116069-315135-1701423089 - Holdem no limit (0.01€/0.02€) - 2023/12/01 09:31:29 UTC
Table: 'Colorado' 6-max (real money) Seat #6 is the button
Seat 1: Fried Berg (1.03€)
Seat 2: Max134Max (2.10€)
Seat 3: jdeepenslip (2€)
Seat 4: FILTONFLOUSE (2.65€)
Seat 5: tichettede3 (2.65€)
Seat 6: papashark14 (1.95€)
*** ANTE/BLINDS ***
Fried Berg posts small blind 0.01€
Max134Max posts big blind 0.02€
Dealt to Fried Berg [7d Ks]
*** PRE-FLOP *** 
jdeepenslip folds
FILTONFLOUSE folds
tichettede3 folds
papashark14 folds
Fried Berg folds
Max134Max collected 0.03€ from pot
*** SUMMARY ***
Total pot 0.03€ | No rake
Seat 2: Max134Max (big blind) won 0.03€


Winamax Poker - HOLD-UP "Colorado" - HandId: #19116069-315146-1701423103 - Holdem no limit (0.01€/0.02€) - 2023/12/01 09:31:43 UTC
Table: 'Colorado' 6-max (real money) Seat #6 is the button
Seat 1: papashark14 (1.87€)
Seat 2: Fried Berg (1.02€)
Seat 3: Neferusobek (2.45€)
Seat 4: bubka 1974 (2.02€)
Seat 5: jdeepenslip (2.54€)
Seat 6: haouuum28 (1.81€)
*** ANTE/BLINDS ***
papashark14 posts small blind 0.01€
Fried Berg posts big blind 0.02€
Dealt to Fried Berg [7d 2h]
*** PRE-FLOP *** 
Neferusobek folds
bubka 1974 calls 0.02€
jdeepenslip folds
haouuum28 folds
papashark14 folds
Fried Berg checks
*** FLOP *** [8c Ac Jc]
Fried Berg checks
bubka 1974 bets 0.05€
Fried Berg folds
bubka 1974 collected 0.09€ from pot
*** SUMMARY ***
Total pot 0.09€ | Rake 0.01€
Board: [8c Ac Jc]
Seat 4: bubka 1974 won 0.09€


Winamax Poker - HOLD-UP "Colorado" - HandId: #19116069-315156-1701423113 - Holdem no limit (0.01€/0.02€) - 2023/12/01 09:31:53 UTC
Table: 'Colorado' 6-max (real money) Seat #6 is the button
Seat 1: KON-2-PEUTE (2€)
Seat 2: Dovisclaire (0.87€)
Seat 3: Fried Berg (1€)
Seat 4: TheRealWill (3.01€)
Seat 5: MeR2GPa1rOnd (2.72€)
Seat 6: jdeepenslip (2.54€)
*** ANTE/BLINDS ***
KON-2-PEUTE posts small blind 0.01€
Dovisclaire posts big blind 0.02€
Dealt to Fried Berg [2d Qs]
*** PRE-FLOP *** 
Fried Berg folds
TheRealWill raises 0.04€ to 0.06€
MeR2GPa1rOnd raises 0.12€ to 0.18€
jdeepenslip folds
KON-2-PEUTE folds
Dovisclaire folds
TheRealWill raises 0.32€ to 0.50€
MeR2GPa1rOnd calls 0.32€
*** FLOP *** [Ah As Ac]
TheRealWill checks
MeR2GPa1rOnd bets 0.36€
TheRealWill calls 0.36€
*** TURN *** [Ah As Ac][9d]
TheRealWill checks
MeR2GPa1rOnd checks
*** RIVER *** [Ah As Ac 9d][3h]
TheRealWill bets 2.15€ and is all-in
MeR2GPa1rOnd folds
TheRealWill collected 3.72€ from pot
*** SUMMARY ***
Total pot 3.72€ | Rake 0.18€
Board: [Ah As Ac 9d 3h]
Seat 4: TheRealWill won 3.72€


Winamax Poker - HOLD-UP "Colorado" - HandId: #19116069-315158-1701423116 - Holdem no limit (0.01€/0.02€) - 2023/12/01 09:31:56 UTC
Table: 'Colorado' 6-max (real money) Seat #6 is the button
Seat 1: Emotif-Lion4 (2.34€)
Seat 2: jdeepenslip (2.54€)
Seat 3: bubka 1974 (2.04€)
Seat 4: FILTONFLOUSE (3.38€)
Seat 5: Fried Berg (1€)
Seat 6: Davidoo36 (0.16€)
*** ANTE/BLINDS ***
Emotif-Lion4 posts small blind 0.01€
jdeepenslip posts big blind 0.02€
Dealt to Fried Berg [8s 5d]
*** PRE-FLOP *** 
bubka 1974 folds
FILTONFLOUSE folds
Fried Berg folds
Davidoo36 calls 0.02€
Emotif-Lion4 calls 0.01€
jdeepenslip checks
*** FLOP *** [9c 6s Th]
Emotif-Lion4 checks
jdeepenslip checks
Davidoo36 bets 0.02€
Emotif-Lion4 folds
jdeepenslip folds
Davidoo36 collected 0.07€ from pot
*** SUMMARY ***
Total pot 0.07€ | Rake 0.01€
Board: [9c 6s Th]
Seat 6: Davidoo36 (button) won 0.07€


Winamax Poker - HOLD-UP "Colorado" - HandId: #19116069-315160-1701423120 - Holdem no limit (0.01€/0.02€) - 2023/12/01 09:32:00 UTC
Table: 'Colorado' 6-max (real money) Seat #6 is the button
Seat 1: FabWest (2.11€)
Seat 2: slowreplay (2.01€)
Seat 3: PACS 024 (2.61€)
Seat 4: Fried Berg (1€)
Seat 5: FILTONFLOUSE (3.38€)
Seat 6: cygoud (2.10€)
*** ANTE/BLINDS ***
FabWest posts small blind 0.01€
slowreplay posts big blind 0.02€
Dealt to Fried Berg [5h 2d]
*** PRE-FLOP *** 
PACS 024 folds
Fried Berg folds
FILTONFLOUSE folds
cygoud folds
FabWest raises 0.05€ to 0.07€
slowreplay folds
FabWest collected 0.09€ from pot
*** SUMMARY ***
Total pot 0.09€ | No rake
Seat 1: FabWest (small blind) won 0.09€


Winamax Poker - HOLD-UP "Colorado" - HandId: #19116069-315164-1701423124 - Holdem no limit (0.01€/0.02€) - 2023/12/01 09:32:04 UTC
Table: 'Colorado' 6-max (real money) Seat #6 is the button
Seat 1: FILTONFLOUSE (3.38€)
Seat 2: Toon89 (4.14€)
Seat 3: Chamois 2638 (2€)
Seat 4: altruiste546 (2.39€)
Seat 5: haouuum28 (4.35€)
Seat 6: Fried Berg (1€)
*** ANTE/BLINDS ***
FILTONFLOUSE posts small blind 0.01€
Toon89 posts big blind 0.02€
Dealt to Fried Berg [9c 5d]
*** PRE-FLOP *** 
Chamois 2638 calls 0.02€
altruiste546 folds
haouuum28 folds
Fried Berg folds
FILTONFLOUSE folds
Toon89 checks
*** FLOP *** [Ah Th 8c]
Toon89 checks
Chamois 2638 checks
*** TURN *** [Ah Th 8c][Kh]
Toon89 checks
Chamois 2638 checks
*** RIVER *** [Ah Th 8c Kh][8s]
Toon89 bets 0.05€
Chamois 2638 calls 0.05€
*** SHOW DOWN ***
Toon89 shows [Qd 9d] (One pair : 8)
Chamois 2638 shows [Kd 7s] (Two pairs : Kings and 8)
Chamois 2638 collected 0.13€ from pot
*** SUMMARY ***
Total pot 0.13€ | Rake 0.02€
Board: [Ah Th 8c Kh 8s]
Seat 2: Toon89 (big blind) showed [Qd 9d] and lost with One pair : 8
Seat 3: Chamois 2638 showed [Kd 7s] and won 0.13€ with Two pairs : Kings and 8


Winamax Poker - HOLD-UP "Colorado" - HandId: #19116069-315165-1701423126 - Holdem no limit (0.01€/0.02€) - 2023/12/01 09:32:06 UTC
Table: 'Colorado' 6-max (real money) Seat #6 is the button
Seat 1: Perf-31 (2€)
Seat 2: FILTONFLOUSE (3.37€)
Seat 3: tichettede3 (2.75€)
Seat 4: sopra61 (1.20€)
Seat 5: Fried Berg (1€)
Seat 6: KON-2-PEUTE (2€)
*** ANTE/BLINDS ***
Perf-31 posts small blind 0.01€
FILTONFLOUSE posts big blind 0.02€
Dealt to Fried Berg [6h 6c]
*** PRE-FLOP *** 
tichettede3 folds
sopra61 folds
Fried Berg raises 0.10€ to 0.12€
KON-2-PEUTE folds
Perf-31 folds
FILTONFLOUSE folds
Fried Berg collected 0.15€ from pot
*** SUMMARY ***
Total pot 0.15€ | No rake
Seat 5: Fried Berg won 0.15€


Winamax Poker - HOLD-UP "Colorado" - HandId: #19116069-315192-1701423155 - Holdem no limit (0.01€/0.02€) - 2023/12/01 09:32:35 UTC
Table: 'Colorado' 6-max (real money) Seat #6 is the button
Seat 1: tichettede3 (2.61€)
Seat 2: Fried Berg (1.03€)
Seat 3: LilRun (4.56€)
Seat 4: loreal78 (0.97€)
Seat 5: Clemence75 (2€)
Seat 6: PEPEKA (2.50€)
*** ANTE/BLINDS ***
tichettede3 posts small blind 0.01€
Fried Berg posts big blind 0.02€
Dealt to Fried Berg [Qh Ac]
*** PRE-FLOP *** 
LilRun raises 0.04€ to 0.06€
loreal78 folds
Clemence75 folds
PEPEKA folds
tichettede3 calls 0.05€
Fried Berg calls 0.04€
*** FLOP *** [8d 3c 7h]
tichettede3 bets 0.12€
Fried Berg calls 0.12€
LilRun folds
*** TURN *** [8d 3c 7h][7d]
tichettede3 bets 0.27€
Fried Berg folds
tichettede3 collected 0.65€ from pot
*** SUMMARY ***
Total pot 0.65€ | Rake 0.04€
Board: [8d 3c 7h 7d]
Seat 1: tichettede3 (small blind) won 0.65€


Winamax Poker - HOLD-UP "Colorado" - HandId: #19116069-315265-1701423228 - Holdem no limit (0.01€/0.02€) - 2023/12/01 09:33:48 UTC
Table: 'Colorado' 6-max (real money) Seat #6 is the button
Seat 1: Davidoo36 (0.14€)
Seat 2: FILTONFLOUSE (2.44€)
Seat 3: Catacao (0.50€)
Seat 4: Dovisclaire (0.82€)
Seat 5: Fried Berg (0.85€)
Seat 6: DonKmillo (0.61€)
*** ANTE/BLINDS ***
Davidoo36 posts small blind 0.01€
FILTONFLOUSE posts big blind 0.02€
Dealt to Fried Berg [2d Kc]
*** PRE-FLOP *** 
Catacao folds
Dovisclaire raises 0.04€ to 0.06€
Fried Berg folds
DonKmillo folds
Davidoo36 folds
FILTONFLOUSE calls 0.04€
*** FLOP *** [Ac 2c 6c]
FILTONFLOUSE checks
Dovisclaire checks
*** TURN *** [Ac 2c 6c][5d]
FILTONFLOUSE bets 0.10€
Dovisclaire folds
FILTONFLOUSE collected 0.22€ from pot
*** SUMMARY ***
Total pot 0.22€ | Rake 0.01€
Board: [Ac 2c 6c 5d]
Seat 2: FILTONFLOUSE (big blind) won 0.22€


Winamax Poker - HOLD-UP "Colorado" - HandId: #19116069-315284-1701423249 - Holdem no limit (0.01€/0.02€) - 2023/12/01 09:34:09 UTC
Table: 'Colorado' 6-max (real money) Seat #6 is the button
Seat 1: Fried Berg (0.85€)
Seat 2: pelouseverte (1.22€)
Seat 3: Hagreed (2.56€)
Seat 4: Titine543 (3.67€)
Seat 5: bubka 1974 (2.31€)
Seat 6: slowreplay (2€)
*** ANTE/BLINDS ***
Fried Berg posts small blind 0.01€
pelouseverte posts big blind 0.02€
Dealt to Fried Berg [7h 4d]
*** PRE-FLOP *** 
Hagreed folds
Titine543 folds
bubka 1974 folds
slowreplay folds
Fried Berg folds
pelouseverte collected 0.03€ from pot
*** SUMMARY ***
Total pot 0.03€ | No rake
Seat 2: pelouseverte (big blind) won 0.03€


Winamax Poker - HOLD-UP "Colorado" - HandId: #19116069-315286-1701423252 - Holdem no limit (0.01€/0.02€) - 2023/12/01 09:34:12 UTC
Table: 'Colorado' 6-max (real money) Seat #6 is the button
Seat 1: curiouz dje (2.50€)
Seat 2: TheRealWill (2.19€)
Seat 3: Fried Berg (0.84€)
Seat 4: ilergeta (2.08€)
Seat 5: Hagreed (2.56€)
Seat 6: bubka 1974 (2.31€)
*** ANTE/BLINDS ***
curiouz dje posts small blind 0.01€
TheRealWill posts big blind 0.02€
Dealt to Fried Berg [Js 4d]
*** PRE-FLOP *** 
Fried Berg folds
ilergeta folds
Hagreed folds
bubka 1974 calls 0.02€
curiouz dje folds
TheRealWill checks
*** FLOP *** [3s Kh Jd]
TheRealWill checks
bubka 1974 bets 0.05€
TheRealWill calls 0.05€
*** TURN *** [3s Kh Jd][Th]
TheRealWill bets 0.08€
bubka 1974 calls 0.08€
*** RIVER *** [3s Kh Jd Th][7c]
TheRealWill bets 0.20€
bubka 1974 calls 0.20€
*** SHOW DOWN ***
bubka 1974 shows [Qc Ks] (One pair : Kings)
TheRealWill shows [7s Kc] (Two pairs : Kings and 7)
TheRealWill collected 0.64€ from pot
*** SUMMARY ***
Total pot 0.64€ | Rake 0.07€
Board: [3s Kh Jd Th 7c]
Seat 2: TheRealWill (big blind) showed [7s Kc] and won 0.64€ with Two pairs : Kings and 7
Seat 6: bubka 1974 (button) showed [Qc Ks] and lost with One pair : Kings


Winamax Poker - HOLD-UP "Colorado" - HandId: #19116069-315288-1701423254 - Holdem no limit (0.01€/0.02€) - 2023/12/01 09:34:14 UTC
Table: 'Colorado' 6-max (real money) Seat #6 is the button
Seat 1: MoneyGrowing (2.64€)
Seat 2: Fried Berg (0.84€)
Seat 3: yann_Lord590 (6.85€)
Seat 4: SirX (1.68€)
Seat 5: Titine543 (3.67€)
Seat 6: Stelenox (2.09€)
*** ANTE/BLINDS ***
MoneyGrowing posts small blind 0.01€
Fried Berg posts big blind 0.02€
Dealt to Fried Berg [6s 7c]
*** PRE-FLOP *** 
yann_Lord590 calls 0.02€
SirX folds
Titine543 calls 0.02€
Stelenox folds
MoneyGrowing folds
Fried Berg checks
*** FLOP *** [Th Js Jc]
Fried Berg checks
yann_Lord590 bets 0.05€
Titine543 calls 0.05€
Fried Berg folds
*** TURN *** [Th Js Jc][Tc]
yann_Lord590 bets 0.11€
Titine543 calls 0.11€
*** RIVER *** [Th Js Jc Tc][6c]
yann_Lord590 bets 0.14€
Titine543 calls 0.14€
*** SHOW DOWN ***
yann_Lord590 shows [Ts Qs] (Full of Tens and Jacks)
Titine543 shows [Td Qd] (Full of Tens and Jacks)
Titine543 collected 0.30€ from pot
yann_Lord590 collected 0.30€ from pot
*** SUMMARY ***
Total pot 0.60€ | Rake 0.07€
Board: [Th Js Jc Tc 6c]
Seat 3: yann_Lord590 showed [Ts Qs] and won 0.30€ with Full of Tens and Jacks
Seat 5: Titine543 showed [Td Qd] and won 0.30€ with Full of Tens and Jacks


Winamax Poker - HOLD-UP "Colorado" - HandId: #19116069-315302-1701423269 - Holdem no limit (0.01€/0.02€) - 2023/12/01 09:34:29 UTC
Table: 'Colorado' 6-max (real money) Seat #6 is the button
Seat 1: Fried Berg (0.82€)
Seat 2: MoneyGrowing (2.66€)
Seat 3: Zanghief068 (2.08€)
Seat 4: papashark14 (1.79€)
Seat 5: MrFlash9 (2€)
Seat 6: pelouseverte (0.94€)
*** ANTE/BLINDS ***
Fried Berg posts small blind 0.01€
MoneyGrowing posts big blind 0.02€
Dealt to Fried Berg [Qd 4c]
*** PRE-FLOP *** 
Zanghief068 raises 0.06€ to 0.08€
papashark14 folds
MrFlash9 folds
pelouseverte folds
Fried Berg folds
MoneyGrowing folds
Zanghief068 collected 0.11€ from pot
*** SUMMARY ***
Total pot 0.11€ | No rake
Seat 3: Zanghief068 won 0.11€


Winamax Poker - HOLD-UP "Colorado" - HandId: #19116069-315303-1701423271 - Holdem no limit (0.01€/0.02€) - 2023/12/01 09:34:31 UTC
Table: 'Colorado' 6-max (real money) Seat #6 is the button
Seat 1: jdeepenslip (2€)
Seat 2: haouuum28 (1.82€)
Seat 3: ilergeta (2.03€)
Seat 4: vicieux59 (0.38€)
Seat 5: Fried Berg (0.81€)
Seat 6: MrFlash9 (2€)
*** ANTE/BLINDS ***
jdeepenslip posts small blind 0.01€
haouuum28 posts big blind 0.02€
Dealt to Fried Berg [7s Ks]
*** PRE-FLOP *** 
ilergeta folds
vicieux59 folds
Fried Berg raises 0.02€ to 0.04€
MrFlash9 calls 0.04€
jdeepenslip folds
haouuum28 folds
*** FLOP *** [8s Jh 5c]
Fried Berg checks
MrFlash9 checks
*** TURN *** [8s Jh 5c][8h]
Fried Berg checks
MrFlash9 bets 0.04€
Fried Berg folds
MrFlash9 collected 0.14€ from pot
*** SUMMARY ***
Total pot 0.14€ | Rake 0.01€
Board: [8s Jh 5c 8h]
Seat 6: MrFlash9 (button) won 0.14€


Winamax Poker - HOLD-UP "Colorado" - HandId: #19116069-315347-1701423322 - Holdem no limit (0.01€/0.02€) - 2023/12/01 09:35:22 UTC
Table: 'Colorado' 6-max (real money) Seat #6 is the button
Seat 1: curiouz dje (2.66€)
Seat 2: Fried Berg (0.77€)
Seat 3: Catacao (0.55€)
Seat 4: Tompahmax (3.29€)
Seat 5: Clemence75 (2€)
Seat 6: JAWIKE1 (0.40€)
*** ANTE/BLINDS ***
curiouz dje posts small blind 0.01€
Fried Berg posts big blind 0.02€
Dealt to Fried Berg [7s Jd]
*** PRE-FLOP *** 
Catacao folds
Tompahmax raises 0.02€ to 0.04€
Clemence75 folds
JAWIKE1 folds
curiouz dje raises 0.17€ to 0.21€
Fried Berg folds
Tompahmax calls 0.17€
*** FLOP *** [9d 5h 6c]
curiouz dje bets 0.15€
Tompahmax folds
curiouz dje collected 0.55€ from pot
*** SUMMARY ***
Total pot 0.55€ | Rake 0.04€
Board: [9d 5h 6c]
Seat 1: curiouz dje (small blind) won 0.55€


Winamax Poker - HOLD-UP "Colorado" - HandId: #19116069-315351-1701423325 - Holdem no limit (0.01€/0.02€) - 2023/12/01 09:35:25 UTC
Table: 'Colorado' 6-max (real money) Seat #6 is the button
Seat 1: tichettede3 (2.87€)
Seat 2: JAWIKE1 (0.40€)
Seat 3: Joueur-15405 (2.87€)
Seat 4: Fried Berg (0.75€)
Seat 5: tequilaaaa (2€)
Seat 6: kameleon73 (2€)
*** ANTE/BLINDS ***
tichettede3 posts small blind 0.01€
JAWIKE1 posts big blind 0.02€
Dealt to Fried Berg [8h 3h]
*** PRE-FLOP *** 
Joueur-15405 folds
Fried Berg folds
tequilaaaa folds
kameleon73 folds
tichettede3 folds
JAWIKE1 collected 0.03€ from pot
*** SUMMARY ***
Total pot 0.03€ | No rake
Seat 2: JAWIKE1 (big blind) won 0.03€


Winamax Poker - HOLD-UP "Colorado" - HandId: #19116069-315352-1701423328 - Holdem no limit (0.01€/0.02€) - 2023/12/01 09:35:28 UTC
Table: 'Colorado' 6-max (real money) Seat #6 is the button
Seat 1: MrFlash9 (2.09€)
Seat 2: kameleon73 (2€)
Seat 3: jdeepenslip (2€)
Seat 4: Fried Berg (0.75€)
Seat 5: Neferusobek (2.89€)
Seat 6: Joueur-15405 (2.87€)
*** ANTE/BLINDS ***
MrFlash9 posts small blind 0.01€
kameleon73 posts big blind 0.02€
Dealt to Fried Berg [7s Kh]
*** PRE-FLOP *** 
jdeepenslip folds
Fried Berg folds
Neferusobek folds
Joueur-15405 folds
MrFlash9 raises 0.04€ to 0.06€
kameleon73 folds
MrFlash9 collected 0.08€ from pot
*** SUMMARY ***
Total pot 0.08€ | No rake
Seat 1: MrFlash9 (small blind) won 0.08€


Winamax Poker - HOLD-UP "Colorado" - HandId: #19116069-315362-1701423340 - Holdem no limit (0.01€/0.02€) - 2023/12/01 09:35:40 UTC
Table: 'Colorado' 6-max (real money) Seat #6 is the button
Seat 1: jdeepenslip (2€)
Seat 2: Davidoo36 (0.14€)
Seat 3: MoneyGrowing (2.56€)
Seat 4: Zanghief068 (2.11€)
Seat 5: Fried Berg (0.75€)
Seat 6: bubka 1974 (1.89€)
*** ANTE/BLINDS ***
jdeepenslip posts small blind 0.01€
Davidoo36 posts big blind 0.02€
Dealt to Fried Berg [8d Ad]
*** PRE-FLOP *** 
MoneyGrowing folds
Zanghief068 raises 0.04€ to 0.06€
Fried Berg raises 0.12€ to 0.18€
bubka 1974 folds
jdeepenslip folds
Davidoo36 calls 0.12€ and is all-in
Zanghief068 calls 0.12€
*** FLOP *** [7d Th 2d]
Zanghief068 checks
Fried Berg bets 0.10€
Zanghief068 raises 1.83€ to 1.93€ and is all-in
Fried Berg calls 0.47€ and is all-in
*** TURN *** [7d Th 2d][2c]
*** RIVER *** [7d Th 2d 2c][2h]
*** SHOW DOWN ***
Davidoo36 shows [Kd Jd] (Trips of 2)
Fried Berg shows [8d Ad] (Trips of 2)
Zanghief068 shows [6s Td] (Full of 2 and Tens)
Zanghief068 collected 2.84€ from pot
*** SUMMARY ***
Total pot 2.84€ | Rake 0.17€
Board: [7d Th 2d 2c 2h]
Seat 2: Davidoo36 (big blind) showed [Kd Jd] and lost with Trips of 2
Seat 4: Zanghief068 showed [6s Td] and won 2.84€ with Full of 2 and Tens
Seat 5: Fried Berg showed [8d Ad] and lost with Trips of 2


Winamax Poker - HOLD-UP "Colorado" - HandId: #19116069-315411-1701423398 - Holdem no limit (0.01€/0.02€) - 2023/12/01 09:36:38 UTC
Table: 'Colorado' 6-max (real money) Seat #6 is the button
Seat 1: Fried Berg (0.50€)
Seat 2: slowreplay (2€)
Seat 3: FabWest (2.82€)
Seat 4: Manupoy (3.55€)
Seat 5: haouuum28 (1.69€)
Seat 6: ilergeta (2€)
*** ANTE/BLINDS ***
Fried Berg posts small blind 0.01€
slowreplay posts big blind 0.02€
Dealt to Fried Berg [Jd 9d]
*** PRE-FLOP *** 
FabWest folds
Manupoy folds
haouuum28 raises 0.04€ to 0.06€
ilergeta folds
Fried Berg calls 0.05€
slowreplay folds
*** FLOP *** [8s 6h 6s]
Fried Berg checks
haouuum28 bets 0.14€
Fried Berg folds
haouuum28 collected 0.27€ from pot
*** SUMMARY ***
Total pot 0.27€ | Rake 0.01€
Board: [8s 6h 6s]
Seat 5: haouuum28 won 0.27€


Winamax Poker - HOLD-UP "Colorado" - HandId: #19116069-315426-1701423418 - Holdem no limit (0.01€/0.02€) - 2023/12/01 09:36:58 UTC
Table: 'Colorado' 6-max (real money) Seat #6 is the button
Seat 1: Bacardi34 (3.91€)
Seat 2: Justo_170382 (0.99€)
Seat 3: FabWest (2.99€)
Seat 4: Fried Berg (0.44€)
Seat 5: Davidoo36 (0.49€)
Seat 6: haamataraa (2.10€)
*** ANTE/BLINDS ***
Bacardi34 posts small blind 0.01€
Justo_170382 posts big blind 0.02€
Dealt to Fried Berg [Ks Ah]
*** PRE-FLOP *** 
FabWest folds
Fried Berg raises 0.02€ to 0.04€
Davidoo36 calls 0.04€
haamataraa folds
Bacardi34 calls 0.03€
Justo_170382 calls 0.02€
*** FLOP *** [7h Tc As]
Bacardi34 checks
Justo_170382 checks
Fried Berg bets 0.10€
Davidoo36 folds
Bacardi34 calls 0.10€
Justo_170382 calls 0.10€
*** TURN *** [7h Tc As][Qd]
Bacardi34 checks
Justo_170382 checks
Fried Berg checks
*** RIVER *** [7h Tc As Qd][Kc]
Bacardi34 checks
Justo_170382 bets 0.30€
Fried Berg calls 0.30€ and is all-in
Bacardi34 folds
*** SHOW DOWN ***
Fried Berg shows [Ks Ah] (Two pairs : Aces and Kings)
Justo_170382 shows [Jc Ad] (Straight Ace high)
Justo_170382 collected 0.95€ from pot
*** SUMMARY ***
Total pot 0.95€ | Rake 0.11€
Board: [7h Tc As Qd Kc]
Seat 2: Justo_170382 (big blind) showed [Jc Ad] and won 0.95€ with Straight Ace high
Seat 4: Fried Berg showed [Ks Ah] and lost with Two pairs : Aces and Kings


Winamax Poker - HOLD-UP "Colorado" - HandId: #19116069-315626-1701423621 - Holdem no limit (0.01€/0.02€) - 2023/12/01 09:40:21 UTC
Table: 'Colorado' 6-max (real money) Seat #6 is the button
Seat 1: Fried Berg (0.50€)
Seat 2: haouuum28 (1.89€)
Seat 3: MoneyGrowing (2.65€)
Seat 4: Nicoo49003 (3.90€)
Seat 5: AAdellKK (1.20€)
Seat 6: jjakpour (1.16€)
*** ANTE/BLINDS ***
Fried Berg posts small blind 0.01€
haouuum28 posts big blind 0.02€
Dealt to Fried Berg [Td Kc]
*** PRE-FLOP *** 
MoneyGrowing folds
Nicoo49003 folds
AAdellKK folds
jjakpour folds
Fried Berg calls 0.01€
haouuum28 checks
*** FLOP *** [Kh 2d 8s]
Fried Berg bets 0.03€
haouuum28 folds
Fried Berg collected 0.07€ from pot
*** SUMMARY ***
Total pot 0.07€ | No rake
Board: [Kh 2d 8s]
Seat 1: Fried Berg (small blind) won 0.07€


Winamax Poker - HOLD-UP "Colorado" - HandId: #19116069-315664-1701423653 - Holdem no limit (0.01€/0.02€) - 2023/12/01 09:40:53 UTC
Table: 'Colorado' 6-max (real money) Seat #6 is the button
Seat 1: curiouz dje (2.56€)
Seat 2: Nicoo49003 (3.92€)
Seat 3: Pffft... (2€)
Seat 4: Neferusobek (2€)
Seat 5: Leonamon (3.19€)
Seat 6: Fried Berg (0.52€)
*** ANTE/BLINDS ***
curiouz dje posts small blind 0.01€
Nicoo49003 posts big blind 0.02€
Dealt to Fried Berg [4s Kc]
*** PRE-FLOP *** 
Pffft... folds
Neferusobek raises 0.04€ to 0.06€
Leonamon folds
Fried Berg folds
curiouz dje calls 0.05€
Nicoo49003 folds
*** FLOP *** [8d Qc 7h]
curiouz dje checks
Neferusobek checks
*** TURN *** [8d Qc 7h][3h]
curiouz dje bets 0.11€
Neferusobek calls 0.11€
*** RIVER *** [8d Qc 7h 3h][8h]
curiouz dje checks
Neferusobek checks
*** SHOW DOWN ***
curiouz dje shows [As 7s] (Two pairs : 8 and 7)
Neferusobek shows [Qd Jd] (Two pairs : Queens and 8)
Neferusobek collected 0.32€ from pot
*** SUMMARY ***
Total pot 0.32€ | Rake 0.04€
Board: [8d Qc 7h 3h 8h]
Seat 1: curiouz dje (small blind) showed [As 7s] and lost with Two pairs : 8 and 7
Seat 4: Neferusobek showed [Qd Jd] and won 0.32€ with Two pairs : Queens and 8


Winamax Poker - HOLD-UP "Colorado" - HandId: #19116069-315675-1701423661 - Holdem no limit (0.01€/0.02€) - 2023/12/01 09:41:01 UTC
Table: 'Colorado' 6-max (real money) Seat #6 is the button
Seat 1: slowreplay (2.54€)
Seat 2: Clemence75 (2.08€)
Seat 3: Fried Berg (0.52€)
Seat 4: OMG76 (1.85€)
Seat 5: PACS 024 (1.43€)
Seat 6: tequilaaaa (2.11€)
*** ANTE/BLINDS ***
slowreplay posts small blind 0.01€
Clemence75 posts big blind 0.02€
Dealt to Fried Berg [3s Kc]
*** PRE-FLOP *** 
Fried Berg folds
OMG76 folds
PACS 024 raises 0.04€ to 0.06€
tequilaaaa folds
slowreplay folds
Clemence75 calls 0.04€
*** FLOP *** [5s Th As]
Clemence75 checks
PACS 024 checks
*** TURN *** [5s Th As][3d]
Clemence75 checks
PACS 024 bets 0.07€
Clemence75 calls 0.07€
*** RIVER *** [5s Th As 3d][Qs]
Clemence75 bets 0.10€
PACS 024 folds
Clemence75 collected 0.34€ from pot
*** SUMMARY ***
Total pot 0.34€ | Rake 0.03€
Board: [5s Th As 3d Qs]
Seat 2: Clemence75 (big blind) won 0.34€


Winamax Poker - HOLD-UP "Colorado" - HandId: #19116069-315677-1701423663 - Holdem no limit (0.01€/0.02€) - 2023/12/01 09:41:03 UTC
Table: 'Colorado' 6-max (real money) Seat #6 is the button
Seat 1: Thequeen1205 (2.31€)
Seat 2: FabWest (2.99€)
Seat 3: Fried Berg (0.52€)
Seat 4: jjakpour (1.11€)
Seat 5: haouuum28 (4.38€)
Seat 6: OMG76 (1.85€)
*** ANTE/BLINDS ***
Thequeen1205 posts small blind 0.01€
FabWest posts big blind 0.02€
Dealt to Fried Berg [Qh Qc]
*** PRE-FLOP *** 
Fried Berg raises 0.04€ to 0.06€
jjakpour folds
haouuum28 folds
OMG76 calls 0.06€
Thequeen1205 folds
FabWest calls 0.04€
*** FLOP *** [Tc Kc 9h]
FabWest checks
Fried Berg bets 0.06€
OMG76 calls 0.06€
FabWest calls 0.06€
*** TURN *** [Tc Kc 9h][8s]
FabWest checks
Fried Berg checks
OMG76 bets 0.20€
FabWest calls 0.20€
Fried Berg folds
*** RIVER *** [Tc Kc 9h 8s][6s]
FabWest checks
OMG76 checks
*** SHOW DOWN ***
FabWest shows [Jh Kh] (One pair : Kings)
OMG76 shows [Kd Td] (Two pairs : Kings and Tens)
OMG76 collected 0.69€ from pot
*** SUMMARY ***
Total pot 0.69€ | Rake 0.08€
Board: [Tc Kc 9h 8s 6s]
Seat 2: FabWest (big blind) showed [Jh Kh] and lost with One pair : Kings
Seat 6: OMG76 (button) showed [Kd Td] and won 0.69€ with Two pairs : Kings and Tens


Winamax Poker - HOLD-UP "Colorado" - HandId: #19116069-315722-1701423714 - Holdem no limit (0.01€/0.02€) - 2023/12/01 09:41:54 UTC
Table: 'Colorado' 6-max (real money) Seat #6 is the button
Seat 1: FabWest (2.67€)
Seat 2: OMG76 (2.22€)
Seat 3: kameleon73 (2.05€)
Seat 4: curiouz dje (2.32€)
Seat 5: TheRealWill (2.82€)
Seat 6: Fried Berg (0.40€)
Hold-up to Pot: total 0.10€
*** ANTE/BLINDS ***
FabWest posts small blind 0.01€
OMG76 posts big blind 0.02€
Dealt to Fried Berg [8s Ts]
*** PRE-FLOP *** 
kameleon73 raises 0.04€ to 0.06€
curiouz dje folds
TheRealWill folds
Fried Berg calls 0.06€
FabWest folds
OMG76 calls 0.04€
*** FLOP *** [As Td Jh]
OMG76 checks
kameleon73 bets 0.07€
Fried Berg calls 0.07€
OMG76 calls 0.07€
*** TURN *** [As Td Jh][7h]
OMG76 checks
kameleon73 bets 0.11€
Fried Berg folds
OMG76 calls 0.11€
*** RIVER *** [As Td Jh 7h][8h]
OMG76 checks
kameleon73 bets 0.20€
OMG76 folds
kameleon73 collected 0.86€ from pot
*** SUMMARY ***
Total pot 0.86€ | Rake 0.06€
Board: [As Td Jh 7h 8h]
Seat 3: kameleon73 won 0.86€


Winamax Poker - HOLD-UP "Colorado" - HandId: #19116069-315767-1701423765 - Holdem no limit (0.01€/0.02€) - 2023/12/01 09:42:45 UTC
Table: 'Colorado' 6-max (real money) Seat #6 is the button
Seat 1: haouuum28 (1.92€)
Seat 2: Davidoo36 (0.48€)
Seat 3: ITALIA291 (2.07€)
Seat 4: Fried Berg (0.27€)
Seat 5: Pffft... (2€)
Seat 6: Zanghief068 (2.33€)
*** ANTE/BLINDS ***
haouuum28 posts small blind 0.01€
Davidoo36 posts big blind 0.02€
Dealt to Fried Berg [2d 2s]
*** PRE-FLOP *** 
ITALIA291 folds
Fried Berg folds
Pffft... folds
Zanghief068 raises 0.02€ to 0.04€
haouuum28 folds
Davidoo36 calls 0.02€
*** FLOP *** [6h Td Jh]
Davidoo36 checks
Zanghief068 checks
*** TURN *** [6h Td Jh][Th]
Davidoo36 checks
Zanghief068 checks
*** RIVER *** [6h Td Jh Th][8s]
Davidoo36 checks
Zanghief068 bets 0.02€
Davidoo36 folds
Zanghief068 collected 0.10€ from pot
*** SUMMARY ***
Total pot 0.10€ | Rake 0.01€
Board: [6h Td Jh Th 8s]
Seat 6: Zanghief068 (button) won 0.10€


Winamax Poker - HOLD-UP "Colorado" - HandId: #19116069-315769-1701423769 - Holdem no limit (0.01€/0.02€) - 2023/12/01 09:42:49 UTC
Table: 'Colorado' 6-max (real money) Seat #6 is the button
Seat 1: Neferusobek (2.15€)
Seat 2: Fried Berg (0.27€)
Seat 3: yoda63150 (1.93€)
Seat 4: slowreplay (2.03€)
Seat 5: TheRealWill (3.23€)
Seat 6: MrFlash9 (2.64€)
*** ANTE/BLINDS ***
Neferusobek posts small blind 0.01€
Fried Berg posts big blind 0.02€
Dealt to Fried Berg [Ts 7h]
*** PRE-FLOP *** 
yoda63150 folds
slowreplay folds
TheRealWill folds
MrFlash9 folds
Neferusobek raises 0.04€ to 0.06€
Fried Berg folds
Neferusobek collected 0.08€ from pot
*** SUMMARY ***
Total pot 0.08€ | No rake
Seat 1: Neferusobek (small blind) won 0.08€


Winamax Poker - HOLD-UP "Colorado" - HandId: #19116069-315777-1701423779 - Holdem no limit (0.01€/0.02€) - 2023/12/01 09:42:59 UTC
Table: 'Colorado' 6-max (real money) Seat #6 is the button
Seat 1: TheRealWill (3.23€)
Seat 2: tequilaaaa (2.24€)
Seat 3: Hydramist (2.71€)
Seat 4: slowreplay (2.54€)
Seat 5: LilRun (2.31€)
Seat 6: Fried Berg (0.25€)
*** ANTE/BLINDS ***
TheRealWill posts small blind 0.01€
tequilaaaa posts big blind 0.02€
Dealt to Fried Berg [8c 3c]
*** PRE-FLOP *** 
Hydramist folds
slowreplay raises 0.03€ to 0.05€
LilRun calls 0.05€
Fried Berg folds
TheRealWill calls 0.04€
tequilaaaa raises 0.26€ to 0.31€
slowreplay raises 2.23€ to 2.54€ and is all-in
LilRun folds
TheRealWill folds
tequilaaaa calls 1.93€ and is all-in
*** FLOP *** [6c Jc Ks]
*** TURN *** [6c Jc Ks][7c]
*** RIVER *** [6c Jc Ks 7c][Th]
*** SHOW DOWN ***
tequilaaaa shows [Jd As] (One pair : Jacks)
slowreplay shows [Kh Ad] (One pair : Kings)
slowreplay collected 4.42€ from pot
*** SUMMARY ***
Total pot 4.42€ | Rake 0.46€
Board: [6c Jc Ks 7c Th]
Seat 2: tequilaaaa (big blind) showed [Jd As] and lost with One pair : Jacks
Seat 4: slowreplay showed [Kh Ad] and won 4.42€ with One pair : Kings


Winamax Poker - HOLD-UP "Colorado" - HandId: #19116069-315787-1701423789 - Holdem no limit (0.01€/0.02€) - 2023/12/01 09:43:09 UTC
Table: 'Colorado' 6-max (real money) Seat #6 is the button
Seat 1: Fried Berg (0.25€)
Seat 2: Neferusobek (2.07€)
Seat 3: nda94 (0.47€)
Seat 4: Jimmy91lenny (2.03€)
Seat 5: curiouz dje (2.29€)
Seat 6: FabWest (2.27€)
*** ANTE/BLINDS ***
Fried Berg posts small blind 0.01€
Neferusobek posts big blind 0.02€
Dealt to Fried Berg [5s 2d]
*** PRE-FLOP *** 
nda94 calls 0.02€
Jimmy91lenny folds
curiouz dje folds
FabWest folds
Fried Berg folds
Neferusobek checks
*** FLOP *** [Ks 5c Tc]
Neferusobek checks
nda94 checks
*** TURN *** [Ks 5c Tc][Kh]
Neferusobek checks
nda94 checks
*** RIVER *** [Ks 5c Tc Kh][Th]
Neferusobek checks
nda94 checks
*** SHOW DOWN ***
nda94 shows [3d 4d] (Two pairs : Kings and Tens)
Neferusobek shows [8d Jd] (Two pairs : Kings and Tens)
Neferusobek collected 0.04€ from pot
*** SUMMARY ***
Total pot 0.04€ | Rake 0.01€
Board: [Ks 5c Tc Kh Th]
Seat 2: Neferusobek (big blind) showed [8d Jd] and won 0.04€ with Two pairs : Kings and Tens
Seat 3: nda94 showed [3d 4d] and lost with Two pairs : Kings and Tens


Winamax Poker - HOLD-UP "Colorado" - HandId: #19116069-315792-1701423794 - Holdem no limit (0.01€/0.02€) - 2023/12/01 09:43:14 UTC
Table: 'Colorado' 6-max (real money) Seat #6 is the button
Seat 1: SirX (4.30€)
Seat 2: Fried Berg (0.24€)
Seat 3: Joueur-15405 (2.85€)
Seat 4: Clemence75 (2.12€)
Seat 5: jdeepenslip (2.09€)
Seat 6: MeR2GPa1rOnd (2.86€)
*** ANTE/BLINDS ***
SirX posts small blind 0.01€
Fried Berg posts big blind 0.02€
Dealt to Fried Berg [Ts Jc]
*** PRE-FLOP *** 
Joueur-15405 folds
Clemence75 folds
jdeepenslip folds
MeR2GPa1rOnd raises 0.03€ to 0.05€
SirX calls 0.04€
Fried Berg calls 0.03€
*** FLOP *** [9h Th 8d]
SirX checks
Fried Berg checks
MeR2GPa1rOnd bets 0.10€
SirX folds
Fried Berg calls 0.10€
*** TURN *** [9h Th 8d][4d]
Fried Berg checks
MeR2GPa1rOnd bets 0.12€
Fried Berg calls 0.09€ and is all-in
*** RIVER *** [9h Th 8d 4d][Ac]
*** SHOW DOWN ***
Fried Berg shows [Ts Jc] (One pair : Tens)
MeR2GPa1rOnd shows [6s 8s] (One pair : 8)
MeR2GPa1rOnd collected 0.03€ from side pot 1
Fried Berg collected 0.48€ from main pot
*** SUMMARY ***
Total pot 0.51€ | Rake 0.05€
Board: [9h Th 8d 4d Ac]
Seat 2: Fried Berg (big blind) showed [Ts Jc] and won 0.48€ with One pair : Tens
Seat 6: MeR2GPa1rOnd (button) showed [6s 8s] and won 0.03€ with One pair : 8


Winamax Poker - HOLD-UP "Colorado" - HandId: #19116069-315848-1701423859 - Holdem no limit (0.01€/0.02€) - 2023/12/01 09:44:19 UTC
Table: 'Colorado' 6-max (real money) Seat #6 is the button
Seat 1: OMG76 (2.21€)
Seat 2: kameleon73 (2.38€)
Seat 3: Fried Berg (0.48€)
Seat 4: FILTONFLOUSE (2.08€)
Seat 5: JAKA 10 (0.66€)
Seat 6: Neferusobek (2.09€)
Hold-up to Pot: total 0.20€
*** ANTE/BLINDS ***
OMG76 posts small blind 0.01€
kameleon73 posts big blind 0.02€
Dealt to Fried Berg [4s 5h]
*** PRE-FLOP *** 
Fried Berg folds
FILTONFLOUSE folds
JAKA 10 raises 0.64€ to 0.66€ and is all-in
Neferusobek folds
OMG76 calls 0.65€
kameleon73 folds
*** FLOP *** [9d 3d Ah]
*** TURN *** [9d 3d Ah][6d]
*** RIVER *** [9d 3d Ah 6d][Jd]
*** SHOW DOWN ***
OMG76 shows [Qc As] (One pair : Aces)
JAKA 10 shows [Qd Js] (Flush Queen high)
JAKA 10 collected 1.41€ from pot
*** SUMMARY ***
Total pot 1.41€ | Rake 0.13€
Board: [9d 3d Ah 6d Jd]
Seat 1: OMG76 (small blind) showed [Qc As] and lost with One pair : Aces
Seat 5: JAKA 10 showed [Qd Js] and won 1.41€ with Flush Queen high


Winamax Poker - HOLD-UP "Colorado" - HandId: #19116069-315854-1701423865 - Holdem no limit (0.01€/0.02€) - 2023/12/01 09:44:25 UTC
Table: 'Colorado' 6-max (real money) Seat #6 is the button
Seat 1: PIQSOU (2.01€)
Seat 2: tichettede3 (3.90€)
Seat 3: haouuum28 (2.11€)
Seat 4: ilergeta (2€)
Seat 5: Fried Berg (0.48€)
Seat 6: slowreplay (4.43€)
Hold-up to Pot: total 0.10€
*** ANTE/BLINDS ***
PIQSOU posts small blind 0.01€
tichettede3 posts big blind 0.02€
Dealt to Fried Berg [7d As]
*** PRE-FLOP *** 
haouuum28 folds
ilergeta raises 0.07€ to 0.09€
Fried Berg folds
slowreplay folds
PIQSOU folds
tichettede3 folds
ilergeta collected 0.22€ from pot
*** SUMMARY ***
Total pot 0.22€ | No rake
Seat 4: ilergeta won 0.22€


Winamax Poker - HOLD-UP "Colorado" - HandId: #19116069-315883-1701423894 - Holdem no limit (0.01€/0.02€) - 2023/12/01 09:44:54 UTC
Table: 'Colorado' 6-max (real money) Seat #6 is the button
Seat 1: Neferusobek (2.63€)
Seat 2: curiouz dje (2.07€)
Seat 3: pelouseverte (4.04€)
Seat 4: momoiheb (0.76€)
Seat 5: Fried Berg (0.48€)
Seat 6: Houarn (2€)
*** ANTE/BLINDS ***
Neferusobek posts small blind 0.01€
curiouz dje posts big blind 0.02€
Dealt to Fried Berg [3s Kh]
*** PRE-FLOP *** 
pelouseverte folds
momoiheb folds
Fried Berg folds
Houarn folds
Neferusobek raises 0.04€ to 0.06€
curiouz dje folds
Neferusobek collected 0.08€ from pot
*** SUMMARY ***
Total pot 0.08€ | No rake
Seat 1: Neferusobek (small blind) won 0.08€


Winamax Poker - HOLD-UP "Colorado" - HandId: #19116069-315886-1701423897 - Holdem no limit (0.01€/0.02€) - 2023/12/01 09:44:57 UTC
Table: 'Colorado' 6-max (real money) Seat #6 is the button
Seat 1: Zanghief068 (2.33€)
Seat 2: Fried Berg (0.48€)
Seat 3: Flo83601 (3.05€)
Seat 4: OMG76 (1.55€)
Seat 5: Max134Max (7.97€)
Seat 6: Houarn (2€)
Hold-up to Pot: total 0.10€
*** ANTE/BLINDS ***
Zanghief068 posts small blind 0.01€
Fried Berg posts big blind 0.02€
Dealt to Fried Berg [Qs Ac]
*** PRE-FLOP *** 
Flo83601 calls 0.02€
OMG76 calls 0.02€
Max134Max folds
Houarn folds
Zanghief068 raises 0.06€ to 0.08€
Fried Berg raises 0.40€ to 0.48€ and is all-in
Flo83601 folds
OMG76 folds
Zanghief068 folds
Fried Berg collected 0.70€ from pot
*** SUMMARY ***
Total pot 0.70€ | No rake
Seat 2: Fried Berg (big blind) won 0.70€


Winamax Poker - HOLD-UP "Colorado" - HandId: #19116069-315917-1701423927 - Holdem no limit (0.01€/0.02€) - 2023/12/01 09:45:27 UTC
Table: 'Colorado' 6-max (real money) Seat #6 is the button
Seat 1: fifi2308 (2.59€)
Seat 2: Max134Max (7.96€)
Seat 3: tichettede3 (3.88€)
Seat 4: Kevalam (1.85€)
Seat 5: slowreplay (2€)
Seat 6: Fried Berg (0.70€)
*** ANTE/BLINDS ***
fifi2308 posts small blind 0.01€
Max134Max posts big blind 0.02€
Dealt to Fried Berg [Qc 9s]
*** PRE-FLOP *** 
tichettede3 raises 0.03€ to 0.05€
Kevalam folds
slowreplay folds
Fried Berg folds
fifi2308 folds
Max134Max folds
tichettede3 collected 0.08€ from pot
*** SUMMARY ***
Total pot 0.08€ | No rake
Seat 3: tichettede3 won 0.08€


Winamax Poker - HOLD-UP "Colorado" - HandId: #19116069-315927-1701423935 - Holdem no limit (0.01€/0.02€) - 2023/12/01 09:45:35 UTC
Table: 'Colorado' 6-max (real money) Seat #6 is the button
Seat 1: Fried Berg (0.70€)
Seat 2: Hydramist (2.93€)
Seat 3: Neferusobek (2.59€)
Seat 4: El tiki tiki (1.93€)
Seat 5: Flo83601 (3.77€)
Seat 6: Clemence75 (2€)
*** ANTE/BLINDS ***
Fried Berg posts small blind 0.01€
Hydramist posts big blind 0.02€
Dealt to Fried Berg [5h 2c]
*** PRE-FLOP *** 
Neferusobek folds
El tiki tiki folds
Flo83601 folds
Clemence75 folds
Fried Berg folds
Hydramist collected 0.03€ from pot
*** SUMMARY ***
Total pot 0.03€ | No rake
Seat 2: Hydramist (big blind) won 0.03€


Winamax Poker - HOLD-UP "Colorado" - HandId: #19116069-315933-1701423939 - Holdem no limit (0.01€/0.02€) - 2023/12/01 09:45:39 UTC
Table: 'Colorado' 6-max (real money) Seat #6 is the button
Seat 1: Fried Berg (0.69€)
Seat 2: PIQSOU (2.03€)
Seat 3: FabWest (2€)
Seat 4: messor (2.02€)
Seat 5: Houarn (2.21€)
Seat 6: El tiki tiki (1.93€)
*** ANTE/BLINDS ***
Fried Berg posts small blind 0.01€
PIQSOU posts big blind 0.02€
Dealt to Fried Berg [Kd 8h]
*** PRE-FLOP *** 
FabWest folds
messor folds
Houarn folds
El tiki tiki raises 0.03€ to 0.05€
Fried Berg folds
PIQSOU folds
El tiki tiki collected 0.08€ from pot
*** SUMMARY ***
Total pot 0.08€ | No rake
Seat 6: El tiki tiki (button) won 0.08€


Winamax Poker - HOLD-UP "Colorado" - HandId: #19116069-315948-1701423949 - Holdem no limit (0.01€/0.02€) - 2023/12/01 09:45:49 UTC
Table: 'Colorado' 6-max (real money) Seat #6 is the button
Seat 1: Clemence75 (2€)
Seat 2: messor (2.02€)
Seat 3: Fried Berg (0.68€)
Seat 4: jdeepenslip (2.01€)
Seat 5: haouuum28 (2.02€)
Seat 6: Hydramist (2.93€)
*** ANTE/BLINDS ***
Clemence75 posts small blind 0.01€
messor posts big blind 0.02€
Dealt to Fried Berg [3d Kd]
*** PRE-FLOP *** 
Fried Berg folds
jdeepenslip folds
haouuum28 raises 0.02€ to 0.04€
Hydramist folds
Clemence75 folds
messor calls 0.02€
*** FLOP *** [4c Qd Ac]
messor checks
haouuum28 bets 0.05€
messor calls 0.05€
*** TURN *** [4c Qd Ac][6s]
messor checks
haouuum28 checks
*** RIVER *** [4c Qd Ac 6s][2s]
messor checks
haouuum28 checks
*** SHOW DOWN ***
messor shows [Tc Kc] (High card : Ace)
haouuum28 shows [7s As] (One pair : Aces)
haouuum28 collected 0.17€ from pot
*** SUMMARY ***
Total pot 0.17€ | Rake 0.02€
Board: [4c Qd Ac 6s 2s]
Seat 2: messor (big blind) showed [Tc Kc] and lost with High card : Ace
Seat 5: haouuum28 showed [7s As] and won 0.17€ with One pair : Aces


Winamax Poker - HOLD-UP "Colorado" - HandId: #19116069-315950-1701423951 - Holdem no limit (0.01€/0.02€) - 2023/12/01 09:45:51 UTC
Table: 'Colorado' 6-max (real money) Seat #6 is the button
Seat 1: Houarn (2.19€)
Seat 2: Max134Max (7.97€)
Seat 3: PIQSOU (2.01€)
Seat 4: Fried Berg (0.68€)
Seat 5: Clemence75 (2€)
Seat 6: onurb57 (2.01€)
*** ANTE/BLINDS ***
Houarn posts small blind 0.01€
Max134Max posts big blind 0.02€
Dealt to Fried Berg [5h 4c]
*** PRE-FLOP *** 
PIQSOU raises 0.03€ to 0.05€
Fried Berg folds
Clemence75 folds
onurb57 folds
Houarn raises 0.05€ to 0.10€
Max134Max folds
PIQSOU folds
Houarn collected 0.17€ from pot
*** SUMMARY ***
Total pot 0.17€ | No rake
Seat 1: Houarn (small blind) won 0.17€


Winamax Poker - HOLD-UP "Colorado" - HandId: #19116069-315953-1701423953 - Holdem no limit (0.01€/0.02€) - 2023/12/01 09:45:53 UTC
Table: 'Colorado' 6-max (real money) Seat #6 is the button
Seat 1: Neferusobek (2€)
Seat 2: Fatbinta (0.62€)
Seat 3: TheRealWill (3.16€)
Seat 4: _Croute_ (2.63€)
Seat 5: Fried Berg (0.68€)
Seat 6: MoneyGrowing (2€)
*** ANTE/BLINDS ***
Neferusobek posts small blind 0.01€
Fatbinta posts big blind 0.02€
Dealt to Fried Berg [7c Ad]
*** PRE-FLOP *** 
TheRealWill folds
_Croute_ folds
Fried Berg raises 0.02€ to 0.04€
MoneyGrowing folds
Neferusobek raises 0.12€ to 0.16€
Fatbinta folds
Fried Berg calls 0.12€
*** FLOP *** [Jc Js 9c]
Neferusobek bets 0.22€
Fried Berg calls 0.22€
*** TURN *** [Jc Js 9c][8s]
Neferusobek bets 1.62€ and is all-in
Fried Berg calls 0.30€ and is all-in
*** RIVER *** [Jc Js 9c 8s][Qs]
*** SHOW DOWN ***
Fried Berg shows [7c Ad] (One pair : Jacks)
Neferusobek shows [Tc As] (Straight Queen high)
Neferusobek collected 2.56€ from pot
*** SUMMARY ***
Total pot 2.56€ | Rake 0.14€
Board: [Jc Js 9c 8s Qs]
Seat 1: Neferusobek (small blind) showed [Tc As] and won 2.56€ with Straight Queen high
Seat 5: Fried Berg showed [7c Ad] and lost with One pair : Jacks


Winamax Poker - HOLD-UP "Colorado" - HandId: #19116069-316043-1701424023 - Holdem no limit (0.01€/0.02€) - 2023/12/01 09:47:03 UTC
Table: 'Colorado' 6-max (real money) Seat #6 is the button
Seat 1: Fatbinta (0.57€)
Seat 2: BAAC0 (2.01€)
Seat 3: ilergeta (4.25€)
Seat 4: curiouz dje (2€)
Seat 5: Fried Berg (0.50€)
Seat 6: Houarn (2.23€)
*** ANTE/BLINDS ***
Fatbinta posts small blind 0.01€
BAAC0 posts big blind 0.02€
Dealt to Fried Berg [7h 9h]
*** PRE-FLOP *** 
ilergeta folds
curiouz dje folds
Fried Berg folds
Houarn folds
Fatbinta raises 0.02€ to 0.04€
BAAC0 calls 0.02€
*** FLOP *** [5d 3s 9d]
Fatbinta bets 0.08€
BAAC0 calls 0.08€
*** TURN *** [5d 3s 9d][3h]
Fatbinta checks
BAAC0 checks
*** RIVER *** [5d 3s 9d 3h][Kh]
Fatbinta checks
BAAC0 bets 0.18€
Fatbinta folds
BAAC0 collected 0.40€ from pot
*** SUMMARY ***
Total pot 0.40€ | Rake 0.02€
Board: [5d 3s 9d 3h Kh]
Seat 2: BAAC0 (big blind) won 0.40€


Winamax Poker - HOLD-UP "Colorado" - HandId: #19116069-316068-1701424045 - Holdem no limit (0.01€/0.02€) - 2023/12/01 09:47:25 UTC
Table: 'Colorado' 6-max (real money) Seat #6 is the button
Seat 1: Fried Berg (0.50€)
Seat 2: TheRealWill (2.57€)
Seat 3: Flo83601 (3.03€)
Seat 4: Neferusobek (2.02€)
Seat 5: Houarn (1.89€)
Seat 6: Adame199623 (2€)
*** ANTE/BLINDS ***
Fried Berg posts small blind 0.01€
TheRealWill posts big blind 0.02€
Dealt to Fried Berg [2h 6c]
*** PRE-FLOP *** 
Flo83601 folds
Neferusobek folds
Houarn raises 0.04€ to 0.06€
Adame199623 folds
Fried Berg folds
TheRealWill raises 0.18€ to 0.24€
Houarn folds
TheRealWill collected 0.31€ from pot
*** SUMMARY ***
Total pot 0.31€ | No rake
Seat 2: TheRealWill (big blind) won 0.31€


Winamax Poker - HOLD-UP "Colorado" - HandId: #19116069-316081-1701424055 - Holdem no limit (0.01€/0.02€) - 2023/12/01 09:47:35 UTC
Table: 'Colorado' 6-max (real money) Seat #6 is the button
Seat 1: PIQSOU (2.18€)
Seat 2: Fried Berg (0.49€)
Seat 3: Joueur-15405 (2.88€)
Seat 4: Zanghief068 (2.06€)
Seat 5: Pffft... (4.05€)
Seat 6: sAArtouKK (2.07€)
*** ANTE/BLINDS ***
PIQSOU posts small blind 0.01€
Fried Berg posts big blind 0.02€
Dealt to Fried Berg [Ks 4s]
*** PRE-FLOP *** 
Joueur-15405 folds
Zanghief068 raises 0.06€ to 0.08€
Pffft... folds
sAArtouKK folds
PIQSOU folds
Fried Berg calls 0.06€
*** FLOP *** [Kh 5d 7h]
Fried Berg bets 0.06€
Zanghief068 folds
Fried Berg collected 0.21€ from pot
*** SUMMARY ***
Total pot 0.21€ | Rake 0.02€
Board: [Kh 5d 7h]
Seat 2: Fried Berg (big blind) won 0.21€


Winamax Poker - HOLD-UP "Colorado" - HandId: #19116069-316130-1701424095 - Holdem no limit (0.01€/0.02€) - 2023/12/01 09:48:15 UTC
Table: 'Colorado' 6-max (real money) Seat #6 is the button
Seat 1: cerber44 (0.52€)
Seat 2: FILTONFLOUSE (4.08€)
Seat 3: Fried Berg (0.56€)
Seat 4: slowreplay (2€)
Seat 5: sAArtouKK (2.04€)
Seat 6: curiouz dje (2.22€)
*** ANTE/BLINDS ***
cerber44 posts small blind 0.01€
FILTONFLOUSE posts big blind 0.02€
Dealt to Fried Berg [Qs 9c]
*** PRE-FLOP *** 
Fried Berg folds
slowreplay folds
sAArtouKK folds
curiouz dje folds
cerber44 folds
FILTONFLOUSE collected 0.03€ from pot
*** SUMMARY ***
Total pot 0.03€ | No rake
Seat 2: FILTONFLOUSE (big blind) won 0.03€


Winamax Poker - HOLD-UP "Colorado" - HandId: #19116069-316133-1701424098 - Holdem no limit (0.01€/0.02€) - 2023/12/01 09:48:18 UTC
Table: 'Colorado' 6-max (real money) Seat #6 is the button
Seat 1: curiouz dje (2.22€)
Seat 2: jdeepenslip (2.32€)
Seat 3: Fried Berg (0.56€)
Seat 4: BIGDEAL63 (0.61€)
Seat 5: kameleon73 (3.40€)
Seat 6: sAArtouKK (2.04€)
*** ANTE/BLINDS ***
curiouz dje posts small blind 0.01€
jdeepenslip posts big blind 0.02€
Dealt to Fried Berg [5c 5s]
*** PRE-FLOP *** 
Fried Berg raises 0.02€ to 0.04€
BIGDEAL63 calls 0.04€
kameleon73 folds
sAArtouKK folds
curiouz dje folds
jdeepenslip folds
*** FLOP *** [Tc 7s 2c]
Fried Berg checks
BIGDEAL63 bets 0.11€
Fried Berg calls 0.11€
*** TURN *** [Tc 7s 2c][8d]
Fried Berg checks
BIGDEAL63 bets 0.33€
Fried Berg calls 0.33€
*** RIVER *** [Tc 7s 2c 8d][2d]
Fried Berg checks
BIGDEAL63 bets 0.02€
Fried Berg calls 0.02€
*** SHOW DOWN ***
Fried Berg shows [5c 5s] (Two pairs : 5 and 2)
BIGDEAL63 shows [Ks Td] (Two pairs : Tens and 2)
BIGDEAL63 collected 0.93€ from pot
*** SUMMARY ***
Total pot 0.93€ | Rake 0.10€
Board: [Tc 7s 2c 8d 2d]
Seat 3: Fried Berg showed [5c 5s] and lost with Two pairs : 5 and 2
Seat 4: BIGDEAL63 showed [Ks Td] and won 0.93€ with Two pairs : Tens and 2


Winamax Poker - HOLD-UP "Colorado" - HandId: #19116069-316195-1701424147 - Holdem no limit (0.01€/0.02€) - 2023/12/01 09:49:07 UTC
Table: 'Colorado' 6-max (real money) Seat #6 is the button
Seat 1: BAAC0 (1.71€)
Seat 2: FabWest (2.09€)
Seat 3: curiouz dje (2.19€)
Seat 4: Houarn (2.72€)
Seat 5: BIGDEAL63 (1.04€)
Seat 6: Fried Berg (0.06€)
*** ANTE/BLINDS ***
BAAC0 posts small blind 0.01€
FabWest posts big blind 0.02€
Dealt to Fried Berg [7d Th]
*** PRE-FLOP *** 
curiouz dje folds
Houarn folds
BIGDEAL63 raises 0.04€ to 0.06€
Fried Berg folds
BAAC0 folds
FabWest folds
BIGDEAL63 collected 0.09€ from pot
*** SUMMARY ***
Total pot 0.09€ | No rake
Seat 5: BIGDEAL63 won 0.09€


Winamax Poker - HOLD-UP "Colorado" - HandId: #19116069-316222-1701424165 - Holdem no limit (0.01€/0.02€) - 2023/12/01 09:49:25 UTC
Table: 'Colorado' 6-max (real money) Seat #6 is the button
Seat 1: Davidoo36 (1.03€)
Seat 2: TheRealWill (3.04€)
Seat 3: Pffft... (2.10€)
Seat 4: H.D.LANDRU (0.61€)
Seat 5: JAKA 10 (1.44€)
Seat 6: Fried Berg (0.06€)
*** ANTE/BLINDS ***
Davidoo36 posts small blind 0.01€
TheRealWill posts big blind 0.02€
Dealt to Fried Berg [7h Ac]
*** PRE-FLOP *** 
Pffft... folds
H.D.LANDRU folds
JAKA 10 folds
Fried Berg raises 0.04€ to 0.06€ and is all-in
Davidoo36 folds
TheRealWill calls 0.04€
*** FLOP *** [8h 5h 7d]
*** TURN *** [8h 5h 7d][8d]
*** RIVER *** [8h 5h 7d 8d][6h]
*** SHOW DOWN ***
Fried Berg shows [7h Ac] (Two pairs : 8 and 7)
TheRealWill shows [4c 5d] (Straight 8 high)
TheRealWill collected 0.12€ from pot
*** SUMMARY ***
Total pot 0.12€ | Rake 0.01€
Board: [8h 5h 7d 8d 6h]
Seat 2: TheRealWill (big blind) showed [4c 5d] and won 0.12€ with Straight 8 high
Seat 6: Fried Berg (button) showed [7h Ac] and lost with Two pairs : 8 and 7


Winamax Poker - HOLD-UP "Colorado" - HandId: #19116069-316294-1701424213 - Holdem no limit (0.01€/0.02€) - 2023/12/01 09:50:13 UTC
Table: 'Colorado' 6-max (real money) Seat #6 is the button
Seat 1: FabWest (2.33€)
Seat 2: Gildus44 (1.53€)
Seat 3: LAG0URMANDE (1.97€)
Seat 4: Fried Berg (0.50€)
Seat 5: tequilaaaa (2.60€)
Seat 6: Clemence75 (3.35€)
*** ANTE/BLINDS ***
FabWest posts small blind 0.01€
Gildus44 posts big blind 0.02€
Dealt to Fried Berg [9h 7c]
*** PRE-FLOP *** 
LAG0URMANDE raises 0.03€ to 0.05€
Fried Berg folds
tequilaaaa folds
Clemence75 folds
FabWest folds
Gildus44 folds
LAG0URMANDE collected 0.08€ from pot
*** SUMMARY ***
Total pot 0.08€ | No rake
Seat 3: LAG0URMANDE won 0.08€


Winamax Poker - HOLD-UP "Colorado" - HandId: #19116069-316305-1701424220 - Holdem no limit (0.01€/0.02€) - 2023/12/01 09:50:20 UTC
Table: 'Colorado' 6-max (real money) Seat #6 is the button
Seat 1: Neferusobek (2.42€)
Seat 2: Aggro Loser (2.27€)
Seat 3: grut28 (2.04€)
Seat 4: FabWest (2.32€)
Seat 5: jdeepenslip (2.27€)
Seat 6: Fried Berg (0.50€)
*** ANTE/BLINDS ***
Neferusobek posts small blind 0.01€
Aggro Loser posts big blind 0.02€
Dealt to Fried Berg [7d Jc]
*** PRE-FLOP *** 
grut28 folds
FabWest folds
jdeepenslip folds
Fried Berg folds
Neferusobek folds
Aggro Loser collected 0.03€ from pot
*** SUMMARY ***
Total pot 0.03€ | No rake
Seat 2: Aggro Loser (big blind) won 0.03€


Winamax Poker - HOLD-UP "Colorado" - HandId: #19116069-316316-1701424228 - Holdem no limit (0.01€/0.02€) - 2023/12/01 09:50:28 UTC
Table: 'Colorado' 6-max (real money) Seat #6 is the button
Seat 1: haouuum28 (1.57€)
Seat 2: grut28 (2.04€)
Seat 3: FabWest (2.07€)
Seat 4: Fried Berg (0.50€)
Seat 5: tequilaaaa (2€)
Seat 6: messor (2€)
*** ANTE/BLINDS ***
haouuum28 posts small blind 0.01€
grut28 posts big blind 0.02€
Dealt to Fried Berg [Ks Td]
*** PRE-FLOP *** 
FabWest folds
Fried Berg folds
tequilaaaa folds
messor raises 0.03€ to 0.05€
haouuum28 folds
grut28 folds
messor collected 0.08€ from pot
*** SUMMARY ***
Total pot 0.08€ | No rake
Seat 6: messor (button) won 0.08€


Winamax Poker - HOLD-UP "Colorado" - HandId: #19116069-316326-1701424236 - Holdem no limit (0.01€/0.02€) - 2023/12/01 09:50:36 UTC
Table: 'Colorado' 6-max (real money) Seat #6 is the button
Seat 1: Aggro Loser (2.20€)
Seat 2: Fried Berg (0.50€)
Seat 3: FabWest (2.49€)
Seat 4: LAG0URMANDE (2.09€)
Seat 5: Clemence75 (2.40€)
Seat 6: Pffft... (4.23€)
*** ANTE/BLINDS ***
Aggro Loser posts small blind 0.01€
Fried Berg posts big blind 0.02€
Dealt to Fried Berg [Ts 3d]
*** PRE-FLOP *** 
FabWest folds
LAG0URMANDE raises 0.03€ to 0.05€
Clemence75 raises 0.15€ to 0.20€
Pffft... folds
Aggro Loser folds
Fried Berg folds
LAG0URMANDE calls 0.15€
*** FLOP *** [9s Ad 5c]
LAG0URMANDE checks
Clemence75 bets 0.16€
LAG0URMANDE folds
Clemence75 collected 0.55€ from pot
*** SUMMARY ***
Total pot 0.55€ | Rake 0.04€
Board: [9s Ad 5c]
Seat 5: Clemence75 won 0.55€


Winamax Poker - HOLD-UP "Colorado" - HandId: #19116069-316337-1701424243 - Holdem no limit (0.01€/0.02€) - 2023/12/01 09:50:43 UTC
Table: 'Colorado' 6-max (real money) Seat #6 is the button
Seat 1: MoneyGrowing (2€)
Seat 2: curiouz dje (2.09€)
Seat 3: Neferusobek (2€)
Seat 4: Fried Berg (0.48€)
Seat 5: sAArtouKK (2.37€)
Seat 6: Hydramist (2.20€)
*** ANTE/BLINDS ***
MoneyGrowing posts small blind 0.01€
curiouz dje posts big blind 0.02€
Dealt to Fried Berg [9c 4d]
*** PRE-FLOP *** 
Neferusobek folds
Fried Berg folds
sAArtouKK folds
Hydramist folds
MoneyGrowing folds
curiouz dje collected 0.03€ from pot
*** SUMMARY ***
Total pot 0.03€ | No rake
Seat 2: curiouz dje (big blind) won 0.03€


Winamax Poker - HOLD-UP "Colorado" - HandId: #19116069-316341-1701424246 - Holdem no limit (0.01€/0.02€) - 2023/12/01 09:50:46 UTC
Table: 'Colorado' 6-max (real money) Seat #6 is the button
Seat 1: Happy1000 (2.97€)
Seat 2: Perf-31 (2.13€)
Seat 3: Aggro Loser (2.19€)
Seat 4: slowreplay (2.01€)
Seat 5: Fried Berg (0.48€)
Seat 6: haouuum28 (1.56€)
*** ANTE/BLINDS ***
Happy1000 posts small blind 0.01€
Perf-31 posts big blind 0.02€
Dealt to Fried Berg [6d 3h]
*** PRE-FLOP *** 
Aggro Loser folds
slowreplay folds
Fried Berg folds
haouuum28 raises 0.02€ to 0.04€
Happy1000 folds
Perf-31 calls 0.02€
*** FLOP *** [5d Js Th]
Perf-31 checks
haouuum28 checks
*** TURN *** [5d Js Th][4s]
Perf-31 checks
haouuum28 checks
*** RIVER *** [5d Js Th 4s][2c]
Perf-31 bets 0.06€
haouuum28 raises 0.21€ to 0.27€
Perf-31 folds
haouuum28 collected 0.40€ from pot
*** SUMMARY ***
Total pot 0.40€ | Rake 0.02€
Board: [5d Js Th 4s 2c]
Seat 6: haouuum28 (button) won 0.40€


Winamax Poker - HOLD-UP "Colorado" - HandId: #19116069-316343-1701424249 - Holdem no limit (0.01€/0.02€) - 2023/12/01 09:50:49 UTC
Table: 'Colorado' 6-max (real money) Seat #6 is the button
Seat 1: Nombrillus (2.05€)
Seat 2: Neferusobek (2.95€)
Seat 3: TheRealWill (2.09€)
Seat 4: KON-2-PEUTE (2€)
Seat 5: Houarn (2.30€)
Seat 6: Fried Berg (0.48€)
*** ANTE/BLINDS ***
Nombrillus posts small blind 0.01€
Neferusobek posts big blind 0.02€
Dealt to Fried Berg [9s 3d]
*** PRE-FLOP *** 
TheRealWill folds
KON-2-PEUTE folds
Houarn folds
Fried Berg folds
Nombrillus raises 0.04€ to 0.06€
Neferusobek folds
Nombrillus collected 0.08€ from pot
*** SUMMARY ***
Total pot 0.08€ | No rake
Seat 1: Nombrillus (small blind) won 0.08€


Winamax Poker - HOLD-UP "Colorado" - HandId: #19116069-316347-1701424252 - Holdem no limit (0.01€/0.02€) - 2023/12/01 09:50:52 UTC
Table: 'Colorado' 6-max (real money) Seat #6 is the button
Seat 1: Bacardi34 (5.04€)
Seat 2: Kevalam (2.34€)
Seat 3: Fried Berg (0.48€)
Seat 4: pelouseverte (4.12€)
Seat 5: Houarn (2.30€)
Seat 6: TheRealWill (2.09€)
*** ANTE/BLINDS ***
Bacardi34 posts small blind 0.01€
Kevalam posts big blind 0.02€
Dealt to Fried Berg [Jc 4c]
*** PRE-FLOP *** 
Fried Berg folds
pelouseverte raises 0.02€ to 0.04€
Houarn folds
TheRealWill folds
Bacardi34 folds
Kevalam calls 0.02€
*** FLOP *** [Qd 9h Kd]
Kevalam checks
pelouseverte checks
*** TURN *** [Qd 9h Kd][Td]
Kevalam checks
pelouseverte checks
*** RIVER *** [Qd 9h Kd Td][4h]
Kevalam bets 0.14€
pelouseverte folds
Kevalam collected 0.22€ from pot
*** SUMMARY ***
Total pot 0.22€ | Rake 0.01€
Board: [Qd 9h Kd Td 4h]
Seat 2: Kevalam (big blind) won 0.22€


Winamax Poker - HOLD-UP "Colorado" - HandId: #19116069-316349-1701424254 - Holdem no limit (0.01€/0.02€) - 2023/12/01 09:50:54 UTC
Table: 'Colorado' 6-max (real money) Seat #6 is the button
Seat 1: KON-2-PEUTE (2€)
Seat 2: TonyInfinite (2€)
Seat 3: PIQSOU (2€)
Seat 4: BAAC0 (1.28€)
Seat 5: slowreplay (2.01€)
Seat 6: Fried Berg (0.48€)
*** ANTE/BLINDS ***
KON-2-PEUTE posts small blind 0.01€
TonyInfinite posts big blind 0.02€
Dealt to Fried Berg [Js Jd]
*** PRE-FLOP *** 
PIQSOU folds
BAAC0 folds
slowreplay folds
Fried Berg raises 0.04€ to 0.06€
KON-2-PEUTE folds
TonyInfinite folds
Fried Berg collected 0.09€ from pot
*** SUMMARY ***
Total pot 0.09€ | No rake
Seat 6: Fried Berg (button) won 0.09€


Winamax Poker - HOLD-UP "Colorado" - HandId: #19116069-316369-1701424268 - Holdem no limit (0.01€/0.02€) - 2023/12/01 09:51:08 UTC
Table: 'Colorado' 6-max (real money) Seat #6 is the button
Seat 1: Davidoo36 (1.03€)
Seat 2: Fried Berg (0.51€)
Seat 3: BAAC0 (1.70€)
Seat 4: Happy1000 (2.96€)
Seat 5: MrFlash9 (3.06€)
Seat 6: blought-22 (3.10€)
*** ANTE/BLINDS ***
Davidoo36 posts small blind 0.01€
Fried Berg posts big blind 0.02€
Dealt to Fried Berg [7d 6c]
*** PRE-FLOP *** 
BAAC0 folds
Happy1000 folds
MrFlash9 folds
blought-22 folds
Davidoo36 folds
Fried Berg collected 0.03€ from pot
*** SUMMARY ***
Total pot 0.03€ | No rake
Seat 2: Fried Berg (big blind) won 0.03€


Winamax Poker - HOLD-UP "Colorado" - HandId: #19116069-316400-1701424290 - Holdem no limit (0.01€/0.02€) - 2023/12/01 09:51:30 UTC
Table: 'Colorado' 6-max (real money) Seat #6 is the button
Seat 1: Fried Berg (0.52€)
Seat 2: Dovisclaire (0.56€)
Seat 3: MoneyGrowing (2€)
Seat 4: curiouz dje (2.17€)
Seat 5: FabWest (2.04€)
Seat 6: Neferusobek (2.96€)
*** ANTE/BLINDS ***
Fried Berg posts small blind 0.01€
Dovisclaire posts big blind 0.02€
Dealt to Fried Berg [4h Qc]
*** PRE-FLOP *** 
MoneyGrowing folds
curiouz dje folds
FabWest folds
Neferusobek folds
Fried Berg folds
Dovisclaire collected 0.03€ from pot
*** SUMMARY ***
Total pot 0.03€ | No rake
Seat 2: Dovisclaire (big blind) won 0.03€


Winamax Poker - HOLD-UP "Colorado" - HandId: #19116069-316411-1701424299 - Holdem no limit (0.01€/0.02€) - 2023/12/01 09:51:39 UTC
Table: 'Colorado' 6-max (real money) Seat #6 is the button
Seat 1: FabWest (2.02€)
Seat 2: MoneyGrowing (2€)
Seat 3: tequilaaaa (2.14€)
Seat 4: ilergeta (3.96€)
Seat 5: kameleon73 (3.24€)
Seat 6: Fried Berg (0.51€)
*** ANTE/BLINDS ***
FabWest posts small blind 0.01€
MoneyGrowing posts big blind 0.02€
Dealt to Fried Berg [5c 9s]
*** PRE-FLOP *** 
tequilaaaa calls 0.02€
ilergeta folds
kameleon73 raises 0.04€ to 0.06€
Fried Berg folds
FabWest folds
MoneyGrowing folds
tequilaaaa folds
kameleon73 collected 0.11€ from pot
*** SUMMARY ***
Total pot 0.11€ | No rake
Seat 5: kameleon73 won 0.11€


Winamax Poker - HOLD-UP "Colorado" - HandId: #19116069-316423-1701424309 - Holdem no limit (0.01€/0.02€) - 2023/12/01 09:51:49 UTC
Table: 'Colorado' 6-max (real money) Seat #6 is the button
Seat 1: Fried Berg (0.51€)
Seat 2: drAsKaryyy (1.19€)
Seat 3: LAG0URMANDE (2.09€)
Seat 4: tequilaaaa (2.12€)
Seat 5: FabWest (2.01€)
Seat 6: Aggro Loser (2.15€)
*** ANTE/BLINDS ***
Fried Berg posts small blind 0.01€
drAsKaryyy posts big blind 0.02€
Dealt to Fried Berg [8c 6c]
*** PRE-FLOP *** 
LAG0URMANDE folds
tequilaaaa folds
FabWest folds
Aggro Loser folds
Fried Berg folds
drAsKaryyy collected 0.03€ from pot
*** SUMMARY ***
Total pot 0.03€ | No rake
Seat 2: drAsKaryyy (big blind) won 0.03€


Winamax Poker - HOLD-UP "Colorado" - HandId: #19116069-316435-1701424316 - Holdem no limit (0.01€/0.02€) - 2023/12/01 09:51:56 UTC
Table: 'Colorado' 6-max (real money) Seat #6 is the button
Seat 1: FabWest (2.90€)
Seat 2: Fried Berg (0.50€)
Seat 3: Happy1000 (2.97€)
Seat 4: KON-2-PEUTE (3.92€)
Seat 5: BAAC0 (1.73€)
Seat 6: Titine543 (2.15€)
*** ANTE/BLINDS ***
FabWest posts small blind 0.01€
Fried Berg posts big blind 0.02€
Dealt to Fried Berg [4c Th]
*** PRE-FLOP *** 
Happy1000 folds
KON-2-PEUTE folds
BAAC0 raises 0.03€ to 0.05€
Titine543 calls 0.05€
FabWest folds
Fried Berg folds
*** FLOP *** [2d 5s 3c]
BAAC0 checks
Titine543 checks
*** TURN *** [2d 5s 3c][5h]
BAAC0 bets 0.10€
Titine543 folds
BAAC0 collected 0.22€ from pot
*** SUMMARY ***
Total pot 0.22€ | Rake 0.01€
Board: [2d 5s 3c 5h]
Seat 5: BAAC0 won 0.22€


Winamax Poker - HOLD-UP "Colorado" - HandId: #19116069-316442-1701424321 - Holdem no limit (0.01€/0.02€) - 2023/12/01 09:52:01 UTC
Table: 'Colorado' 6-max (real money) Seat #6 is the button
Seat 1: Neferusobek (2.96€)
Seat 2: Clemence75 (2.31€)
Seat 3: curiouz dje (2.27€)
Seat 4: LeDoc51 (2.17€)
Seat 5: Fried Berg (0.48€)
Seat 6: Cedlebon (2.06€)
*** ANTE/BLINDS ***
Neferusobek posts small blind 0.01€
Clemence75 posts big blind 0.02€
Dealt to Fried Berg [Td 8c]
*** PRE-FLOP *** 
curiouz dje folds
LeDoc51 folds
Fried Berg folds
Cedlebon folds
Neferusobek folds
Clemence75 collected 0.03€ from pot
*** SUMMARY ***
Total pot 0.03€ | No rake
Seat 2: Clemence75 (big blind) won 0.03€


Winamax Poker - HOLD-UP "Colorado" - HandId: #19116069-316445-1701424323 - Holdem no limit (0.01€/0.02€) - 2023/12/01 09:52:03 UTC
Table: 'Colorado' 6-max (real money) Seat #6 is the button
Seat 1: ilergeta (2€)
Seat 2: tichettede3 (2.27€)
Seat 3: slowreplay (2€)
Seat 4: TheRealWill (2.19€)
Seat 5: MisterZen (2€)
Seat 6: Fried Berg (0.48€)
*** ANTE/BLINDS ***
ilergeta posts small blind 0.01€
tichettede3 posts big blind 0.02€
Dealt to Fried Berg [2s 6h]
*** PRE-FLOP *** 
slowreplay raises 0.03€ to 0.05€
TheRealWill folds
MisterZen folds
Fried Berg folds
ilergeta folds
tichettede3 raises 0.11€ to 0.16€
slowreplay folds
tichettede3 collected 0.22€ from pot
*** SUMMARY ***
Total pot 0.22€ | No rake
Seat 2: tichettede3 (big blind) won 0.22€


Winamax Poker - HOLD-UP "Colorado" - HandId: #19116069-316448-1701424325 - Holdem no limit (0.01€/0.02€) - 2023/12/01 09:52:05 UTC
Table: 'Colorado' 6-max (real money) Seat #6 is the button
Seat 1: Fried Berg (0.48€)
Seat 2: Cedlebon (2.06€)
Seat 3: Bacardi34 (4.99€)
Seat 4: nda94 (0.44€)
Seat 5: FILTONFLOUSE (2€)
Seat 6: MisterZen (2€)
*** ANTE/BLINDS ***
Fried Berg posts small blind 0.01€
Cedlebon posts big blind 0.02€
Dealt to Fried Berg [6h Qs]
*** PRE-FLOP *** 
Bacardi34 folds
nda94 folds
FILTONFLOUSE folds
MisterZen raises 0.02€ to 0.04€
Fried Berg folds
Cedlebon calls 0.02€
*** FLOP *** [2c 3h 8c]
Cedlebon checks
MisterZen checks
*** TURN *** [2c 3h 8c][3s]
Cedlebon checks
MisterZen checks
*** RIVER *** [2c 3h 8c 3s][6d]
Cedlebon bets 0.09€
MisterZen folds
Cedlebon collected 0.17€ from pot
*** SUMMARY ***
Total pot 0.17€ | Rake 0.01€
Board: [2c 3h 8c 3s 6d]
Seat 2: Cedlebon (big blind) won 0.17€


Winamax Poker - HOLD-UP "Colorado" - HandId: #19116069-316453-1701424330 - Holdem no limit (0.01€/0.02€) - 2023/12/01 09:52:10 UTC
Table: 'Colorado' 6-max (real money) Seat #6 is the button
Seat 1: Happy1000 (2.97€)
Seat 2: Pffft... (3.77€)
Seat 3: Aggro Loser (2.74€)
Seat 4: curiouz dje (2€)
Seat 5: Fried Berg (0.47€)
Seat 6: FILTONFLOUSE (2€)
*** ANTE/BLINDS ***
Happy1000 posts small blind 0.01€
Pffft... posts big blind 0.02€
Dealt to Fried Berg [Ks 6d]
*** PRE-FLOP *** 
Aggro Loser folds
curiouz dje folds
Fried Berg folds
FILTONFLOUSE raises 0.03€ to 0.05€
Happy1000 calls 0.04€
Pffft... folds
*** FLOP *** [5s Kc Kd]
Happy1000 checks
FILTONFLOUSE checks
*** TURN *** [5s Kc Kd][7c]
Happy1000 bets 0.02€
FILTONFLOUSE folds
Happy1000 collected 0.13€ from pot
*** SUMMARY ***
Total pot 0.13€ | Rake 0.01€
Board: [5s Kc Kd 7c]
Seat 1: Happy1000 (small blind) won 0.13€


Winamax Poker - HOLD-UP "Colorado" - HandId: #19116069-316459-1701424334 - Holdem no limit (0.01€/0.02€) - 2023/12/01 09:52:14 UTC
Table: 'Colorado' 6-max (real money) Seat #6 is the button
Seat 1: PACS 024 (2.60€)
Seat 2: Houarn (1.36€)
Seat 3: Fried Berg (0.47€)
Seat 4: Phinsh43 (5.46€)
Seat 5: Neferusobek (2€)
Seat 6: Clemence75 (2.31€)
*** ANTE/BLINDS ***
PACS 024 posts small blind 0.01€
Houarn posts big blind 0.02€
Dealt to Fried Berg [7h 2h]
*** PRE-FLOP *** 
Fried Berg folds
Phinsh43 folds
Neferusobek folds
Clemence75 folds
PACS 024 folds
Houarn collected 0.03€ from pot
*** SUMMARY ***
Total pot 0.03€ | No rake
Seat 2: Houarn (big blind) won 0.03€


Winamax Poker - HOLD-UP "Colorado" - HandId: #19116069-316465-1701424337 - Holdem no limit (0.01€/0.02€) - 2023/12/01 09:52:17 UTC
Table: 'Colorado' 6-max (real money) Seat #6 is the button
Seat 1: tequilaaaa (2.60€)
Seat 2: Adame199623 (2.07€)
Seat 3: Fried Berg (0.47€)
Seat 4: curiouz dje (2.24€)
Seat 5: jdeepenslip (2.80€)
Seat 6: Pffft... (3.75€)
*** ANTE/BLINDS ***
tequilaaaa posts small blind 0.01€
Adame199623 posts big blind 0.02€
Dealt to Fried Berg [Qs 9h]
*** PRE-FLOP *** 
Fried Berg folds
curiouz dje folds
jdeepenslip raises 0.03€ to 0.05€
Pffft... folds
tequilaaaa folds
Adame199623 folds
jdeepenslip collected 0.08€ from pot
*** SUMMARY ***
Total pot 0.08€ | No rake
Seat 5: jdeepenslip won 0.08€


Winamax Poker - HOLD-UP "Colorado" - HandId: #19116069-316468-1701424339 - Holdem no limit (0.01€/0.02€) - 2023/12/01 09:52:19 UTC
Table: 'Colorado' 6-max (real money) Seat #6 is the button
Seat 1: Titine543 (1.91€)
Seat 2: Hydramist (2.14€)
Seat 3: Clemence75 (2.31€)
Seat 4: Fried Berg (0.47€)
Seat 5: cerber44 (1.15€)
Seat 6: Aggro Loser (2.27€)
*** ANTE/BLINDS ***
Titine543 posts small blind 0.01€
Hydramist posts big blind 0.02€
Dealt to Fried Berg [Qh 8d]
*** PRE-FLOP *** 
Clemence75 folds
Fried Berg folds
cerber44 folds
Aggro Loser raises 0.03€ to 0.05€
Titine543 folds
Hydramist folds
Aggro Loser collected 0.08€ from pot
*** SUMMARY ***
Total pot 0.08€ | No rake
Seat 6: Aggro Loser (button) won 0.08€


Winamax Poker - HOLD-UP "Colorado" - HandId: #19116069-316473-1701424343 - Holdem no limit (0.01€/0.02€) - 2023/12/01 09:52:23 UTC
Table: 'Colorado' 6-max (real money) Seat #6 is the button
Seat 1: Clemence75 (2.31€)
Seat 2: PIQSOU (2.03€)
Seat 3: Houarn (1.37€)
Seat 4: Fried Berg (0.47€)
Seat 5: curiouz dje (2€)
Seat 6: MisterZen (1.96€)
Hold-up to Pot: total 0.20€
*** ANTE/BLINDS ***
Clemence75 posts small blind 0.01€
PIQSOU posts big blind 0.02€
Dealt to Fried Berg [7c Kc]
*** PRE-FLOP *** 
Houarn folds
Fried Berg raises 0.02€ to 0.04€
curiouz dje calls 0.04€
MisterZen calls 0.04€
Clemence75 folds
PIQSOU folds
*** FLOP *** [6s 2d 8c]
Fried Berg checks
curiouz dje bets 0.18€
MisterZen folds
Fried Berg folds
curiouz dje collected 0.51€ from pot
*** SUMMARY ***
Total pot 0.51€ | Rake 0.02€
Board: [6s 2d 8c]
Seat 5: curiouz dje won 0.51€


Winamax Poker - HOLD-UP "Colorado" - HandId: #19116069-316533-1701424391 - Holdem no limit (0.01€/0.02€) - 2023/12/01 09:53:11 UTC
Table: 'Colorado' 6-max (real money) Seat #6 is the button
Seat 1: KON-2-PEUTE (3.92€)
Seat 2: nda94 (1.47€)
Seat 3: Fried Berg (0.43€)
Seat 4: grut28 (1.81€)
Seat 5: FILTONFLOUSE (5.25€)
Seat 6: Hydramist (3.34€)
*** ANTE/BLINDS ***
KON-2-PEUTE posts small blind 0.01€
nda94 posts big blind 0.02€
Dealt to Fried Berg [7s 8h]
*** PRE-FLOP *** 
Fried Berg folds
grut28 folds
FILTONFLOUSE folds
Hydramist folds
KON-2-PEUTE folds
nda94 collected 0.03€ from pot
*** SUMMARY ***
Total pot 0.03€ | No rake
Seat 2: nda94 (big blind) won 0.03€


Winamax Poker - HOLD-UP "Colorado" - HandId: #19116069-316539-1701424394 - Holdem no limit (0.01€/0.02€) - 2023/12/01 09:53:14 UTC
Table: 'Colorado' 6-max (real money) Seat #6 is the button
Seat 1: Phinsh43 (5.52€)
Seat 2: PACS 024 (2.76€)
Seat 3: grut28 (1.81€)
Seat 4: MrFlash9 (2.65€)
Seat 5: Fried Berg (0.43€)
Seat 6: Pffft... (2.33€)
*** ANTE/BLINDS ***
Phinsh43 posts small blind 0.01€
PACS 024 posts big blind 0.02€
Dealt to Fried Berg [2c 6c]
*** PRE-FLOP *** 
grut28 folds
MrFlash9 folds
Fried Berg folds
Pffft... folds
Phinsh43 folds
PACS 024 collected 0.03€ from pot
*** SUMMARY ***
Total pot 0.03€ | No rake
Seat 2: PACS 024 (big blind) won 0.03€


Winamax Poker - HOLD-UP "Colorado" - HandId: #19116069-316542-1701424395 - Holdem no limit (0.01€/0.02€) - 2023/12/01 09:53:15 UTC
Table: 'Colorado' 6-max (real money) Seat #6 is the button
Seat 1: Hydramist (3.34€)
Seat 2: Fried Berg (0.43€)
Seat 3: pelouseverte (4.05€)
Seat 4: Aggro Loser (2.31€)
Seat 5: Dovisclaire (0.65€)
Seat 6: Phinsh43 (5.51€)
*** ANTE/BLINDS ***
Hydramist posts small blind 0.01€
Fried Berg posts big blind 0.02€
Dealt to Fried Berg [7s 3h]
*** PRE-FLOP *** 
pelouseverte folds
Aggro Loser folds
Dovisclaire folds
Phinsh43 folds
Hydramist folds
Fried Berg collected 0.03€ from pot
*** SUMMARY ***
Total pot 0.03€ | No rake
Seat 2: Fried Berg (big blind) won 0.03€


Winamax Poker - HOLD-UP "Colorado" - HandId: #19116069-316554-1701424405 - Holdem no limit (0.01€/0.02€) - 2023/12/01 09:53:25 UTC
Table: 'Colorado' 6-max (real money) Seat #6 is the button
Seat 1: grut28 (1.79€)
Seat 2: Soul93440 (0.70€)
Seat 3: Perf-31 (2.13€)
Seat 4: Fried Berg (0.44€)
Seat 5: pelouseverte (1.43€)
Seat 6: Aggro Loser (2€)
*** ANTE/BLINDS ***
grut28 posts small blind 0.01€
Soul93440 posts big blind 0.02€
Dealt to Fried Berg [6h Tc]
*** PRE-FLOP *** 
Perf-31 raises 0.05€ to 0.07€
Fried Berg folds
pelouseverte folds
Aggro Loser folds
grut28 folds
Soul93440 folds
Perf-31 collected 0.10€ from pot
*** SUMMARY ***
Total pot 0.10€ | No rake
Seat 3: Perf-31 won 0.10€


Winamax Poker - HOLD-UP "Colorado" - HandId: #19116069-316556-1701424407 - Holdem no limit (0.01€/0.02€) - 2023/12/01 09:53:27 UTC
Table: 'Colorado' 6-max (real money) Seat #6 is the button
Seat 1: PIQSOU (2€)
Seat 2: Fried Berg (0.44€)
Seat 3: slowreplay (2€)
Seat 4: Hydramist (6.70€)
Seat 5: grut28 (1.78€)
Seat 6: kameleon73 (3.37€)
*** ANTE/BLINDS ***
PIQSOU posts small blind 0.01€
Fried Berg posts big blind 0.02€
Dealt to Fried Berg [7d 2s]
*** PRE-FLOP *** 
slowreplay folds
Hydramist raises 0.03€ to 0.05€
grut28 folds
kameleon73 folds
PIQSOU folds
Fried Berg folds
Hydramist collected 0.08€ from pot
*** SUMMARY ***
Total pot 0.08€ | No rake
Seat 4: Hydramist won 0.08€


Winamax Poker - HOLD-UP "Colorado" - HandId: #19116069-316562-1701424411 - Holdem no limit (0.01€/0.02€) - 2023/12/01 09:53:31 UTC
Table: 'Colorado' 6-max (real money) Seat #6 is the button
Seat 1: slowreplay (3.19€)
Seat 2: Aggro Loser (2.35€)
Seat 3: Adame199623 (2.16€)
Seat 4: FILTONFLOUSE (5.23€)
Seat 5: Fried Berg (0.42€)
Seat 6: TheRealWill (2.16€)
*** ANTE/BLINDS ***
slowreplay posts small blind 0.01€
Aggro Loser posts big blind 0.02€
Dealt to Fried Berg [7c Qs]
*** PRE-FLOP *** 
Adame199623 folds
FILTONFLOUSE folds
Fried Berg folds
TheRealWill folds
slowreplay folds
Aggro Loser collected 0.03€ from pot
*** SUMMARY ***
Total pot 0.03€ | No rake
Seat 2: Aggro Loser (big blind) won 0.03€


Winamax Poker - HOLD-UP "Colorado" - HandId: #19116069-316567-1701424415 - Holdem no limit (0.01€/0.02€) - 2023/12/01 09:53:35 UTC
Table: 'Colorado' 6-max (real money) Seat #6 is the button
Seat 1: Fried Berg (0.42€)
Seat 2: FILTONFLOUSE (5.23€)
Seat 3: LAG0URMANDE (2€)
Seat 4: cerber44 (1.13€)
Seat 5: pelouseverte (0.55€)
Seat 6: El tiki tiki (2.27€)
*** ANTE/BLINDS ***
Fried Berg posts small blind 0.01€
FILTONFLOUSE posts big blind 0.02€
Dealt to Fried Berg [7h Ad]
*** PRE-FLOP *** 
LAG0URMANDE folds
cerber44 folds
pelouseverte folds
El tiki tiki folds
Fried Berg raises 0.02€ to 0.04€
FILTONFLOUSE folds
Fried Berg collected 0.06€ from pot
*** SUMMARY ***
Total pot 0.06€ | No rake
Seat 1: Fried Berg (small blind) won 0.06€


Winamax Poker - HOLD-UP "Colorado" - HandId: #19116069-316593-1701424437 - Holdem no limit (0.01€/0.02€) - 2023/12/01 09:53:57 UTC
Table: 'Colorado' 6-max (real money) Seat #6 is the button
Seat 1: FILTONFLOUSE (5.21€)
Seat 2: Polanskii (3.58€)
Seat 3: Fried Berg (0.44€)
Seat 4: jdeepenslip (2.87€)
Seat 5: Houarn (1.91€)
Seat 6: Pffft... (2.12€)
*** ANTE/BLINDS ***
FILTONFLOUSE posts small blind 0.01€
Polanskii posts big blind 0.02€
Dealt to Fried Berg [8h 3c]
*** PRE-FLOP *** 
Fried Berg folds
jdeepenslip folds
Houarn folds
Pffft... raises 0.04€ to 0.06€
FILTONFLOUSE folds
Polanskii calls 0.04€
*** FLOP *** [6d Js 6h]
Polanskii checks
Pffft... bets 0.07€
Polanskii folds
Pffft... collected 0.19€ from pot
*** SUMMARY ***
Total pot 0.19€ | Rake 0.01€
Board: [6d Js 6h]
Seat 6: Pffft... (button) won 0.19€


Winamax Poker - HOLD-UP "Colorado" - HandId: #19116069-316595-1701424439 - Holdem no limit (0.01€/0.02€) - 2023/12/01 09:53:59 UTC
Table: 'Colorado' 6-max (real money) Seat #6 is the button
Seat 1: FILTONFLOUSE (5.20€)
Seat 2: Fried Berg (0.44€)
Seat 3: PIQSOU (2€)
Seat 4: tequilaaaa (2.25€)
Seat 5: Flo83601 (4.06€)
Seat 6: Aggro Loser (2.35€)
*** ANTE/BLINDS ***
FILTONFLOUSE posts small blind 0.01€
Fried Berg posts big blind 0.02€
Dealt to Fried Berg [6c 4d]
*** PRE-FLOP *** 
PIQSOU raises 0.03€ to 0.05€
tequilaaaa folds
Flo83601 folds
Aggro Loser raises 0.10€ to 0.15€
FILTONFLOUSE folds
Fried Berg folds
PIQSOU calls 0.10€
*** FLOP *** [Ts Kd 9h]
PIQSOU checks
Aggro Loser bets 0.17€
PIQSOU raises 0.25€ to 0.42€
Aggro Loser folds
PIQSOU collected 0.85€ from pot
*** SUMMARY ***
Total pot 0.85€ | Rake 0.07€
Board: [Ts Kd 9h]
Seat 3: PIQSOU won 0.85€


Winamax Poker - HOLD-UP "Colorado" - HandId: #19116069-316601-1701424445 - Holdem no limit (0.01€/0.02€) - 2023/12/01 09:54:05 UTC
Table: 'Colorado' 6-max (real money) Seat #6 is the button
Seat 1: Hydramist (2.20€)
Seat 2: JAKA 10 (1.94€)
Seat 3: FILTONFLOUSE (5.19€)
Seat 4: KON-2-PEUTE (2.01€)
Seat 5: PACS 024 (2.66€)
Seat 6: Fried Berg (0.42€)
*** ANTE/BLINDS ***
Hydramist posts small blind 0.01€
JAKA 10 posts big blind 0.02€
Dealt to Fried Berg [5s 8c]
*** PRE-FLOP *** 
FILTONFLOUSE folds
KON-2-PEUTE folds
PACS 024 folds
Fried Berg folds
Hydramist folds
JAKA 10 collected 0.03€ from pot
*** SUMMARY ***
Total pot 0.03€ | No rake
Seat 2: JAKA 10 (big blind) won 0.03€


Winamax Poker - HOLD-UP "Colorado" - HandId: #19116069-316603-1701424447 - Holdem no limit (0.01€/0.02€) - 2023/12/01 09:54:07 UTC
Table: 'Colorado' 6-max (real money) Seat #6 is the button
Seat 1: Fried Berg (0.42€)
Seat 2: Adame199623 (2€)
Seat 3: slowreplay (2.08€)
Seat 4: PACS 024 (2.66€)
Seat 5: Neferusobek (2€)
Seat 6: FILTONFLOUSE (5.19€)
*** ANTE/BLINDS ***
Fried Berg posts small blind 0.01€
Adame199623 posts big blind 0.02€
Dealt to Fried Berg [Ah Kd]
*** PRE-FLOP *** 
slowreplay folds
PACS 024 folds
Neferusobek folds
FILTONFLOUSE raises 0.03€ to 0.05€
Fried Berg calls 0.04€
Adame199623 folds
*** FLOP *** [9c Qc Js]
Fried Berg checks
FILTONFLOUSE checks
*** TURN *** [9c Qc Js][Ts]
Fried Berg checks
FILTONFLOUSE bets 0.10€
Fried Berg calls 0.10€
*** RIVER *** [9c Qc Js Ts][7d]
Fried Berg checks
FILTONFLOUSE bets 0.21€
Fried Berg raises 0.06€ to 0.27€ and is all-in
FILTONFLOUSE calls 0.06€
*** SHOW DOWN ***
FILTONFLOUSE shows [Ks 5s] (Straight King high)
Fried Berg shows [Ah Kd] (Straight Ace high)
Fried Berg collected 0.77€ from pot
*** SUMMARY ***
Total pot 0.77€ | Rake 0.09€
Board: [9c Qc Js Ts 7d]
Seat 1: Fried Berg (small blind) showed [Ah Kd] and won 0.77€ with Straight Ace high
Seat 6: FILTONFLOUSE (button) showed [Ks 5s] and lost with Straight King high


Winamax Poker - HOLD-UP "Colorado" - HandId: #19116069-316666-1701424494 - Holdem no limit (0.01€/0.02€) - 2023/12/01 09:54:54 UTC
Table: 'Colorado' 6-max (real money) Seat #6 is the button
Seat 1: Fish_tre33 (2.77€)
Seat 2: Mr-mika57 (0.40€)
Seat 3: MrFlash9 (2€)
Seat 4: JAWIKE1 (0.47€)
Seat 5: jdeepenslip (2.93€)
Seat 6: Fried Berg (0.77€)
*** ANTE/BLINDS ***
Fish_tre33 posts small blind 0.01€
Mr-mika57 posts big blind 0.02€
Dealt to Fried Berg [9d Kd]
*** PRE-FLOP *** 
MrFlash9 folds
JAWIKE1 raises 0.02€ to 0.04€
jdeepenslip folds
Fried Berg calls 0.04€
Fish_tre33 folds
Mr-mika57 folds
*** FLOP *** [Ah 5s 4s]
JAWIKE1 bets 0.05€
Fried Berg calls 0.05€
*** TURN *** [Ah 5s 4s][9s]
JAWIKE1 checks
Fried Berg checks
*** RIVER *** [Ah 5s 4s 9s][Js]
JAWIKE1 checks
Fried Berg checks
*** SHOW DOWN ***
JAWIKE1 shows [8c 5c] (One pair : 5)
Fried Berg shows [9d Kd] (One pair : 9)
Fried Berg collected 0.19€ from pot
*** SUMMARY ***
Total pot 0.19€ | Rake 0.02€
Board: [Ah 5s 4s 9s Js]
Seat 4: JAWIKE1 showed [8c 5c] and lost with One pair : 5
Seat 6: Fried Berg (button) showed [9d Kd] and won 0.19€ with One pair : 9


Winamax Poker - HOLD-UP "Colorado" - HandId: #19116069-316726-1701424531 - Holdem no limit (0.01€/0.02€) - 2023/12/01 09:55:31 UTC
Table: 'Colorado' 6-max (real money) Seat #6 is the button
Seat 1: Neferusobek (2.86€)
Seat 2: Houarn (1.73€)
Seat 3: Adame199623 (2€)
Seat 4: Fried Berg (0.87€)
Seat 5: JAWIKE1 (0.38€)
Seat 6: Hydramist (2.20€)
*** ANTE/BLINDS ***
Neferusobek posts small blind 0.01€
Houarn posts big blind 0.02€
Dealt to Fried Berg [9c Ah]
*** PRE-FLOP *** 
Adame199623 folds
Fried Berg raises 0.02€ to 0.04€
JAWIKE1 calls 0.04€
Hydramist calls 0.04€
Neferusobek folds
Houarn folds
*** FLOP *** [6d Th 6c]
Fried Berg checks
JAWIKE1 checks
Hydramist checks
*** TURN *** [6d Th 6c][6h]
Fried Berg checks
JAWIKE1 checks
Hydramist checks
*** RIVER *** [6d Th 6c 6h][7c]
Fried Berg checks
JAWIKE1 checks
Hydramist checks
*** SHOW DOWN ***
JAWIKE1 shows [4c 5d] (Trips of 6)
Hydramist shows [9d Jd] (Trips of 6)
Fried Berg shows [9c Ah] (Trips of 6)
Fried Berg collected 0.13€ from pot
*** SUMMARY ***
Total pot 0.13€ | Rake 0.02€
Board: [6d Th 6c 6h 7c]
Seat 4: Fried Berg showed [9c Ah] and won 0.13€ with Trips of 6
Seat 5: JAWIKE1 showed [4c 5d] and lost with Trips of 6
Seat 6: Hydramist (button) showed [9d Jd] and lost with Trips of 6


Winamax Poker - HOLD-UP "Colorado" - HandId: #19116069-316812-1701424595 - Holdem no limit (0.01€/0.02€) - 2023/12/01 09:56:35 UTC
Table: 'Colorado' 6-max (real money) Seat #6 is the button
Seat 1: Houarn (0.88€)
Seat 2: Aggro Loser (2.25€)
Seat 3: Fried Berg (0.96€)
Seat 4: Clemence75 (2.03€)
Seat 5: El tiki tiki (1.93€)
Seat 6: JAWIKE1 (0.34€)
*** ANTE/BLINDS ***
Houarn posts small blind 0.01€
Aggro Loser posts big blind 0.02€
Dealt to Fried Berg [4s 7d]
*** PRE-FLOP *** 
Fried Berg folds
Clemence75 folds
El tiki tiki folds
JAWIKE1 raises 0.02€ to 0.04€
Houarn folds
Aggro Loser folds
JAWIKE1 collected 0.07€ from pot
*** SUMMARY ***
Total pot 0.07€ | No rake
Seat 6: JAWIKE1 (button) won 0.07€


Winamax Poker - HOLD-UP "Colorado" - HandId: #19116069-316819-1701424597 - Holdem no limit (0.01€/0.02€) - 2023/12/01 09:56:37 UTC
Table: 'Colorado' 6-max (real money) Seat #6 is the button
Seat 1: LimpDoud (2.01€)
Seat 2: Fried Berg (0.96€)
Seat 3: nda94 (2.80€)
Seat 4: Braisinho 10 (0.60€)
Seat 5: KON-2-PEUTE (2€)
Seat 6: TheRealWill (2€)
*** ANTE/BLINDS ***
LimpDoud posts small blind 0.01€
Fried Berg posts big blind 0.02€
Dealt to Fried Berg [Ad Th]
*** PRE-FLOP *** 
nda94 calls 0.02€
Braisinho 10 calls 0.02€
KON-2-PEUTE folds
TheRealWill folds
LimpDoud folds
Fried Berg checks
*** FLOP *** [3h 7d Jd]
Fried Berg checks
nda94 checks
Braisinho 10 checks
*** TURN *** [3h 7d Jd][Ks]
Fried Berg checks
nda94 checks
Braisinho 10 checks
*** RIVER *** [3h 7d Jd Ks][Qd]
Fried Berg bets 0.05€
nda94 folds
Braisinho 10 folds
Fried Berg collected 0.11€ from pot
*** SUMMARY ***
Total pot 0.11€ | Rake 0.01€
Board: [3h 7d Jd Ks Qd]
Seat 2: Fried Berg (big blind) won 0.11€


Winamax Poker - HOLD-UP "Colorado" - HandId: #19116069-316902-1701424647 - Holdem no limit (0.01€/0.02€) - 2023/12/01 09:57:27 UTC
Table: 'Colorado' 6-max (real money) Seat #6 is the button
Seat 1: Aggro Loser (2.10€)
Seat 2: Braisinho 10 (0.58€)
Seat 3: curiouz dje (2.54€)
Seat 4: LimpDoud (2€)
Seat 5: Fried Berg (1€)
Seat 6: Adame199623 (2€)
*** ANTE/BLINDS ***
Aggro Loser posts small blind 0.01€
Braisinho 10 posts big blind 0.02€
Dealt to Fried Berg [8d Td]
*** PRE-FLOP *** 
curiouz dje folds
LimpDoud folds
Fried Berg raises 0.02€ to 0.04€
Adame199623 folds
Aggro Loser folds
Braisinho 10 folds
Fried Berg collected 0.07€ from pot
*** SUMMARY ***
Total pot 0.07€ | No rake
Seat 5: Fried Berg won 0.07€


Winamax Poker - HOLD-UP "Colorado" - HandId: #19116069-316917-1701424656 - Holdem no limit (0.01€/0.02€) - 2023/12/01 09:57:36 UTC
Table: 'Colorado' 6-max (real money) Seat #6 is the button
Seat 1: Fried Berg (1.03€)
Seat 2: curiouz dje (2.54€)
Seat 3: Aggro Loser (2.07€)
Seat 4: FILTONFLOUSE (4.60€)
Seat 5: PACS 024 (1.44€)
Seat 6: Nicoo49003 (3.99€)
*** ANTE/BLINDS ***
Fried Berg posts small blind 0.01€
curiouz dje posts big blind 0.02€
Dealt to Fried Berg [Ks 7c]
*** PRE-FLOP *** 
Aggro Loser folds
FILTONFLOUSE folds
PACS 024 folds
Nicoo49003 folds
Fried Berg calls 0.01€
curiouz dje checks
*** FLOP *** [Jc Th Js]
Fried Berg checks
curiouz dje checks
*** TURN *** [Jc Th Js][Qh]
Fried Berg checks
curiouz dje checks
*** RIVER *** [Jc Th Js Qh][Kc]
Fried Berg bets 0.03€
curiouz dje calls 0.03€
*** SHOW DOWN ***
Fried Berg shows [Ks 7c] (Two pairs : Kings and Jacks)
curiouz dje shows [Ah 9c] (Straight Ace high)
curiouz dje collected 0.09€ from pot
*** SUMMARY ***
Total pot 0.09€ | Rake 0.01€
Board: [Jc Th Js Qh Kc]
Seat 1: Fried Berg (small blind) showed [Ks 7c] and lost with Two pairs : Kings and Jacks
Seat 2: curiouz dje (big blind) showed [Ah 9c] and won 0.09€ with Straight Ace high


Winamax Poker - HOLD-UP "Colorado" - HandId: #19116069-316990-1701424722 - Holdem no limit (0.01€/0.02€) - 2023/12/01 09:58:42 UTC
Table: 'Colorado' 6-max (real money) Seat #6 is the button
Seat 1: Neferusobek (3.37€)
Seat 2: Titine543 (2.11€)
Seat 3: Houarn (1.61€)
Seat 4: Fried Berg (0.98€)
Seat 5: oliveponcar (2€)
Seat 6: kameleon73 (3.61€)
*** ANTE/BLINDS ***
Neferusobek posts small blind 0.01€
Titine543 posts big blind 0.02€
Dealt to Fried Berg [6c Jh]
*** PRE-FLOP *** 
Houarn folds
Fried Berg folds
oliveponcar folds
kameleon73 folds
Neferusobek folds
Titine543 collected 0.03€ from pot
*** SUMMARY ***
Total pot 0.03€ | No rake
Seat 2: Titine543 (big blind) won 0.03€


Winamax Poker - HOLD-UP "Colorado" - HandId: #19116069-316999-1701424729 - Holdem no limit (0.01€/0.02€) - 2023/12/01 09:58:49 UTC
Table: 'Colorado' 6-max (real money) Seat #6 is the button
Seat 1: Aggro Loser (2.17€)
Seat 2: Max134Max (4.02€)
Seat 3: LilRun (2.23€)
Seat 4: Mazter9 (2.20€)
Seat 5: popolka (1.63€)
Seat 6: Fried Berg (0.98€)
*** ANTE/BLINDS ***
Aggro Loser posts small blind 0.01€
Max134Max posts big blind 0.02€
Dealt to Fried Berg [5d 9c]
*** PRE-FLOP *** 
LilRun folds
Mazter9 folds
popolka folds
Fried Berg folds
Aggro Loser folds
Max134Max collected 0.03€ from pot
*** SUMMARY ***
Total pot 0.03€ | No rake
Seat 2: Max134Max (big blind) won 0.03€


Winamax Poker - HOLD-UP "Colorado" - HandId: #19116069-317011-1701424739 - Holdem no limit (0.01€/0.02€) - 2023/12/01 09:58:59 UTC
Table: 'Colorado' 6-max (real money) Seat #6 is the button
Seat 1: tequilaaaa (2.08€)
Seat 2: Adame199623 (2.03€)
Seat 3: Fried Berg (0.98€)
Seat 4: Aggro Loser (2.16€)
Seat 5: jdeepenslip (2.79€)
Seat 6: pelouseverte (3.60€)
*** ANTE/BLINDS ***
tequilaaaa posts small blind 0.01€
Adame199623 posts big blind 0.02€
Dealt to Fried Berg [8c 3d]
*** PRE-FLOP *** 
Fried Berg folds
Aggro Loser folds
jdeepenslip folds
pelouseverte calls 0.02€
tequilaaaa folds
Adame199623 raises 0.10€ to 0.12€
pelouseverte folds
Adame199623 collected 0.15€ from pot
*** SUMMARY ***
Total pot 0.15€ | No rake
Seat 2: Adame199623 (big blind) won 0.15€


Winamax Poker - HOLD-UP "Colorado" - HandId: #19116069-317013-1701424741 - Holdem no limit (0.01€/0.02€) - 2023/12/01 09:59:01 UTC
Table: 'Colorado' 6-max (real money) Seat #6 is the button
Seat 1: Fried Berg (0.98€)
Seat 2: tichettede3 (3.34€)
Seat 3: kameleon73 (3.59€)
Seat 4: MisterZen (1.64€)
Seat 5: oliveponcar (2.13€)
Seat 6: slowreplay (2.30€)
*** ANTE/BLINDS ***
Fried Berg posts small blind 0.01€
tichettede3 posts big blind 0.02€
Dealt to Fried Berg [8h Ac]
*** PRE-FLOP *** 
kameleon73 folds
MisterZen raises 0.02€ to 0.04€
oliveponcar folds
slowreplay folds
Fried Berg calls 0.03€
tichettede3 folds
*** FLOP *** [3c Kd 7h]
Fried Berg checks
MisterZen checks
*** TURN *** [3c Kd 7h][Qs]
Fried Berg checks
MisterZen bets 0.03€
Fried Berg folds
MisterZen collected 0.12€ from pot
*** SUMMARY ***
Total pot 0.12€ | Rake 0.01€
Board: [3c Kd 7h Qs]
Seat 4: MisterZen won 0.12€


Winamax Poker - HOLD-UP "Colorado" - HandId: #19116069-317046-1701424764 - Holdem no limit (0.01€/0.02€) - 2023/12/01 09:59:24 UTC
Table: 'Colorado' 6-max (real money) Seat #6 is the button
Seat 1: Cedlebon (2.68€)
Seat 2: Aggro Loser (4.69€)
Seat 3: ilergeta (2.09€)
Seat 4: Fried Berg (0.94€)
Seat 5: pelouseverte (1.33€)
Seat 6: Scr.squirrel (1.38€)
Hold-up to Pot: total 0.10€
*** ANTE/BLINDS ***
Cedlebon posts small blind 0.01€
Aggro Loser posts big blind 0.02€
Dealt to Fried Berg [2h 2s]
*** PRE-FLOP *** 
ilergeta folds
Fried Berg calls 0.02€
pelouseverte folds
Scr.squirrel folds
Cedlebon raises 0.13€ to 0.15€
Aggro Loser folds
Fried Berg folds
Cedlebon collected 0.29€ from pot
*** SUMMARY ***
Total pot 0.29€ | No rake
Seat 1: Cedlebon (small blind) won 0.29€


Winamax Poker - HOLD-UP "Colorado" - HandId: #19116069-317083-1701424795 - Holdem no limit (0.01€/0.02€) - 2023/12/01 09:59:55 UTC
Table: 'Colorado' 6-max (real money) Seat #6 is the button
Seat 1: Flo83601 (5.19€)
Seat 2: Fried Berg (0.92€)
Seat 3: LimpDoud (2.16€)
Seat 4: FILTONFLOUSE (4.51€)
Seat 5: Hydramist (2.09€)
Seat 6: LilRun (2.30€)
*** ANTE/BLINDS ***
Flo83601 posts small blind 0.01€
Fried Berg posts big blind 0.02€
Dealt to Fried Berg [3s 3c]
*** PRE-FLOP *** 
LimpDoud raises 0.03€ to 0.05€
FILTONFLOUSE folds
Hydramist folds
LilRun calls 0.05€
Flo83601 folds
Fried Berg folds
*** FLOP *** [Kc 4c Js]
LimpDoud bets 0.07€
LilRun folds
LimpDoud collected 0.19€ from pot
*** SUMMARY ***
Total pot 0.19€ | Rake 0.01€
Board: [Kc 4c Js]
Seat 3: LimpDoud won 0.19€


Winamax Poker - HOLD-UP "Colorado" - HandId: #19116069-317100-1701424808 - Holdem no limit (0.01€/0.02€) - 2023/12/01 10:00:08 UTC
Table: 'Colorado' 6-max (real money) Seat #6 is the button
Seat 1: nda94 (2.98€)
Seat 2: Mazter9 (2.27€)
Seat 3: oliveponcar (2.05€)
Seat 4: MrFlash9 (2.02€)
Seat 5: Fried Berg (0.90€)
Seat 6: Hydramist (6.48€)
*** ANTE/BLINDS ***
nda94 posts small blind 0.01€
Mazter9 posts big blind 0.02€
Dealt to Fried Berg [6c As]
*** PRE-FLOP *** 
oliveponcar folds
MrFlash9 folds
Fried Berg raises 0.02€ to 0.04€
Hydramist folds
nda94 folds
Mazter9 folds
Fried Berg collected 0.07€ from pot
*** SUMMARY ***
Total pot 0.07€ | No rake
Seat 5: Fried Berg won 0.07€


Winamax Poker - HOLD-UP "Colorado" - HandId: #19116069-317114-1701424819 - Holdem no limit (0.01€/0.02€) - 2023/12/01 10:00:19 UTC
Table: 'Colorado' 6-max (real money) Seat #6 is the button
Seat 1: Clemence75 (2.15€)
Seat 2: Fried Berg (0.93€)
Seat 3: TheRealWill (2.44€)
Seat 4: PIQSOU (3.58€)
Seat 5: slowreplay (2€)
Seat 6: grut28 (2.95€)
*** ANTE/BLINDS ***
Clemence75 posts small blind 0.01€
Fried Berg posts big blind 0.02€
Dealt to Fried Berg [6d Ac]
*** PRE-FLOP *** 
TheRealWill folds
PIQSOU folds
slowreplay folds
grut28 folds
Clemence75 raises 0.04€ to 0.06€
Fried Berg calls 0.04€
*** FLOP *** [As Qd 9c]
Clemence75 bets 0.04€
Fried Berg folds
Clemence75 collected 0.15€ from pot
*** SUMMARY ***
Total pot 0.15€ | Rake 0.01€
Board: [As Qd 9c]
Seat 1: Clemence75 (small blind) won 0.15€


Winamax Poker - HOLD-UP "Colorado" - HandId: #19116069-317136-1701424842 - Holdem no limit (0.01€/0.02€) - 2023/12/01 10:00:42 UTC
Table: 'Colorado' 6-max (real money) Seat #6 is the button
Seat 1: Fried Berg (0.87€)
Seat 2: youtile (1.90€)
Seat 3: pelouseverte (3.71€)
Seat 4: jdeepenslip (2.57€)
Seat 5: ITALIA291 (2.57€)
Seat 6: TheRealWill (4.94€)
Hold-up to Pot: total 0.10€
*** ANTE/BLINDS ***
Fried Berg posts small blind 0.01€
youtile posts big blind 0.02€
Dealt to Fried Berg [4s 3d]
*** PRE-FLOP *** 
pelouseverte folds
jdeepenslip folds
ITALIA291 raises 0.04€ to 0.06€
TheRealWill folds
Fried Berg folds
youtile calls 0.04€
*** FLOP *** [Jc Kd 4d]
youtile bets 0.08€
ITALIA291 calls 0.08€
*** TURN *** [Jc Kd 4d][3h]
youtile bets 0.14€
ITALIA291 folds
youtile collected 0.50€ from pot
*** SUMMARY ***
Total pot 0.50€ | Rake 0.03€
Board: [Jc Kd 4d 3h]
Seat 2: youtile (big blind) won 0.50€


Winamax Poker - HOLD-UP "Colorado" - HandId: #19116069-317147-1701424852 - Holdem no limit (0.01€/0.02€) - 2023/12/01 10:00:52 UTC
Table: 'Colorado' 6-max (real money) Seat #6 is the button
Seat 1: LeDoc51 (2.74€)
Seat 2: Neferusobek (3.55€)
Seat 3: Fried Berg (0.86€)
Seat 4: Dovisclaire (0.24€)
Seat 5: Adame199623 (2.10€)
Seat 6: slowreplay (2.32€)
*** ANTE/BLINDS ***
LeDoc51 posts small blind 0.01€
Neferusobek posts big blind 0.02€
Dealt to Fried Berg [As Qs]
*** PRE-FLOP *** 
Fried Berg raises 0.02€ to 0.04€
Dovisclaire folds
Adame199623 folds
slowreplay calls 0.04€
LeDoc51 folds
Neferusobek folds
*** FLOP *** [Td 3h 8s]
Fried Berg bets 0.04€
slowreplay calls 0.04€
*** TURN *** [Td 3h 8s][6h]
Fried Berg bets 0.10€
slowreplay raises 0.10€ to 0.20€
Fried Berg calls 0.10€
*** RIVER *** [Td 3h 8s 6h][2s]
Fried Berg checks
slowreplay checks
*** SHOW DOWN ***
Fried Berg shows [As Qs] (High card : Ace)
slowreplay shows [9c 9d] (One pair : 9)
slowreplay collected 0.53€ from pot
*** SUMMARY ***
Total pot 0.53€ | Rake 0.06€
Board: [Td 3h 8s 6h 2s]
Seat 3: Fried Berg showed [As Qs] and lost with High card : Ace
Seat 6: slowreplay (button) showed [9c 9d] and won 0.53€ with One pair : 9


Winamax Poker - HOLD-UP "Colorado" - HandId: #19116069-317203-1701424910 - Holdem no limit (0.01€/0.02€) - 2023/12/01 10:01:50 UTC
Table: 'Colorado' 6-max (real money) Seat #6 is the button
Seat 1: slowreplay (2.57€)
Seat 2: tequilaaaa (2.40€)
Seat 3: KON-2-PEUTE (2.11€)
Seat 4: curiouz dje (2.30€)
Seat 5: Fried Berg (0.58€)
Seat 6: PIQSOU (2€)
*** ANTE/BLINDS ***
slowreplay posts small blind 0.01€
tequilaaaa posts big blind 0.02€
Dealt to Fried Berg [Qd 6h]
*** PRE-FLOP *** 
KON-2-PEUTE raises 0.03€ to 0.05€
curiouz dje folds
Fried Berg folds
PIQSOU folds
slowreplay folds
tequilaaaa folds
KON-2-PEUTE collected 0.08€ from pot
*** SUMMARY ***
Total pot 0.08€ | No rake
Seat 3: KON-2-PEUTE won 0.08€


Winamax Poker - HOLD-UP "Colorado" - HandId: #19116069-317210-1701424916 - Holdem no limit (0.01€/0.02€) - 2023/12/01 10:01:56 UTC
Table: 'Colorado' 6-max (real money) Seat #6 is the button
Seat 1: kameleon73 (4.92€)
Seat 2: fifi2308 (1.84€)
Seat 3: jdeepenslip (3.28€)
Seat 4: Puma108 (0.23€)
Seat 5: Fried Berg (0.58€)
Seat 6: PACS 024 (1.34€)
*** ANTE/BLINDS ***
kameleon73 posts small blind 0.01€
fifi2308 posts big blind 0.02€
Dealt to Fried Berg [As 6h]
*** PRE-FLOP *** 
jdeepenslip raises 0.03€ to 0.05€
Puma108 calls 0.05€
Fried Berg folds
PACS 024 calls 0.05€
kameleon73 folds
fifi2308 folds
*** FLOP *** [Ac 8d Js]
jdeepenslip checks
Puma108 checks
PACS 024 bets 0.02€
jdeepenslip folds
Puma108 calls 0.02€
*** TURN *** [Ac 8d Js][5s]
Puma108 checks
PACS 024 bets 0.06€
Puma108 calls 0.06€
*** RIVER *** [Ac 8d Js 5s][9s]
Puma108 checks
PACS 024 bets 0.10€
Puma108 folds
PACS 024 collected 0.41€ from pot
*** SUMMARY ***
Total pot 0.41€ | Rake 0.03€
Board: [Ac 8d Js 5s 9s]
Seat 6: PACS 024 (button) won 0.41€


Winamax Poker - HOLD-UP "Colorado" - HandId: #19116069-317224-1701424925 - Holdem no limit (0.01€/0.02€) - 2023/12/01 10:02:05 UTC
Table: 'Colorado' 6-max (real money) Seat #6 is the button
Seat 1: crossRiver (2€)
Seat 2: El tiki tiki (2.27€)
Seat 3: ECPulga (2.45€)
Seat 4: Fried Berg (0.58€)
Seat 5: FILTONFLOUSE (4.63€)
Seat 6: TheRealWill (2.03€)
*** ANTE/BLINDS ***
crossRiver posts small blind 0.01€
El tiki tiki posts big blind 0.02€
Dealt to Fried Berg [3h Ac]
*** PRE-FLOP *** 
ECPulga folds
Fried Berg folds
FILTONFLOUSE folds
TheRealWill folds
crossRiver folds
El tiki tiki collected 0.03€ from pot
*** SUMMARY ***
Total pot 0.03€ | No rake
Seat 2: El tiki tiki (big blind) won 0.03€


Winamax Poker - HOLD-UP "Colorado" - HandId: #19116069-317229-1701424928 - Holdem no limit (0.01€/0.02€) - 2023/12/01 10:02:08 UTC
Table: 'Colorado' 6-max (real money) Seat #6 is the button
Seat 1: curiouz dje (2.63€)
Seat 2: KON-2-PEUTE (3.63€)
Seat 3: OursDesMers (1.96€)
Seat 4: Adame199623 (2.07€)
Seat 5: ECPulga (2.45€)
Seat 6: Fried Berg (0.58€)
*** ANTE/BLINDS ***
curiouz dje posts small blind 0.01€
KON-2-PEUTE posts big blind 0.02€
Dealt to Fried Berg [Kh 6h]
*** PRE-FLOP *** 
OursDesMers folds
Adame199623 folds
ECPulga folds
Fried Berg raises 0.02€ to 0.04€
curiouz dje folds
KON-2-PEUTE calls 0.02€
*** FLOP *** [7d Tc 2h]
KON-2-PEUTE checks
Fried Berg checks
*** TURN *** [7d Tc 2h][8h]
KON-2-PEUTE checks
Fried Berg checks
*** RIVER *** [7d Tc 2h 8h][3d]
KON-2-PEUTE checks
Fried Berg checks
*** SHOW DOWN ***
Fried Berg shows [Kh 6h] (High card : King)
KON-2-PEUTE shows [Jc Ac] (High card : Ace)
KON-2-PEUTE collected 0.08€ from pot
*** SUMMARY ***
Total pot 0.08€ | Rake 0.01€
Board: [7d Tc 2h 8h 3d]
Seat 2: KON-2-PEUTE (big blind) showed [Jc Ac] and won 0.08€ with High card : Ace
Seat 6: Fried Berg (button) showed [Kh 6h] and lost with High card : King


Winamax Poker - HOLD-UP "Colorado" - HandId: #19116069-317275-1701424968 - Holdem no limit (0.01€/0.02€) - 2023/12/01 10:02:48 UTC
Table: 'Colorado' 6-max (real money) Seat #6 is the button
Seat 1: tequilaaaa (2.05€)
Seat 2: Aggro Loser (2.87€)
Seat 3: LAG0URMANDE (2€)
Seat 4: Neferusobek (3.50€)
Seat 5: KON-2-PEUTE (3.67€)
Seat 6: Fried Berg (0.54€)
Hold-up to Pot: total 0.10€
*** ANTE/BLINDS ***
tequilaaaa posts small blind 0.01€
Aggro Loser posts big blind 0.02€
Dealt to Fried Berg [9s 8s]
*** PRE-FLOP *** 
LAG0URMANDE raises 0.03€ to 0.05€
Neferusobek folds
KON-2-PEUTE calls 0.05€
Fried Berg raises 0.49€ to 0.54€ and is all-in
tequilaaaa folds
Aggro Loser folds
LAG0URMANDE raises 1.46€ to 2€ and is all-in
KON-2-PEUTE folds
*** FLOP *** [3s 7s 7h]
*** TURN *** [3s 7s 7h][5h]
*** RIVER *** [3s 7s 7h 5h][Kd]
*** SHOW DOWN ***
Fried Berg shows [9s 8s] (One pair : 7)
LAG0URMANDE shows [4c Ac] (One pair : 7)
LAG0URMANDE collected 2.60€ from pot
*** SUMMARY ***
Total pot 2.60€ | Rake 0.12€
Board: [3s 7s 7h 5h Kd]
Seat 3: LAG0URMANDE showed [4c Ac] and won 2.60€ with One pair : 7
Seat 6: Fried Berg (button) showed [9s 8s] and lost with One pair : 7


Winamax Poker - HOLD-UP "Colorado" - HandId: #19116069-321160-1701427884 - Holdem no limit (0.01€/0.02€) - 2023/12/01 10:51:24 UTC
Table: 'Colorado' 6-max (real money) Seat #6 is the button
Seat 1: Cejargordas (2.44€)
Seat 2: Fried Berg (0.50€)
Seat 3: divin.Ange64 (2.38€)
Seat 4: KKamarAAde (3.84€)
Seat 5: FILTONFLOUSE (2.03€)
Seat 6: Plisken11 (0.82€)
*** ANTE/BLINDS ***
Cejargordas posts small blind 0.01€
Fried Berg posts big blind 0.02€
Dealt to Fried Berg [5s 3d]
*** PRE-FLOP *** 
divin.Ange64 folds
KKamarAAde folds
FILTONFLOUSE folds
Plisken11 raises 0.04€ to 0.06€
Cejargordas folds
Fried Berg folds
Plisken11 collected 0.09€ from pot
*** SUMMARY ***
Total pot 0.09€ | No rake
Seat 6: Plisken11 (button) won 0.09€


Winamax Poker - HOLD-UP "Colorado" - HandId: #19116069-321206-1701427916 - Holdem no limit (0.01€/0.02€) - 2023/12/01 10:51:56 UTC
Table: 'Colorado' 6-max (real money) Seat #6 is the button
Seat 1: Fried Berg (0.48€)
Seat 2: PIQSOU (4.95€)
Seat 3: LM231620 (0.44€)
Seat 4: KKamarAAde (2.81€)
Seat 5: stuart79 (3.11€)
Seat 6: divin.Ange64 (2.38€)
*** ANTE/BLINDS ***
Fried Berg posts small blind 0.01€
PIQSOU posts big blind 0.02€
Dealt to Fried Berg [8h Th]
*** PRE-FLOP *** 
LM231620 folds
KKamarAAde folds
stuart79 raises 0.04€ to 0.06€
divin.Ange64 folds
Fried Berg folds
PIQSOU folds
stuart79 collected 0.09€ from pot
*** SUMMARY ***
Total pot 0.09€ | No rake
Seat 5: stuart79 won 0.09€


Winamax Poker - HOLD-UP "Colorado" - HandId: #19116069-321237-1701427935 - Holdem no limit (0.01€/0.02€) - 2023/12/01 10:52:15 UTC
Table: 'Colorado' 6-max (real money) Seat #6 is the button
Seat 1: Thequeen1205 (2.09€)
Seat 2: LeDoc51 (1.03€)
Seat 3: Fried Berg (0.47€)
Seat 4: Pffft... (2.16€)
Seat 5: FILTONFLOUSE (2.18€)
Seat 6: Xnikos2X (2.19€)
*** ANTE/BLINDS ***
Thequeen1205 posts small blind 0.01€
LeDoc51 posts big blind 0.02€
Dealt to Fried Berg [4d Qs]
*** PRE-FLOP *** 
Fried Berg folds
Pffft... folds
FILTONFLOUSE raises 0.03€ to 0.05€
Xnikos2X folds
Thequeen1205 folds
LeDoc51 folds
FILTONFLOUSE collected 0.08€ from pot
*** SUMMARY ***
Total pot 0.08€ | No rake
Seat 5: FILTONFLOUSE won 0.08€


Winamax Poker - HOLD-UP "Colorado" - HandId: #19116069-321239-1701427937 - Holdem no limit (0.01€/0.02€) - 2023/12/01 10:52:17 UTC
Table: 'Colorado' 6-max (real money) Seat #6 is the button
Seat 1: MasTo22 (2.01€)
Seat 2: korade (2.05€)
Seat 3: Fish_tre33 (1.79€)
Seat 4: Fried Berg (0.47€)
Seat 5: KKamarAAde (4.76€)
Seat 6: curiouz dje (2.08€)
*** ANTE/BLINDS ***
MasTo22 posts small blind 0.01€
korade posts big blind 0.02€
Dealt to Fried Berg [3s 4s]
*** PRE-FLOP *** 
Fish_tre33 folds
Fried Berg calls 0.02€
KKamarAAde folds
curiouz dje folds
MasTo22 calls 0.01€
korade checks
*** FLOP *** [6h 4d Qs]
MasTo22 checks
korade checks
Fried Berg checks
*** TURN *** [6h 4d Qs][Qc]
MasTo22 checks
korade checks
Fried Berg checks
*** RIVER *** [6h 4d Qs Qc][Kh]
MasTo22 bets 0.06€
korade folds
Fried Berg calls 0.06€
*** SHOW DOWN ***
MasTo22 shows [Jc 7c] (One pair : Queens)
Fried Berg shows [3s 4s] (Two pairs : Queens and 4)
Fried Berg collected 0.16€ from pot
*** SUMMARY ***
Total pot 0.16€ | Rake 0.02€
Board: [6h 4d Qs Qc Kh]
Seat 1: MasTo22 (small blind) showed [Jc 7c] and lost with One pair : Queens
Seat 4: Fried Berg showed [3s 4s] and won 0.16€ with Two pairs : Queens and 4


Winamax Poker - HOLD-UP "Colorado" - HandId: #19116069-321304-1701427990 - Holdem no limit (0.01€/0.02€) - 2023/12/01 10:53:10 UTC
Table: 'Colorado' 6-max (real money) Seat #6 is the button
Seat 1: _FanZ_ (2.39€)
Seat 2: Tilted_Donk (2.11€)
Seat 3: MasTo22 (1.93€)
Seat 4: Xnikos2X (3.60€)
Seat 5: Fried Berg (0.55€)
Seat 6: PIQSOU (4.96€)
*** ANTE/BLINDS ***
_FanZ_ posts small blind 0.01€
Tilted_Donk posts big blind 0.02€
Dealt to Fried Berg [7h Jd]
*** PRE-FLOP *** 
MasTo22 calls 0.02€
Xnikos2X folds
Fried Berg folds
PIQSOU folds
_FanZ_ calls 0.01€
Tilted_Donk checks
*** FLOP *** [2c 6c 3d]
_FanZ_ bets 0.06€
Tilted_Donk folds
MasTo22 calls 0.06€
*** TURN *** [2c 6c 3d][Kc]
_FanZ_ bets 0.12€
MasTo22 calls 0.12€
*** RIVER *** [2c 6c 3d Kc][Ad]
_FanZ_ checks
MasTo22 checks
*** SHOW DOWN ***
MasTo22 shows [Qd Kh] (One pair : Kings)
_FanZ_ shows [6s 2s] (Two pairs : 6 and 2)
_FanZ_ collected 0.38€ from pot
*** SUMMARY ***
Total pot 0.38€ | Rake 0.04€
Board: [2c 6c 3d Kc Ad]
Seat 1: _FanZ_ (small blind) showed [6s 2s] and won 0.38€ with Two pairs : 6 and 2
Seat 3: MasTo22 showed [Qd Kh] and lost with One pair : Kings


Winamax Poker - HOLD-UP "Colorado" - HandId: #19116069-321325-1701428009 - Holdem no limit (0.01€/0.02€) - 2023/12/01 10:53:29 UTC
Table: 'Colorado' 6-max (real money) Seat #6 is the button
Seat 1: Tonisa98 (2.32€)
Seat 2: TaBrEaMoI (2.10€)
Seat 3: KRILIN-66 (1.50€)
Seat 4: korade (2.03€)
Seat 5: ricki64 (1€)
Seat 6: Fried Berg (0.55€)
*** ANTE/BLINDS ***
Tonisa98 posts small blind 0.01€
TaBrEaMoI posts big blind 0.02€
Dealt to Fried Berg [2h Ts]
*** PRE-FLOP *** 
KRILIN-66 folds
korade folds
ricki64 raises 0.05€ to 0.07€
Fried Berg folds
Tonisa98 folds
TaBrEaMoI folds
ricki64 collected 0.10€ from pot
*** SUMMARY ***
Total pot 0.10€ | No rake
Seat 5: ricki64 won 0.10€


Winamax Poker - HOLD-UP "Colorado" - HandId: #19116069-321338-1701428020 - Holdem no limit (0.01€/0.02€) - 2023/12/01 10:53:40 UTC
Table: 'Colorado' 6-max (real money) Seat #6 is the button
Seat 1: curiouz dje (2.04€)
Seat 2: FILTONFLOUSE (2.24€)
Seat 3: grut28 (5.70€)
Seat 4: Fried Berg (0.55€)
Seat 5: Sucre10 (2€)
Seat 6: Lucky_Donkey (2.73€)
*** ANTE/BLINDS ***
curiouz dje posts small blind 0.01€
FILTONFLOUSE posts big blind 0.02€
Dealt to Fried Berg [6d Qh]
*** PRE-FLOP *** 
grut28 folds
Fried Berg folds
Sucre10 folds
Lucky_Donkey folds
curiouz dje folds
FILTONFLOUSE collected 0.03€ from pot
*** SUMMARY ***
Total pot 0.03€ | No rake
Seat 2: FILTONFLOUSE (big blind) won 0.03€


Winamax Poker - HOLD-UP "Colorado" - HandId: #19116069-321344-1701428025 - Holdem no limit (0.01€/0.02€) - 2023/12/01 10:53:45 UTC
Table: 'Colorado' 6-max (real money) Seat #6 is the button
Seat 1: Pop_hop_hop (1.36€)
Seat 2: Fried Berg (0.55€)
Seat 3: MVital23 (0.65€)
Seat 4: YoSoyPablo17 (1.55€)
Seat 5: papashark14 (1.92€)
Seat 6: KKamarAAde (3.99€)
*** ANTE/BLINDS ***
Pop_hop_hop posts small blind 0.01€
Fried Berg posts big blind 0.02€
Dealt to Fried Berg [8c 4c]
*** PRE-FLOP *** 
MVital23 folds
YoSoyPablo17 folds
papashark14 folds
KKamarAAde raises 0.04€ to 0.06€
Pop_hop_hop folds
Fried Berg folds
KKamarAAde collected 0.09€ from pot
*** SUMMARY ***
Total pot 0.09€ | No rake
Seat 6: KKamarAAde (button) won 0.09€


Winamax Poker - HOLD-UP "Colorado" - HandId: #19116069-321382-1701428058 - Holdem no limit (0.01€/0.02€) - 2023/12/01 10:54:18 UTC
Table: 'Colorado' 6-max (real money) Seat #6 is the button
Seat 1: Fried Berg (0.53€)
Seat 2: papashark14 (1.92€)
Seat 3: lut1dupoivre (0.25€)
Seat 4: CHANGAS (2.15€)
Seat 5: Pop_hop_hop (1.35€)
Seat 6: 121 (2.30€)
*** ANTE/BLINDS ***
Fried Berg posts small blind 0.01€
papashark14 posts big blind 0.02€
Dealt to Fried Berg [9c 5c]
*** PRE-FLOP *** 
lut1dupoivre folds
CHANGAS raises 0.04€ to 0.06€
Pop_hop_hop folds
121 folds
Fried Berg folds
papashark14 folds
CHANGAS collected 0.09€ from pot
*** SUMMARY ***
Total pot 0.09€ | No rake
Seat 4: CHANGAS won 0.09€


Winamax Poker - HOLD-UP "Colorado" - HandId: #19116069-321410-1701428080 - Holdem no limit (0.01€/0.02€) - 2023/12/01 10:54:40 UTC
Table: 'Colorado' 6-max (real money) Seat #6 is the button
Seat 1: Cejargordas (3.70€)
Seat 2: lestat6993 (2.38€)
Seat 3: Fried Berg (0.52€)
Seat 4: grut28 (5.59€)
Seat 5: Br3izh_P0k3r (2.71€)
Seat 6: Pop_hop_hop (3.70€)
*** ANTE/BLINDS ***
Cejargordas posts small blind 0.01€
lestat6993 posts big blind 0.02€
Dealt to Fried Berg [5s 9c]
*** PRE-FLOP *** 
Fried Berg folds
grut28 folds
Br3izh_P0k3r raises 0.04€ to 0.06€
Pop_hop_hop folds
Cejargordas raises 0.14€ to 0.20€
lestat6993 folds
Br3izh_P0k3r calls 0.14€
*** FLOP *** [6c 4c 9s]
Cejargordas bets 0.27€
Br3izh_P0k3r calls 0.27€
*** TURN *** [6c 4c 9s][5d]
Cejargordas bets 1.53€
Br3izh_P0k3r calls 1.53€
*** RIVER *** [6c 4c 9s 5d][3c]
Cejargordas bets 1.70€ and is all-in
Br3izh_P0k3r folds
Cejargordas collected 5.32€ from pot
*** SUMMARY ***
Total pot 5.32€ | Rake 0.40€
Board: [6c 4c 9s 5d 3c]
Seat 1: Cejargordas (small blind) won 5.32€


Winamax Poker - HOLD-UP "Colorado" - HandId: #19116069-321412-1701428082 - Holdem no limit (0.01€/0.02€) - 2023/12/01 10:54:42 UTC
Table: 'Colorado' 6-max (real money) Seat #6 is the button
Seat 1: korade (2.03€)
Seat 2: KKamarAAde (2.06€)
Seat 3: Gafe2018 (2€)
Seat 4: PtitDidine (2.21€)
Seat 5: Fried Berg (0.52€)
Seat 6: FILTONFLOUSE (2.06€)
*** ANTE/BLINDS ***
korade posts small blind 0.01€
KKamarAAde posts big blind 0.02€
Dealt to Fried Berg [8s Ah]
*** PRE-FLOP *** 
Gafe2018 folds
PtitDidine folds
Fried Berg raises 0.02€ to 0.04€
FILTONFLOUSE folds
korade folds
KKamarAAde folds
Fried Berg collected 0.07€ from pot
*** SUMMARY ***
Total pot 0.07€ | No rake
Seat 5: Fried Berg won 0.07€


Winamax Poker - HOLD-UP "Colorado" - HandId: #19116069-321434-1701428099 - Holdem no limit (0.01€/0.02€) - 2023/12/01 10:54:59 UTC
Table: 'Colorado' 6-max (real money) Seat #6 is the button
Seat 1: curiouz dje (4.13€)
Seat 2: Polanskii (2€)
Seat 3: cecilon (0.59€)
Seat 4: Myriamneuf (0.42€)
Seat 5: FILTONFLOUSE (2.21€)
Seat 6: Fried Berg (0.55€)
*** ANTE/BLINDS ***
curiouz dje posts small blind 0.01€
Polanskii posts big blind 0.02€
Dealt to Fried Berg [6h 7s]
*** PRE-FLOP *** 
cecilon folds
Myriamneuf folds
FILTONFLOUSE folds
Fried Berg raises 0.04€ to 0.06€
curiouz dje folds
Polanskii folds
Fried Berg collected 0.09€ from pot
*** SUMMARY ***
Total pot 0.09€ | No rake
Seat 6: Fried Berg (button) won 0.09€


Winamax Poker - HOLD-UP "Colorado" - HandId: #19116069-321487-1701428136 - Holdem no limit (0.01€/0.02€) - 2023/12/01 10:55:36 UTC
Table: 'Colorado' 6-max (real money) Seat #6 is the button
Seat 1: Fried Berg (0.58€)
Seat 2: Jojo-andros5 (0.51€)
Seat 3: JFSredbaron (2€)
Seat 4: CHANGAS (2.18€)
Seat 5: haouuum28 (3.17€)
Seat 6: Xnikos2X (2.12€)
*** ANTE/BLINDS ***
Fried Berg posts small blind 0.01€
Jojo-andros5 posts big blind 0.02€
Dealt to Fried Berg [Jc 7h]
*** PRE-FLOP *** 
JFSredbaron raises 0.04€ to 0.06€
CHANGAS folds
haouuum28 folds
Xnikos2X raises 0.12€ to 0.18€
Fried Berg folds
Jojo-andros5 folds
JFSredbaron raises 0.27€ to 0.45€
Xnikos2X raises 1.67€ to 2.12€ and is all-in
JFSredbaron calls 1.55€ and is all-in
*** FLOP *** [3d 6s Js]
*** TURN *** [3d 6s Js][9d]
*** RIVER *** [3d 6s Js 9d][Jh]
*** SHOW DOWN ***
JFSredbaron shows [Kc Kd] (Two pairs : Kings and Jacks)
Xnikos2X shows [Ah Ad] (Two pairs : Aces and Jacks)
Xnikos2X collected 3.75€ from pot
*** SUMMARY ***
Total pot 3.75€ | Rake 0.40€
Board: [3d 6s Js 9d Jh]
Seat 3: JFSredbaron showed [Kc Kd] and lost with Two pairs : Kings and Jacks
Seat 6: Xnikos2X (button) showed [Ah Ad] and won 3.75€ with Two pairs : Aces and Jacks


Winamax Poker - HOLD-UP "Colorado" - HandId: #19116069-321500-1701428149 - Holdem no limit (0.01€/0.02€) - 2023/12/01 10:55:49 UTC
Table: 'Colorado' 6-max (real money) Seat #6 is the button
Seat 1: Pffft... (3.18€)
Seat 2: Fried Berg (0.57€)
Seat 3: FILTONFLOUSE (2€)
Seat 4: Jojo-andros5 (0.49€)
Seat 5: grut28 (5.65€)
Seat 6: Davidoo36 (0.58€)
*** ANTE/BLINDS ***
Pffft... posts small blind 0.01€
Fried Berg posts big blind 0.02€
Dealt to Fried Berg [3d 3s]
*** PRE-FLOP *** 
FILTONFLOUSE folds
Jojo-andros5 calls 0.02€
grut28 folds
Davidoo36 raises 0.02€ to 0.04€
Pffft... folds
Fried Berg folds
Jojo-andros5 calls 0.02€
*** FLOP *** [7s 6h 6s]
Jojo-andros5 bets 0.02€
Davidoo36 calls 0.02€
*** TURN *** [7s 6h 6s][5d]
Jojo-andros5 bets 0.02€
Davidoo36 calls 0.02€
*** RIVER *** [7s 6h 6s 5d][Td]
Jojo-andros5 bets 0.07€
Davidoo36 calls 0.07€
*** SHOW DOWN ***
Davidoo36 shows [Ac Th] (Two pairs : Tens and 6)
Jojo-andros5 shows [7h 7c] (Full of 7 and 6)
Jojo-andros5 collected 0.30€ from pot
*** SUMMARY ***
Total pot 0.30€ | Rake 0.03€
Board: [7s 6h 6s 5d Td]
Seat 4: Jojo-andros5 showed [7h 7c] and won 0.30€ with Full of 7 and 6
Seat 6: Davidoo36 (button) showed [Ac Th] and lost with Two pairs : Tens and 6


Winamax Poker - HOLD-UP "Colorado" - HandId: #19116069-321531-1701428180 - Holdem no limit (0.01€/0.02€) - 2023/12/01 10:56:20 UTC
Table: 'Colorado' 6-max (real money) Seat #6 is the button
Seat 1: Cejargordas (6.63€)
Seat 2: fpvx (1.03€)
Seat 3: Fried Berg (0.55€)
Seat 4: PIQSOU (4.69€)
Seat 5: TaBrEaMoI (2.33€)
Seat 6: haouuum28 (3.20€)
Hold-up to Pot: total 0.10€
*** ANTE/BLINDS ***
Cejargordas posts small blind 0.01€
fpvx posts big blind 0.02€
Dealt to Fried Berg [Ks Js]
*** PRE-FLOP *** 
Fried Berg raises 0.53€ to 0.55€ and is all-in
PIQSOU folds
TaBrEaMoI folds
haouuum28 folds
Cejargordas folds
fpvx raises 0.48€ to 1.03€ and is all-in
*** FLOP *** [Qc Ts 6c]
*** TURN *** [Qc Ts 6c][3c]
*** RIVER *** [Qc Ts 6c 3c][Jc]
*** SHOW DOWN ***
Fried Berg shows [Ks Js] (One pair : Jacks)
fpvx shows [Jh 6d] (Two pairs : Jacks and 6)
fpvx collected 1.58€ from pot
*** SUMMARY ***
Total pot 1.58€ | Rake 0.11€
Board: [Qc Ts 6c 3c Jc]
Seat 2: fpvx (big blind) showed [Jh 6d] and won 1.58€ with Two pairs : Jacks and 6
Seat 3: Fried Berg showed [Ks Js] and lost with One pair : Jacks


Winamax Poker - HOLD-UP "Colorado" - HandId: #19116069-321630-1701428253 - Holdem no limit (0.01€/0.02€) - 2023/12/01 10:57:33 UTC
Table: 'Colorado' 6-max (real money) Seat #6 is the button
Seat 1: stuart79 (2.79€)
Seat 2: Brao7592 (0.63€)
Seat 3: Xnikos2X (2.04€)
Seat 4: Fried Berg (0.50€)
Seat 5: Lucky_Donkey (2.51€)
Seat 6: korade (4.38€)
*** ANTE/BLINDS ***
stuart79 posts small blind 0.01€
Brao7592 posts big blind 0.02€
Dealt to Fried Berg [6h 2s]
*** PRE-FLOP *** 
Xnikos2X folds
Fried Berg folds
Lucky_Donkey raises 0.04€ to 0.06€
korade folds
stuart79 folds
Brao7592 calls 0.04€
*** FLOP *** [3h As 3c]
Brao7592 checks
Lucky_Donkey bets 0.05€
Brao7592 folds
Lucky_Donkey collected 0.17€ from pot
*** SUMMARY ***
Total pot 0.17€ | Rake 0.01€
Board: [3h As 3c]
Seat 5: Lucky_Donkey won 0.17€


Winamax Poker - HOLD-UP "Colorado" - HandId: #19116069-321636-1701428257 - Holdem no limit (0.01€/0.02€) - 2023/12/01 10:57:37 UTC
Table: 'Colorado' 6-max (real money) Seat #6 is the button
Seat 1: jdeepenslip (2€)
Seat 2: Gafe2018 (2.03€)
Seat 3: Pffft... (2.05€)
Seat 4: L INCONNU (0.86€)
Seat 5: Fried Berg (0.50€)
Seat 6: orzanco (1.61€)
*** ANTE/BLINDS ***
jdeepenslip posts small blind 0.01€
Gafe2018 posts big blind 0.02€
Dealt to Fried Berg [2s 4s]
*** PRE-FLOP *** 
Pffft... raises 0.04€ to 0.06€
L INCONNU folds
Fried Berg folds
orzanco folds
jdeepenslip folds
Gafe2018 folds
Pffft... collected 0.09€ from pot
*** SUMMARY ***
Total pot 0.09€ | No rake
Seat 3: Pffft... won 0.09€


Winamax Poker - HOLD-UP "Colorado" - HandId: #19116069-321640-1701428261 - Holdem no limit (0.01€/0.02€) - 2023/12/01 10:57:41 UTC
Table: 'Colorado' 6-max (real money) Seat #6 is the button
Seat 1: GTO-Mieko (3.24€)
Seat 2: haouuum28 (3.27€)
Seat 3: stuart79 (2.76€)
Seat 4: jdeepenslip (2€)
Seat 5: korade (4.38€)
Seat 6: Fried Berg (0.50€)
*** ANTE/BLINDS ***
GTO-Mieko posts small blind 0.01€
haouuum28 posts big blind 0.02€
Dealt to Fried Berg [9d Jc]
*** PRE-FLOP *** 
stuart79 raises 0.04€ to 0.06€
jdeepenslip folds
korade calls 0.06€
Fried Berg folds
GTO-Mieko folds
haouuum28 folds
*** FLOP *** [7d Ac Js]
stuart79 bets 0.05€
korade folds
stuart79 collected 0.18€ from pot
*** SUMMARY ***
Total pot 0.18€ | Rake 0.02€
Board: [7d Ac Js]
Seat 3: stuart79 won 0.18€


Winamax Poker - HOLD-UP "Colorado" - HandId: #19116069-321662-1701428279 - Holdem no limit (0.01€/0.02€) - 2023/12/01 10:57:59 UTC
Table: 'Colorado' 6-max (real money) Seat #6 is the button
Seat 1: papashark14 (1.96€)
Seat 2: Fried Berg (0.50€)
Seat 3: g8o8k8u (2.41€)
Seat 4: FILTONFLOUSE (2.10€)
Seat 5: soliderock (2.27€)
Seat 6: Baston57 (1.80€)
*** ANTE/BLINDS ***
papashark14 posts small blind 0.01€
Fried Berg posts big blind 0.02€
Dealt to Fried Berg [Tc Ah]
*** PRE-FLOP *** 
g8o8k8u folds
FILTONFLOUSE raises 0.04€ to 0.06€
soliderock folds
Baston57 folds
papashark14 folds
Fried Berg calls 0.04€
*** FLOP *** [Jd 7s 5c]
Fried Berg checks
FILTONFLOUSE bets 0.05€
Fried Berg calls 0.05€
*** TURN *** [Jd 7s 5c][8s]
Fried Berg checks
FILTONFLOUSE checks
*** RIVER *** [Jd 7s 5c 8s][As]
Fried Berg checks
FILTONFLOUSE bets 0.06€
Fried Berg calls 0.06€
*** SHOW DOWN ***
Fried Berg shows [Tc Ah] (One pair : Aces)
FILTONFLOUSE shows [Ad Qd] (One pair : Aces)
FILTONFLOUSE collected 0.31€ from pot
*** SUMMARY ***
Total pot 0.31€ | Rake 0.04€
Board: [Jd 7s 5c 8s As]
Seat 2: Fried Berg (big blind) showed [Tc Ah] and lost with One pair : Aces
Seat 4: FILTONFLOUSE showed [Ad Qd] and won 0.31€ with One pair : Aces


Winamax Poker - HOLD-UP "Colorado" - HandId: #19116069-321715-1701428321 - Holdem no limit (0.01€/0.02€) - 2023/12/01 10:58:41 UTC
Table: 'Colorado' 6-max (real money) Seat #6 is the button
Seat 1: Fried Berg (0.33€)
Seat 2: FILTONFLOUSE (2.24€)
Seat 3: haouuum28 (3.25€)
Seat 4: KKamarAAde (2.37€)
Seat 5: DosdeBras (0.80€)
Seat 6: Johnbedoin18 (5.37€)
*** ANTE/BLINDS ***
Fried Berg posts small blind 0.01€
FILTONFLOUSE posts big blind 0.02€
Dealt to Fried Berg [Ad Jc]
*** PRE-FLOP *** 
haouuum28 raises 0.02€ to 0.04€
KKamarAAde folds
DosdeBras folds
Johnbedoin18 folds
Fried Berg raises 0.02€ to 0.06€
FILTONFLOUSE folds
haouuum28 calls 0.02€
*** FLOP *** [8d 7c 3c]
Fried Berg checks
haouuum28 checks
*** TURN *** [8d 7c 3c][6c]
Fried Berg checks
haouuum28 checks
*** RIVER *** [8d 7c 3c 6c][5c]
Fried Berg bets 0.05€
haouuum28 calls 0.05€
*** SHOW DOWN ***
haouuum28 shows [9c As] (Flush 9 high)
Fried Berg shows [Ad Jc] (Flush Jack high)
Fried Berg collected 0.22€ from pot
*** SUMMARY ***
Total pot 0.22€ | Rake 0.02€
Board: [8d 7c 3c 6c 5c]
Seat 1: Fried Berg (small blind) showed [Ad Jc] and won 0.22€ with Flush Jack high
Seat 3: haouuum28 showed [9c As] and lost with Flush 9 high


Winamax Poker - HOLD-UP "Colorado" - HandId: #19116069-321774-1701428372 - Holdem no limit (0.01€/0.02€) - 2023/12/01 10:59:32 UTC
Table: 'Colorado' 6-max (real money) Seat #6 is the button
Seat 1: orzanco (1.89€)
Seat 2: haouuum28 (3.14€)
Seat 3: Fried Berg (0.44€)
Seat 4: Polanskii (2.21€)
Seat 5: ITALIA291 (2.20€)
Seat 6: Cejargordas (6.91€)
*** ANTE/BLINDS ***
orzanco posts small blind 0.01€
haouuum28 posts big blind 0.02€
Dealt to Fried Berg [Ad 2s]
*** PRE-FLOP *** 
Fried Berg folds
Polanskii folds
ITALIA291 folds
Cejargordas raises 0.04€ to 0.06€
orzanco folds
haouuum28 folds
Cejargordas collected 0.09€ from pot
*** SUMMARY ***
Total pot 0.09€ | No rake
Seat 6: Cejargordas (button) won 0.09€


Winamax Poker - HOLD-UP "Colorado" - HandId: #19116069-321777-1701428376 - Holdem no limit (0.01€/0.02€) - 2023/12/01 10:59:36 UTC
Table: 'Colorado' 6-max (real money) Seat #6 is the button
Seat 1: Letyran7857 (3.94€)
Seat 2: jdeepenslip (3.65€)
Seat 3: g8o8k8u (2.39€)
Seat 4: Fried Berg (0.44€)
Seat 5: L INCONNU (0.79€)
Seat 6: FenderTolra (2.03€)
*** ANTE/BLINDS ***
Letyran7857 posts small blind 0.01€
jdeepenslip posts big blind 0.02€
Dealt to Fried Berg [Js 7h]
*** PRE-FLOP *** 
g8o8k8u folds
Fried Berg folds
L INCONNU folds
FenderTolra folds
Letyran7857 folds
jdeepenslip collected 0.03€ from pot
*** SUMMARY ***
Total pot 0.03€ | No rake
Seat 2: jdeepenslip (big blind) won 0.03€


Winamax Poker - HOLD-UP "Colorado" - HandId: #19116069-321780-1701428378 - Holdem no limit (0.01€/0.02€) - 2023/12/01 10:59:38 UTC
Table: 'Colorado' 6-max (real money) Seat #6 is the button
Seat 1: FenderTolra (2.03€)
Seat 2: Xnikos2X (2.26€)
Seat 3: Letyran7857 (3.93€)
Seat 4: g8o8k8u (2.39€)
Seat 5: Fried Berg (0.44€)
Seat 6: Clemence75 (2.07€)
*** ANTE/BLINDS ***
FenderTolra posts small blind 0.01€
Xnikos2X posts big blind 0.02€
Dealt to Fried Berg [8c 6s]
*** PRE-FLOP *** 
Letyran7857 folds
g8o8k8u folds
Fried Berg folds
Clemence75 folds
FenderTolra raises 0.04€ to 0.06€
Xnikos2X folds
FenderTolra collected 0.08€ from pot
*** SUMMARY ***
Total pot 0.08€ | No rake
Seat 1: FenderTolra (small blind) won 0.08€


Winamax Poker - HOLD-UP "Colorado" - HandId: #19116069-321785-1701428381 - Holdem no limit (0.01€/0.02€) - 2023/12/01 10:59:41 UTC
Table: 'Colorado' 6-max (real money) Seat #6 is the button
Seat 1: jdeepenslip (3.66€)
Seat 2: Letyran7857 (3.93€)
Seat 3: Fish_tre33 (2.85€)
Seat 4: Thequeen1205 (2.13€)
Seat 5: g8o8k8u (2.38€)
Seat 6: Fried Berg (0.44€)
*** ANTE/BLINDS ***
jdeepenslip posts small blind 0.01€
Letyran7857 posts big blind 0.02€
Dealt to Fried Berg [5d 4d]
*** PRE-FLOP *** 
Fish_tre33 folds
Thequeen1205 folds
g8o8k8u raises 0.04€ to 0.06€
Fried Berg calls 0.06€
jdeepenslip folds
Letyran7857 calls 0.04€
*** FLOP *** [6d Kc 2s]
Letyran7857 checks
g8o8k8u bets 0.06€
Fried Berg calls 0.06€
Letyran7857 calls 0.06€
*** TURN *** [6d Kc 2s][Js]
Letyran7857 checks
g8o8k8u bets 0.26€
Fried Berg folds
Letyran7857 calls 0.26€
*** RIVER *** [6d Kc 2s Js][Ah]
Letyran7857 checks
g8o8k8u bets 0.89€
Letyran7857 folds
g8o8k8u collected 1.69€ from pot
*** SUMMARY ***
Total pot 1.69€ | Rake 0.09€
Board: [6d Kc 2s Js Ah]
Seat 5: g8o8k8u won 1.69€


Winamax Poker - HOLD-UP "Colorado" - HandId: #19116069-321821-1701428413 - Holdem no limit (0.01€/0.02€) - 2023/12/01 11:00:13 UTC
Table: 'Colorado' 6-max (real money) Seat #6 is the button
Seat 1: TaBrEaMoI (2.40€)
Seat 2: a.masa (2.46€)
Seat 3: CHANGAS (2.21€)
Seat 4: Davidoo36 (0.40€)
Seat 5: Fried Berg (0.32€)
Seat 6: Cejargordas (5.30€)
*** ANTE/BLINDS ***
TaBrEaMoI posts small blind 0.01€
a.masa posts big blind 0.02€
Dealt to Fried Berg [Ks 5h]
*** PRE-FLOP *** 
CHANGAS folds
Davidoo36 raises 0.04€ to 0.06€
Fried Berg folds
Cejargordas raises 0.17€ to 0.23€
TaBrEaMoI folds
a.masa folds
Davidoo36 calls 0.17€
*** FLOP *** [7d 6s Qh]
Davidoo36 bets 0.17€ and is all-in
Cejargordas calls 0.17€
*** TURN *** [7d 6s Qh][Th]
*** RIVER *** [7d 6s Qh Th][7h]
*** SHOW DOWN ***
Cejargordas shows [Ac Js] (One pair : 7)
Davidoo36 shows [Qc Ah] (Two pairs : Queens and 7)
Davidoo36 collected 0.75€ from pot
*** SUMMARY ***
Total pot 0.75€ | Rake 0.08€
Board: [7d 6s Qh Th 7h]
Seat 4: Davidoo36 showed [Qc Ah] and won 0.75€ with Two pairs : Queens and 7
Seat 6: Cejargordas (button) showed [Ac Js] and lost with One pair : 7


Winamax Poker - HOLD-UP "Colorado" - HandId: #19116069-321830-1701428419 - Holdem no limit (0.01€/0.02€) - 2023/12/01 11:00:19 UTC
Table: 'Colorado' 6-max (real money) Seat #6 is the button
Seat 1: a.masa (2.44€)
Seat 2: Fried Berg (0.32€)
Seat 3: LIAMINE76000 (1.67€)
Seat 4: TaBrEaMoI (2.98€)
Seat 5: DosdeBras (0.80€)
Seat 6: YoSoyPablo17 (2.75€)
*** ANTE/BLINDS ***
a.masa posts small blind 0.01€
Fried Berg posts big blind 0.02€
Dealt to Fried Berg [7c 2d]
*** PRE-FLOP *** 
LIAMINE76000 folds
TaBrEaMoI folds
DosdeBras folds
YoSoyPablo17 folds
a.masa raises 0.04€ to 0.06€
Fried Berg folds
a.masa collected 0.08€ from pot
*** SUMMARY ***
Total pot 0.08€ | No rake
Seat 1: a.masa (small blind) won 0.08€


Winamax Poker - HOLD-UP "Colorado" - HandId: #19116069-321856-1701428441 - Holdem no limit (0.01€/0.02€) - 2023/12/01 11:00:41 UTC
Table: 'Colorado' 6-max (real money) Seat #6 is the button
Seat 1: Fried Berg (0.30€)
Seat 2: Clemence75 (2.04€)
Seat 3: Max297 (0.52€)
Seat 4: messor (2.15€)
Seat 5: Tilted_Donk (2.27€)
Seat 6: KKamarAAde (4.31€)
*** ANTE/BLINDS ***
Fried Berg posts small blind 0.01€
Clemence75 posts big blind 0.02€
Dealt to Fried Berg [Ad Kh]
*** PRE-FLOP *** 
Max297 folds
messor folds
Tilted_Donk folds
KKamarAAde raises 0.04€ to 0.06€
Fried Berg raises 0.24€ to 0.30€ and is all-in
Clemence75 folds
KKamarAAde calls 0.24€
*** FLOP *** [Th Ah 8s]
*** TURN *** [Th Ah 8s][7c]
*** RIVER *** [Th Ah 8s 7c][6d]
*** SHOW DOWN ***
Fried Berg shows [Ad Kh] (One pair : Aces)
KKamarAAde shows [Tc Ac] (Two pairs : Aces and Tens)
KKamarAAde collected 0.56€ from pot
*** SUMMARY ***
Total pot 0.56€ | Rake 0.06€
Board: [Th Ah 8s 7c 6d]
Seat 1: Fried Berg (small blind) showed [Ad Kh] and lost with One pair : Aces
Seat 6: KKamarAAde (button) showed [Tc Ac] and won 0.56€ with Two pairs : Aces and Tens


Winamax Poker - HOLD-UP "Colorado" - HandId: #19116069-321900-1701428476 - Holdem no limit (0.01€/0.02€) - 2023/12/01 11:01:16 UTC
Table: 'Colorado' 6-max (real money) Seat #6 is the button
Seat 1: TaBrEaMoI (2.35€)
Seat 2: FenderTolra (2.02€)
Seat 3: Fried Berg (0.50€)
Seat 4: vinzou050 (6.53€)
Seat 5: usap66600 (2.04€)
Seat 6: Lucky_Donkey (3.10€)
*** ANTE/BLINDS ***
TaBrEaMoI posts small blind 0.01€
FenderTolra posts big blind 0.02€
Dealt to Fried Berg [8d Qs]
*** PRE-FLOP *** 
Fried Berg folds
vinzou050 raises 0.03€ to 0.05€
usap66600 folds
Lucky_Donkey folds
TaBrEaMoI folds
FenderTolra folds
vinzou050 collected 0.08€ from pot
*** SUMMARY ***
Total pot 0.08€ | No rake
Seat 4: vinzou050 won 0.08€


Winamax Poker - HOLD-UP "Colorado" - HandId: #19116069-321915-1701428490 - Holdem no limit (0.01€/0.02€) - 2023/12/01 11:01:30 UTC
Table: 'Colorado' 6-max (real money) Seat #6 is the button
Seat 1: Clemence75 (2.18€)
Seat 2: Cejargordas (4.84€)
Seat 3: Pffft... (2.27€)
Seat 4: Fried Berg (0.50€)
Seat 5: Polanskii (2.31€)
Seat 6: Fanfan21260 (1.62€)
Hold-up to Pot: total 0.10€
*** ANTE/BLINDS ***
Clemence75 posts small blind 0.01€
Cejargordas posts big blind 0.02€
Dealt to Fried Berg [Kd 2s]
*** PRE-FLOP *** 
Pffft... folds
Fried Berg folds
Polanskii raises 0.04€ to 0.06€
Fanfan21260 calls 0.06€
Clemence75 raises 0.24€ to 0.30€
Cejargordas folds
Polanskii folds
Fanfan21260 calls 0.24€
*** FLOP *** [Ad 3c 5d]
Clemence75 bets 0.26€
Fanfan21260 folds
Clemence75 collected 0.97€ from pot
*** SUMMARY ***
Total pot 0.97€ | Rake 0.07€
Board: [Ad 3c 5d]
Seat 1: Clemence75 (small blind) won 0.97€


Winamax Poker - HOLD-UP "Colorado" - HandId: #19116069-321922-1701428496 - Holdem no limit (0.01€/0.02€) - 2023/12/01 11:01:36 UTC
Table: 'Colorado' 6-max (real money) Seat #6 is the button
Seat 1: jdeepenslip (2.07€)
Seat 2: phileduc (1.21€)
Seat 3: Adame199623 (2€)
Seat 4: Pffft... (2.37€)
Seat 5: korade (1.91€)
Seat 6: Fried Berg (0.50€)
*** ANTE/BLINDS ***
jdeepenslip posts small blind 0.01€
phileduc posts big blind 0.02€
Dealt to Fried Berg [Ts Kh]
*** PRE-FLOP *** 
Adame199623 folds
Pffft... folds
korade raises 0.03€ to 0.05€
Fried Berg calls 0.05€
jdeepenslip folds
phileduc folds
*** FLOP *** [As Tc 3c]
korade bets 0.07€
Fried Berg calls 0.07€
*** TURN *** [As Tc 3c][Ac]
korade checks
Fried Berg bets 0.09€
korade folds
Fried Berg collected 0.33€ from pot
*** SUMMARY ***
Total pot 0.33€ | Rake 0.03€
Board: [As Tc 3c Ac]
Seat 6: Fried Berg (button) won 0.33€


Winamax Poker - HOLD-UP "Colorado" - HandId: #19116069-321988-1701428541 - Holdem no limit (0.01€/0.02€) - 2023/12/01 11:02:21 UTC
Table: 'Colorado' 6-max (real money) Seat #6 is the button
Seat 1: messor (2.05€)
Seat 2: FILTONFLOUSE (2.26€)
Seat 3: _gonzai_ (2€)
Seat 4: Fried Berg (0.62€)
Seat 5: korade (4.42€)
Seat 6: Xnikos2X (2.32€)
*** ANTE/BLINDS ***
messor posts small blind 0.01€
FILTONFLOUSE posts big blind 0.02€
Dealt to Fried Berg [4c 5s]
*** PRE-FLOP *** 
_gonzai_ raises 0.04€ to 0.06€
Fried Berg folds
korade folds
Xnikos2X folds
messor folds
FILTONFLOUSE folds
_gonzai_ collected 0.09€ from pot
*** SUMMARY ***
Total pot 0.09€ | No rake
Seat 3: _gonzai_ won 0.09€


Winamax Poker - HOLD-UP "Colorado" - HandId: #19116069-321993-1701428546 - Holdem no limit (0.01€/0.02€) - 2023/12/01 11:02:26 UTC
Table: 'Colorado' 6-max (real money) Seat #6 is the button
Seat 1: ITALIA291 (2.25€)
Seat 2: Fried Berg (0.62€)
Seat 3: usap66600 (2.12€)
Seat 4: DigBick99 (4.25€)
Seat 5: LIAMINE76000 (1.66€)
Seat 6: Letyran7857 (3.39€)
*** ANTE/BLINDS ***
ITALIA291 posts small blind 0.01€
Fried Berg posts big blind 0.02€
Dealt to Fried Berg [Qs 3c]
*** PRE-FLOP *** 
usap66600 folds
DigBick99 folds
LIAMINE76000 folds
Letyran7857 raises 0.04€ to 0.06€
ITALIA291 folds
Fried Berg folds
Letyran7857 collected 0.09€ from pot
*** SUMMARY ***
Total pot 0.09€ | No rake
Seat 6: Letyran7857 (button) won 0.09€


Winamax Poker - HOLD-UP "Colorado" - HandId: #19116069-322024-1701428569 - Holdem no limit (0.01€/0.02€) - 2023/12/01 11:02:49 UTC
Table: 'Colorado' 6-max (real money) Seat #6 is the button
Seat 1: Fried Berg (0.60€)
Seat 2: Clemence75 (2.60€)
Seat 3: Polanskii (2.25€)
Seat 4: Cejargordas (2€)
Seat 5: _gonzai_ (2.03€)
Seat 6: LexieMaiko (3.60€)
*** ANTE/BLINDS ***
Fried Berg posts small blind 0.01€
Clemence75 posts big blind 0.02€
Dealt to Fried Berg [9s As]
*** PRE-FLOP *** 
Polanskii folds
Cejargordas folds
_gonzai_ folds
LexieMaiko folds
Fried Berg raises 0.02€ to 0.04€
Clemence75 folds
Fried Berg collected 0.06€ from pot
*** SUMMARY ***
Total pot 0.06€ | No rake
Seat 1: Fried Berg (small blind) won 0.06€


Winamax Poker - HOLD-UP "Colorado" - HandId: #19116069-322179-1701428687 - Holdem no limit (0.01€/0.02€) - 2023/12/01 11:04:47 UTC
Table: 'Colorado' 6-max (real money) Seat #6 is the button
Seat 1: FILTONFLOUSE (2.24€)
Seat 2: LIAMINE76000 (1.60€)
Seat 3: Fried Berg (0.62€)
Seat 4: Cejargordas (5.07€)
Seat 5: Tilted_Donk (2.09€)
Seat 6: DonKmillo (3.77€)
*** ANTE/BLINDS ***
FILTONFLOUSE posts small blind 0.01€
LIAMINE76000 posts big blind 0.02€
Dealt to Fried Berg [6c 5d]
*** PRE-FLOP *** 
Fried Berg folds
Cejargordas folds
Tilted_Donk folds
DonKmillo folds
FILTONFLOUSE folds
LIAMINE76000 collected 0.03€ from pot
*** SUMMARY ***
Total pot 0.03€ | No rake
Seat 2: LIAMINE76000 (big blind) won 0.03€


Winamax Poker - HOLD-UP "Colorado" - HandId: #19116069-322189-1701428693 - Holdem no limit (0.01€/0.02€) - 2023/12/01 11:04:53 UTC
Table: 'Colorado' 6-max (real money) Seat #6 is the button
Seat 1: Pffft... (2€)
Seat 2: grut28 (5.63€)
Seat 3: Clemence75 (2.57€)
Seat 4: mea botellas (3.30€)
Seat 5: Fried Berg (0.62€)
Seat 6: Xnikos2X (5.41€)
*** ANTE/BLINDS ***
Pffft... posts small blind 0.01€
grut28 posts big blind 0.02€
Dealt to Fried Berg [Qd Qh]
*** PRE-FLOP *** 
Clemence75 folds
mea botellas raises 0.02€ to 0.04€
Fried Berg calls 0.04€
Xnikos2X calls 0.04€
Pffft... folds
grut28 folds
*** FLOP *** [8d 3s Kh]
mea botellas checks
Fried Berg checks
Xnikos2X checks
*** TURN *** [8d 3s Kh][2c]
mea botellas checks
Fried Berg bets 0.06€
Xnikos2X folds
mea botellas calls 0.06€
*** RIVER *** [8d 3s Kh 2c][8c]
mea botellas checks
Fried Berg bets 0.09€
mea botellas calls 0.09€
*** SHOW DOWN ***
mea botellas shows [Ah 2h] (Two pairs : 8 and 2)
Fried Berg shows [Qd Qh] (Two pairs : Queens and 8)
Fried Berg collected 0.40€ from pot
*** SUMMARY ***
Total pot 0.40€ | Rake 0.05€
Board: [8d 3s Kh 2c 8c]
Seat 4: mea botellas showed [Ah 2h] and lost with Two pairs : 8 and 2
Seat 5: Fried Berg showed [Qd Qh] and won 0.40€ with Two pairs : Queens and 8


Winamax Poker - HOLD-UP "Colorado" - HandId: #19116069-322309-1701428786 - Holdem no limit (0.01€/0.02€) - 2023/12/01 11:06:26 UTC
Table: 'Colorado' 6-max (real money) Seat #6 is the button
Seat 1: Xnikos2X (3.62€)
Seat 2: g8o8k8u (2€)
Seat 3: mea botellas (3.11€)
Seat 4: X3a26J23i54 (1.79€)
Seat 5: Letyran7857 (3.22€)
Seat 6: Fried Berg (0.83€)
*** ANTE/BLINDS ***
Xnikos2X posts small blind 0.01€
g8o8k8u posts big blind 0.02€
Dealt to Fried Berg [8d Qd]
*** PRE-FLOP *** 
mea botellas folds
X3a26J23i54 folds
Letyran7857 raises 0.03€ to 0.05€
Fried Berg raises 0.03€ to 0.08€
Xnikos2X folds
g8o8k8u folds
Letyran7857 calls 0.03€
*** FLOP *** [6s 5c 6d]
Letyran7857 checks
Fried Berg checks
*** TURN *** [6s 5c 6d][9h]
Letyran7857 checks
Fried Berg checks
*** RIVER *** [6s 5c 6d 9h][9c]
Letyran7857 checks
Fried Berg checks
*** SHOW DOWN ***
Fried Berg shows [8d Qd] (Two pairs : 9 and 6)
Letyran7857 shows [Td Kh] (Two pairs : 9 and 6)
Letyran7857 collected 0.17€ from pot
*** SUMMARY ***
Total pot 0.17€ | Rake 0.02€
Board: [6s 5c 6d 9h 9c]
Seat 5: Letyran7857 showed [Td Kh] and won 0.17€ with Two pairs : 9 and 6
Seat 6: Fried Berg (button) showed [8d Qd] and lost with Two pairs : 9 and 6


Winamax Poker - HOLD-UP "Colorado" - HandId: #19116069-322365-1701428833 - Holdem no limit (0.01€/0.02€) - 2023/12/01 11:07:13 UTC
Table: 'Colorado' 6-max (real money) Seat #6 is the button
Seat 1: BrokBroken (2€)
Seat 2: Davy_King (1.43€)
Seat 3: Cejargordas (2.13€)
Seat 4: KKamarAAde (2€)
Seat 5: Cedlebon (3.71€)
Seat 6: Fried Berg (0.75€)
*** ANTE/BLINDS ***
BrokBroken posts small blind 0.01€
Davy_King posts big blind 0.02€
Dealt to Fried Berg [4s 5d]
*** PRE-FLOP *** 
Cejargordas folds
KKamarAAde folds
Cedlebon folds
Fried Berg folds
BrokBroken folds
Davy_King collected 0.03€ from pot
*** SUMMARY ***
Total pot 0.03€ | No rake
Seat 2: Davy_King (big blind) won 0.03€


Winamax Poker - HOLD-UP "Colorado" - HandId: #19116069-322381-1701428845 - Holdem no limit (0.01€/0.02€) - 2023/12/01 11:07:25 UTC
Table: 'Colorado' 6-max (real money) Seat #6 is the button
Seat 1: messor (2.04€)
Seat 2: Fried Berg (0.75€)
Seat 3: SpeedMizno (2€)
Seat 4: Tilted_Donk (2.24€)
Seat 5: Pffft... (2.08€)
Seat 6: DigBick99 (3.27€)
Hold-up to Pot: total 0.50€
*** ANTE/BLINDS ***
messor posts small blind 0.01€
Fried Berg posts big blind 0.02€
Dealt to Fried Berg [Ts 7s]
*** PRE-FLOP *** 
SpeedMizno calls 0.02€
Tilted_Donk folds
Pffft... raises 0.04€ to 0.06€
DigBick99 folds
messor folds
Fried Berg calls 0.04€
SpeedMizno calls 0.04€
*** FLOP *** [9d 8h 3s]
Fried Berg checks
SpeedMizno checks
Pffft... checks
*** TURN *** [9d 8h 3s][6d]
Fried Berg bets 0.69€ and is all-in
SpeedMizno folds
Pffft... folds
Fried Berg collected 1.36€ from pot
*** SUMMARY ***
Total pot 1.36€ | Rake 0.02€
Board: [9d 8h 3s 6d]
Seat 2: Fried Berg (big blind) won 1.36€


Winamax Poker - HOLD-UP "Colorado" - HandId: #19116069-322459-1701428902 - Holdem no limit (0.01€/0.02€) - 2023/12/01 11:08:22 UTC
Table: 'Colorado' 6-max (real money) Seat #6 is the button
Seat 1: las210qt (0.88€)
Seat 2: PIQSOU (2€)
Seat 3: Fried Berg (1.36€)
Seat 4: SpeedMizno (2€)
Seat 5: Ddm8 (2.24€)
Seat 6: grut28 (3.35€)
*** ANTE/BLINDS ***
las210qt posts small blind 0.01€
PIQSOU posts big blind 0.02€
Dealt to Fried Berg [8c Ac]
*** PRE-FLOP *** 
Fried Berg raises 0.02€ to 0.04€
SpeedMizno folds
Ddm8 folds
grut28 folds
las210qt folds
PIQSOU folds
Fried Berg collected 0.07€ from pot
*** SUMMARY ***
Total pot 0.07€ | No rake
Seat 3: Fried Berg won 0.07€


Winamax Poker - HOLD-UP "Colorado" - HandId: #19116069-322489-1701428924 - Holdem no limit (0.01€/0.02€) - 2023/12/01 11:08:44 UTC
Table: 'Colorado' 6-max (real money) Seat #6 is the button
Seat 1: Fried Berg (1.39€)
Seat 2: CHANGAS (2.82€)
Seat 3: raptor01 (0.56€)
Seat 4: messor (2€)
Seat 5: orzanco (1.36€)
Seat 6: Foli_73 (0.58€)
*** ANTE/BLINDS ***
Fried Berg posts small blind 0.01€
CHANGAS posts big blind 0.02€
Dealt to Fried Berg [8h Qc]
*** PRE-FLOP *** 
raptor01 folds
messor folds
orzanco folds
Foli_73 folds
Fried Berg folds
CHANGAS collected 0.03€ from pot
*** SUMMARY ***
Total pot 0.03€ | No rake
Seat 2: CHANGAS (big blind) won 0.03€


Winamax Poker - HOLD-UP "Colorado" - HandId: #19116069-322503-1701428938 - Holdem no limit (0.01€/0.02€) - 2023/12/01 11:08:58 UTC
Table: 'Colorado' 6-max (real money) Seat #6 is the button
Seat 1: KKamarAAde (2€)
Seat 2: Tahanouti (1.76€)
Seat 3: DonKmillo (3.76€)
Seat 4: Fried Berg (1.38€)
Seat 5: raptor01 (0.55€)
Seat 6: djbassco (3.49€)
*** ANTE/BLINDS ***
KKamarAAde posts small blind 0.01€
Tahanouti posts big blind 0.02€
Dealt to Fried Berg [Qd 5d]
*** PRE-FLOP *** 
DonKmillo folds
Fried Berg folds
raptor01 folds
djbassco folds
KKamarAAde folds
Tahanouti collected 0.03€ from pot
*** SUMMARY ***
Total pot 0.03€ | No rake
Seat 2: Tahanouti (big blind) won 0.03€


Winamax Poker - HOLD-UP "Colorado" - HandId: #19116069-322511-1701428943 - Holdem no limit (0.01€/0.02€) - 2023/12/01 11:09:03 UTC
Table: 'Colorado' 6-max (real money) Seat #6 is the button
Seat 1: mea botellas (3.02€)
Seat 2: grut28 (3.32€)
Seat 3: Fanfan21260 (2.01€)
Seat 4: las210qt (0.85€)
Seat 5: g8o8k8u (2€)
Seat 6: Fried Berg (1.38€)
*** ANTE/BLINDS ***
mea botellas posts small blind 0.01€
grut28 posts big blind 0.02€
Dealt to Fried Berg [Ac 9c]
*** PRE-FLOP *** 
Fanfan21260 calls 0.02€
las210qt folds
g8o8k8u folds
Fried Berg raises 0.10€ to 0.12€
mea botellas folds
grut28 folds
Fanfan21260 calls 0.10€
*** FLOP *** [6s 6c 4h]
Fanfan21260 bets 0.09€
Fried Berg calls 0.09€
*** TURN *** [6s 6c 4h][7s]
Fanfan21260 bets 0.16€
Fried Berg calls 0.16€
*** RIVER *** [6s 6c 4h 7s][6h]
Fanfan21260 bets 0.27€
Fried Berg calls 0.27€
*** SHOW DOWN ***
Fanfan21260 shows [Js 9d] (Trips of 6)
Fried Berg shows [Ac 9c] (Trips of 6)
Fried Berg collected 1.18€ from pot
*** SUMMARY ***
Total pot 1.18€ | Rake 0.13€
Board: [6s 6c 4h 7s 6h]
Seat 3: Fanfan21260 showed [Js 9d] and lost with Trips of 6
Seat 6: Fried Berg (button) showed [Ac 9c] and won 1.18€ with Trips of 6


Winamax Poker - HOLD-UP "Colorado" - HandId: #19116069-322598-1701429009 - Holdem no limit (0.01€/0.02€) - 2023/12/01 11:10:09 UTC
Table: 'Colorado' 6-max (real money) Seat #6 is the button
Seat 1: DigBick99 (2.12€)
Seat 2: FenderTolra (2.13€)
Seat 3: Fried Berg (1.92€)
Seat 4: willytiti34 (1.73€)
Seat 5: Johnbedoin18 (2.29€)
Seat 6: Fanfan21260 (1.37€)
*** ANTE/BLINDS ***
DigBick99 posts small blind 0.01€
FenderTolra posts big blind 0.02€
Dealt to Fried Berg [6h 8h]
*** PRE-FLOP *** 
Fried Berg calls 0.02€
willytiti34 calls 0.02€
Johnbedoin18 folds
Fanfan21260 folds
DigBick99 calls 0.01€
FenderTolra raises 0.10€ to 0.12€
Fried Berg folds
willytiti34 calls 0.10€
DigBick99 folds
*** FLOP *** [7s Ad Qh]
FenderTolra bets 0.09€
willytiti34 raises 0.67€ to 0.76€
FenderTolra folds
willytiti34 collected 1.08€ from pot
*** SUMMARY ***
Total pot 1.08€ | Rake 0.05€
Board: [7s Ad Qh]
Seat 4: willytiti34 won 1.08€


Winamax Poker - HOLD-UP "Colorado" - HandId: #19116069-322719-1701429123 - Holdem no limit (0.01€/0.02€) - 2023/12/01 11:12:03 UTC
Table: 'Colorado' 6-max (real money) Seat #6 is the button
Seat 1: Fried Berg (1.90€)
Seat 2: usap66600 (1.89€)
Seat 3: St. Germain (3.53€)
Seat 4: Pffft... (3.62€)
Seat 5: Aggro Loser (2.03€)
Seat 6: TaBrEaMoI (2.65€)
Hold-up to Pot: total 0.10€
*** ANTE/BLINDS ***
Fried Berg posts small blind 0.01€
usap66600 posts big blind 0.02€
Dealt to Fried Berg [2s Tc]
*** PRE-FLOP *** 
St. Germain folds
Pffft... folds
Aggro Loser folds
TaBrEaMoI raises 0.03€ to 0.05€
Fried Berg folds
usap66600 folds
TaBrEaMoI collected 0.18€ from pot
*** SUMMARY ***
Total pot 0.18€ | No rake
Seat 6: TaBrEaMoI (button) won 0.18€


Winamax Poker - HOLD-UP "Colorado" - HandId: #19116069-322725-1701429128 - Holdem no limit (0.01€/0.02€) - 2023/12/01 11:12:08 UTC
Table: 'Colorado' 6-max (real money) Seat #6 is the button
Seat 1: korade (4.08€)
Seat 2: Fried Berg (1.89€)
Seat 3: Cedlebon (3.98€)
Seat 4: Foli_73 (0.96€)
Seat 5: Aggro Loser (2.07€)
Seat 6: Cejargordas (5.23€)
*** ANTE/BLINDS ***
korade posts small blind 0.01€
Fried Berg posts big blind 0.02€
Dealt to Fried Berg [Th Ts]
*** PRE-FLOP *** 
Cedlebon folds
Foli_73 folds
Aggro Loser folds
Cejargordas folds
korade folds
Fried Berg collected 0.03€ from pot
*** SUMMARY ***
Total pot 0.03€ | No rake
Seat 2: Fried Berg (big blind) won 0.03€


Winamax Poker - HOLD-UP "Colorado" - HandId: #19116069-322744-1701429141 - Holdem no limit (0.01€/0.02€) - 2023/12/01 11:12:21 UTC
Table: 'Colorado' 6-max (real money) Seat #6 is the button
Seat 1: Caropitchoun (2€)
Seat 2: ECPulga (3.47€)
Seat 3: korade (4.06€)
Seat 4: Fried Berg (1.90€)
Seat 5: g8o8k8u (2.21€)
Seat 6: Antho-B-69 (2.79€)
*** ANTE/BLINDS ***
Caropitchoun posts small blind 0.01€
ECPulga posts big blind 0.02€
Dealt to Fried Berg [Ks 4h]
*** PRE-FLOP *** 
korade folds
Fried Berg folds
g8o8k8u folds
Antho-B-69 folds
Caropitchoun folds
ECPulga collected 0.03€ from pot
*** SUMMARY ***
Total pot 0.03€ | No rake
Seat 2: ECPulga (big blind) won 0.03€


Winamax Poker - HOLD-UP "Colorado" - HandId: #19116069-322749-1701429144 - Holdem no limit (0.01€/0.02€) - 2023/12/01 11:12:24 UTC
Table: 'Colorado' 6-max (real money) Seat #6 is the button
Seat 1: Tilted_Donk (2.15€)
Seat 2: _gonzai_ (2.88€)
Seat 3: KKamarAAde (2€)
Seat 4: DosdeBras (1.70€)
Seat 5: Fried Berg (1.90€)
Seat 6: Tahanouti (3.29€)
*** ANTE/BLINDS ***
Tilted_Donk posts small blind 0.01€
_gonzai_ posts big blind 0.02€
Dealt to Fried Berg [5h 4d]
*** PRE-FLOP *** 
KKamarAAde folds
DosdeBras folds
Fried Berg folds
Tahanouti folds
Tilted_Donk folds
_gonzai_ collected 0.03€ from pot
*** SUMMARY ***
Total pot 0.03€ | No rake
Seat 2: _gonzai_ (big blind) won 0.03€


Winamax Poker - HOLD-UP "Colorado" - HandId: #19116069-322752-1701429146 - Holdem no limit (0.01€/0.02€) - 2023/12/01 11:12:26 UTC
Table: 'Colorado' 6-max (real money) Seat #6 is the button
Seat 1: DigBick99 (2.58€)
Seat 2: St. Germain (1.53€)
Seat 3: messor (2.19€)
Seat 4: TaBrEaMoI (2.78€)
Seat 5: Adrianohhhh (2.07€)
Seat 6: Fried Berg (1.90€)
*** ANTE/BLINDS ***
DigBick99 posts small blind 0.01€
St. Germain posts big blind 0.02€
Dealt to Fried Berg [2c 5c]
*** PRE-FLOP *** 
messor folds
TaBrEaMoI folds
Adrianohhhh folds
Fried Berg folds
DigBick99 folds
St. Germain collected 0.03€ from pot
*** SUMMARY ***
Total pot 0.03€ | No rake
Seat 2: St. Germain (big blind) won 0.03€


Winamax Poker - HOLD-UP "Colorado" - HandId: #19116069-322763-1701429155 - Holdem no limit (0.01€/0.02€) - 2023/12/01 11:12:35 UTC
Table: 'Colorado' 6-max (real money) Seat #6 is the button
Seat 1: FILTONFLOUSE (2.79€)
Seat 2: Max297 (1.50€)
Seat 3: djbassco (5.07€)
Seat 4: FenderTolra (2€)
Seat 5: Fried Berg (1.90€)
Seat 6: stuart79 (1.75€)
*** ANTE/BLINDS ***
FILTONFLOUSE posts small blind 0.01€
Max297 posts big blind 0.02€
Dealt to Fried Berg [Qh 7d]
*** PRE-FLOP *** 
djbassco folds
FenderTolra raises 0.04€ to 0.06€
Fried Berg folds
stuart79 folds
FILTONFLOUSE folds
Max297 folds
FenderTolra collected 0.09€ from pot
*** SUMMARY ***
Total pot 0.09€ | No rake
Seat 4: FenderTolra won 0.09€


Winamax Poker - HOLD-UP "Colorado" - HandId: #19116069-322766-1701429157 - Holdem no limit (0.01€/0.02€) - 2023/12/01 11:12:37 UTC
Table: 'Colorado' 6-max (real money) Seat #6 is the button
Seat 1: TaBrEaMoI (2€)
Seat 2: Pffft... (2.80€)
Seat 3: Fried Berg (1.90€)
Seat 4: FILTONFLOUSE (2.78€)
Seat 5: ITALIA291 (3.03€)
Seat 6: Baston57 (1.18€)
*** ANTE/BLINDS ***
TaBrEaMoI posts small blind 0.01€
Pffft... posts big blind 0.02€
Dealt to Fried Berg [8s 8c]
*** PRE-FLOP *** 
Fried Berg raises 0.02€ to 0.04€
FILTONFLOUSE folds
ITALIA291 folds
Baston57 raises 0.08€ to 0.12€
TaBrEaMoI folds
Pffft... folds
Fried Berg calls 0.08€
*** FLOP *** [5s 4d 7s]
Fried Berg checks
Baston57 bets 0.09€
Fried Berg calls 0.09€
*** TURN *** [5s 4d 7s][3s]
Fried Berg checks
Baston57 checks
*** RIVER *** [5s 4d 7s 3s][Th]
Fried Berg checks
Baston57 bets 0.97€ and is all-in
Fried Berg folds
Baston57 collected 1.37€ from pot
*** SUMMARY ***
Total pot 1.37€ | Rake 0.05€
Board: [5s 4d 7s 3s Th]
Seat 6: Baston57 (button) won 1.37€


Winamax Poker - HOLD-UP "Colorado" - HandId: #19116069-322838-1701429211 - Holdem no limit (0.01€/0.02€) - 2023/12/01 11:13:31 UTC
Table: 'Colorado' 6-max (real money) Seat #6 is the button
Seat 1: Astaril (2.06€)
Seat 2: Fried Berg (1.69€)
Seat 3: Negreanu013 (0.88€)
Seat 4: da_igual (2.44€)
Seat 5: FILTONFLOUSE (3.04€)
Seat 6: Aggro Loser (2€)
*** ANTE/BLINDS ***
Astaril posts small blind 0.01€
Fried Berg posts big blind 0.02€
Dealt to Fried Berg [Qs 2c]
*** PRE-FLOP *** 
Negreanu013 folds
da_igual raises 0.04€ to 0.06€
FILTONFLOUSE folds
Aggro Loser folds
Astaril folds
Fried Berg folds
da_igual collected 0.09€ from pot
*** SUMMARY ***
Total pot 0.09€ | No rake
Seat 4: da_igual won 0.09€


Winamax Poker - HOLD-UP "Colorado" - HandId: #19116069-322855-1701429223 - Holdem no limit (0.01€/0.02€) - 2023/12/01 11:13:43 UTC
Table: 'Colorado' 6-max (real money) Seat #6 is the button
Seat 1: Fried Berg (1.67€)
Seat 2: KKamarAAde (4.46€)
Seat 3: DigBick99 (3.15€)
Seat 4: mea botellas (3.02€)
Seat 5: oliveponcar (2.77€)
Seat 6: Pffft... (2.17€)
*** ANTE/BLINDS ***
Fried Berg posts small blind 0.01€
KKamarAAde posts big blind 0.02€
Dealt to Fried Berg [4d 8h]
*** PRE-FLOP *** 
DigBick99 folds
mea botellas folds
oliveponcar raises 0.08€ to 0.10€
Pffft... folds
Fried Berg folds
KKamarAAde folds
oliveponcar collected 0.13€ from pot
*** SUMMARY ***
Total pot 0.13€ | No rake
Seat 5: oliveponcar won 0.13€


Winamax Poker - HOLD-UP "Colorado" - HandId: #19116069-322857-1701429225 - Holdem no limit (0.01€/0.02€) - 2023/12/01 11:13:45 UTC
Table: 'Colorado' 6-max (real money) Seat #6 is the button
Seat 1: vicieux59 (0.54€)
Seat 2: FenderTolra (3.22€)
Seat 3: DigBick99 (3.41€)
Seat 4: Fried Berg (1.66€)
Seat 5: ITALIA291 (3.03€)
Seat 6: Foli_73 (0.42€)
*** ANTE/BLINDS ***
vicieux59 posts small blind 0.01€
FenderTolra posts big blind 0.02€
Dealt to Fried Berg [7h Ks]
*** PRE-FLOP *** 
DigBick99 folds
Fried Berg folds
ITALIA291 folds
Foli_73 folds
vicieux59 folds
FenderTolra collected 0.03€ from pot
*** SUMMARY ***
Total pot 0.03€ | No rake
Seat 2: FenderTolra (big blind) won 0.03€


Winamax Poker - HOLD-UP "Colorado" - HandId: #19116069-322859-1701429227 - Holdem no limit (0.01€/0.02€) - 2023/12/01 11:13:47 UTC
Table: 'Colorado' 6-max (real money) Seat #6 is the button
Seat 1: DosdeBras (1.77€)
Seat 2: da_igual (2.47€)
Seat 3: vinzou050 (5.09€)
Seat 4: divin.Ange64 (0.85€)
Seat 5: Fried Berg (1.66€)
Seat 6: 1trospecti0n (2€)
*** ANTE/BLINDS ***
DosdeBras posts small blind 0.01€
da_igual posts big blind 0.02€
Dealt to Fried Berg [Qh 4h]
*** PRE-FLOP *** 
vinzou050 folds
divin.Ange64 folds
Fried Berg calls 0.02€
1trospecti0n folds
DosdeBras raises 0.09€ to 0.11€
da_igual folds
Fried Berg folds
DosdeBras collected 0.15€ from pot
*** SUMMARY ***
Total pot 0.15€ | No rake
Seat 1: DosdeBras (small blind) won 0.15€


Winamax Poker - HOLD-UP "Colorado" - HandId: #19116069-322884-1701429246 - Holdem no limit (0.01€/0.02€) - 2023/12/01 11:14:06 UTC
Table: 'Colorado' 6-max (real money) Seat #6 is the button
Seat 1: YoSoyPablo17 (2.28€)
Seat 2: soliderock (2.04€)
Seat 3: Fried Berg (1.64€)
Seat 4: colgate12 (3.25€)
Seat 5: steph290 (0.59€)
Seat 6: 1trospecti0n (2€)
*** ANTE/BLINDS ***
YoSoyPablo17 posts small blind 0.01€
soliderock posts big blind 0.02€
Dealt to Fried Berg [Js 3h]
*** PRE-FLOP *** 
Fried Berg folds
colgate12 folds
steph290 folds
1trospecti0n folds
YoSoyPablo17 calls 0.01€
soliderock checks
*** FLOP *** [7h 3s 9h]
YoSoyPablo17 checks
soliderock checks
*** TURN *** [7h 3s 9h][Ah]
YoSoyPablo17 checks
soliderock checks
*** RIVER *** [7h 3s 9h Ah][Ad]
YoSoyPablo17 checks
soliderock checks
*** SHOW DOWN ***
YoSoyPablo17 shows [Qh 8d] (One pair : Aces)
soliderock shows [8h Qd] (One pair : Aces)
soliderock collected 0.02€ from pot
YoSoyPablo17 collected 0.02€ from pot
*** SUMMARY ***
Total pot 0.04€ | No rake
Board: [7h 3s 9h Ah Ad]
Seat 1: YoSoyPablo17 (small blind) showed [Qh 8d] and won 0.02€ with One pair : Aces
Seat 2: soliderock (big blind) showed [8h Qd] and won 0.02€ with One pair : Aces


Winamax Poker - HOLD-UP "Colorado" - HandId: #19116069-322886-1701429247 - Holdem no limit (0.01€/0.02€) - 2023/12/01 11:14:07 UTC
Table: 'Colorado' 6-max (real money) Seat #6 is the button
Seat 1: Thequeen1205 (2.50€)
Seat 2: Fried Berg (1.64€)
Seat 3: TaBrEaMoI (2.83€)
Seat 4: St. Germain (3.64€)
Seat 5: da_igual (2.45€)
Seat 6: colgate12 (3.25€)
*** ANTE/BLINDS ***
Thequeen1205 posts small blind 0.01€
Fried Berg posts big blind 0.02€
Dealt to Fried Berg [8c Ac]
*** PRE-FLOP *** 
TaBrEaMoI folds
St. Germain folds
da_igual folds
colgate12 folds
Thequeen1205 folds
Fried Berg collected 0.03€ from pot
*** SUMMARY ***
Total pot 0.03€ | No rake
Seat 2: Fried Berg (big blind) won 0.03€


Winamax Poker - HOLD-UP "Colorado" - HandId: #19116069-322895-1701429254 - Holdem no limit (0.01€/0.02€) - 2023/12/01 11:14:14 UTC
Table: 'Colorado' 6-max (real money) Seat #6 is the button
Seat 1: BrokBroken (2€)
Seat 2: Aggro Loser (2.47€)
Seat 3: X3a26J23i54 (2.23€)
Seat 4: Fried Berg (1.65€)
Seat 5: KKamarAAde (4.44€)
Seat 6: jdeepenslip (2.22€)
*** ANTE/BLINDS ***
BrokBroken posts small blind 0.01€
Aggro Loser posts big blind 0.02€
Dealt to Fried Berg [5s 2h]
*** PRE-FLOP *** 
X3a26J23i54 folds
Fried Berg folds
KKamarAAde folds
jdeepenslip raises 0.02€ to 0.04€
BrokBroken folds
Aggro Loser folds
jdeepenslip collected 0.07€ from pot
*** SUMMARY ***
Total pot 0.07€ | No rake
Seat 6: jdeepenslip (button) won 0.07€


Winamax Poker - HOLD-UP "Colorado" - HandId: #19116069-322899-1701429258 - Holdem no limit (0.01€/0.02€) - 2023/12/01 11:14:18 UTC
Table: 'Colorado' 6-max (real money) Seat #6 is the button
Seat 1: oliveponcar (2.78€)
Seat 2: Tahanouti (3.06€)
Seat 3: Thequeen1205 (2.48€)
Seat 4: cecilon (0.49€)
Seat 5: Fried Berg (1.65€)
Seat 6: DigBick99 (2.52€)
*** ANTE/BLINDS ***
oliveponcar posts small blind 0.01€
Tahanouti posts big blind 0.02€
Dealt to Fried Berg [8d Jc]
*** PRE-FLOP *** 
Thequeen1205 folds
cecilon folds
Fried Berg folds
DigBick99 folds
oliveponcar folds
Tahanouti collected 0.03€ from pot
*** SUMMARY ***
Total pot 0.03€ | No rake
Seat 2: Tahanouti (big blind) won 0.03€


Winamax Poker - HOLD-UP "Colorado" - HandId: #19116069-322902-1701429261 - Holdem no limit (0.01€/0.02€) - 2023/12/01 11:14:21 UTC
Table: 'Colorado' 6-max (real money) Seat #6 is the button
Seat 1: Fried Berg (1.65€)
Seat 2: cecilon (0.49€)
Seat 3: Caropitchoun (3.67€)
Seat 4: oliveponcar (2.77€)
Seat 5: JFSredbaron (5.47€)
Seat 6: Pffft... (2.14€)
*** ANTE/BLINDS ***
Fried Berg posts small blind 0.01€
cecilon posts big blind 0.02€
Dealt to Fried Berg [6s Qc]
*** PRE-FLOP *** 
Caropitchoun folds
oliveponcar raises 0.04€ to 0.06€
JFSredbaron folds
Pffft... folds
Fried Berg folds
cecilon folds
oliveponcar collected 0.09€ from pot
*** SUMMARY ***
Total pot 0.09€ | No rake
Seat 4: oliveponcar won 0.09€


Winamax Poker - HOLD-UP "Colorado" - HandId: #19116069-322905-1701429264 - Holdem no limit (0.01€/0.02€) - 2023/12/01 11:14:24 UTC
Table: 'Colorado' 6-max (real money) Seat #6 is the button
Seat 1: CHANGAS (3.52€)
Seat 2: papashark14 (2€)
Seat 3: Fried Berg (1.64€)
Seat 4: 1trospecti0n (2€)
Seat 5: DosdeBras (1.82€)
Seat 6: steph290 (0.59€)
*** ANTE/BLINDS ***
CHANGAS posts small blind 0.01€
papashark14 posts big blind 0.02€
Dealt to Fried Berg [Kh 6h]
*** PRE-FLOP *** 
Fried Berg folds
1trospecti0n raises 0.04€ to 0.06€
DosdeBras folds
steph290 folds
CHANGAS folds
papashark14 folds
1trospecti0n collected 0.09€ from pot
*** SUMMARY ***
Total pot 0.09€ | No rake
Seat 4: 1trospecti0n won 0.09€


Winamax Poker - HOLD-UP "Colorado" - HandId: #19116069-322910-1701429268 - Holdem no limit (0.01€/0.02€) - 2023/12/01 11:14:28 UTC
Table: 'Colorado' 6-max (real money) Seat #6 is the button
Seat 1: DosdeBras (1.82€)
Seat 2: Fried Berg (1.64€)
Seat 3: djbassco (4.98€)
Seat 4: steph290 (0.59€)
Seat 5: Pffft... (2.14€)
Seat 6: las210qt (0.68€)
*** ANTE/BLINDS ***
DosdeBras posts small blind 0.01€
Fried Berg posts big blind 0.02€
Dealt to Fried Berg [Ad 8s]
*** PRE-FLOP *** 
djbassco folds
steph290 raises 0.02€ to 0.04€
Pffft... folds
las210qt calls 0.04€
DosdeBras folds
Fried Berg calls 0.02€
*** FLOP *** [4s 3s 4d]
Fried Berg checks
steph290 checks
las210qt checks
*** TURN *** [4s 3s 4d][Jc]
Fried Berg bets 0.04€
steph290 calls 0.04€
las210qt folds
*** RIVER *** [4s 3s 4d Jc][7c]
Fried Berg checks
steph290 checks
*** SHOW DOWN ***
Fried Berg shows [Ad 8s] (One pair : 4)
steph290 shows [Qh Js] (Two pairs : Jacks and 4)
steph290 collected 0.19€ from pot
*** SUMMARY ***
Total pot 0.19€ | Rake 0.02€
Board: [4s 3s 4d Jc 7c]
Seat 2: Fried Berg (big blind) showed [Ad 8s] and lost with One pair : 4
Seat 4: steph290 showed [Qh Js] and won 0.19€ with Two pairs : Jacks and 4


Winamax Poker - HOLD-UP "Colorado" - HandId: #19116069-322980-1701429320 - Holdem no limit (0.01€/0.02€) - 2023/12/01 11:15:20 UTC
Table: 'Colorado' 6-max (real money) Seat #6 is the button
Seat 1: Fried Berg (1.56€)
Seat 2: Johnbedoin18 (1.85€)
Seat 3: steph290 (0.70€)
Seat 4: Tahanouti (1.93€)
Seat 5: Clochitte974 (1.02€)
Seat 6: TaBrEaMoI (4.54€)
*** ANTE/BLINDS ***
Fried Berg posts small blind 0.01€
Johnbedoin18 posts big blind 0.02€
Dealt to Fried Berg [Jd 2d]
*** PRE-FLOP *** 
steph290 folds
Tahanouti folds
Clochitte974 folds
TaBrEaMoI folds
Fried Berg folds
Johnbedoin18 collected 0.03€ from pot
*** SUMMARY ***
Total pot 0.03€ | No rake
Seat 2: Johnbedoin18 (big blind) won 0.03€


Winamax Poker - HOLD-UP "Colorado" - HandId: #19116069-322988-1701429325 - Holdem no limit (0.01€/0.02€) - 2023/12/01 11:15:25 UTC
Table: 'Colorado' 6-max (real money) Seat #6 is the button
Seat 1: TaBrEaMoI (4.54€)
Seat 2: Clochitte974 (1.02€)
Seat 3: mea botellas (3.07€)
Seat 4: Fried Berg (1.55€)
Seat 5: Cejargordas (4.66€)
Seat 6: KKamarAAde (4.67€)
*** ANTE/BLINDS ***
TaBrEaMoI posts small blind 0.01€
Clochitte974 posts big blind 0.02€
Dealt to Fried Berg [Kd 2s]
*** PRE-FLOP *** 
mea botellas folds
Fried Berg folds
Cejargordas raises 0.04€ to 0.06€
KKamarAAde folds
TaBrEaMoI folds
Clochitte974 calls 0.04€
*** FLOP *** [5h 6s Jh]
Clochitte974 bets 0.05€
Cejargordas folds
Clochitte974 collected 0.17€ from pot
*** SUMMARY ***
Total pot 0.17€ | Rake 0.01€
Board: [5h 6s Jh]
Seat 2: Clochitte974 (big blind) won 0.17€


Winamax Poker - HOLD-UP "Colorado" - HandId: #19116069-322990-1701429328 - Holdem no limit (0.01€/0.02€) - 2023/12/01 11:15:28 UTC
Table: 'Colorado' 6-max (real money) Seat #6 is the button
Seat 1: DigBick99 (3.43€)
Seat 2: Baston57 (2.50€)
Seat 3: Johnbedoin18 (1.86€)
Seat 4: mea botellas (3.07€)
Seat 5: Fried Berg (1.55€)
Seat 6: St. Germain (3.72€)
*** ANTE/BLINDS ***
DigBick99 posts small blind 0.01€
Baston57 posts big blind 0.02€
Dealt to Fried Berg [5c 7c]
*** PRE-FLOP *** 
Johnbedoin18 folds
mea botellas folds
Fried Berg raises 0.02€ to 0.04€
St. Germain folds
DigBick99 folds
Baston57 folds
Fried Berg collected 0.07€ from pot
*** SUMMARY ***
Total pot 0.07€ | No rake
Seat 5: Fried Berg won 0.07€


Winamax Poker - HOLD-UP "Colorado" - HandId: #19116069-323007-1701429341 - Holdem no limit (0.01€/0.02€) - 2023/12/01 11:15:41 UTC
Table: 'Colorado' 6-max (real money) Seat #6 is the button
Seat 1: jdeepenslip (2.07€)
Seat 2: St. Germain (3.72€)
Seat 3: Jojo-andros5 (0.66€)
Seat 4: Baston57 (2.48€)
Seat 5: Caropitchoun (2.13€)
Seat 6: Fried Berg (1.58€)
*** ANTE/BLINDS ***
jdeepenslip posts small blind 0.01€
St. Germain posts big blind 0.02€
Dealt to Fried Berg [Ac 4c]
*** PRE-FLOP *** 
Jojo-andros5 folds
Baston57 calls 0.02€
Caropitchoun folds
Fried Berg raises 0.02€ to 0.04€
jdeepenslip folds
St. Germain calls 0.02€
Baston57 calls 0.02€
*** FLOP *** [6d 9s 5d]
St. Germain checks
Baston57 checks
Fried Berg bets 0.04€
St. Germain folds
Baston57 calls 0.04€
*** TURN *** [6d 9s 5d][5c]
Baston57 checks
Fried Berg bets 0.07€
Baston57 calls 0.07€
*** RIVER *** [6d 9s 5d 5c][3s]
Baston57 checks
Fried Berg bets 0.02€
Baston57 calls 0.02€
*** SHOW DOWN ***
Fried Berg shows [Ac 4c] (One pair : 5)
Baston57 shows [7s As] (One pair : 5)
Baston57 collected 0.35€ from pot
*** SUMMARY ***
Total pot 0.35€ | Rake 0.04€
Board: [6d 9s 5d 5c 3s]
Seat 4: Baston57 showed [7s As] and won 0.35€ with One pair : 5
Seat 6: Fried Berg (button) showed [Ac 4c] and lost with One pair : 5


Winamax Poker - HOLD-UP "Colorado" - HandId: #19116069-323076-1701429395 - Holdem no limit (0.01€/0.02€) - 2023/12/01 11:16:35 UTC
Table: 'Colorado' 6-max (real money) Seat #6 is the button
Seat 1: X3a26J23i54 (2.16€)
Seat 2: Astaril (2.03€)
Seat 3: Solda14 (2.47€)
Seat 4: Baston57 (2.66€)
Seat 5: willytiti34 (2.18€)
Seat 6: Fried Berg (1.41€)
*** ANTE/BLINDS ***
X3a26J23i54 posts small blind 0.01€
Astaril posts big blind 0.02€
Dealt to Fried Berg [9c 7c]
*** PRE-FLOP *** 
Solda14 raises 0.04€ to 0.06€
Baston57 folds
willytiti34 folds
Fried Berg calls 0.06€
X3a26J23i54 folds
Astaril calls 0.04€
*** FLOP *** [7s Qh 2h]
Astaril checks
Solda14 checks
Fried Berg bets 0.07€
Astaril calls 0.07€
Solda14 calls 0.07€
*** TURN *** [7s Qh 2h][4s]
Astaril checks
Solda14 checks
Fried Berg checks
*** RIVER *** [7s Qh 2h 4s][As]
Astaril checks
Solda14 checks
Fried Berg checks
*** SHOW DOWN ***
Solda14 shows [Ks Kc] (One pair : Kings)
Fried Berg shows [9c 7c] (One pair : 7)
Astaril shows [Ah 9d] (One pair : Aces)
Astaril collected 0.36€ from pot
*** SUMMARY ***
Total pot 0.36€ | Rake 0.04€
Board: [7s Qh 2h 4s As]
Seat 2: Astaril (big blind) showed [Ah 9d] and won 0.36€ with One pair : Aces
Seat 3: Solda14 showed [Ks Kc] and lost with One pair : Kings
Seat 6: Fried Berg (button) showed [9c 7c] and lost with One pair : 7


Winamax Poker - HOLD-UP "Colorado" - HandId: #19116069-323132-1701429436 - Holdem no limit (0.01€/0.02€) - 2023/12/01 11:17:16 UTC
Table: 'Colorado' 6-max (real money) Seat #6 is the button
Seat 1: Astaril (2.26€)
Seat 2: papashark14 (2.04€)
Seat 3: 1trospecti0n (2.05€)
Seat 4: Fried Berg (1.28€)
Seat 5: Solda14 (2.34€)
Seat 6: CHANGAS (3.48€)
Hold-up to Pot: total 0.10€
*** ANTE/BLINDS ***
Astaril posts small blind 0.01€
papashark14 posts big blind 0.02€
Dealt to Fried Berg [3h 4c]
*** PRE-FLOP *** 
1trospecti0n folds
Fried Berg folds
Solda14 calls 0.02€
CHANGAS folds
Astaril raises 0.16€ to 0.18€
papashark14 folds
Solda14 folds
Astaril collected 0.32€ from pot
*** SUMMARY ***
Total pot 0.32€ | No rake
Seat 1: Astaril (small blind) won 0.32€


Winamax Poker - HOLD-UP "Colorado" - HandId: #19116069-323139-1701429442 - Holdem no limit (0.01€/0.02€) - 2023/12/01 11:17:22 UTC
Table: 'Colorado' 6-max (real money) Seat #6 is the button
Seat 1: Fried Berg (1.28€)
Seat 2: divin.Ange64 (2€)
Seat 3: willytiti34 (2.28€)
Seat 4: LexieMaiko (0.32€)
Seat 5: KKamarAAde (2.01€)
Seat 6: tobytom (2.05€)
*** ANTE/BLINDS ***
Fried Berg posts small blind 0.01€
divin.Ange64 posts big blind 0.02€
Dealt to Fried Berg [7s Js]
*** PRE-FLOP *** 
willytiti34 raises 0.57€ to 0.59€
LexieMaiko folds
KKamarAAde folds
tobytom folds
Fried Berg folds
divin.Ange64 folds
willytiti34 collected 0.62€ from pot
*** SUMMARY ***
Total pot 0.62€ | No rake
Seat 3: willytiti34 won 0.62€


Winamax Poker - HOLD-UP "Colorado" - HandId: #19116069-323159-1701429462 - Holdem no limit (0.01€/0.02€) - 2023/12/01 11:17:42 UTC
Table: 'Colorado' 6-max (real money) Seat #6 is the button
Seat 1: las210qt (0.30€)
Seat 2: Fried Berg (1.27€)
Seat 3: da_igual (2.41€)
Seat 4: oliveponcar (4.08€)
Seat 5: cecilon (0.38€)
Seat 6: jdeepenslip (3.36€)
*** ANTE/BLINDS ***
las210qt posts small blind 0.01€
Fried Berg posts big blind 0.02€
Dealt to Fried Berg [7s Qh]
*** PRE-FLOP *** 
da_igual raises 0.04€ to 0.06€
oliveponcar calls 0.06€
cecilon folds
jdeepenslip folds
las210qt calls 0.05€
Fried Berg folds
*** FLOP *** [Th 9s 7d]
las210qt checks
da_igual bets 0.10€
oliveponcar folds
las210qt calls 0.10€
*** TURN *** [Th 9s 7d][2h]
las210qt checks
da_igual checks
*** RIVER *** [Th 9s 7d 2h][7c]
las210qt bets 0.14€ and is all-in
da_igual calls 0.14€
*** SHOW DOWN ***
da_igual shows [Kc Tc] (Two pairs : Tens and 7)
las210qt shows [8s Js] (Straight Jack high)
las210qt collected 0.61€ from pot
*** SUMMARY ***
Total pot 0.61€ | Rake 0.07€
Board: [Th 9s 7d 2h 7c]
Seat 1: las210qt (small blind) showed [8s Js] and won 0.61€ with Straight Jack high
Seat 3: da_igual showed [Kc Tc] and lost with Two pairs : Tens and 7


Winamax Poker - HOLD-UP "Colorado" - HandId: #19116069-323163-1701429468 - Holdem no limit (0.01€/0.02€) - 2023/12/01 11:17:48 UTC
Table: 'Colorado' 6-max (real money) Seat #6 is the button
Seat 1: Aggro Loser (2€)
Seat 2: bitchete (0.64€)
Seat 3: Fried Berg (1.25€)
Seat 4: TaBrEaMoI (2.55€)
Seat 5: Davidoo36 (0.73€)
Seat 6: Tilted_Donk (2.11€)
*** ANTE/BLINDS ***
Aggro Loser posts small blind 0.01€
bitchete posts big blind 0.02€
Dealt to Fried Berg [2c 8c]
*** PRE-FLOP *** 
Fried Berg folds
TaBrEaMoI raises 0.04€ to 0.06€
Davidoo36 folds
Tilted_Donk folds
Aggro Loser folds
bitchete folds
TaBrEaMoI collected 0.09€ from pot
*** SUMMARY ***
Total pot 0.09€ | No rake
Seat 4: TaBrEaMoI won 0.09€


Winamax Poker - HOLD-UP "Colorado" - HandId: #19116069-323187-1701429489 - Holdem no limit (0.01€/0.02€) - 2023/12/01 11:18:09 UTC
Table: 'Colorado' 6-max (real money) Seat #6 is the button
Seat 1: Jurabelka (2.30€)
Seat 2: KKamarAAde (4.67€)
Seat 3: JFSredbaron (5.67€)
Seat 4: fleurdenacre (0.69€)
Seat 5: Fried Berg (1.25€)
Seat 6: 1trospecti0n (2€)
*** ANTE/BLINDS ***
Jurabelka posts small blind 0.01€
KKamarAAde posts big blind 0.02€
Dealt to Fried Berg [3h 6c]
*** PRE-FLOP *** 
JFSredbaron raises 0.04€ to 0.06€
fleurdenacre folds
Fried Berg folds
1trospecti0n folds
Jurabelka calls 0.05€
KKamarAAde folds
*** FLOP *** [8c 7s Jd]
Jurabelka bets 0.02€
JFSredbaron raises 0.11€ to 0.13€
Jurabelka folds
JFSredbaron collected 0.27€ from pot
*** SUMMARY ***
Total pot 0.27€ | Rake 0.02€
Board: [8c 7s Jd]
Seat 3: JFSredbaron won 0.27€


Winamax Poker - HOLD-UP "Colorado" - HandId: #19116069-323197-1701429498 - Holdem no limit (0.01€/0.02€) - 2023/12/01 11:18:18 UTC
Table: 'Colorado' 6-max (real money) Seat #6 is the button
Seat 1: DigBick99 (3.06€)
Seat 2: vinzou050 (4.47€)
Seat 3: jdeepenslip (2.01€)
Seat 4: Captain_JL (0.46€)
Seat 5: narcam01 (1.21€)
Seat 6: Fried Berg (1.25€)
Hold-up to Pot: total 0.20€
*** ANTE/BLINDS ***
DigBick99 posts small blind 0.01€
vinzou050 posts big blind 0.02€
Dealt to Fried Berg [6s Ad]
*** PRE-FLOP *** 
jdeepenslip raises 0.25€ to 0.27€
Captain_JL folds
narcam01 folds
Fried Berg folds
DigBick99 folds
vinzou050 folds
jdeepenslip collected 0.50€ from pot
*** SUMMARY ***
Total pot 0.50€ | No rake
Seat 3: jdeepenslip won 0.50€


Winamax Poker - HOLD-UP "Colorado" - HandId: #19116069-323240-1701429531 - Holdem no limit (0.01€/0.02€) - 2023/12/01 11:18:51 UTC
Table: 'Colorado' 6-max (real money) Seat #6 is the button
Seat 1: bitchete (0.62€)
Seat 2: AlexMata1103 (1.97€)
Seat 3: orzanco (1.73€)
Seat 4: soliderock (2.05€)
Seat 5: Fried Berg (1.25€)
Seat 6: Astaril (3.31€)
*** ANTE/BLINDS ***
bitchete posts small blind 0.01€
AlexMata1103 posts big blind 0.02€
Dealt to Fried Berg [7d Jh]
*** PRE-FLOP *** 
orzanco folds
soliderock folds
Fried Berg folds
Astaril folds
bitchete calls 0.01€
AlexMata1103 checks
*** FLOP *** [9c Th 2d]
bitchete checks
AlexMata1103 checks
*** TURN *** [9c Th 2d][5c]
bitchete checks
AlexMata1103 checks
*** RIVER *** [9c Th 2d 5c][7h]
bitchete checks
AlexMata1103 checks
*** SHOW DOWN ***
bitchete shows [Kh Qs] (High card : King)
AlexMata1103 shows [5d Ks] (One pair : 5)
AlexMata1103 collected 0.04€ from pot
*** SUMMARY ***
Total pot 0.04€ | No rake
Board: [9c Th 2d 5c 7h]
Seat 1: bitchete (small blind) showed [Kh Qs] and lost with High card : King
Seat 2: AlexMata1103 (big blind) showed [5d Ks] and won 0.04€ with One pair : 5


Winamax Poker - HOLD-UP "Colorado" - HandId: #19116069-323250-1701429536 - Holdem no limit (0.01€/0.02€) - 2023/12/01 11:18:56 UTC
Table: 'Colorado' 6-max (real money) Seat #6 is the button
Seat 1: Fried Berg (1.25€)
Seat 2: soliderock (2.05€)
Seat 3: Johnbedoin18 (3.46€)
Seat 4: Astaril (3.30€)
Seat 5: papashark14 (1.34€)
Seat 6: Cejargordas (4.39€)
*** ANTE/BLINDS ***
Fried Berg posts small blind 0.01€
soliderock posts big blind 0.02€
Dealt to Fried Berg [6s 5s]
*** PRE-FLOP *** 
Johnbedoin18 folds
Astaril folds
papashark14 folds
Cejargordas folds
Fried Berg raises 0.02€ to 0.04€
soliderock calls 0.02€
*** FLOP *** [7c 9d Js]
Fried Berg checks
soliderock checks
*** TURN *** [7c 9d Js][9c]
Fried Berg checks
soliderock checks
*** RIVER *** [7c 9d Js 9c][3d]
Fried Berg checks
soliderock checks
*** SHOW DOWN ***
Fried Berg shows [6s 5s] (One pair : 9)
soliderock shows [As 7d] (Two pairs : 9 and 7)
soliderock collected 0.07€ from pot
*** SUMMARY ***
Total pot 0.07€ | Rake 0.01€
Board: [7c 9d Js 9c 3d]
Seat 1: Fried Berg (small blind) showed [6s 5s] and lost with One pair : 9
Seat 2: soliderock (big blind) showed [As 7d] and won 0.07€ with Two pairs : 9 and 7


Winamax Poker - HOLD-UP "Colorado" - HandId: #19116069-323321-1701429604 - Holdem no limit (0.01€/0.02€) - 2023/12/01 11:20:04 UTC
Table: 'Colorado' 6-max (real money) Seat #6 is the button
Seat 1: soliderock (2.08€)
Seat 2: Fried Berg (1.21€)
Seat 3: KKamarAAde (4.11€)
Seat 4: Alexisdpp (5.36€)
Seat 5: tobytom (2€)
Seat 6: 1trospecti0n (2€)
*** ANTE/BLINDS ***
soliderock posts small blind 0.01€
Fried Berg posts big blind 0.02€
Dealt to Fried Berg [3c Ah]
*** PRE-FLOP *** 
KKamarAAde raises 0.04€ to 0.06€
Alexisdpp folds
tobytom folds
1trospecti0n folds
soliderock folds
Fried Berg folds
KKamarAAde collected 0.09€ from pot
*** SUMMARY ***
Total pot 0.09€ | No rake
Seat 3: KKamarAAde won 0.09€


Winamax Poker - HOLD-UP "Colorado" - HandId: #19116069-323325-1701429610 - Holdem no limit (0.01€/0.02€) - 2023/12/01 11:20:10 UTC
Table: 'Colorado' 6-max (real money) Seat #6 is the button
Seat 1: txalintxo (1.86€)
Seat 2: 1trospecti0n (2€)
Seat 3: Fried Berg (1.19€)
Seat 4: g8o8k8u (2.01€)
Seat 5: Jurabelka (2.83€)
Seat 6: tobytom (2€)
Hold-up to Pot: total 0.20€
*** ANTE/BLINDS ***
txalintxo posts small blind 0.01€
1trospecti0n posts big blind 0.02€
Dealt to Fried Berg [9s 6c]
*** PRE-FLOP *** 
Fried Berg folds
g8o8k8u folds
Jurabelka folds
tobytom raises 0.04€ to 0.06€
txalintxo calls 0.05€
1trospecti0n raises 1.94€ to 2€ and is all-in
tobytom folds
txalintxo folds
1trospecti0n collected 2.32€ from pot
*** SUMMARY ***
Total pot 2.32€ | No rake
Seat 2: 1trospecti0n (big blind) won 2.32€


Winamax Poker - HOLD-UP "Colorado" - HandId: #19116069-323332-1701429616 - Holdem no limit (0.01€/0.02€) - 2023/12/01 11:20:16 UTC
Table: 'Colorado' 6-max (real money) Seat #6 is the button
Seat 1: 121 (2.13€)
Seat 2: narcam01 (1.13€)
Seat 3: oliveponcar (5.61€)
Seat 4: Fried Berg (1.19€)
Seat 5: FILTONFLOUSE (2.63€)
Seat 6: a.masa (6.08€)
*** ANTE/BLINDS ***
121 posts small blind 0.01€
narcam01 posts big blind 0.02€
Dealt to Fried Berg [2h 5h]
*** PRE-FLOP *** 
oliveponcar folds
Fried Berg folds
FILTONFLOUSE folds
a.masa folds
121 folds
narcam01 collected 0.03€ from pot
*** SUMMARY ***
Total pot 0.03€ | No rake
Seat 2: narcam01 (big blind) won 0.03€


Winamax Poker - HOLD-UP "Colorado" - HandId: #19116069-323335-1701429618 - Holdem no limit (0.01€/0.02€) - 2023/12/01 11:20:18 UTC
Table: 'Colorado' 6-max (real money) Seat #6 is the button
Seat 1: FILTONFLOUSE (2.63€)
Seat 2: Pffft... (2.89€)
Seat 3: colgate12 (4.52€)
Seat 4: 121 (2.12€)
Seat 5: DonKmillo (3.61€)
Seat 6: Fried Berg (1.19€)
*** ANTE/BLINDS ***
FILTONFLOUSE posts small blind 0.01€
Pffft... posts big blind 0.02€
Dealt to Fried Berg [5h Kc]
*** PRE-FLOP *** 
colgate12 folds
121 folds
DonKmillo folds
Fried Berg folds
FILTONFLOUSE folds
Pffft... collected 0.03€ from pot
*** SUMMARY ***
Total pot 0.03€ | No rake
Seat 2: Pffft... (big blind) won 0.03€


Winamax Poker - HOLD-UP "Colorado" - HandId: #19116069-323343-1701429624 - Holdem no limit (0.01€/0.02€) - 2023/12/01 11:20:24 UTC
Table: 'Colorado' 6-max (real money) Seat #6 is the button
Seat 1: dada1979 (0.56€)
Seat 2: fleurdenacre (0.63€)
Seat 3: Berig (1.92€)
Seat 4: Fried Berg (1.19€)
Seat 5: DigBick99 (3.03€)
Seat 6: St. Germain (4.30€)
*** ANTE/BLINDS ***
dada1979 posts small blind 0.01€
fleurdenacre posts big blind 0.02€
Dealt to Fried Berg [3h 6s]
*** PRE-FLOP *** 
Berig folds
Fried Berg folds
DigBick99 folds
St. Germain folds
dada1979 calls 0.01€
fleurdenacre checks
*** FLOP *** [8s Ks 5d]
dada1979 checks
fleurdenacre checks
*** TURN *** [8s Ks 5d][Ad]
dada1979 checks
fleurdenacre bets 0.04€
dada1979 calls 0.04€
*** RIVER *** [8s Ks 5d Ad][2s]
dada1979 checks
fleurdenacre checks
*** SHOW DOWN ***
dada1979 shows [Jd Qd] (High card : Ace)
fleurdenacre shows [As 5h] (Two pairs : Aces and 5)
fleurdenacre collected 0.11€ from pot
*** SUMMARY ***
Total pot 0.11€ | Rake 0.01€
Board: [8s Ks 5d Ad 2s]
Seat 1: dada1979 (small blind) showed [Jd Qd] and lost with High card : Ace
Seat 2: fleurdenacre (big blind) showed [As 5h] and won 0.11€ with Two pairs : Aces and 5


Winamax Poker - HOLD-UP "Colorado" - HandId: #19116069-323347-1701429627 - Holdem no limit (0.01€/0.02€) - 2023/12/01 11:20:27 UTC
Table: 'Colorado' 6-max (real money) Seat #6 is the button
Seat 1: Astaril (2.15€)
Seat 2: Fried Berg (1.19€)
Seat 3: jdeepenslip (2.22€)
Seat 4: Berig (1.91€)
Seat 5: willytiti34 (1.52€)
Seat 6: DigBick99 (3.03€)
Hold-up to Pot: total 0.10€
*** ANTE/BLINDS ***
Astaril posts small blind 0.01€
Fried Berg posts big blind 0.02€
Dealt to Fried Berg [Ad Jc]
*** PRE-FLOP *** 
jdeepenslip folds
Berig calls 0.02€
willytiti34 folds
DigBick99 raises 0.08€ to 0.10€
Astaril folds
Fried Berg calls 0.08€
Berig folds
*** FLOP *** [3c 8h Kh]
Fried Berg checks
DigBick99 bets 0.11€
Fried Berg calls 0.11€
*** TURN *** [3c 8h Kh][9d]
Fried Berg checks
DigBick99 checks
*** RIVER *** [3c 8h Kh 9d][Kd]
Fried Berg checks
DigBick99 checks
*** SHOW DOWN ***
DigBick99 shows [5c Ah] (One pair : Kings)
Fried Berg shows [Ad Jc] (One pair : Kings)
Fried Berg collected 0.50€ from pot
*** SUMMARY ***
Total pot 0.50€ | Rake 0.05€
Board: [3c 8h Kh 9d Kd]
Seat 2: Fried Berg (big blind) showed [Ad Jc] and won 0.50€ with One pair : Kings
Seat 6: DigBick99 (button) showed [5c Ah] and lost with One pair : Kings


Winamax Poker - HOLD-UP "Colorado" - HandId: #19116069-323398-1701429674 - Holdem no limit (0.01€/0.02€) - 2023/12/01 11:21:14 UTC
Table: 'Colorado' 6-max (real money) Seat #6 is the button
Seat 1: Leneuf9 (1.92€)
Seat 2: ricki64 (2.07€)
Seat 3: Fried Berg (1.48€)
Seat 4: PaireDeJoker (0.96€)
Seat 5: Blurran (0.90€)
Seat 6: KKamarAAde (2.28€)
*** ANTE/BLINDS ***
Leneuf9 posts small blind 0.01€
ricki64 posts big blind 0.02€
Dealt to Fried Berg [3s 5d]
*** PRE-FLOP *** 
Fried Berg folds
PaireDeJoker calls 0.02€
Blurran folds
KKamarAAde raises 0.06€ to 0.08€
Leneuf9 folds
ricki64 calls 0.06€
PaireDeJoker calls 0.06€
*** FLOP *** [Qd Jh 8h]
ricki64 checks
PaireDeJoker checks
KKamarAAde bets 0.16€
ricki64 calls 0.16€
PaireDeJoker folds
*** TURN *** [Qd Jh 8h][7h]
ricki64 checks
KKamarAAde checks
*** RIVER *** [Qd Jh 8h 7h][Qc]
ricki64 checks
KKamarAAde checks
*** SHOW DOWN ***
ricki64 shows [Th 7d] (Two pairs : Queens and 7)
KKamarAAde shows [Ac Jd] (Two pairs : Queens and Jacks)
KKamarAAde collected 0.51€ from pot
*** SUMMARY ***
Total pot 0.51€ | Rake 0.06€
Board: [Qd Jh 8h 7h Qc]
Seat 2: ricki64 (big blind) showed [Th 7d] and lost with Two pairs : Queens and 7
Seat 6: KKamarAAde (button) showed [Ac Jd] and won 0.51€ with Two pairs : Queens and Jacks


Winamax Poker - HOLD-UP "Colorado" - HandId: #19116069-323403-1701429679 - Holdem no limit (0.01€/0.02€) - 2023/12/01 11:21:19 UTC
Table: 'Colorado' 6-max (real money) Seat #6 is the button
Seat 1: Fried Berg (1.48€)
Seat 2: Hareng.72444 (0.50€)
Seat 3: DigBick99 (2.09€)
Seat 4: jdeepenslip (3.25€)
Seat 5: cecilon (0.61€)
Seat 6: Blurran (0.90€)
*** ANTE/BLINDS ***
Fried Berg posts small blind 0.01€
Hareng.72444 posts big blind 0.02€
Dealt to Fried Berg [4c 7d]
*** PRE-FLOP *** 
DigBick99 raises 0.04€ to 0.06€
jdeepenslip folds
cecilon folds
Blurran calls 0.06€
Fried Berg folds
Hareng.72444 calls 0.04€
*** FLOP *** [Jh 7h Qh]
Hareng.72444 checks
DigBick99 bets 0.15€
Blurran folds
Hareng.72444 calls 0.15€
*** TURN *** [Jh 7h Qh][8s]
Hareng.72444 checks
DigBick99 bets 0.32€
Hareng.72444 calls 0.29€ and is all-in
*** RIVER *** [Jh 7h Qh 8s][Kc]
*** SHOW DOWN ***
Hareng.72444 shows [4h 2s] (High card : King)
DigBick99 shows [Ac As] (One pair : Aces)
DigBick99 collected 0.99€ from pot
*** SUMMARY ***
Total pot 0.99€ | Rake 0.11€
Board: [Jh 7h Qh 8s Kc]
Seat 2: Hareng.72444 (big blind) showed [4h 2s] and lost with High card : King
Seat 3: DigBick99 showed [Ac As] and won 0.99€ with One pair : Aces


Winamax Poker - HOLD-UP "Colorado" - HandId: #19116069-323407-1701429685 - Holdem no limit (0.01€/0.02€) - 2023/12/01 11:21:25 UTC
Table: 'Colorado' 6-max (real money) Seat #6 is the button
Seat 1: Tilted_Donk (2.09€)
Seat 2: YoSoyPablo17 (2.52€)
Seat 3: Tyza.Davz (2.76€)
Seat 4: cecilon (0.61€)
Seat 5: Fried Berg (1.47€)
Seat 6: Cejargordas (2.18€)
*** ANTE/BLINDS ***
Tilted_Donk posts small blind 0.01€
YoSoyPablo17 posts big blind 0.02€
Dealt to Fried Berg [7c 7d]
*** PRE-FLOP *** 
Tyza.Davz folds
cecilon folds
Fried Berg raises 0.02€ to 0.04€
Cejargordas folds
Tilted_Donk raises 0.36€ to 0.40€
YoSoyPablo17 folds
Fried Berg folds
Tilted_Donk collected 0.46€ from pot
*** SUMMARY ***
Total pot 0.46€ | No rake
Seat 1: Tilted_Donk (small blind) won 0.46€


Winamax Poker - HOLD-UP "Colorado" - HandId: #19116069-323450-1701429727 - Holdem no limit (0.01€/0.02€) - 2023/12/01 11:22:07 UTC
Table: 'Colorado' 6-max (real money) Seat #6 is the button
Seat 1: Thequeen1205 (2.29€)
Seat 2: PaireDeJoker (0.87€)
Seat 3: DonKmillo (3.61€)
Seat 4: Fried Berg (1.43€)
Seat 5: txalintxo (1.91€)
Seat 6: divin.Ange64 (2.28€)
*** ANTE/BLINDS ***
Thequeen1205 posts small blind 0.01€
PaireDeJoker posts big blind 0.02€
Dealt to Fried Berg [Qs 4h]
*** PRE-FLOP *** 
DonKmillo folds
Fried Berg folds
txalintxo raises 0.03€ to 0.05€
divin.Ange64 calls 0.05€
Thequeen1205 folds
PaireDeJoker calls 0.03€
*** FLOP *** [Ts 6s Ks]
PaireDeJoker checks
txalintxo checks
divin.Ange64 checks
*** TURN *** [Ts 6s Ks][6h]
PaireDeJoker checks
txalintxo checks
divin.Ange64 checks
*** RIVER *** [Ts 6s Ks 6h][6d]
PaireDeJoker checks
txalintxo bets 0.06€
divin.Ange64 calls 0.06€
PaireDeJoker folds
*** SHOW DOWN ***
divin.Ange64 shows [2s 2h] (Full of 6 and 2)
txalintxo shows [Qc Qh] (Full of 6 and Queens)
txalintxo collected 0.25€ from pot
*** SUMMARY ***
Total pot 0.25€ | Rake 0.03€
Board: [Ts 6s Ks 6h 6d]
Seat 5: txalintxo showed [Qc Qh] and won 0.25€ with Full of 6 and Queens
Seat 6: divin.Ange64 (button) showed [2s 2h] and lost with Full of 6 and 2


Winamax Poker - HOLD-UP "Colorado" - HandId: #19116069-323454-1701429729 - Holdem no limit (0.01€/0.02€) - 2023/12/01 11:22:09 UTC
Table: 'Colorado' 6-max (real money) Seat #6 is the button
Seat 1: mea botellas (3.36€)
Seat 2: Toon89 (2.26€)
Seat 3: HinnyX (2€)
Seat 4: TheMaiden (2.19€)
Seat 5: Fried Berg (1.43€)
Seat 6: papashark14 (1.82€)
*** ANTE/BLINDS ***
mea botellas posts small blind 0.01€
Toon89 posts big blind 0.02€
Dealt to Fried Berg [Kd 3d]
*** PRE-FLOP *** 
HinnyX folds
TheMaiden raises 0.04€ to 0.06€
Fried Berg folds
papashark14 folds
mea botellas folds
Toon89 calls 0.04€
*** FLOP *** [4h 6h Jh]
Toon89 checks
TheMaiden checks
*** TURN *** [4h 6h Jh][2s]
Toon89 checks
TheMaiden bets 0.05€
Toon89 folds
TheMaiden collected 0.17€ from pot
*** SUMMARY ***
Total pot 0.17€ | Rake 0.01€
Board: [4h 6h Jh 2s]
Seat 4: TheMaiden won 0.17€


Winamax Poker - HOLD-UP "Colorado" - HandId: #19116069-323459-1701429733 - Holdem no limit (0.01€/0.02€) - 2023/12/01 11:22:13 UTC
Table: 'Colorado' 6-max (real money) Seat #6 is the button
Seat 1: ricki64 (1.83€)
Seat 2: jdeepenslip (3.23€)
Seat 3: oliveponcar (3.61€)
Seat 4: Tilted_Donk (2.20€)
Seat 5: papashark14 (1.82€)
Seat 6: Fried Berg (1.43€)
*** ANTE/BLINDS ***
ricki64 posts small blind 0.01€
jdeepenslip posts big blind 0.02€
Dealt to Fried Berg [7h 9d]
*** PRE-FLOP *** 
oliveponcar folds
Tilted_Donk folds
papashark14 folds
Fried Berg folds
ricki64 calls 0.01€
jdeepenslip checks
*** FLOP *** [2c Ah Kc]
ricki64 bets 0.02€
jdeepenslip raises 0.08€ to 0.10€
ricki64 calls 0.08€
*** TURN *** [2c Ah Kc][6d]
ricki64 checks
jdeepenslip bets 0.19€
ricki64 calls 0.19€
*** RIVER *** [2c Ah Kc 6d][2d]
ricki64 checks
jdeepenslip bets 2.92€ and is all-in
ricki64 calls 1.52€ and is all-in
*** SHOW DOWN ***
ricki64 shows [Kd 8h] (Two pairs : Kings and 2)
jdeepenslip shows [Ad 2h] (Full of 2 and Aces)
jdeepenslip collected 4.69€ from pot
*** SUMMARY ***
Total pot 4.69€ | Rake 0.37€
Board: [2c Ah Kc 6d 2d]
Seat 1: ricki64 (small blind) showed [Kd 8h] and lost with Two pairs : Kings and 2
Seat 2: jdeepenslip (big blind) showed [Ad 2h] and won 4.69€ with Full of 2 and Aces


Winamax Poker - HOLD-UP "Colorado" - HandId: #19116069-323461-1701429735 - Holdem no limit (0.01€/0.02€) - 2023/12/01 11:22:15 UTC
Table: 'Colorado' 6-max (real money) Seat #6 is the button
Seat 1: Fried Berg (1.43€)
Seat 2: Leneuf9 (1.94€)
Seat 3: tobytom (2€)
Seat 4: mea botellas (3.35€)
Seat 5: Caropitchoun (3.73€)
Seat 6: DGG23 (0.47€)
*** ANTE/BLINDS ***
Fried Berg posts small blind 0.01€
Leneuf9 posts big blind 0.02€
Dealt to Fried Berg [Js Kh]
*** PRE-FLOP *** 
tobytom folds
mea botellas folds
Caropitchoun folds
DGG23 folds
Fried Berg raises 0.02€ to 0.04€
Leneuf9 calls 0.02€
*** FLOP *** [6d 7s Jh]
Fried Berg bets 0.02€
Leneuf9 calls 0.02€
*** TURN *** [6d 7s Jh][Qs]
Fried Berg checks
Leneuf9 bets 0.08€
Fried Berg calls 0.08€
*** RIVER *** [6d 7s Jh Qs][6h]
Fried Berg checks
Leneuf9 checks
*** SHOW DOWN ***
Leneuf9 shows [Ac 5d] (One pair : 6)
Fried Berg shows [Js Kh] (Two pairs : Jacks and 6)
Fried Berg collected 0.25€ from pot
*** SUMMARY ***
Total pot 0.25€ | Rake 0.03€
Board: [6d 7s Jh Qs 6h]
Seat 1: Fried Berg (small blind) showed [Js Kh] and won 0.25€ with Two pairs : Jacks and 6
Seat 2: Leneuf9 (big blind) showed [Ac 5d] and lost with One pair : 6


Winamax Poker - HOLD-UP "Colorado" - HandId: #19116069-323488-1701429768 - Holdem no limit (0.01€/0.02€) - 2023/12/01 11:22:48 UTC
Table: 'Colorado' 6-max (real money) Seat #6 is the button
Seat 1: Blurran (0.60€)
Seat 2: Fried Berg (1.54€)
Seat 3: Leneuf9 (1.80€)
Seat 4: Tilted_Donk (2.13€)
Seat 5: 121 (3.65€)
Seat 6: colgate12 (4.41€)
*** ANTE/BLINDS ***
Blurran posts small blind 0.01€
Fried Berg posts big blind 0.02€
Dealt to Fried Berg [Ad Qh]
*** PRE-FLOP *** 
Leneuf9 folds
Tilted_Donk folds
121 folds
colgate12 folds
Blurran folds
Fried Berg collected 0.03€ from pot
*** SUMMARY ***
Total pot 0.03€ | No rake
Seat 2: Fried Berg (big blind) won 0.03€


Winamax Poker - HOLD-UP "Colorado" - HandId: #19116069-323499-1701429776 - Holdem no limit (0.01€/0.02€) - 2023/12/01 11:22:56 UTC
Table: 'Colorado' 6-max (real money) Seat #6 is the button
Seat 1: Tilted_Donk (2.03€)
Seat 2: Johnbedoin18 (7.40€)
Seat 3: GTO-Mieko (2€)
Seat 4: Max297 (3.13€)
Seat 5: dada1979 (0.55€)
Seat 6: Fried Berg (1.55€)
*** ANTE/BLINDS ***
Tilted_Donk posts small blind 0.01€
Johnbedoin18 posts big blind 0.02€
Dealt to Fried Berg [6s 8h]
*** PRE-FLOP *** 
GTO-Mieko folds
Max297 folds
dada1979 raises 0.05€ to 0.07€
Fried Berg folds
Tilted_Donk folds
Johnbedoin18 folds
dada1979 collected 0.10€ from pot
*** SUMMARY ***
Total pot 0.10€ | No rake
Seat 5: dada1979 won 0.10€


Winamax Poker - HOLD-UP "Colorado" - HandId: #19116069-323505-1701429780 - Holdem no limit (0.01€/0.02€) - 2023/12/01 11:23:00 UTC
Table: 'Colorado' 6-max (real money) Seat #6 is the button
Seat 1: HinnyX (2€)
Seat 2: DonKmillo (3.58€)
Seat 3: Fried Berg (1.55€)
Seat 4: GTO-Mieko (2€)
Seat 5: TaBrEaMoI (3.13€)
Seat 6: wmx-b52pzfw (0.50€)
*** ANTE/BLINDS ***
HinnyX posts small blind 0.01€
DonKmillo posts big blind 0.02€
Dealt to Fried Berg [Qh Td]
*** PRE-FLOP *** 
Fried Berg folds
GTO-Mieko folds
TaBrEaMoI folds
wmx-b52pzfw folds
HinnyX folds
DonKmillo collected 0.03€ from pot
*** SUMMARY ***
Total pot 0.03€ | No rake
Seat 2: DonKmillo (big blind) won 0.03€


Winamax Poker - HOLD-UP "Colorado" - HandId: #19116069-323509-1701429783 - Holdem no limit (0.01€/0.02€) - 2023/12/01 11:23:03 UTC
Table: 'Colorado' 6-max (real money) Seat #6 is the button
Seat 1: DigBick99 (2.52€)
Seat 2: Tilted_Donk (2.02€)
Seat 3: Fried Berg (1.55€)
Seat 4: Leneuf9 (1.81€)
Seat 5: LilRun (2.03€)
Seat 6: TaBrEaMoI (3.13€)
Hold-up to Pot: total 0.20€
*** ANTE/BLINDS ***
DigBick99 posts small blind 0.01€
Tilted_Donk posts big blind 0.02€
Dealt to Fried Berg [9d 5s]
*** PRE-FLOP *** 
Fried Berg folds
Leneuf9 raises 0.05€ to 0.07€
LilRun calls 0.07€
TaBrEaMoI folds
DigBick99 folds
Tilted_Donk folds
*** FLOP *** [5d Ac 6c]
Leneuf9 bets 0.19€
LilRun calls 0.19€
*** TURN *** [5d Ac 6c][9h]
Leneuf9 bets 0.38€
LilRun calls 0.38€
*** RIVER *** [5d Ac 6c 9h][5h]
Leneuf9 bets 1.17€ and is all-in
LilRun calls 1.17€
*** SHOW DOWN ***
LilRun shows [As 7c] (Two pairs : Aces and 5)
Leneuf9 shows [Tc Ah] (Two pairs : Aces and 5)
Leneuf9 collected 3.48€ from pot
*** SUMMARY ***
Total pot 3.48€ | Rake 0.37€
Board: [5d Ac 6c 9h 5h]
Seat 4: Leneuf9 showed [Tc Ah] and won 3.48€ with Two pairs : Aces and 5
Seat 5: LilRun showed [As 7c] and lost with Two pairs : Aces and 5


Winamax Poker - HOLD-UP "Colorado" - HandId: #19116069-323513-1701429788 - Holdem no limit (0.01€/0.02€) - 2023/12/01 11:23:08 UTC
Table: 'Colorado' 6-max (real money) Seat #6 is the button
Seat 1: St. Germain (4.23€)
Seat 2: Fried Berg (1.55€)
Seat 3: tobytom (2€)
Seat 4: Johnbedoin18 (7.38€)
Seat 5: dada1979 (0.58€)
Seat 6: HinnyX (2€)
*** ANTE/BLINDS ***
St. Germain posts small blind 0.01€
Fried Berg posts big blind 0.02€
Dealt to Fried Berg [Jd Ac]
*** PRE-FLOP *** 
tobytom folds
Johnbedoin18 folds
dada1979 folds
HinnyX calls 0.02€
St. Germain folds
Fried Berg checks
*** FLOP *** [8d Jh 5s]
Fried Berg checks
HinnyX checks
*** TURN *** [8d Jh 5s][4d]
Fried Berg checks
HinnyX bets 0.03€
Fried Berg calls 0.03€
*** RIVER *** [8d Jh 5s 4d][8c]
Fried Berg checks
HinnyX checks
*** SHOW DOWN ***
HinnyX shows [Qd Ts] (One pair : 8)
Fried Berg shows [Jd Ac] (Two pairs : Jacks and 8)
Fried Berg collected 0.10€ from pot
*** SUMMARY ***
Total pot 0.10€ | Rake 0.01€
Board: [8d Jh 5s 4d 8c]
Seat 2: Fried Berg (big blind) showed [Jd Ac] and won 0.10€ with Two pairs : Jacks and 8
Seat 6: HinnyX (button) showed [Qd Ts] and lost with One pair : 8


Winamax Poker - HOLD-UP "Colorado" - HandId: #19116069-323553-1701429827 - Holdem no limit (0.01€/0.02€) - 2023/12/01 11:23:47 UTC
Table: 'Colorado' 6-max (real money) Seat #6 is the button
Seat 1: Adrianohhhh (2.01€)
Seat 2: tobytom (2€)
Seat 3: Baston57 (2.78€)
Seat 4: Fried Berg (1.60€)
Seat 5: Tilted_Donk (2€)
Seat 6: HinnyX (2€)
*** ANTE/BLINDS ***
Adrianohhhh posts small blind 0.01€
tobytom posts big blind 0.02€
Dealt to Fried Berg [Ah 6s]
*** PRE-FLOP *** 
Baston57 folds
Fried Berg calls 0.02€
Tilted_Donk raises 0.28€ to 0.30€
HinnyX folds
Adrianohhhh folds
tobytom folds
Fried Berg folds
Tilted_Donk collected 0.35€ from pot
*** SUMMARY ***
Total pot 0.35€ | No rake
Seat 5: Tilted_Donk won 0.35€


Winamax Poker - HOLD-UP "Colorado" - HandId: #19116069-323569-1701429844 - Holdem no limit (0.01€/0.02€) - 2023/12/01 11:24:04 UTC
Table: 'Colorado' 6-max (real money) Seat #6 is the button
Seat 1: FenderTolra (2€)
Seat 2: DGG23 (0.50€)
Seat 3: bitchete (0.88€)
Seat 4: Tyza.Davz (3.21€)
Seat 5: Fried Berg (1.58€)
Seat 6: Pffft... (2.81€)
*** ANTE/BLINDS ***
FenderTolra posts small blind 0.01€
DGG23 posts big blind 0.02€
Dealt to Fried Berg [8s 2d]
*** PRE-FLOP *** 
bitchete calls 0.02€
Tyza.Davz folds
Fried Berg folds
Pffft... folds
FenderTolra raises 0.08€ to 0.10€
DGG23 folds
bitchete folds
FenderTolra collected 0.14€ from pot
*** SUMMARY ***
Total pot 0.14€ | No rake
Seat 1: FenderTolra (small blind) won 0.14€


Winamax Poker - HOLD-UP "Colorado" - HandId: #19116069-323570-1701429845 - Holdem no limit (0.01€/0.02€) - 2023/12/01 11:24:05 UTC
Table: 'Colorado' 6-max (real money) Seat #6 is the button
Seat 1: Fried Berg (1.58€)
Seat 2: HinnyX (2€)
Seat 3: Johnbedoin18 (3.69€)
Seat 4: Leneuf9 (2.25€)
Seat 5: divin.Ange64 (2€)
Seat 6: g8o8k8u (2.69€)
*** ANTE/BLINDS ***
Fried Berg posts small blind 0.01€
HinnyX posts big blind 0.02€
Dealt to Fried Berg [Tc Ts]
*** PRE-FLOP *** 
Johnbedoin18 folds
Leneuf9 folds
divin.Ange64 folds
g8o8k8u raises 0.04€ to 0.06€
Fried Berg calls 0.05€
HinnyX folds
*** FLOP *** [4s 4h 9h]
Fried Berg bets 0.04€
g8o8k8u folds
Fried Berg collected 0.17€ from pot
*** SUMMARY ***
Total pot 0.17€ | Rake 0.01€
Board: [4s 4h 9h]
Seat 1: Fried Berg (small blind) won 0.17€


Winamax Poker - HOLD-UP "Colorado" - HandId: #19116069-323600-1701429880 - Holdem no limit (0.01€/0.02€) - 2023/12/01 11:24:40 UTC
Table: 'Colorado' 6-max (real money) Seat #6 is the button
Seat 1: Cejargordas (4.61€)
Seat 2: Braisinho 10 (1.41€)
Seat 3: DonKmillo (3.59€)
Seat 4: cecilon (0.53€)
Seat 5: Leneuf9 (2.75€)
Seat 6: Fried Berg (1.65€)
*** ANTE/BLINDS ***
Cejargordas posts small blind 0.01€
Braisinho 10 posts big blind 0.02€
Dealt to Fried Berg [Ac Td]
*** PRE-FLOP *** 
DonKmillo folds
cecilon raises 0.03€ to 0.05€
Leneuf9 calls 0.05€
Fried Berg calls 0.05€
Cejargordas calls 0.04€
Braisinho 10 folds
*** FLOP *** [Qh 4d 4s]
Cejargordas checks
cecilon checks
Leneuf9 checks
Fried Berg checks
*** TURN *** [Qh 4d 4s][Ts]
Cejargordas checks
cecilon checks
Leneuf9 checks
Fried Berg bets 0.04€
Cejargordas calls 0.04€
cecilon folds
Leneuf9 folds
*** RIVER *** [Qh 4d 4s Ts][Ad]
Cejargordas checks
Fried Berg bets 0.11€
Cejargordas calls 0.11€
*** SHOW DOWN ***
Cejargordas shows [Qs 9h] (Two pairs : Queens and 4)
Fried Berg shows [Ac Td] (Two pairs : Aces and Tens)
Fried Berg collected 0.47€ from pot
*** SUMMARY ***
Total pot 0.47€ | Rake 0.05€
Board: [Qh 4d 4s Ts Ad]
Seat 1: Cejargordas (small blind) showed [Qs 9h] and lost with Two pairs : Queens and 4
Seat 6: Fried Berg (button) showed [Ac Td] and won 0.47€ with Two pairs : Aces and Tens


Winamax Poker - HOLD-UP "Colorado" - HandId: #19116069-323703-1701429968 - Holdem no limit (0.01€/0.02€) - 2023/12/01 11:26:08 UTC
Table: 'Colorado' 6-max (real money) Seat #6 is the button
Seat 1: TaBrEaMoI (4.75€)
Seat 2: jdeepenslip (4.57€)
Seat 3: Fried Berg (1.92€)
Seat 4: Astaril (4.16€)
Seat 5: David Boring (2€)
Seat 6: Toon89 (2.23€)
*** ANTE/BLINDS ***
TaBrEaMoI posts small blind 0.01€
jdeepenslip posts big blind 0.02€
Dealt to Fried Berg [2c 5c]
*** PRE-FLOP *** 
Fried Berg folds
Astaril folds
David Boring folds
Toon89 folds
TaBrEaMoI folds
jdeepenslip collected 0.03€ from pot
*** SUMMARY ***
Total pot 0.03€ | No rake
Seat 2: jdeepenslip (big blind) won 0.03€


Winamax Poker - HOLD-UP "Colorado" - HandId: #19116069-323710-1701429974 - Holdem no limit (0.01€/0.02€) - 2023/12/01 11:26:14 UTC
Table: 'Colorado' 6-max (real money) Seat #6 is the button
Seat 1: Tahanouti (1.47€)
Seat 2: FenderTolra (2€)
Seat 3: oliveponcar (3.58€)
Seat 4: RaFaLX13 (0.74€)
Seat 5: 121 (3.42€)
Seat 6: Fried Berg (1.92€)
*** ANTE/BLINDS ***
Tahanouti posts small blind 0.01€
FenderTolra posts big blind 0.02€
Dealt to Fried Berg [9s 8h]
*** PRE-FLOP *** 
oliveponcar folds
RaFaLX13 folds
121 raises 0.04€ to 0.06€
Fried Berg folds
Tahanouti calls 0.05€
FenderTolra folds
*** FLOP *** [5c Kc Ks]
Tahanouti checks
121 bets 0.07€
Tahanouti folds
121 collected 0.20€ from pot
*** SUMMARY ***
Total pot 0.20€ | Rake 0.01€
Board: [5c Kc Ks]
Seat 5: 121 won 0.20€


Winamax Poker - HOLD-UP "Colorado" - HandId: #19116069-323723-1701429984 - Holdem no limit (0.01€/0.02€) - 2023/12/01 11:26:24 UTC
Table: 'Colorado' 6-max (real money) Seat #6 is the button
Seat 1: JFSredbaron (2€)
Seat 2: Fried Berg (1.92€)
Seat 3: orzanco (1.24€)
Seat 4: jdeepenslip (4.57€)
Seat 5: papashark14 (1.65€)
Seat 6: DigBick99 (2.52€)
*** ANTE/BLINDS ***
JFSredbaron posts small blind 0.01€
Fried Berg posts big blind 0.02€
Dealt to Fried Berg [Qc 3c]
*** PRE-FLOP *** 
orzanco folds
jdeepenslip folds
papashark14 folds
DigBick99 folds
JFSredbaron folds
Fried Berg collected 0.03€ from pot
*** SUMMARY ***
Total pot 0.03€ | No rake
Seat 2: Fried Berg (big blind) won 0.03€


Winamax Poker - HOLD-UP "Colorado" - HandId: #19116069-323736-1701429996 - Holdem no limit (0.01€/0.02€) - 2023/12/01 11:26:36 UTC
Table: 'Colorado' 6-max (real money) Seat #6 is the button
Seat 1: FenderTolra (2€)
Seat 2: fifre07 (1.98€)
Seat 3: haouuum28 (1.97€)
Seat 4: Fried Berg (1.93€)
Seat 5: divin.Ange64 (2€)
Seat 6: Tahanouti (1.41€)
*** ANTE/BLINDS ***
FenderTolra posts small blind 0.01€
fifre07 posts big blind 0.02€
Dealt to Fried Berg [4c Qs]
*** PRE-FLOP *** 
haouuum28 folds
Fried Berg folds
divin.Ange64 raises 0.04€ to 0.06€
Tahanouti folds
FenderTolra folds
fifre07 folds
divin.Ange64 collected 0.09€ from pot
*** SUMMARY ***
Total pot 0.09€ | No rake
Seat 5: divin.Ange64 won 0.09€


Winamax Poker - HOLD-UP "Colorado" - HandId: #19116069-323743-1701430002 - Holdem no limit (0.01€/0.02€) - 2023/12/01 11:26:42 UTC
Table: 'Colorado' 6-max (real money) Seat #6 is the button
Seat 1: Fried Berg (1.93€)
Seat 2: Blurran (0.79€)
Seat 3: AlexMata1103 (2.04€)
Seat 4: JFSredbaron (2€)
Seat 5: tobytom (2.37€)
Seat 6: TaBrEaMoI (3.44€)
*** ANTE/BLINDS ***
Fried Berg posts small blind 0.01€
Blurran posts big blind 0.02€
Dealt to Fried Berg [6d 5c]
*** PRE-FLOP *** 
AlexMata1103 folds
JFSredbaron raises 0.04€ to 0.06€
tobytom folds
TaBrEaMoI folds
Fried Berg folds
Blurran calls 0.04€
*** FLOP *** [7d 8h Qs]
Blurran checks
JFSredbaron checks
*** TURN *** [7d 8h Qs][7h]
Blurran checks
JFSredbaron checks
*** RIVER *** [7d 8h Qs 7h][5h]
Blurran checks
JFSredbaron checks
*** SHOW DOWN ***
Blurran shows [Ts Ad] (One pair : 7)
JFSredbaron shows [Jd As] (One pair : 7)
JFSredbaron collected 0.12€ from pot
*** SUMMARY ***
Total pot 0.12€ | Rake 0.01€
Board: [7d 8h Qs 7h 5h]
Seat 2: Blurran (big blind) showed [Ts Ad] and lost with One pair : 7
Seat 4: JFSredbaron showed [Jd As] and won 0.12€ with One pair : 7


Winamax Poker - HOLD-UP "Colorado" - HandId: #19116069-323747-1701430005 - Holdem no limit (0.01€/0.02€) - 2023/12/01 11:26:45 UTC
Table: 'Colorado' 6-max (real money) Seat #6 is the button
Seat 1: Tilted_Donk (2.30€)
Seat 2: Killim (1.31€)
Seat 3: St. Germain (4.09€)
Seat 4: Alexisdpp (5.29€)
Seat 5: Fried Berg (1.92€)
Seat 6: FenderTolra (2€)
*** ANTE/BLINDS ***
Tilted_Donk posts small blind 0.01€
Killim posts big blind 0.02€
Dealt to Fried Berg [7h 5s]
*** PRE-FLOP *** 
St. Germain folds
Alexisdpp raises 0.02€ to 0.04€
Fried Berg folds
FenderTolra folds
Tilted_Donk folds
Killim calls 0.02€
*** FLOP *** [3d 9c As]
Killim checks
Alexisdpp bets 0.06€
Killim folds
Alexisdpp collected 0.14€ from pot
*** SUMMARY ***
Total pot 0.14€ | Rake 0.01€
Board: [3d 9c As]
Seat 4: Alexisdpp won 0.14€


Winamax Poker - HOLD-UP "Colorado" - HandId: #19116069-326282-1701431811 - Holdem no limit (0.01€/0.02€) - 2023/12/01 11:56:51 UTC
Table: 'Colorado' 6-max (real money) Seat #6 is the button
Seat 1: tobytom (2.27€)
Seat 2: Fried Berg (0.50€)
Seat 3: Max297 (0.84€)
Seat 4: Pop_hop_hop (1.82€)
Seat 5: TaBrEaMoI (4.96€)
Seat 6: DonKmillo (5.80€)
*** ANTE/BLINDS ***
tobytom posts small blind 0.01€
Fried Berg posts big blind 0.02€
Dealt to Fried Berg [Ts As]
*** PRE-FLOP *** 
Max297 folds
Pop_hop_hop folds
TaBrEaMoI folds
DonKmillo folds
tobytom folds
Fried Berg collected 0.03€ from pot
*** SUMMARY ***
Total pot 0.03€ | No rake
Seat 2: Fried Berg (big blind) won 0.03€


Winamax Poker - HOLD-UP "Colorado" - HandId: #19116069-326299-1701431820 - Holdem no limit (0.01€/0.02€) - 2023/12/01 11:57:00 UTC
Table: 'Colorado' 6-max (real money) Seat #6 is the button
Seat 1: Fried Berg (0.51€)
Seat 2: PaireDeJoker (1.44€)
Seat 3: Joan009 (2€)
Seat 4: ilergeta (3€)
Seat 5: tobytom (2.26€)
Seat 6: Hug2579 (0.42€)
*** ANTE/BLINDS ***
Fried Berg posts small blind 0.01€
PaireDeJoker posts big blind 0.02€
Dealt to Fried Berg [Kc 7h]
*** PRE-FLOP *** 
Joan009 folds
ilergeta folds
tobytom folds
Hug2579 folds
Fried Berg folds
PaireDeJoker collected 0.03€ from pot
*** SUMMARY ***
Total pot 0.03€ | No rake
Seat 2: PaireDeJoker (big blind) won 0.03€


Winamax Poker - HOLD-UP "Colorado" - HandId: #19116069-326326-1701431834 - Holdem no limit (0.01€/0.02€) - 2023/12/01 11:57:14 UTC
Table: 'Colorado' 6-max (real money) Seat #6 is the button
Seat 1: LilRun (5.84€)
Seat 2: Blurran (0.90€)
Seat 3: Fried Berg (0.50€)
Seat 4: Leneuf9 (2.23€)
Seat 5: tobytom (2.03€)
Seat 6: Cejargordas (4.04€)
*** ANTE/BLINDS ***
LilRun posts small blind 0.01€
Blurran posts big blind 0.02€
Dealt to Fried Berg [7h 7c]
*** PRE-FLOP *** 
Fried Berg calls 0.02€
Leneuf9 folds
tobytom folds
Cejargordas folds
LilRun calls 0.01€
Blurran checks
*** FLOP *** [3h 6d 8d]
LilRun checks
Blurran checks
Fried Berg checks
*** TURN *** [3h 6d 8d][Jh]
LilRun bets 0.04€
Blurran folds
Fried Berg calls 0.04€
*** RIVER *** [3h 6d 8d Jh][5c]
LilRun checks
Fried Berg checks
*** SHOW DOWN ***
LilRun shows [4s 4d] (One pair : 4)
Fried Berg shows [7h 7c] (One pair : 7)
Fried Berg collected 0.13€ from pot
*** SUMMARY ***
Total pot 0.13€ | Rake 0.01€
Board: [3h 6d 8d Jh 5c]
Seat 1: LilRun (small blind) showed [4s 4d] and lost with One pair : 4
Seat 3: Fried Berg showed [7h 7c] and won 0.13€ with One pair : 7


Winamax Poker - HOLD-UP "Colorado" - HandId: #19116069-326455-1701431899 - Holdem no limit (0.01€/0.02€) - 2023/12/01 11:58:19 UTC
Table: 'Colorado' 6-max (real money) Seat #6 is the button
Seat 1: oliveponcar (4.36€)
Seat 2: curiouz dje (2.16€)
Seat 3: Blurran (0.59€)
Seat 4: Fried Berg (0.57€)
Seat 5: JFSredbaron (2.07€)
Seat 6: crush game (4.06€)
*** ANTE/BLINDS ***
oliveponcar posts small blind 0.01€
curiouz dje posts big blind 0.02€
Dealt to Fried Berg [Ad 8d]
*** PRE-FLOP *** 
Blurran folds
Fried Berg raises 0.02€ to 0.04€
JFSredbaron folds
crush game folds
oliveponcar folds
curiouz dje folds
Fried Berg collected 0.07€ from pot
*** SUMMARY ***
Total pot 0.07€ | No rake
Seat 4: Fried Berg won 0.07€


Winamax Poker - HOLD-UP "Colorado" - HandId: #19116069-326523-1701431932 - Holdem no limit (0.01€/0.02€) - 2023/12/01 11:58:52 UTC
Table: 'Colorado' 6-max (real money) Seat #6 is the button
Seat 1: FenderTolra (2.67€)
Seat 2: Direct Oli (1.97€)
Seat 3: Krudson1 (2.93€)
Seat 4: Blurran (0.44€)
Seat 5: Fried Berg (0.60€)
Seat 6: TaBrEaMoI (2.48€)
*** ANTE/BLINDS ***
FenderTolra posts small blind 0.01€
Direct Oli posts big blind 0.02€
Dealt to Fried Berg [8d Tc]
*** PRE-FLOP *** 
Krudson1 folds
Blurran folds
Fried Berg folds
TaBrEaMoI folds
FenderTolra raises 0.04€ to 0.06€
Direct Oli folds
FenderTolra collected 0.08€ from pot
*** SUMMARY ***
Total pot 0.08€ | No rake
Seat 1: FenderTolra (small blind) won 0.08€


Winamax Poker - HOLD-UP "Colorado" - HandId: #19116069-326551-1701431951 - Holdem no limit (0.01€/0.02€) - 2023/12/01 11:59:11 UTC
Table: 'Colorado' 6-max (real money) Seat #6 is the button
Seat 1: cril14100 (1.98€)
Seat 2: ilergeta (3.44€)
Seat 3: slowreplay (2€)
Seat 4: BAAC0 (2.33€)
Seat 5: Jeje27 (1.97€)
Seat 6: Fried Berg (0.60€)
*** ANTE/BLINDS ***
cril14100 posts small blind 0.01€
ilergeta posts big blind 0.02€
Dealt to Fried Berg [4d Qd]
*** PRE-FLOP *** 
slowreplay folds
BAAC0 folds
Jeje27 folds
Fried Berg raises 0.02€ to 0.04€
cril14100 calls 0.03€
ilergeta calls 0.02€
*** FLOP *** [8d Kc 9c]
cril14100 checks
ilergeta checks
Fried Berg checks
*** TURN *** [8d Kc 9c][9d]
cril14100 bets 0.04€
ilergeta folds
Fried Berg calls 0.04€
*** RIVER *** [8d Kc 9c 9d][7s]
cril14100 checks
Fried Berg checks
*** SHOW DOWN ***
Fried Berg shows [4d Qd] (One pair : 9)
cril14100 shows [Ts Tc] (Two pairs : Tens and 9)
cril14100 collected 0.18€ from pot
*** SUMMARY ***
Total pot 0.18€ | Rake 0.02€
Board: [8d Kc 9c 9d 7s]
Seat 1: cril14100 (small blind) showed [Ts Tc] and won 0.18€ with Two pairs : Tens and 9
Seat 6: Fried Berg (button) showed [4d Qd] and lost with One pair : 9


Winamax Poker - HOLD-UP "Colorado" - HandId: #19116069-326657-1701432010 - Holdem no limit (0.01€/0.02€) - 2023/12/01 12:00:10 UTC
Table: 'Colorado' 6-max (real money) Seat #6 is the button
Seat 1: Blurran (0.52€)
Seat 2: S-aaron24 (2.67€)
Seat 3: Sucre10 (3.64€)
Seat 4: BAAC0 (2.74€)
Seat 5: Fried Berg (0.52€)
Seat 6: cril14100 (2.08€)
*** ANTE/BLINDS ***
Blurran posts small blind 0.01€
S-aaron24 posts big blind 0.02€
Dealt to Fried Berg [6c Qh]
*** PRE-FLOP *** 
Sucre10 folds
BAAC0 folds
Fried Berg folds
cril14100 folds
Blurran folds
S-aaron24 collected 0.03€ from pot
*** SUMMARY ***
Total pot 0.03€ | No rake
Seat 2: S-aaron24 (big blind) won 0.03€


Winamax Poker - HOLD-UP "Colorado" - HandId: #19116069-326679-1701432020 - Holdem no limit (0.01€/0.02€) - 2023/12/01 12:00:20 UTC
Table: 'Colorado' 6-max (real money) Seat #6 is the button
Seat 1: BAAC0 (2.74€)
Seat 2: Fried Berg (0.52€)
Seat 3: Pffft... (2.65€)
Seat 4: Fanfan21260 (1.89€)
Seat 5: GALALE (1.47€)
Seat 6: hello7585 (2.13€)
*** ANTE/BLINDS ***
BAAC0 posts small blind 0.01€
Fried Berg posts big blind 0.02€
Dealt to Fried Berg [6c 9d]
*** PRE-FLOP *** 
Pffft... folds
Fanfan21260 calls 0.02€
GALALE calls 0.02€
hello7585 calls 0.02€
BAAC0 folds
Fried Berg checks
*** FLOP *** [6h Ac 8d]
Fried Berg checks
Fanfan21260 bets 0.03€
GALALE calls 0.03€
hello7585 folds
Fried Berg folds
*** TURN *** [6h Ac 8d][Ts]
Fanfan21260 bets 0.05€
GALALE folds
Fanfan21260 collected 0.18€ from pot
*** SUMMARY ***
Total pot 0.18€ | Rake 0.02€
Board: [6h Ac 8d Ts]
Seat 4: Fanfan21260 won 0.18€


Winamax Poker - HOLD-UP "Colorado" - HandId: #19116069-326769-1701432075 - Holdem no limit (0.01€/0.02€) - 2023/12/01 12:01:15 UTC
Table: 'Colorado' 6-max (real money) Seat #6 is the button
Seat 1: Fried Berg (0.50€)
Seat 2: cril14100 (2.08€)
Seat 3: gostvision (2€)
Seat 4: Rodriguee (2€)
Seat 5: Krudson1 (3.48€)
Seat 6: Joan009 (2.27€)
*** ANTE/BLINDS ***
Fried Berg posts small blind 0.01€
cril14100 posts big blind 0.02€
Dealt to Fried Berg [4s Qh]
*** PRE-FLOP *** 
gostvision folds
Rodriguee folds
Krudson1 folds
Joan009 raises 0.03€ to 0.05€
Fried Berg folds
cril14100 folds
Joan009 collected 0.08€ from pot
*** SUMMARY ***
Total pot 0.08€ | No rake
Seat 6: Joan009 (button) won 0.08€


Winamax Poker - HOLD-UP "Colorado" - HandId: #19116069-326821-1701432105 - Holdem no limit (0.01€/0.02€) - 2023/12/01 12:01:45 UTC
Table: 'Colorado' 6-max (real money) Seat #6 is the button
Seat 1: Fanfan21260 (1.92€)
Seat 2: HiTxXx (2.05€)
Seat 3: Fried Berg (0.49€)
Seat 4: arkiond3 (1.85€)
Seat 5: p4ppysl4m (3.70€)
Seat 6: Babi78_ (3.26€)
*** ANTE/BLINDS ***
Fanfan21260 posts small blind 0.01€
HiTxXx posts big blind 0.02€
Dealt to Fried Berg [Ks Qd]
*** PRE-FLOP *** 
Fried Berg raises 0.02€ to 0.04€
arkiond3 calls 0.04€
p4ppysl4m folds
Babi78_ folds
Fanfan21260 calls 0.03€
HiTxXx folds
*** FLOP *** [8c 3c Ac]
Fanfan21260 bets 0.02€
Fried Berg folds
arkiond3 calls 0.02€
*** TURN *** [8c 3c Ac][6h]
Fanfan21260 bets 0.06€
arkiond3 calls 0.06€
*** RIVER *** [8c 3c Ac 6h][8h]
Fanfan21260 bets 0.20€
arkiond3 folds
Fanfan21260 collected 0.47€ from pot
*** SUMMARY ***
Total pot 0.47€ | Rake 0.03€
Board: [8c 3c Ac 6h 8h]
Seat 1: Fanfan21260 (small blind) won 0.47€


Winamax Poker - HOLD-UP "Colorado" - HandId: #19116069-327016-1701432217 - Holdem no limit (0.01€/0.02€) - 2023/12/01 12:03:37 UTC
Table: 'Colorado' 6-max (real money) Seat #6 is the button
Seat 1: tobytom (3.63€)
Seat 2: g8o8k8u (2.44€)
Seat 3: Fanfan21260 (2.07€)
Seat 4: Fried Berg (0.45€)
Seat 5: Joan009 (2.20€)
Seat 6: Delpierrot10 (2€)
*** ANTE/BLINDS ***
tobytom posts small blind 0.01€
g8o8k8u posts big blind 0.02€
Dealt to Fried Berg [Jh Kh]
*** PRE-FLOP *** 
Fanfan21260 calls 0.02€
Fried Berg raises 0.04€ to 0.06€
Joan009 folds
Delpierrot10 folds
tobytom folds
g8o8k8u folds
Fanfan21260 calls 0.04€
*** FLOP *** [5h 8h 3c]
Fanfan21260 bets 0.05€
Fried Berg calls 0.05€
*** TURN *** [5h 8h 3c][Ks]
Fanfan21260 bets 0.09€
Fried Berg calls 0.09€
*** RIVER *** [5h 8h 3c Ks][Td]
Fanfan21260 bets 0.15€
Fried Berg calls 0.15€
*** SHOW DOWN ***
Fanfan21260 shows [6c 9d] (High card : King)
Fried Berg shows [Jh Kh] (One pair : Kings)
Fried Berg collected 0.66€ from pot
*** SUMMARY ***
Total pot 0.66€ | Rake 0.07€
Board: [5h 8h 3c Ks Td]
Seat 3: Fanfan21260 showed [6c 9d] and lost with High card : King
Seat 4: Fried Berg showed [Jh Kh] and won 0.66€ with One pair : Kings


Winamax Poker - HOLD-UP "Colorado" - HandId: #19116069-327081-1701432266 - Holdem no limit (0.01€/0.02€) - 2023/12/01 12:04:26 UTC
Table: 'Colorado' 6-max (real money) Seat #6 is the button
Seat 1: Caropitchoun (8€)
Seat 2: slowreplay (2€)
Seat 3: Max297 (1.12€)
Seat 4: cecilon (0.84€)
Seat 5: Fanfan21260 (1.72€)
Seat 6: Fried Berg (0.76€)
*** ANTE/BLINDS ***
Caropitchoun posts small blind 0.01€
slowreplay posts big blind 0.02€
Dealt to Fried Berg [Js 2c]
*** PRE-FLOP *** 
Max297 folds
cecilon folds
Fanfan21260 folds
Fried Berg folds
Caropitchoun folds
slowreplay collected 0.03€ from pot
*** SUMMARY ***
Total pot 0.03€ | No rake
Seat 2: slowreplay (big blind) won 0.03€


Winamax Poker - HOLD-UP "Colorado" - HandId: #19116069-327106-1701432283 - Holdem no limit (0.01€/0.02€) - 2023/12/01 12:04:43 UTC
Table: 'Colorado' 6-max (real money) Seat #6 is the button
Seat 1: gostvision (2€)
Seat 2: Fried Berg (0.76€)
Seat 3: ilergeta (2.43€)
Seat 4: Upswing11 (3.08€)
Seat 5: g8o8k8u (2.47€)
Seat 6: TheRealWill (2.39€)
*** ANTE/BLINDS ***
gostvision posts small blind 0.01€
Fried Berg posts big blind 0.02€
Dealt to Fried Berg [8c 9s]
*** PRE-FLOP *** 
ilergeta folds
Upswing11 folds
g8o8k8u folds
TheRealWill folds
gostvision raises 0.03€ to 0.05€
Fried Berg calls 0.03€
*** FLOP *** [5h 2h 8s]
gostvision checks
Fried Berg checks
*** TURN *** [5h 2h 8s][Jh]
gostvision checks
Fried Berg checks
*** RIVER *** [5h 2h 8s Jh][Jd]
gostvision checks
Fried Berg checks
*** SHOW DOWN ***
gostvision shows [Qh Ks] (One pair : Jacks)
Fried Berg shows [8c 9s] (Two pairs : Jacks and 8)
Fried Berg collected 0.09€ from pot
*** SUMMARY ***
Total pot 0.09€ | Rake 0.01€
Board: [5h 2h 8s Jh Jd]
Seat 1: gostvision (small blind) showed [Qh Ks] and lost with One pair : Jacks
Seat 2: Fried Berg (big blind) showed [8c 9s] and won 0.09€ with Two pairs : Jacks and 8


Winamax Poker - HOLD-UP "Colorado" - HandId: #19116069-327169-1701432329 - Holdem no limit (0.01€/0.02€) - 2023/12/01 12:05:29 UTC
Table: 'Colorado' 6-max (real money) Seat #6 is the button
Seat 1: Fried Berg (0.80€)
Seat 2: BAAC0 (2.56€)
Seat 3: gostvision (2€)
Seat 4: 77cece77 (1.32€)
Seat 5: Caropitchoun (7.92€)
Seat 6: Blurran (0.40€)
Hold-up to Pot: total 0.10€
*** ANTE/BLINDS ***
Fried Berg posts small blind 0.01€
BAAC0 posts big blind 0.02€
Dealt to Fried Berg [Kh 3d]
*** PRE-FLOP *** 
gostvision raises 0.03€ to 0.05€
77cece77 folds
Caropitchoun raises 0.23€ to 0.28€
Blurran folds
Fried Berg folds
BAAC0 folds
gostvision folds
Caropitchoun collected 0.46€ from pot
*** SUMMARY ***
Total pot 0.46€ | No rake
Seat 5: Caropitchoun won 0.46€


Winamax Poker - HOLD-UP "Colorado" - HandId: #19116069-327184-1701432340 - Holdem no limit (0.01€/0.02€) - 2023/12/01 12:05:40 UTC
Table: 'Colorado' 6-max (real money) Seat #6 is the button
Seat 1: FenderTolra (2€)
Seat 2: Leneuf9 (2.50€)
Seat 3: Fried Berg (0.79€)
Seat 4: SnellRojas (2.32€)
Seat 5: Joan009 (2€)
Seat 6: TheRealWill (2€)
Hold-up to Pot: total 0.10€
*** ANTE/BLINDS ***
FenderTolra posts small blind 0.01€
Leneuf9 posts big blind 0.02€
Dealt to Fried Berg [9s Ac]
*** PRE-FLOP *** 
Fried Berg raises 0.02€ to 0.04€
SnellRojas folds
Joan009 folds
TheRealWill calls 0.04€
FenderTolra folds
Leneuf9 folds
*** FLOP *** [Jh 9d 4c]
Fried Berg bets 0.05€
TheRealWill calls 0.05€
*** TURN *** [Jh 9d 4c][5h]
Fried Berg checks
TheRealWill bets 0.16€
Fried Berg calls 0.16€
*** RIVER *** [Jh 9d 4c 5h][9c]
Fried Berg checks
TheRealWill bets 0.63€
Fried Berg calls 0.54€ and is all-in
*** SHOW DOWN ***
Fried Berg shows [9s Ac] (Trips of 9)
TheRealWill shows [5d 5s] (Full of 5 and 9)
TheRealWill collected 1.64€ from pot
*** SUMMARY ***
Total pot 1.64€ | Rake 0.16€
Board: [Jh 9d 4c 5h 9c]
Seat 3: Fried Berg showed [9s Ac] and lost with Trips of 9
Seat 6: TheRealWill (button) showed [5d 5s] and won 1.64€ with Full of 5 and 9


Winamax Poker - HOLD-UP "Colorado" - HandId: #19116069-327424-1701432507 - Holdem no limit (0.01€/0.02€) - 2023/12/01 12:08:27 UTC
Table: 'Colorado' 6-max (real money) Seat #6 is the button
Seat 1: MVital23 (0.56€)
Seat 2: S-aaron24 (2.82€)
Seat 3: HiTxXx (2.34€)
Seat 4: Fried Berg (0.50€)
Seat 5: ilergeta (3.25€)
Seat 6: JFSredbaron (2.03€)
*** ANTE/BLINDS ***
MVital23 posts small blind 0.01€
S-aaron24 posts big blind 0.02€
Dealt to Fried Berg [8h 5d]
*** PRE-FLOP *** 
HiTxXx folds
Fried Berg folds
ilergeta folds
JFSredbaron folds
MVital23 calls 0.01€
S-aaron24 checks
*** FLOP *** [2d 3s Jh]
MVital23 checks
S-aaron24 checks
*** TURN *** [2d 3s Jh][Ts]
MVital23 checks
S-aaron24 bets 0.04€
MVital23 calls 0.04€
*** RIVER *** [2d 3s Jh Ts][5c]
MVital23 checks
S-aaron24 bets 0.09€
MVital23 folds
S-aaron24 collected 0.20€ from pot
*** SUMMARY ***
Total pot 0.20€ | Rake 0.01€
Board: [2d 3s Jh Ts 5c]
Seat 2: S-aaron24 (big blind) won 0.20€


Winamax Poker - HOLD-UP "Colorado" - HandId: #19116069-327431-1701432514 - Holdem no limit (0.01€/0.02€) - 2023/12/01 12:08:34 UTC
Table: 'Colorado' 6-max (real money) Seat #6 is the button
Seat 1: slowreplay (2.23€)
Seat 2: gostvision (2€)
Seat 3: p4ppysl4m (2.10€)
Seat 4: FenderTolra (2.49€)
Seat 5: Fried Berg (0.50€)
Seat 6: Kira17 (2.03€)
*** ANTE/BLINDS ***
slowreplay posts small blind 0.01€
gostvision posts big blind 0.02€
Dealt to Fried Berg [8s 8h]
*** PRE-FLOP *** 
p4ppysl4m folds
FenderTolra folds
Fried Berg raises 0.02€ to 0.04€
Kira17 folds
slowreplay folds
gostvision folds
Fried Berg collected 0.07€ from pot
*** SUMMARY ***
Total pot 0.07€ | No rake
Seat 5: Fried Berg won 0.07€


Winamax Poker - HOLD-UP "Colorado" - HandId: #19116069-327462-1701432535 - Holdem no limit (0.01€/0.02€) - 2023/12/01 12:08:55 UTC
Table: 'Colorado' 6-max (real money) Seat #6 is the button
Seat 1: Blurran (0.53€)
Seat 2: Filet-O-fils (1.54€)
Seat 3: Meg a lodon (1.01€)
Seat 4: AMBM2729 (1.20€)
Seat 5: gostvision (2€)
Seat 6: Fried Berg (0.53€)
*** ANTE/BLINDS ***
Blurran posts small blind 0.01€
Filet-O-fils posts big blind 0.02€
Dealt to Fried Berg [3c Qs]
*** PRE-FLOP *** 
Meg a lodon calls 0.02€
AMBM2729 folds
gostvision folds
Fried Berg folds
Blurran calls 0.01€
Filet-O-fils checks
*** FLOP *** [5c 2h 3d]
Blurran checks
Filet-O-fils checks
Meg a lodon checks
*** TURN *** [5c 2h 3d][Ac]
Blurran checks
Filet-O-fils checks
Meg a lodon checks
*** RIVER *** [5c 2h 3d Ac][8d]
Blurran checks
Filet-O-fils checks
Meg a lodon checks
*** SHOW DOWN ***
Blurran shows [3h Qd] (One pair : 3)
Filet-O-fils shows [6c Kd] (High card : Ace)
Meg a lodon shows [7h 8c] (One pair : 8)
Meg a lodon collected 0.05€ from pot
*** SUMMARY ***
Total pot 0.05€ | Rake 0.01€
Board: [5c 2h 3d Ac 8d]
Seat 1: Blurran (small blind) showed [3h Qd] and lost with One pair : 3
Seat 2: Filet-O-fils (big blind) showed [6c Kd] and lost with High card : Ace
Seat 3: Meg a lodon showed [7h 8c] and won 0.05€ with One pair : 8


Winamax Poker - HOLD-UP "Colorado" - HandId: #19116069-327500-1701432553 - Holdem no limit (0.01€/0.02€) - 2023/12/01 12:09:13 UTC
Table: 'Colorado' 6-max (real money) Seat #6 is the button
Seat 1: Siradella80 (1.89€)
Seat 2: Fanfan21260 (2.15€)
Seat 3: HiTxXx (2.31€)
Seat 4: slowreplay (2.01€)
Seat 5: Fried Berg (0.53€)
Seat 6: Shang_li_hao (2€)
*** ANTE/BLINDS ***
Siradella80 posts small blind 0.01€
Fanfan21260 posts big blind 0.02€
Dealt to Fried Berg [2h Ac]
*** PRE-FLOP *** 
HiTxXx folds
slowreplay folds
Fried Berg folds
Shang_li_hao folds
Siradella80 calls 0.01€
Fanfan21260 checks
*** FLOP *** [Kc 6s 3s]
Siradella80 checks
Fanfan21260 bets 0.04€
Siradella80 folds
Fanfan21260 collected 0.08€ from pot
*** SUMMARY ***
Total pot 0.08€ | No rake
Board: [Kc 6s 3s]
Seat 2: Fanfan21260 (big blind) won 0.08€


Winamax Poker - HOLD-UP "Colorado" - HandId: #19116069-327511-1701432561 - Holdem no limit (0.01€/0.02€) - 2023/12/01 12:09:21 UTC
Table: 'Colorado' 6-max (real money) Seat #6 is the button
Seat 1: hello7585 (1.83€)
Seat 2: Fried Berg (0.53€)
Seat 3: AMBM2729 (1.20€)
Seat 4: gostvision (2€)
Seat 5: cecilon (0.59€)
Seat 6: HiTxXx (4.88€)
*** ANTE/BLINDS ***
hello7585 posts small blind 0.01€
Fried Berg posts big blind 0.02€
Dealt to Fried Berg [3s 2d]
*** PRE-FLOP *** 
AMBM2729 folds
gostvision raises 0.03€ to 0.05€
cecilon folds
HiTxXx folds
hello7585 folds
Fried Berg folds
gostvision collected 0.08€ from pot
*** SUMMARY ***
Total pot 0.08€ | No rake
Seat 4: gostvision won 0.08€


Winamax Poker - HOLD-UP "Colorado" - HandId: #19116069-327546-1701432583 - Holdem no limit (0.01€/0.02€) - 2023/12/01 12:09:43 UTC
Table: 'Colorado' 6-max (real money) Seat #6 is the button
Seat 1: Poke Gyneco (2€)
Seat 2: Shifta (0.10€)
Seat 3: Kira17 (2€)
Seat 4: Fried Berg (0.51€)
Seat 5: papashark14 (1.93€)
Seat 6: DGG23 (0.73€)
*** ANTE/BLINDS ***
Poke Gyneco posts small blind 0.01€
Shifta posts big blind 0.02€
Dealt to Fried Berg [Jh 9h]
*** PRE-FLOP *** 
Kira17 folds
Fried Berg raises 0.02€ to 0.04€
papashark14 folds
DGG23 folds
Poke Gyneco calls 0.03€
Shifta raises 0.06€ to 0.10€ and is all-in
Fried Berg calls 0.06€
Poke Gyneco calls 0.06€
*** FLOP *** [2s 3s 5c]
Poke Gyneco checks
Fried Berg checks
*** TURN *** [2s 3s 5c][4s]
Poke Gyneco checks
Fried Berg checks
*** RIVER *** [2s 3s 5c 4s][Ts]
Poke Gyneco checks
Fried Berg checks
*** SHOW DOWN ***
Poke Gyneco shows [Qh Jc] (High card : Queen)
Fried Berg shows [Jh 9h] (High card : Jack)
Shifta shows [3c 7c] (One pair : 3)
Shifta collected 0.27€ from pot
*** SUMMARY ***
Total pot 0.27€ | Rake 0.03€
Board: [2s 3s 5c 4s Ts]
Seat 1: Poke Gyneco (small blind) showed [Qh Jc] and lost with High card : Queen
Seat 2: Shifta (big blind) showed [3c 7c] and won 0.27€ with One pair : 3
Seat 4: Fried Berg showed [Jh 9h] and lost with High card : Jack


Winamax Poker - HOLD-UP "Colorado" - HandId: #19116069-327607-1701432631 - Holdem no limit (0.01€/0.02€) - 2023/12/01 12:10:31 UTC
Table: 'Colorado' 6-max (real money) Seat #6 is the button
Seat 1: Shifta (0.27€)
Seat 2: p4ppysl4m (2.06€)
Seat 3: FrappeLourde (0.47€)
Seat 4: Caropitchoun (4.48€)
Seat 5: TheRealWill (3.16€)
Seat 6: Fried Berg (0.41€)
*** ANTE/BLINDS ***
Shifta posts small blind 0.01€
p4ppysl4m posts big blind 0.02€
Dealt to Fried Berg [Qh 2s]
*** PRE-FLOP *** 
FrappeLourde folds
Caropitchoun raises 0.04€ to 0.06€
TheRealWill folds
Fried Berg folds
Shifta folds
p4ppysl4m folds
Caropitchoun collected 0.09€ from pot
*** SUMMARY ***
Total pot 0.09€ | No rake
Seat 4: Caropitchoun won 0.09€


Winamax Poker - HOLD-UP "Colorado" - HandId: #19116069-327631-1701432649 - Holdem no limit (0.01€/0.02€) - 2023/12/01 12:10:49 UTC
Table: 'Colorado' 6-max (real money) Seat #6 is the button
Seat 1: Fried Berg (0.41€)
Seat 2: DonKmillo (8.27€)
Seat 3: Upswing11 (5.67€)
Seat 4: curiouz dje (2.12€)
Seat 5: Blurran (0.53€)
Seat 6: HiTxXx (2.26€)
*** ANTE/BLINDS ***
Fried Berg posts small blind 0.01€
DonKmillo posts big blind 0.02€
Dealt to Fried Berg [9h 5d]
*** PRE-FLOP *** 
Upswing11 folds
curiouz dje raises 0.03€ to 0.05€
Blurran folds
HiTxXx folds
Fried Berg folds
DonKmillo folds
curiouz dje collected 0.08€ from pot
*** SUMMARY ***
Total pot 0.08€ | No rake
Seat 4: curiouz dje won 0.08€


Winamax Poker - HOLD-UP "Colorado" - HandId: #19116069-327636-1701432654 - Holdem no limit (0.01€/0.02€) - 2023/12/01 12:10:54 UTC
Table: 'Colorado' 6-max (real money) Seat #6 is the button
Seat 1: TONETONE510 (1.70€)
Seat 2: papashark14 (1.49€)
Seat 3: Fried Berg (0.40€)
Seat 4: slowreplay (2.19€)
Seat 5: TaBrEaMoI (4.61€)
Seat 6: hello7585 (2.04€)
*** ANTE/BLINDS ***
TONETONE510 posts small blind 0.01€
papashark14 posts big blind 0.02€
Dealt to Fried Berg [2d 2h]
*** PRE-FLOP *** 
Fried Berg folds
slowreplay raises 0.03€ to 0.05€
TaBrEaMoI folds
hello7585 folds
TONETONE510 calls 0.04€
papashark14 folds
*** FLOP *** [3d Jh 2c]
TONETONE510 checks
slowreplay bets 0.08€
TONETONE510 folds
slowreplay collected 0.19€ from pot
*** SUMMARY ***
Total pot 0.19€ | Rake 0.01€
Board: [3d Jh 2c]
Seat 4: slowreplay won 0.19€


Winamax Poker - HOLD-UP "Colorado" - HandId: #19116069-327644-1701432659 - Holdem no limit (0.01€/0.02€) - 2023/12/01 12:10:59 UTC
Table: 'Colorado' 6-max (real money) Seat #6 is the button
Seat 1: DonKmillo (8.25€)
Seat 2: hello7585 (2.18€)
Seat 3: Pop_hop_hop (4.02€)
Seat 4: Thequeen1205 (6.12€)
Seat 5: Fried Berg (0.40€)
Seat 6: Meg a lodon (1.04€)
*** ANTE/BLINDS ***
DonKmillo posts small blind 0.01€
hello7585 posts big blind 0.02€
Dealt to Fried Berg [5h 9s]
*** PRE-FLOP *** 
Pop_hop_hop folds
Thequeen1205 folds
Fried Berg folds
Meg a lodon raises 0.02€ to 0.04€
DonKmillo folds
hello7585 calls 0.02€
*** FLOP *** [Qs 8s Ad]
hello7585 checks
Meg a lodon bets 0.05€
hello7585 folds
Meg a lodon collected 0.13€ from pot
*** SUMMARY ***
Total pot 0.13€ | Rake 0.01€
Board: [Qs 8s Ad]
Seat 6: Meg a lodon (button) won 0.13€


Winamax Poker - HOLD-UP "Colorado" - HandId: #19116069-327648-1701432661 - Holdem no limit (0.01€/0.02€) - 2023/12/01 12:11:01 UTC
Table: 'Colorado' 6-max (real money) Seat #6 is the button
Seat 1: HiTxXx (4.81€)
Seat 2: Fried Berg (0.40€)
Seat 3: haouuum28 (2.15€)
Seat 4: Joan009 (2.02€)
Seat 5: bAd_b3At (0.42€)
Seat 6: David Boring (3.39€)
*** ANTE/BLINDS ***
HiTxXx posts small blind 0.01€
Fried Berg posts big blind 0.02€
Dealt to Fried Berg [Qc Ks]
*** PRE-FLOP *** 
haouuum28 folds
Joan009 folds
bAd_b3At raises 0.02€ to 0.04€
David Boring folds
HiTxXx folds
Fried Berg calls 0.02€
*** FLOP *** [4c As Th]
Fried Berg checks
bAd_b3At bets 0.05€
Fried Berg calls 0.05€
*** TURN *** [4c As Th][7d]
Fried Berg checks
bAd_b3At checks
*** RIVER *** [4c As Th 7d][4s]
Fried Berg checks
bAd_b3At checks
*** SHOW DOWN ***
Fried Berg shows [Qc Ks] (One pair : 4)
bAd_b3At shows [6d 6s] (Two pairs : 6 and 4)
bAd_b3At collected 0.17€ from pot
*** SUMMARY ***
Total pot 0.17€ | Rake 0.02€
Board: [4c As Th 7d 4s]
Seat 2: Fried Berg (big blind) showed [Qc Ks] and lost with One pair : 4
Seat 5: bAd_b3At showed [6d 6s] and won 0.17€ with Two pairs : 6 and 4


Winamax Poker - HOLD-UP "Colorado" - HandId: #19116069-327708-1701432703 - Holdem no limit (0.01€/0.02€) - 2023/12/01 12:11:43 UTC
Table: 'Colorado' 6-max (real money) Seat #6 is the button
Seat 1: Fried Berg (0.31€)
Seat 2: crush game (3.68€)
Seat 3: Kira17 (1.21€)
Seat 4: gostvision (2.25€)
Seat 5: Piiranha (2.18€)
Seat 6: bAd_b3At (0.50€)
*** ANTE/BLINDS ***
Fried Berg posts small blind 0.01€
crush game posts big blind 0.02€
Dealt to Fried Berg [Ah 6h]
*** PRE-FLOP *** 
Kira17 calls 0.02€
gostvision folds
Piiranha folds
bAd_b3At calls 0.02€
Fried Berg raises 0.02€ to 0.04€
crush game folds
Kira17 calls 0.02€
bAd_b3At folds
*** FLOP *** [3c 7d 9s]
Fried Berg checks
Kira17 checks
*** TURN *** [3c 7d 9s][5h]
Fried Berg checks
Kira17 bets 0.04€
Fried Berg calls 0.04€
*** RIVER *** [3c 7d 9s 5h][8s]
Fried Berg checks
Kira17 bets 0.07€
Fried Berg calls 0.07€
*** SHOW DOWN ***
Kira17 shows [Tc Td] (One pair : Tens)
Fried Berg shows [Ah 6h] (Straight 9 high)
Fried Berg collected 0.31€ from pot
*** SUMMARY ***
Total pot 0.31€ | Rake 0.03€
Board: [3c 7d 9s 5h 8s]
Seat 1: Fried Berg (small blind) showed [Ah 6h] and won 0.31€ with Straight 9 high
Seat 3: Kira17 showed [Tc Td] and lost with One pair : Tens


Winamax Poker - HOLD-UP "Colorado" - HandId: #19116069-327785-1701432752 - Holdem no limit (0.01€/0.02€) - 2023/12/01 12:12:32 UTC
Table: 'Colorado' 6-max (real money) Seat #6 is the button
Seat 1: Shang_li_hao (2.01€)
Seat 2: crush game (3.68€)
Seat 3: Fried Berg (0.47€)
Seat 4: caarloosgb (2.34€)
Seat 5: curiouz dje (4.17€)
Seat 6: dadou13100 (3.87€)
*** ANTE/BLINDS ***
Shang_li_hao posts small blind 0.01€
crush game posts big blind 0.02€
Dealt to Fried Berg [Ah 4d]
*** PRE-FLOP *** 
Fried Berg folds
caarloosgb calls 0.02€
curiouz dje folds
dadou13100 folds
Shang_li_hao folds
crush game checks
*** FLOP *** [3d 7s 9c]
crush game checks
caarloosgb bets 0.05€
crush game folds
caarloosgb collected 0.09€ from pot
*** SUMMARY ***
Total pot 0.09€ | Rake 0.01€
Board: [3d 7s 9c]
Seat 4: caarloosgb won 0.09€


Winamax Poker - HOLD-UP "Colorado" - HandId: #19116069-327806-1701432769 - Holdem no limit (0.01€/0.02€) - 2023/12/01 12:12:49 UTC
Table: 'Colorado' 6-max (real money) Seat #6 is the button
Seat 1: TaBrEaMoI (3.78€)
Seat 2: curiouz dje (4.16€)
Seat 3: Damspins (2.37€)
Seat 4: Fried Berg (0.47€)
Seat 5: papashark14 (2.01€)
Seat 6: PaitOn (2.29€)
*** ANTE/BLINDS ***
TaBrEaMoI posts small blind 0.01€
curiouz dje posts big blind 0.02€
Dealt to Fried Berg [4c Jh]
*** PRE-FLOP *** 
Damspins calls 0.02€
Fried Berg folds
papashark14 folds
PaitOn raises 0.04€ to 0.06€
TaBrEaMoI folds
curiouz dje folds
Damspins calls 0.04€
*** FLOP *** [3d 6s 8h]
Damspins checks
PaitOn bets 0.10€
Damspins folds
PaitOn collected 0.23€ from pot
*** SUMMARY ***
Total pot 0.23€ | Rake 0.02€
Board: [3d 6s 8h]
Seat 6: PaitOn (button) won 0.23€


Winamax Poker - HOLD-UP "Colorado" - HandId: #19116069-327812-1701432772 - Holdem no limit (0.01€/0.02€) - 2023/12/01 12:12:52 UTC
Table: 'Colorado' 6-max (real money) Seat #6 is the button
Seat 1: JFSredbaron (2.01€)
Seat 2: ABDELBEYADH (0.50€)
Seat 3: gostvision (2.28€)
Seat 4: Delpierrot10 (1.72€)
Seat 5: Upswing11 (3.03€)
Seat 6: Fried Berg (0.47€)
*** ANTE/BLINDS ***
JFSredbaron posts small blind 0.01€
ABDELBEYADH posts big blind 0.02€
Dealt to Fried Berg [Jd Qs]
*** PRE-FLOP *** 
gostvision folds
Delpierrot10 raises 0.03€ to 0.05€
Upswing11 calls 0.05€
Fried Berg calls 0.05€
JFSredbaron folds
ABDELBEYADH folds
*** FLOP *** [Kc 7d 8h]
Delpierrot10 bets 0.06€
Upswing11 calls 0.06€
Fried Berg folds
*** TURN *** [Kc 7d 8h][Qc]
Delpierrot10 checks
Upswing11 checks
*** RIVER *** [Kc 7d 8h Qc][5d]
Delpierrot10 bets 0.11€
Upswing11 folds
Delpierrot10 collected 0.38€ from pot
*** SUMMARY ***
Total pot 0.38€ | Rake 0.03€
Board: [Kc 7d 8h Qc 5d]
Seat 4: Delpierrot10 won 0.38€


Winamax Poker - HOLD-UP "Colorado" - HandId: #19116069-327864-1701432809 - Holdem no limit (0.01€/0.02€) - 2023/12/01 12:13:29 UTC
Table: 'Colorado' 6-max (real money) Seat #6 is the button
Seat 1: HiTxXx (2€)
Seat 2: Filet-O-fils (1.41€)
Seat 3: slowreplay (2€)
Seat 4: Fried Berg (0.42€)
Seat 5: hello7585 (1.75€)
Seat 6: AMBM2729 (1.20€)
*** ANTE/BLINDS ***
HiTxXx posts small blind 0.01€
Filet-O-fils posts big blind 0.02€
Dealt to Fried Berg [7d Th]
*** PRE-FLOP *** 
slowreplay folds
Fried Berg folds
hello7585 raises 0.05€ to 0.07€
AMBM2729 folds
HiTxXx folds
Filet-O-fils folds
hello7585 collected 0.10€ from pot
*** SUMMARY ***
Total pot 0.10€ | No rake
Seat 5: hello7585 won 0.10€


Winamax Poker - HOLD-UP "Colorado" - HandId: #19116069-327869-1701432813 - Holdem no limit (0.01€/0.02€) - 2023/12/01 12:13:33 UTC
Table: 'Colorado' 6-max (real money) Seat #6 is the button
Seat 1: PaitOn (2.37€)
Seat 2: Fried Berg (0.42€)
Seat 3: FenderTolra (2€)
Seat 4: Thor99 (2€)
Seat 5: slowreplay (2€)
Seat 6: Caropitchoun (8.03€)
*** ANTE/BLINDS ***
PaitOn posts small blind 0.01€
Fried Berg posts big blind 0.02€
Dealt to Fried Berg [8c 9s]
*** PRE-FLOP *** 
FenderTolra folds
Thor99 raises 0.03€ to 0.05€
slowreplay folds
Caropitchoun folds
PaitOn folds
Fried Berg folds
Thor99 collected 0.08€ from pot
*** SUMMARY ***
Total pot 0.08€ | No rake
Seat 4: Thor99 won 0.08€


Winamax Poker - HOLD-UP "Colorado" - HandId: #19116069-327883-1701432819 - Holdem no limit (0.01€/0.02€) - 2023/12/01 12:13:39 UTC
Table: 'Colorado' 6-max (real money) Seat #6 is the button
Seat 1: gagnejamais4 (2.01€)
Seat 2: Pffft... (6.46€)
Seat 3: Fried Berg (0.40€)
Seat 4: curiouz dje (2€)
Seat 5: Shang_li_hao (2€)
Seat 6: Filet-O-fils (1.39€)
*** ANTE/BLINDS ***
gagnejamais4 posts small blind 0.01€
Pffft... posts big blind 0.02€
Dealt to Fried Berg [5d 4s]
*** PRE-FLOP *** 
Fried Berg folds
curiouz dje folds
Shang_li_hao folds
Filet-O-fils raises 0.03€ to 0.05€
gagnejamais4 folds
Pffft... folds
Filet-O-fils collected 0.08€ from pot
*** SUMMARY ***
Total pot 0.08€ | No rake
Seat 6: Filet-O-fils (button) won 0.08€


Winamax Poker - HOLD-UP "Colorado" - HandId: #19116069-327890-1701432823 - Holdem no limit (0.01€/0.02€) - 2023/12/01 12:13:43 UTC
Table: 'Colorado' 6-max (real money) Seat #6 is the button
Seat 1: Fried Berg (0.40€)
Seat 2: papashark14 (2.01€)
Seat 3: HiTxXx (4.65€)
Seat 4: Tofini (2€)
Seat 5: Shang_li_hao (2€)
Seat 6: Hydramist (2.03€)
*** ANTE/BLINDS ***
Fried Berg posts small blind 0.01€
papashark14 posts big blind 0.02€
Dealt to Fried Berg [6h Kc]
*** PRE-FLOP *** 
HiTxXx folds
Tofini folds
Shang_li_hao folds
Hydramist folds
Fried Berg folds
papashark14 collected 0.03€ from pot
*** SUMMARY ***
Total pot 0.03€ | No rake
Seat 2: papashark14 (big blind) won 0.03€


Winamax Poker - HOLD-UP "Colorado" - HandId: #19116069-327894-1701432826 - Holdem no limit (0.01€/0.02€) - 2023/12/01 12:13:46 UTC
Table: 'Colorado' 6-max (real money) Seat #6 is the button
Seat 1: TheRealWill (4.95€)
Seat 2: gostvision (2.30€)
Seat 3: beatrix005 (2.15€)
Seat 4: haouuum28 (2.10€)
Seat 5: Fried Berg (0.39€)
Seat 6: Pffft... (6.44€)
*** ANTE/BLINDS ***
TheRealWill posts small blind 0.01€
gostvision posts big blind 0.02€
Dealt to Fried Berg [9h 7d]
*** PRE-FLOP *** 
beatrix005 folds
haouuum28 folds
Fried Berg folds
Pffft... raises 0.04€ to 0.06€
TheRealWill folds
gostvision folds
Pffft... collected 0.09€ from pot
*** SUMMARY ***
Total pot 0.09€ | No rake
Seat 6: Pffft... (button) won 0.09€


Winamax Poker - HOLD-UP "Colorado" - HandId: #19116069-327897-1701432828 - Holdem no limit (0.01€/0.02€) - 2023/12/01 12:13:48 UTC
Table: 'Colorado' 6-max (real money) Seat #6 is the button
Seat 1: Direct Oli (4.27€)
Seat 2: TaBrEaMoI (3.77€)
Seat 3: 77cece77 (1.38€)
Seat 4: diamantpoker (0.73€)
Seat 5: Fried Berg (0.39€)
Seat 6: Piiranha (2.28€)
*** ANTE/BLINDS ***
Direct Oli posts small blind 0.01€
TaBrEaMoI posts big blind 0.02€
Dealt to Fried Berg [Js Qc]
*** PRE-FLOP *** 
77cece77 folds
diamantpoker raises 0.02€ to 0.04€
Fried Berg calls 0.04€
Piiranha folds
Direct Oli folds
TaBrEaMoI calls 0.02€
*** FLOP *** [7c Kh 8h]
TaBrEaMoI bets 0.03€
diamantpoker calls 0.03€
Fried Berg calls 0.03€
*** TURN *** [7c Kh 8h][3h]
TaBrEaMoI checks
diamantpoker checks
Fried Berg checks
*** RIVER *** [7c Kh 8h 3h][6d]
TaBrEaMoI checks
diamantpoker checks
Fried Berg checks
*** SHOW DOWN ***
TaBrEaMoI shows [Tc Jc] (High card : King)
Fried Berg shows [Js Qc] (High card : King)
diamantpoker shows [6s 5s] (One pair : 6)
diamantpoker collected 0.20€ from pot
*** SUMMARY ***
Total pot 0.20€ | Rake 0.02€
Board: [7c Kh 8h 3h 6d]
Seat 2: TaBrEaMoI (big blind) showed [Tc Jc] and lost with High card : King
Seat 4: diamantpoker showed [6s 5s] and won 0.20€ with One pair : 6
Seat 5: Fried Berg showed [Js Qc] and lost with High card : King


Winamax Poker - HOLD-UP "Colorado" - HandId: #19116069-327945-1701432864 - Holdem no limit (0.01€/0.02€) - 2023/12/01 12:14:24 UTC
Table: 'Colorado' 6-max (real money) Seat #6 is the button
Seat 1: Marto69 (2.20€)
Seat 2: haouuum28 (3.74€)
Seat 3: Fried Berg (0.32€)
Seat 4: ABDELBEYADH (0.79€)
Seat 5: diamantpoker (0.86€)
Seat 6: Johnbedoin18 (9.22€)
*** ANTE/BLINDS ***
Marto69 posts small blind 0.01€
haouuum28 posts big blind 0.02€
Dealt to Fried Berg [5h 2d]
*** PRE-FLOP *** 
Fried Berg folds
ABDELBEYADH folds
diamantpoker raises 0.02€ to 0.04€
Johnbedoin18 folds
Marto69 raises 0.10€ to 0.14€
haouuum28 folds
diamantpoker folds
Marto69 collected 0.20€ from pot
*** SUMMARY ***
Total pot 0.20€ | No rake
Seat 1: Marto69 (small blind) won 0.20€


Winamax Poker - HOLD-UP "Colorado" - HandId: #19116069-327964-1701432874 - Holdem no limit (0.01€/0.02€) - 2023/12/01 12:14:34 UTC
Table: 'Colorado' 6-max (real money) Seat #6 is the button
Seat 1: TaBrEaMoI (4.51€)
Seat 2: Fried Berg (0.32€)
Seat 3: AMBM2729 (1.20€)
Seat 4: Blurran (1.25€)
Seat 5: David Boring (2.01€)
Seat 6: FenderTolra (2.31€)
*** ANTE/BLINDS ***
TaBrEaMoI posts small blind 0.01€
Fried Berg posts big blind 0.02€
Dealt to Fried Berg [9c Jh]
*** PRE-FLOP *** 
AMBM2729 folds
Blurran raises 0.02€ to 0.04€
David Boring folds
FenderTolra folds
TaBrEaMoI folds
Fried Berg folds
Blurran collected 0.07€ from pot
*** SUMMARY ***
Total pot 0.07€ | No rake
Seat 4: Blurran won 0.07€


Winamax Poker - HOLD-UP "Colorado" - HandId: #19116069-327979-1701432884 - Holdem no limit (0.01€/0.02€) - 2023/12/01 12:14:44 UTC
Table: 'Colorado' 6-max (real money) Seat #6 is the button
Seat 1: Fried Berg (0.30€)
Seat 2: David Boring (2.01€)
Seat 3: papashark14 (2.04€)
Seat 4: DonKmillo (8.35€)
Seat 5: Shang_li_hao (2.04€)
Seat 6: Hydramist (2.03€)
*** ANTE/BLINDS ***
Fried Berg posts small blind 0.01€
David Boring posts big blind 0.02€
Dealt to Fried Berg [8c 9d]
*** PRE-FLOP *** 
papashark14 folds
DonKmillo raises 0.04€ to 0.06€
Shang_li_hao folds
Hydramist folds
Fried Berg folds
David Boring calls 0.04€
*** FLOP *** [2h 4c 3h]
David Boring checks
DonKmillo checks
*** TURN *** [2h 4c 3h][8d]
David Boring checks
DonKmillo checks
*** RIVER *** [2h 4c 3h 8d][Qh]
David Boring checks
DonKmillo checks
*** SHOW DOWN ***
DonKmillo shows [Ks Ac] (High card : Ace)
David Boring shows [Qd Kc] (One pair : Queens)
David Boring collected 0.12€ from pot
*** SUMMARY ***
Total pot 0.12€ | Rake 0.01€
Board: [2h 4c 3h 8d Qh]
Seat 2: David Boring (big blind) showed [Qd Kc] and won 0.12€ with One pair : Queens
Seat 4: DonKmillo showed [Ks Ac] and lost with High card : Ace


Winamax Poker - HOLD-UP "Colorado" - HandId: #19116069-327988-1701432890 - Holdem no limit (0.01€/0.02€) - 2023/12/01 12:14:50 UTC
Table: 'Colorado' 6-max (real money) Seat #6 is the button
Seat 1: gostvision (2.37€)
Seat 2: Jojo-andros5 (0.63€)
Seat 3: CARDS_HURTS (1.75€)
Seat 4: Fried Berg (0.29€)
Seat 5: waakave (2.06€)
Seat 6: Hydramist (2€)
Hold-up to Pot: total 0.10€
*** ANTE/BLINDS ***
gostvision posts small blind 0.01€
Jojo-andros5 posts big blind 0.02€
Dealt to Fried Berg [Qh Ad]
*** PRE-FLOP *** 
CARDS_HURTS folds
Fried Berg raises 0.27€ to 0.29€ and is all-in
waakave calls 0.29€
Hydramist folds
gostvision folds
Jojo-andros5 folds
*** FLOP *** [Td 3h 7h]
*** TURN *** [Td 3h 7h][4d]
*** RIVER *** [Td 3h 7h 4d][2d]
*** SHOW DOWN ***
waakave shows [Kc Jc] (High card : King)
Fried Berg shows [Qh Ad] (High card : Ace)
Fried Berg collected 0.65€ from pot
*** SUMMARY ***
Total pot 0.65€ | Rake 0.06€
Board: [Td 3h 7h 4d 2d]
Seat 4: Fried Berg showed [Qh Ad] and won 0.65€ with High card : Ace
Seat 5: waakave showed [Kc Jc] and lost with High card : King


Winamax Poker - HOLD-UP "Colorado" - HandId: #19116069-328017-1701432909 - Holdem no limit (0.01€/0.02€) - 2023/12/01 12:15:09 UTC
Table: 'Colorado' 6-max (real money) Seat #6 is the button
Seat 1: Jojo-andros5 (0.61€)
Seat 2: Manupoy (2.24€)
Seat 3: Caropitchoun (4.51€)
Seat 4: gostvision (2.34€)
Seat 5: waakave (2€)
Seat 6: Fried Berg (0.65€)
*** ANTE/BLINDS ***
Jojo-andros5 posts small blind 0.01€
Manupoy posts big blind 0.02€
Dealt to Fried Berg [3s 7s]
*** PRE-FLOP *** 
Caropitchoun folds
gostvision folds
waakave raises 0.04€ to 0.06€
Fried Berg folds
Jojo-andros5 folds
Manupoy calls 0.04€
*** FLOP *** [2d Kd 9c]
Manupoy bets 0.02€
waakave calls 0.02€
*** TURN *** [2d Kd 9c][Jh]
Manupoy bets 0.06€
waakave calls 0.06€
*** RIVER *** [2d Kd 9c Jh][3d]
Manupoy checks
waakave checks
*** SHOW DOWN ***
waakave shows [Qh Ac] (High card : Ace)
Manupoy shows [Kh 9h] (Two pairs : Kings and 9)
Manupoy collected 0.26€ from pot
*** SUMMARY ***
Total pot 0.26€ | Rake 0.03€
Board: [2d Kd 9c Jh 3d]
Seat 2: Manupoy (big blind) showed [Kh 9h] and won 0.26€ with Two pairs : Kings and 9
Seat 5: waakave showed [Qh Ac] and lost with High card : Ace


Winamax Poker - HOLD-UP "Colorado" - HandId: #19116069-328038-1701432924 - Holdem no limit (0.01€/0.02€) - 2023/12/01 12:15:24 UTC
Table: 'Colorado' 6-max (real money) Seat #6 is the button
Seat 1: slowreplay (2.24€)
Seat 2: tobytom (2€)
Seat 3: KKamarAAde (2€)
Seat 4: AMBM2729 (1.39€)
Seat 5: Fried Berg (0.65€)
Seat 6: FrappeLourde (0.45€)
*** ANTE/BLINDS ***
slowreplay posts small blind 0.01€
tobytom posts big blind 0.02€
Dealt to Fried Berg [6s 9h]
*** PRE-FLOP *** 
KKamarAAde folds
AMBM2729 folds
Fried Berg folds
FrappeLourde folds
slowreplay folds
tobytom collected 0.03€ from pot
*** SUMMARY ***
Total pot 0.03€ | No rake
Seat 2: tobytom (big blind) won 0.03€


Winamax Poker - HOLD-UP "Colorado" - HandId: #19116069-328045-1701432929 - Holdem no limit (0.01€/0.02€) - 2023/12/01 12:15:29 UTC
Table: 'Colorado' 6-max (real money) Seat #6 is the button
Seat 1: Fried Berg (0.65€)
Seat 2: TaBrEaMoI (2.78€)
Seat 3: Ecstatic (2.10€)
Seat 4: ricki64 (1.40€)
Seat 5: Damspins (2.33€)
Seat 6: Tofini (2€)
*** ANTE/BLINDS ***
Fried Berg posts small blind 0.01€
TaBrEaMoI posts big blind 0.02€
Dealt to Fried Berg [4c Ks]
*** PRE-FLOP *** 
Ecstatic folds
ricki64 raises 0.08€ to 0.10€
Damspins folds
Tofini folds
Fried Berg folds
TaBrEaMoI folds
ricki64 collected 0.13€ from pot
*** SUMMARY ***
Total pot 0.13€ | No rake
Seat 4: ricki64 won 0.13€


Winamax Poker - HOLD-UP "Colorado" - HandId: #19116069-328048-1701432932 - Holdem no limit (0.01€/0.02€) - 2023/12/01 12:15:32 UTC
Table: 'Colorado' 6-max (real money) Seat #6 is the button
Seat 1: Justo_170382 (0.48€)
Seat 2: DGG23 (0.23€)
Seat 3: Fried Berg (0.64€)
Seat 4: Ecstatic (2.10€)
Seat 5: slowreplay (2.23€)
Seat 6: Tofini (2€)
*** ANTE/BLINDS ***
Justo_170382 posts small blind 0.01€
DGG23 posts big blind 0.02€
Dealt to Fried Berg [Ac 7d]
*** PRE-FLOP *** 
Fried Berg folds
Ecstatic folds
slowreplay folds
Tofini folds
Justo_170382 raises 0.04€ to 0.06€
DGG23 calls 0.04€
*** FLOP *** [Kh 8c 4h]
Justo_170382 bets 0.12€
DGG23 folds
Justo_170382 collected 0.23€ from pot
*** SUMMARY ***
Total pot 0.23€ | Rake 0.01€
Board: [Kh 8c 4h]
Seat 1: Justo_170382 (small blind) won 0.23€


Winamax Poker - HOLD-UP "Colorado" - HandId: #19116069-328055-1701432937 - Holdem no limit (0.01€/0.02€) - 2023/12/01 12:15:37 UTC
Table: 'Colorado' 6-max (real money) Seat #6 is the button
Seat 1: Bacardi34 (1.98€)
Seat 2: Tofini (2€)
Seat 3: AMBM2729 (1.39€)
Seat 4: Fried Berg (0.64€)
Seat 5: slowreplay (2€)
Seat 6: HiTxXx (4.63€)
*** ANTE/BLINDS ***
Bacardi34 posts small blind 0.01€
Tofini posts big blind 0.02€
Dealt to Fried Berg [Th 7c]
*** PRE-FLOP *** 
AMBM2729 folds
Fried Berg folds
slowreplay folds
HiTxXx raises 0.03€ to 0.05€
Bacardi34 folds
Tofini folds
HiTxXx collected 0.08€ from pot
*** SUMMARY ***
Total pot 0.08€ | No rake
Seat 6: HiTxXx (button) won 0.08€


Winamax Poker - HOLD-UP "Colorado" - HandId: #19116069-328059-1701432942 - Holdem no limit (0.01€/0.02€) - 2023/12/01 12:15:42 UTC
Table: 'Colorado' 6-max (real money) Seat #6 is the button
Seat 1: DonKmillo (8.32€)
Seat 2: Fried Berg (0.64€)
Seat 3: slowreplay (2€)
Seat 4: dadou13100 (3.74€)
Seat 5: AMBM2729 (1.39€)
Seat 6: ricki64 (1.43€)
Hold-up to Pot: total 0.10€
*** ANTE/BLINDS ***
DonKmillo posts small blind 0.01€
Fried Berg posts big blind 0.02€
Dealt to Fried Berg [Ac 6d]
*** PRE-FLOP *** 
slowreplay raises 0.04€ to 0.06€
dadou13100 folds
AMBM2729 folds
ricki64 calls 0.06€
DonKmillo folds
Fried Berg folds
*** FLOP *** [Tc 3s 3h]
slowreplay bets 0.13€
ricki64 raises 0.13€ to 0.26€
slowreplay calls 0.13€
*** TURN *** [Tc 3s 3h][4s]
slowreplay checks
ricki64 bets 0.77€
slowreplay raises 0.91€ to 1.68€ and is all-in
ricki64 calls 0.34€ and is all-in
*** RIVER *** [Tc 3s 3h 4s][Qd]
*** SHOW DOWN ***
slowreplay shows [8h 8c] (Two pairs : 8 and 3)
ricki64 shows [Th Jh] (Two pairs : Tens and 3)
ricki64 collected 2.70€ from main pot
slowreplay collected 0.57€ from side pot 1
*** SUMMARY ***
Total pot 3.27€ | Rake 0.29€
Board: [Tc 3s 3h 4s Qd]
Seat 3: slowreplay showed [8h 8c] and won 0.57€ with Two pairs : 8 and 3
Seat 6: ricki64 (button) showed [Th Jh] and won 2.70€ with Two pairs : Tens and 3


Winamax Poker - HOLD-UP "Colorado" - HandId: #19116069-328094-1701432963 - Holdem no limit (0.01€/0.02€) - 2023/12/01 12:16:03 UTC
Table: 'Colorado' 6-max (real money) Seat #6 is the button
Seat 1: DonKmillo (8.26€)
Seat 2: Jeje27 (1.92€)
Seat 3: Ecstatic (2.13€)
Seat 4: Upswing11 (6.07€)
Seat 5: Starbeckings (1€)
Seat 6: Fried Berg (0.62€)
*** ANTE/BLINDS ***
DonKmillo posts small blind 0.01€
Jeje27 posts big blind 0.02€
Dealt to Fried Berg [9d Jh]
*** PRE-FLOP *** 
Ecstatic folds
Upswing11 folds
Starbeckings raises 0.05€ to 0.07€
Fried Berg folds
DonKmillo folds
Jeje27 folds
Starbeckings collected 0.10€ from pot
*** SUMMARY ***
Total pot 0.10€ | No rake
Seat 5: Starbeckings won 0.10€


Winamax Poker - HOLD-UP "Colorado" - HandId: #19116069-328113-1701432973 - Holdem no limit (0.01€/0.02€) - 2023/12/01 12:16:13 UTC
Table: 'Colorado' 6-max (real money) Seat #6 is the button
Seat 1: Fanfan21260 (1.93€)
Seat 2: HiTxXx (2.02€)
Seat 3: g8o8k8u (2.25€)
Seat 4: Marto69 (2.09€)
Seat 5: Fried Berg (0.62€)
Seat 6: Mali 1969 (0.42€)
*** ANTE/BLINDS ***
Fanfan21260 posts small blind 0.01€
HiTxXx posts big blind 0.02€
Dealt to Fried Berg [9c 4d]
*** PRE-FLOP *** 
g8o8k8u folds
Marto69 folds
Fried Berg folds
Mali 1969 folds
Fanfan21260 folds
HiTxXx collected 0.03€ from pot
*** SUMMARY ***
Total pot 0.03€ | No rake
Seat 2: HiTxXx (big blind) won 0.03€


Winamax Poker - HOLD-UP "Colorado" - HandId: #19116069-328117-1701432975 - Holdem no limit (0.01€/0.02€) - 2023/12/01 12:16:15 UTC
Table: 'Colorado' 6-max (real money) Seat #6 is the button
Seat 1: Fried Berg (0.62€)
Seat 2: KKamarAAde (2€)
Seat 3: Justo_170382 (0.97€)
Seat 4: curiouz dje (2.21€)
Seat 5: Hydramist (2.04€)
Seat 6: AMBM2729 (1.20€)
*** ANTE/BLINDS ***
Fried Berg posts small blind 0.01€
KKamarAAde posts big blind 0.02€
Dealt to Fried Berg [9s Qc]
*** PRE-FLOP *** 
Justo_170382 raises 0.05€ to 0.07€
curiouz dje folds
Hydramist folds
AMBM2729 calls 0.07€
Fried Berg folds
KKamarAAde folds
*** FLOP *** [Jd 6h 8s]
Justo_170382 bets 0.17€
AMBM2729 folds
Justo_170382 collected 0.32€ from pot
*** SUMMARY ***
Total pot 0.32€ | Rake 0.02€
Board: [Jd 6h 8s]
Seat 3: Justo_170382 won 0.32€


Winamax Poker - HOLD-UP "Colorado" - HandId: #19116069-328130-1701432981 - Holdem no limit (0.01€/0.02€) - 2023/12/01 12:16:21 UTC
Table: 'Colorado' 6-max (real money) Seat #6 is the button
Seat 1: Hydramist (2.04€)
Seat 2: Thommynabo (2.63€)
Seat 3: didi5959 (0.39€)
Seat 4: Heming81 (1.86€)
Seat 5: Fried Berg (0.61€)
Seat 6: DGG23 (0.37€)
*** ANTE/BLINDS ***
Hydramist posts small blind 0.01€
Thommynabo posts big blind 0.02€
Dealt to Fried Berg [Ac 4c]
*** PRE-FLOP *** 
didi5959 folds
Heming81 folds
Fried Berg raises 0.10€ to 0.12€
DGG23 folds
Hydramist folds
Thommynabo folds
Fried Berg collected 0.15€ from pot
*** SUMMARY ***
Total pot 0.15€ | No rake
Seat 5: Fried Berg won 0.15€


Winamax Poker - HOLD-UP "Colorado" - HandId: #19116069-328162-1701433001 - Holdem no limit (0.01€/0.02€) - 2023/12/01 12:16:41 UTC
Table: 'Colorado' 6-max (real money) Seat #6 is the button
Seat 1: TaBrEaMoI (2.72€)
Seat 2: Fried Berg (0.64€)
Seat 3: Filet-O-fils (1.42€)
Seat 4: -Y4V- (2.35€)
Seat 5: AceLadouille (1.85€)
Seat 6: curiouz dje (2.55€)
*** ANTE/BLINDS ***
TaBrEaMoI posts small blind 0.01€
Fried Berg posts big blind 0.02€
Dealt to Fried Berg [8c As]
*** PRE-FLOP *** 
Filet-O-fils raises 0.03€ to 0.05€
-Y4V- folds
AceLadouille folds
curiouz dje folds
TaBrEaMoI folds
Fried Berg calls 0.03€
*** FLOP *** [4h 5d 6d]
Fried Berg checks
Filet-O-fils checks
*** TURN *** [4h 5d 6d][Ac]
Fried Berg checks
Filet-O-fils bets 0.07€
Fried Berg calls 0.07€
*** RIVER *** [4h 5d 6d Ac][9s]
Fried Berg checks
Filet-O-fils bets 0.16€
Fried Berg calls 0.16€
*** SHOW DOWN ***
Fried Berg shows [8c As] (One pair : Aces)
Filet-O-fils shows [Ah Jh] (One pair : Aces)
Filet-O-fils collected 0.51€ from pot
*** SUMMARY ***
Total pot 0.51€ | Rake 0.06€
Board: [4h 5d 6d Ac 9s]
Seat 2: Fried Berg (big blind) showed [8c As] and lost with One pair : Aces
Seat 3: Filet-O-fils showed [Ah Jh] and won 0.51€ with One pair : Aces


Winamax Poker - HOLD-UP "Colorado" - HandId: #19116069-328215-1701433036 - Holdem no limit (0.01€/0.02€) - 2023/12/01 12:17:16 UTC
Table: 'Colorado' 6-max (real money) Seat #6 is the button
Seat 1: Joan009 (2.05€)
Seat 2: -Y4V- (2.34€)
Seat 3: Fried Berg (0.36€)
Seat 4: Filet-O-fils (1.65€)
Seat 5: Blurran (0.90€)
Seat 6: LilRun (4.17€)
*** ANTE/BLINDS ***
Joan009 posts small blind 0.01€
-Y4V- posts big blind 0.02€
Dealt to Fried Berg [8h Js]
*** PRE-FLOP *** 
Fried Berg folds
Filet-O-fils folds
Blurran folds
LilRun raises 0.04€ to 0.06€
Joan009 calls 0.05€
-Y4V- folds
*** FLOP *** [8c Ad 7s]
Joan009 checks
LilRun bets 0.05€
Joan009 calls 0.05€
*** TURN *** [8c Ad 7s][Kd]
Joan009 checks
LilRun checks
*** RIVER *** [8c Ad 7s Kd][6s]
Joan009 bets 0.24€
LilRun folds
Joan009 collected 0.46€ from pot
*** SUMMARY ***
Total pot 0.46€ | Rake 0.02€
Board: [8c Ad 7s Kd 6s]
Seat 1: Joan009 (small blind) won 0.46€


Winamax Poker - HOLD-UP "Colorado" - HandId: #19116069-328238-1701433048 - Holdem no limit (0.01€/0.02€) - 2023/12/01 12:17:28 UTC
Table: 'Colorado' 6-max (real money) Seat #6 is the button
Seat 1: p4ppysl4m (2.26€)
Seat 2: David Boring (2.02€)
Seat 3: DonKmillo (8.23€)
Seat 4: Fried Berg (0.36€)
Seat 5: AMBM2729 (1.20€)
Seat 6: slowreplay (2€)
*** ANTE/BLINDS ***
p4ppysl4m posts small blind 0.01€
David Boring posts big blind 0.02€
Dealt to Fried Berg [5s 8d]
*** PRE-FLOP *** 
DonKmillo folds
Fried Berg folds
AMBM2729 folds
slowreplay folds
p4ppysl4m folds
David Boring collected 0.03€ from pot
*** SUMMARY ***
Total pot 0.03€ | No rake
Seat 2: David Boring (big blind) won 0.03€


Winamax Poker - HOLD-UP "Colorado" - HandId: #19116069-328248-1701433054 - Holdem no limit (0.01€/0.02€) - 2023/12/01 12:17:34 UTC
Table: 'Colorado' 6-max (real money) Seat #6 is the button
Seat 1: slowreplay (2€)
Seat 2: g8o8k8u (2.33€)
Seat 3: gostvision (2.87€)
Seat 4: Fried Berg (0.36€)
Seat 5: AMBM2729 (1.20€)
Seat 6: VM Condor908 (2.17€)
*** ANTE/BLINDS ***
slowreplay posts small blind 0.01€
g8o8k8u posts big blind 0.02€
Dealt to Fried Berg [6h 7c]
*** PRE-FLOP *** 
gostvision raises 0.03€ to 0.05€
Fried Berg folds
AMBM2729 folds
VM Condor908 calls 0.05€
slowreplay folds
g8o8k8u folds
*** FLOP *** [Td 2s 9s]
gostvision checks
VM Condor908 bets 0.13€
gostvision folds
VM Condor908 collected 0.25€ from pot
*** SUMMARY ***
Total pot 0.25€ | Rake 0.01€
Board: [Td 2s 9s]
Seat 6: VM Condor908 (button) won 0.25€


Winamax Poker - HOLD-UP "Colorado" - HandId: #19116069-328257-1701433058 - Holdem no limit (0.01€/0.02€) - 2023/12/01 12:17:38 UTC
Table: 'Colorado' 6-max (real money) Seat #6 is the button
Seat 1: Filet-O-fils (1.63€)
Seat 2: Fried Berg (0.36€)
Seat 3: taecm (2€)
Seat 4: Giucar (2.03€)
Seat 5: DIOSLOKI1 9 (0.53€)
Seat 6: DGG23 (0.35€)
*** ANTE/BLINDS ***
Filet-O-fils posts small blind 0.01€
Fried Berg posts big blind 0.02€
Dealt to Fried Berg [5s 5h]
*** PRE-FLOP *** 
taecm raises 0.05€ to 0.07€
Giucar folds
DIOSLOKI1 9 folds
DGG23 folds
Filet-O-fils folds
Fried Berg folds
taecm collected 0.10€ from pot
*** SUMMARY ***
Total pot 0.10€ | No rake
Seat 3: taecm won 0.10€


Winamax Poker - HOLD-UP "Colorado" - HandId: #19116069-328264-1701433062 - Holdem no limit (0.01€/0.02€) - 2023/12/01 12:17:42 UTC
Table: 'Colorado' 6-max (real money) Seat #6 is the button
Seat 1: Fried Berg (0.34€)
Seat 2: TheRealWill (3.02€)
Seat 3: Giucar (2.03€)
Seat 4: gregoritoooo (1.07€)
Seat 5: papashark14 (1.33€)
Seat 6: -Y4V- (2.32€)
*** ANTE/BLINDS ***
Fried Berg posts small blind 0.01€
TheRealWill posts big blind 0.02€
Dealt to Fried Berg [2c 5h]
*** PRE-FLOP *** 
Giucar raises 0.05€ to 0.07€
gregoritoooo calls 0.07€
papashark14 folds
-Y4V- folds
Fried Berg folds
TheRealWill folds
*** FLOP *** [5s 8s Ac]
Giucar bets 0.06€
gregoritoooo raises 0.06€ to 0.12€
Giucar calls 0.06€
*** TURN *** [5s 8s Ac][8c]
Giucar checks
gregoritoooo bets 0.27€
Giucar calls 0.27€
*** RIVER *** [5s 8s Ac 8c][6s]
Giucar checks
gregoritoooo bets 0.61€ and is all-in
Giucar folds
gregoritoooo collected 1.46€ from pot
*** SUMMARY ***
Total pot 1.46€ | Rake 0.10€
Board: [5s 8s Ac 8c 6s]
Seat 4: gregoritoooo won 1.46€


Winamax Poker - HOLD-UP "Colorado" - HandId: #19116069-328270-1701433065 - Holdem no limit (0.01€/0.02€) - 2023/12/01 12:17:45 UTC
Table: 'Colorado' 6-max (real money) Seat #6 is the button
Seat 1: KON-2-PEUTE (2.03€)
Seat 2: FenderTolra (2.02€)
Seat 3: Fried Berg (0.33€)
Seat 4: Sucre10 (1.84€)
Seat 5: Caindymion99 (2€)
Seat 6: Houarn (1.94€)
*** ANTE/BLINDS ***
KON-2-PEUTE posts small blind 0.01€
FenderTolra posts big blind 0.02€
Dealt to Fried Berg [Ad 2c]
*** PRE-FLOP *** 
Fried Berg folds
Sucre10 folds
Caindymion99 folds
Houarn folds
KON-2-PEUTE raises 0.03€ to 0.05€
FenderTolra calls 0.03€
*** FLOP *** [Qc 9d 5d]
KON-2-PEUTE checks
FenderTolra checks
*** TURN *** [Qc 9d 5d][Qs]
KON-2-PEUTE checks
FenderTolra checks
*** RIVER *** [Qc 9d 5d Qs][Qh]
KON-2-PEUTE checks
FenderTolra bets 0.04€
KON-2-PEUTE calls 0.04€
*** SHOW DOWN ***
KON-2-PEUTE shows [Jd Ah] (Trips of Queens)
FenderTolra shows [3h 3d] (Full of Queens and 3)
FenderTolra collected 0.16€ from pot
*** SUMMARY ***
Total pot 0.16€ | Rake 0.02€
Board: [Qc 9d 5d Qs Qh]
Seat 1: KON-2-PEUTE (small blind) showed [Jd Ah] and lost with Trips of Queens
Seat 2: FenderTolra (big blind) showed [3h 3d] and won 0.16€ with Full of Queens and 3


Winamax Poker - HOLD-UP "Colorado" - HandId: #19116069-328281-1701433072 - Holdem no limit (0.01€/0.02€) - 2023/12/01 12:17:52 UTC
Table: 'Colorado' 6-max (real money) Seat #6 is the button
Seat 1: AceLadouille (1.91€)
Seat 2: slowreplay (2€)
Seat 3: Rare-Mulot36 (0.16€)
Seat 4: KKamarAAde (2€)
Seat 5: Blurran (0.67€)
Seat 6: Fried Berg (0.33€)
Hold-up to Pot: total 0.20€
*** ANTE/BLINDS ***
AceLadouille posts small blind 0.01€
slowreplay posts big blind 0.02€
Dealt to Fried Berg [9s Jc]
*** PRE-FLOP *** 
Rare-Mulot36 raises 0.02€ to 0.04€
KKamarAAde folds
Blurran calls 0.04€
Fried Berg folds
AceLadouille calls 0.03€
slowreplay calls 0.02€
*** FLOP *** [4s 4c 6d]
AceLadouille bets 0.02€
slowreplay calls 0.02€
Rare-Mulot36 raises 0.02€ to 0.04€
Blurran folds
AceLadouille raises 0.14€ to 0.18€
slowreplay folds
Rare-Mulot36 calls 0.08€ and is all-in
*** TURN *** [4s 4c 6d][5d]
*** RIVER *** [4s 4c 6d 5d][7d]
*** SHOW DOWN ***
Rare-Mulot36 shows [As 9h] (One pair : 4)
AceLadouille shows [8c 7h] (Straight 8 high)
AceLadouille collected 0.64€ from pot
*** SUMMARY ***
Total pot 0.64€ | Rake 0.04€
Board: [4s 4c 6d 5d 7d]
Seat 1: AceLadouille (small blind) showed [8c 7h] and won 0.64€ with Straight 8 high
Seat 3: Rare-Mulot36 showed [As 9h] and lost with One pair : 4


Winamax Poker - HOLD-UP "Colorado" - HandId: #19116069-328288-1701433077 - Holdem no limit (0.01€/0.02€) - 2023/12/01 12:17:57 UTC
Table: 'Colorado' 6-max (real money) Seat #6 is the button
Seat 1: Upswing11 (6.13€)
Seat 2: Hydramist (2€)
Seat 3: curiouz dje (2.30€)
Seat 4: kamclo (2€)
Seat 5: Mali 1969 (0.53€)
Seat 6: Fried Berg (0.33€)
*** ANTE/BLINDS ***
Upswing11 posts small blind 0.01€
Hydramist posts big blind 0.02€
Dealt to Fried Berg [8c 3d]
*** PRE-FLOP *** 
curiouz dje folds
kamclo folds
Mali 1969 folds
Fried Berg folds
Upswing11 raises 0.04€ to 0.06€
Hydramist folds
Upswing11 collected 0.08€ from pot
*** SUMMARY ***
Total pot 0.08€ | No rake
Seat 1: Upswing11 (small blind) won 0.08€


Winamax Poker - HOLD-UP "Colorado" - HandId: #19116069-328294-1701433081 - Holdem no limit (0.01€/0.02€) - 2023/12/01 12:18:01 UTC
Table: 'Colorado' 6-max (real money) Seat #6 is the button
Seat 1: Tofini (2.12€)
Seat 2: Joan009 (2.07€)
Seat 3: DGG23 (0.31€)
Seat 4: LilRun (4.05€)
Seat 5: Fried Berg (0.33€)
Seat 6: curiouz dje (2.30€)
*** ANTE/BLINDS ***
Tofini posts small blind 0.01€
Joan009 posts big blind 0.02€
Dealt to Fried Berg [2s 2d]
*** PRE-FLOP *** 
DGG23 folds
LilRun folds
Fried Berg folds
curiouz dje folds
Tofini raises 0.03€ to 0.05€
Joan009 folds
Tofini collected 0.07€ from pot
*** SUMMARY ***
Total pot 0.07€ | No rake
Seat 1: Tofini (small blind) won 0.07€


Winamax Poker - HOLD-UP "Colorado" - HandId: #19116069-328298-1701433083 - Holdem no limit (0.01€/0.02€) - 2023/12/01 12:18:03 UTC
Table: 'Colorado' 6-max (real money) Seat #6 is the button
Seat 1: DigBick99 (2€)
Seat 2: papashark14 (1.88€)
Seat 3: Fried Berg (0.33€)
Seat 4: LilRun (4.05€)
Seat 5: curiouz dje (2.11€)
Seat 6: DGG23 (0.31€)
*** ANTE/BLINDS ***
DigBick99 posts small blind 0.01€
papashark14 posts big blind 0.02€
Dealt to Fried Berg [2c 9s]
*** PRE-FLOP *** 
Fried Berg folds
LilRun folds
curiouz dje folds
DGG23 folds
DigBick99 folds
papashark14 collected 0.03€ from pot
*** SUMMARY ***
Total pot 0.03€ | No rake
Seat 2: papashark14 (big blind) won 0.03€


Winamax Poker - HOLD-UP "Colorado" - HandId: #19116069-328301-1701433084 - Holdem no limit (0.01€/0.02€) - 2023/12/01 12:18:04 UTC
Table: 'Colorado' 6-max (real money) Seat #6 is the button
Seat 1: JFSredbaron (2.37€)
Seat 2: Fried Berg (0.33€)
Seat 3: curiouz dje (2.11€)
Seat 4: kamclo (2€)
Seat 5: DGG23 (0.31€)
Seat 6: dadou13100 (2.17€)
*** ANTE/BLINDS ***
JFSredbaron posts small blind 0.01€
Fried Berg posts big blind 0.02€
Dealt to Fried Berg [7h Kd]
*** PRE-FLOP *** 
curiouz dje folds
kamclo folds
DGG23 folds
dadou13100 folds
JFSredbaron raises 0.04€ to 0.06€
Fried Berg folds
JFSredbaron collected 0.08€ from pot
*** SUMMARY ***
Total pot 0.08€ | No rake
Seat 1: JFSredbaron (small blind) won 0.08€


Winamax Poker - HOLD-UP "Colorado" - HandId: #19116069-328370-1701433125 - Holdem no limit (0.01€/0.02€) - 2023/12/01 12:18:45 UTC
Table: 'Colorado' 6-max (real money) Seat #6 is the button
Seat 1: Fried Berg (0.31€)
Seat 2: Shang_li_hao (2.32€)
Seat 3: papashark14 (1.30€)
Seat 4: AMBM2729 (1.20€)
Seat 5: Giucar (1.17€)
Seat 6: DGG23 (0.34€)
*** ANTE/BLINDS ***
Fried Berg posts small blind 0.01€
Shang_li_hao posts big blind 0.02€
Dealt to Fried Berg [Jc Qd]
*** PRE-FLOP *** 
papashark14 raises 0.03€ to 0.05€
AMBM2729 folds
Giucar folds
DGG23 folds
Fried Berg calls 0.04€
Shang_li_hao folds
*** FLOP *** [7d 6h 4s]
Fried Berg bets 0.03€
papashark14 calls 0.03€
*** TURN *** [7d 6h 4s][2c]
Fried Berg checks
papashark14 checks
*** RIVER *** [7d 6h 4s 2c][Kh]
Fried Berg checks
papashark14 checks
*** SHOW DOWN ***
Fried Berg shows [Jc Qd] (High card : King)
papashark14 shows [Ah 4h] (One pair : 4)
papashark14 collected 0.16€ from pot
*** SUMMARY ***
Total pot 0.16€ | Rake 0.02€
Board: [7d 6h 4s 2c Kh]
Seat 1: Fried Berg (small blind) showed [Jc Qd] and lost with High card : King
Seat 3: papashark14 showed [Ah 4h] and won 0.16€ with One pair : 4


Winamax Poker - HOLD-UP "Colorado" - HandId: #19116069-328464-1701433178 - Holdem no limit (0.01€/0.02€) - 2023/12/01 12:19:38 UTC
Table: 'Colorado' 6-max (real money) Seat #6 is the button
Seat 1: curiouz dje (2.27€)
Seat 2: Joan009 (2.03€)
Seat 3: joli45600352 (3.15€)
Seat 4: Tounsi49 (0.99€)
Seat 5: Hydramist (2.24€)
Seat 6: Fried Berg (0.23€)
*** ANTE/BLINDS ***
curiouz dje posts small blind 0.01€
Joan009 posts big blind 0.02€
Dealt to Fried Berg [Qs 4d]
*** PRE-FLOP *** 
joli45600352 folds
Tounsi49 calls 0.02€
Hydramist folds
Fried Berg folds
curiouz dje folds
Joan009 checks
*** FLOP *** [5h As 3h]
Joan009 checks
Tounsi49 checks
*** TURN *** [5h As 3h][4h]
Joan009 checks
Tounsi49 checks
*** RIVER *** [5h As 3h 4h][Ad]
Joan009 checks
Tounsi49 checks
*** SHOW DOWN ***
Tounsi49 shows [Kd 8c] (One pair : Aces)
Joan009 shows [9s 4c] (Two pairs : Aces and 4)
Joan009 collected 0.04€ from pot
*** SUMMARY ***
Total pot 0.04€ | Rake 0.01€
Board: [5h As 3h 4h Ad]
Seat 2: Joan009 (big blind) showed [9s 4c] and won 0.04€ with Two pairs : Aces and 4
Seat 4: Tounsi49 showed [Kd 8c] and lost with One pair : Aces


Winamax Poker - HOLD-UP "Colorado" - HandId: #19116069-328475-1701433184 - Holdem no limit (0.01€/0.02€) - 2023/12/01 12:19:44 UTC
Table: 'Colorado' 6-max (real money) Seat #6 is the button
Seat 1: slowreplay (3.41€)
Seat 2: Hydramist (2.24€)
Seat 3: Filet-O-fils (1.37€)
Seat 4: Houarn (1.96€)
Seat 5: Tofini (2.46€)
Seat 6: Fried Berg (0.23€)
*** ANTE/BLINDS ***
slowreplay posts small blind 0.01€
Hydramist posts big blind 0.02€
Dealt to Fried Berg [Qd 8h]
*** PRE-FLOP *** 
Filet-O-fils folds
Houarn folds
Tofini folds
Fried Berg folds
slowreplay folds
Hydramist collected 0.03€ from pot
*** SUMMARY ***
Total pot 0.03€ | No rake
Seat 2: Hydramist (big blind) won 0.03€


Winamax Poker - HOLD-UP "Colorado" - HandId: #19116069-328482-1701433189 - Holdem no limit (0.01€/0.02€) - 2023/12/01 12:19:49 UTC
Table: 'Colorado' 6-max (real money) Seat #6 is the button
Seat 1: curiouz dje (2.23€)
Seat 2: abitbolG (2€)
Seat 3: HiTxXx (4.34€)
Seat 4: Fried Berg (0.23€)
Seat 5: Filet-O-fils (1.36€)
Seat 6: Houarn (1.96€)
*** ANTE/BLINDS ***
curiouz dje posts small blind 0.01€
abitbolG posts big blind 0.02€
Dealt to Fried Berg [Ad 9s]
*** PRE-FLOP *** 
HiTxXx raises 0.03€ to 0.05€
Fried Berg calls 0.05€
Filet-O-fils calls 0.05€
Houarn folds
curiouz dje calls 0.04€
abitbolG calls 0.03€
*** FLOP *** [Tc 2s Qd]
curiouz dje checks
abitbolG checks
HiTxXx bets 0.09€
Fried Berg calls 0.09€
Filet-O-fils calls 0.09€
curiouz dje folds
abitbolG folds
*** TURN *** [Tc 2s Qd][9h]
HiTxXx bets 0.12€
Fried Berg calls 0.09€ and is all-in
Filet-O-fils calls 0.12€
*** RIVER *** [Tc 2s Qd 9h][8s]
HiTxXx checks
Filet-O-fils checks
*** SHOW DOWN ***
HiTxXx shows [Kh Qc] (One pair : Queens)
Fried Berg shows [Ad 9s] (One pair : 9)
Filet-O-fils shows [Ts Qs] (Two pairs : Queens and Tens)
Filet-O-fils collected 0.76€ from pot
*** SUMMARY ***
Total pot 0.76€ | Rake 0.09€
Board: [Tc 2s Qd 9h 8s]
Seat 3: HiTxXx showed [Kh Qc] and lost with One pair : Queens
Seat 4: Fried Berg showed [Ad 9s] and lost with One pair : 9
Seat 5: Filet-O-fils showed [Ts Qs] and won 0.76€ with Two pairs : Queens and Tens


Winamax Poker - HOLD-UP "Colorado" - HandId: #19116069-328563-1701433246 - Holdem no limit (0.01€/0.02€) - 2023/12/01 12:20:46 UTC
Table: 'Colorado' 6-max (real money) Seat #6 is the button
Seat 1: -Y4V- (2.30€)
Seat 2: Fried Berg (0.50€)
Seat 3: Piiranha (2.22€)
Seat 4: momoiheb (0.51€)
Seat 5: Filet-O-fils (1.86€)
Seat 6: KON-2-PEUTE (2.09€)
*** ANTE/BLINDS ***
-Y4V- posts small blind 0.01€
Fried Berg posts big blind 0.02€
Dealt to Fried Berg [7s 4d]
*** PRE-FLOP *** 
Piiranha folds
momoiheb folds
Filet-O-fils folds
KON-2-PEUTE folds
-Y4V- folds
Fried Berg collected 0.03€ from pot
*** SUMMARY ***
Total pot 0.03€ | No rake
Seat 2: Fried Berg (big blind) won 0.03€


Winamax Poker - HOLD-UP "Colorado" - HandId: #19116069-328575-1701433255 - Holdem no limit (0.01€/0.02€) - 2023/12/01 12:20:55 UTC
Table: 'Colorado' 6-max (real money) Seat #6 is the button
Seat 1: Marto69 (2€)
Seat 2: Shang_li_hao (2.26€)
Seat 3: Thor99 (2.73€)
Seat 4: Fried Berg (0.51€)
Seat 5: David Boring (2.92€)
Seat 6: crush game (5.99€)
*** ANTE/BLINDS ***
Marto69 posts small blind 0.01€
Shang_li_hao posts big blind 0.02€
Dealt to Fried Berg [Ah Js]
*** PRE-FLOP *** 
Thor99 folds
Fried Berg raises 0.02€ to 0.04€
David Boring folds
crush game folds
Marto69 folds
Shang_li_hao folds
Fried Berg collected 0.07€ from pot
*** SUMMARY ***
Total pot 0.07€ | No rake
Seat 4: Fried Berg won 0.07€


Winamax Poker - HOLD-UP "Colorado" - HandId: #19116069-328589-1701433266 - Holdem no limit (0.01€/0.02€) - 2023/12/01 12:21:06 UTC
Table: 'Colorado' 6-max (real money) Seat #6 is the button
Seat 1: Fried Berg (0.54€)
Seat 2: FenderTolra (2.14€)
Seat 3: DigBick99 (2€)
Seat 4: JFSredbaron (2€)
Seat 5: Caindymion99 (2.40€)
Seat 6: AMORFOU (3.60€)
*** ANTE/BLINDS ***
Fried Berg posts small blind 0.01€
FenderTolra posts big blind 0.02€
Dealt to Fried Berg [7h 7c]
*** PRE-FLOP *** 
DigBick99 folds
JFSredbaron folds
Caindymion99 folds
AMORFOU raises 0.03€ to 0.05€
Fried Berg raises 0.10€ to 0.15€
FenderTolra folds
AMORFOU folds
Fried Berg collected 0.22€ from pot
*** SUMMARY ***
Total pot 0.22€ | No rake
Seat 1: Fried Berg (small blind) won 0.22€


Winamax Poker - HOLD-UP "Colorado" - HandId: #19116069-328628-1701433292 - Holdem no limit (0.01€/0.02€) - 2023/12/01 12:21:32 UTC
Table: 'Colorado' 6-max (real money) Seat #6 is the button
Seat 1: waakave (2.32€)
Seat 2: MVital23 (0.50€)
Seat 3: x spoony (2.02€)
Seat 4: Baston57 (2.20€)
Seat 5: Fried Berg (0.61€)
Seat 6: AMBM2729 (1.20€)
*** ANTE/BLINDS ***
waakave posts small blind 0.01€
MVital23 posts big blind 0.02€
Dealt to Fried Berg [9s Kc]
*** PRE-FLOP *** 
x spoony folds
Baston57 calls 0.02€
Fried Berg raises 0.02€ to 0.04€
AMBM2729 raises 0.08€ to 0.12€
waakave folds
MVital23 folds
Baston57 calls 0.10€
Fried Berg folds
*** FLOP *** [5s Jc 7h]
Baston57 checks
AMBM2729 bets 0.11€
Baston57 folds
AMBM2729 collected 0.39€ from pot
*** SUMMARY ***
Total pot 0.39€ | Rake 0.03€
Board: [5s Jc 7h]
Seat 6: AMBM2729 (button) won 0.39€


Winamax Poker - HOLD-UP "Colorado" - HandId: #19116069-328699-1701433341 - Holdem no limit (0.01€/0.02€) - 2023/12/01 12:22:21 UTC
Table: 'Colorado' 6-max (real money) Seat #6 is the button
Seat 1: - ONZE - (2€)
Seat 2: Eytrewq (2€)
Seat 3: Fried Berg (0.57€)
Seat 4: x spoony (2€)
Seat 5: DGG23 (0.50€)
Seat 6: waakave (2.58€)
*** ANTE/BLINDS ***
- ONZE - posts small blind 0.01€
Eytrewq posts big blind 0.02€
Dealt to Fried Berg [3s 8c]
*** PRE-FLOP *** 
Fried Berg folds
x spoony folds
DGG23 folds
waakave raises 0.03€ to 0.05€
- ONZE - folds
Eytrewq calls 0.03€
*** FLOP *** [6h 3h Ts]
Eytrewq checks
waakave bets 0.04€
Eytrewq folds
waakave collected 0.14€ from pot
*** SUMMARY ***
Total pot 0.14€ | Rake 0.01€
Board: [6h 3h Ts]
Seat 6: waakave (button) won 0.14€


Winamax Poker - HOLD-UP "Colorado" - HandId: #19116069-328704-1701433343 - Holdem no limit (0.01€/0.02€) - 2023/12/01 12:22:23 UTC
Table: 'Colorado' 6-max (real money) Seat #6 is the button
Seat 1: Remi-Le-G (2.01€)
Seat 2: taramango (1.77€)
Seat 3: Direct Oli (4.36€)
Seat 4: HiTxXx (2.14€)
Seat 5: Marto69 (2.41€)
Seat 6: Fried Berg (0.57€)
*** ANTE/BLINDS ***
Remi-Le-G posts small blind 0.01€
taramango posts big blind 0.02€
Dealt to Fried Berg [5c 3h]
*** PRE-FLOP *** 
Direct Oli folds
HiTxXx folds
Marto69 folds
Fried Berg folds
Remi-Le-G calls 0.01€
taramango checks
*** FLOP *** [Kc 4s Td]
Remi-Le-G checks
taramango checks
*** TURN *** [Kc 4s Td][2h]
Remi-Le-G bets 0.02€
taramango calls 0.02€
*** RIVER *** [Kc 4s Td 2h][Ks]
Remi-Le-G bets 0.05€
taramango folds
Remi-Le-G collected 0.12€ from pot
*** SUMMARY ***
Total pot 0.12€ | Rake 0.01€
Board: [Kc 4s Td 2h Ks]
Seat 1: Remi-Le-G (small blind) won 0.12€


Winamax Poker - HOLD-UP "Colorado" - HandId: #19116069-328712-1701433347 - Holdem no limit (0.01€/0.02€) - 2023/12/01 12:22:27 UTC
Table: 'Colorado' 6-max (real money) Seat #6 is the button
Seat 1: HiTxXx (2.14€)
Seat 2: x spoony (2.02€)
Seat 3: DigBick99 (2€)
Seat 4: macfishstyle (2.89€)
Seat 5: Hydramist (2.04€)
Seat 6: Fried Berg (0.57€)
*** ANTE/BLINDS ***
HiTxXx posts small blind 0.01€
x spoony posts big blind 0.02€
Dealt to Fried Berg [2d 9s]
*** PRE-FLOP *** 
DigBick99 raises 0.04€ to 0.06€
macfishstyle folds
Hydramist folds
Fried Berg folds
HiTxXx folds
x spoony folds
DigBick99 collected 0.09€ from pot
*** SUMMARY ***
Total pot 0.09€ | No rake
Seat 3: DigBick99 won 0.09€


Winamax Poker - HOLD-UP "Colorado" - HandId: #19116069-328717-1701433351 - Holdem no limit (0.01€/0.02€) - 2023/12/01 12:22:31 UTC
Table: 'Colorado' 6-max (real money) Seat #6 is the button
Seat 1: HiTxXx (2.13€)
Seat 2: Fried Berg (0.57€)
Seat 3: taecm (1.72€)
Seat 4: Hydramist (2.04€)
Seat 5: DGG23 (0.13€)
Seat 6: Marto69 (2.40€)
*** ANTE/BLINDS ***
HiTxXx posts small blind 0.01€
Fried Berg posts big blind 0.02€
Dealt to Fried Berg [Qh Th]
*** PRE-FLOP *** 
taecm folds
Hydramist folds
DGG23 calls 0.02€
Marto69 raises 0.08€ to 0.10€
HiTxXx folds
Fried Berg calls 0.08€
DGG23 raises 0.03€ to 0.13€ and is all-in
Marto69 calls 0.03€
Fried Berg calls 0.03€
*** FLOP *** [7d 4c Ac]
Fried Berg checks
Marto69 checks
*** TURN *** [7d 4c Ac][9c]
Fried Berg checks
Marto69 checks
*** RIVER *** [7d 4c Ac 9c][4d]
Fried Berg checks
Marto69 checks
*** SHOW DOWN ***
Fried Berg shows [Qh Th] (One pair : 4)
Marto69 shows [Js Ks] (One pair : 4)
DGG23 shows [Ah 7h] (Two pairs : Aces and 7)
DGG23 collected 0.36€ from pot
*** SUMMARY ***
Total pot 0.36€ | Rake 0.04€
Board: [7d 4c Ac 9c 4d]
Seat 2: Fried Berg (big blind) showed [Qh Th] and lost with One pair : 4
Seat 5: DGG23 showed [Ah 7h] and won 0.36€ with Two pairs : Aces and 7
Seat 6: Marto69 (button) showed [Js Ks] and lost with One pair : 4


Winamax Poker - HOLD-UP "Colorado" - HandId: #19116069-328781-1701433391 - Holdem no limit (0.01€/0.02€) - 2023/12/01 12:23:11 UTC
Table: 'Colorado' 6-max (real money) Seat #6 is the button
Seat 1: Manupoy (2.14€)
Seat 2: Caindymion99 (2.19€)
Seat 3: kamclo (2.03€)
Seat 4: Fried Berg (0.44€)
Seat 5: Hydramist (2€)
Seat 6: gostvision (2€)
*** ANTE/BLINDS ***
Manupoy posts small blind 0.01€
Caindymion99 posts big blind 0.02€
Dealt to Fried Berg [Ts Th]
*** PRE-FLOP *** 
kamclo folds
Fried Berg raises 0.04€ to 0.06€
Hydramist folds
gostvision calls 0.06€
Manupoy calls 0.05€
Caindymion99 folds
*** FLOP *** [8c 5d 5h]
Manupoy bets 0.02€
Fried Berg calls 0.02€
gostvision calls 0.02€
*** TURN *** [8c 5d 5h][Td]
Manupoy bets 0.02€
Fried Berg calls 0.02€
gostvision raises 0.02€ to 0.04€
Manupoy calls 0.02€
Fried Berg raises 0.02€ to 0.06€
gostvision raises 0.02€ to 0.08€
Manupoy folds
Fried Berg raises 0.02€ to 0.10€
gostvision raises 0.02€ to 0.12€
Fried Berg raises 0.02€ to 0.14€
gostvision raises 0.02€ to 0.16€
Fried Berg raises 0.02€ to 0.18€
gostvision raises 0.02€ to 0.20€
Fried Berg raises 0.02€ to 0.22€
gostvision raises 0.02€ to 0.24€
Fried Berg raises 0.02€ to 0.26€
gostvision raises 0.02€ to 0.28€
Fried Berg raises 0.02€ to 0.30€
gostvision raises 0.02€ to 0.32€
Fried Berg raises 0.02€ to 0.34€
gostvision raises 0.02€ to 0.36€
Fried Berg calls 0.02€ and is all-in
*** RIVER *** [8c 5d 5h Td][8s]
*** SHOW DOWN ***
Fried Berg shows [Ts Th] (Full of Tens and 8)
gostvision shows [8d 8h] (Quads of 8)
gostvision collected 0.92€ from pot
*** SUMMARY ***
Total pot 0.92€ | Rake 0.10€
Board: [8c 5d 5h Td 8s]
Seat 4: Fried Berg showed [Ts Th] and lost with Full of Tens and 8
Seat 6: gostvision (button) showed [8d 8h] and won 0.92€ with Quads of 8


Winamax Poker - HOLD-UP "Colorado" - HandId: #19116069-328981-1701433537 - Holdem no limit (0.01€/0.02€) - 2023/12/01 12:25:37 UTC
Table: 'Colorado' 6-max (real money) Seat #6 is the button
Seat 1: Fried Berg (0.50€)
Seat 2: Rodriguee (3.97€)
Seat 3: g8o8k8u (2.04€)
Seat 4: Manupoy (2.13€)
Seat 5: Noraaaj (0.90€)
Seat 6: elamri07 (1.05€)
*** ANTE/BLINDS ***
Fried Berg posts small blind 0.01€
Rodriguee posts big blind 0.02€
Dealt to Fried Berg [2d 7c]
*** PRE-FLOP *** 
g8o8k8u folds
Manupoy calls 0.02€
Noraaaj folds
elamri07 folds
Fried Berg folds
Rodriguee checks
*** FLOP *** [4s 2c Ah]
Rodriguee checks
Manupoy bets 0.05€
Rodriguee folds
Manupoy collected 0.09€ from pot
*** SUMMARY ***
Total pot 0.09€ | Rake 0.01€
Board: [4s 2c Ah]
Seat 4: Manupoy won 0.09€


Winamax Poker - HOLD-UP "Colorado" - HandId: #19116069-328993-1701433545 - Holdem no limit (0.01€/0.02€) - 2023/12/01 12:25:45 UTC
Table: 'Colorado' 6-max (real money) Seat #6 is the button
Seat 1: x spoony (2€)
Seat 2: gostvision (3.09€)
Seat 3: Fried Berg (0.49€)
Seat 4: FenderTolra (2.09€)
Seat 5: DGG23 (0.43€)
Seat 6: Tofini (2.03€)
*** ANTE/BLINDS ***
x spoony posts small blind 0.01€
gostvision posts big blind 0.02€
Dealt to Fried Berg [Ad Jd]
*** PRE-FLOP *** 
Fried Berg raises 0.04€ to 0.06€
FenderTolra folds
DGG23 folds
Tofini folds
x spoony calls 0.05€
gostvision folds
*** FLOP *** [5h 3d Jc]
x spoony checks
Fried Berg bets 0.04€
x spoony folds
Fried Berg collected 0.17€ from pot
*** SUMMARY ***
Total pot 0.17€ | Rake 0.01€
Board: [5h 3d Jc]
Seat 3: Fried Berg won 0.17€


Winamax Poker - HOLD-UP "Colorado" - HandId: #19116069-329040-1701433578 - Holdem no limit (0.01€/0.02€) - 2023/12/01 12:26:18 UTC
Table: 'Colorado' 6-max (real money) Seat #6 is the button
Seat 1: lut1dupoivre (0.53€)
Seat 2: bastos2525 (2€)
Seat 3: Charlise2 (1.91€)
Seat 4: g8o8k8u (2.18€)
Seat 5: Fried Berg (0.56€)
Seat 6: curiouz dje (3.79€)
*** ANTE/BLINDS ***
lut1dupoivre posts small blind 0.01€
bastos2525 posts big blind 0.02€
Dealt to Fried Berg [3h 9c]
*** PRE-FLOP *** 
Charlise2 folds
g8o8k8u folds
Fried Berg folds
curiouz dje raises 0.03€ to 0.05€
lut1dupoivre folds
bastos2525 folds
curiouz dje collected 0.08€ from pot
*** SUMMARY ***
Total pot 0.08€ | No rake
Seat 6: curiouz dje (button) won 0.08€


Winamax Poker - HOLD-UP "Colorado" - HandId: #19116069-329048-1701433583 - Holdem no limit (0.01€/0.02€) - 2023/12/01 12:26:23 UTC
Table: 'Colorado' 6-max (real money) Seat #6 is the button
Seat 1: Mizoun (2.50€)
Seat 2: Fried Berg (0.56€)
Seat 3: Obiwan70 (2.45€)
Seat 4: Tofini (2.13€)
Seat 5: AMBM2729 (2.16€)
Seat 6: KON-2-PEUTE (2.05€)
*** ANTE/BLINDS ***
Mizoun posts small blind 0.01€
Fried Berg posts big blind 0.02€
Dealt to Fried Berg [4h 4d]
*** PRE-FLOP *** 
Obiwan70 folds
Tofini raises 0.02€ to 0.04€
AMBM2729 folds
KON-2-PEUTE folds
Mizoun raises 0.12€ to 0.16€
Fried Berg folds
Tofini folds
Mizoun collected 0.22€ from pot
*** SUMMARY ***
Total pot 0.22€ | No rake
Seat 1: Mizoun (small blind) won 0.22€


Winamax Poker - HOLD-UP "Colorado" - HandId: #19116069-329067-1701433600 - Holdem no limit (0.01€/0.02€) - 2023/12/01 12:26:40 UTC
Table: 'Colorado' 6-max (real money) Seat #6 is the button
Seat 1: Charlise2 (1.89€)
Seat 2: DGG23 (0.35€)
Seat 3: Upswing11 (5.95€)
Seat 4: KKamarAAde (3.32€)
Seat 5: Fried Berg (0.54€)
Seat 6: Houarn (0.29€)
*** ANTE/BLINDS ***
Charlise2 posts small blind 0.01€
DGG23 posts big blind 0.02€
Dealt to Fried Berg [2d Jc]
*** PRE-FLOP *** 
Upswing11 folds
KKamarAAde folds
Fried Berg folds
Houarn folds
Charlise2 folds
DGG23 collected 0.03€ from pot
*** SUMMARY ***
Total pot 0.03€ | No rake
Seat 2: DGG23 (big blind) won 0.03€


Winamax Poker - HOLD-UP "Colorado" - HandId: #19116069-329074-1701433607 - Holdem no limit (0.01€/0.02€) - 2023/12/01 12:26:47 UTC
Table: 'Colorado' 6-max (real money) Seat #6 is the button
Seat 1: DIOSLOKI1 9 (1.75€)
Seat 2: Tofini (2.09€)
Seat 3: wmx-kmgw88p (1.34€)
Seat 4: Fried Berg (0.54€)
Seat 5: Thommynabo (2.58€)
Seat 6: TheRealWill (2.04€)
*** ANTE/BLINDS ***
DIOSLOKI1 9 posts small blind 0.01€
Tofini posts big blind 0.02€
Dealt to Fried Berg [4c 9c]
*** PRE-FLOP *** 
wmx-kmgw88p folds
Fried Berg folds
Thommynabo folds
TheRealWill raises 0.04€ to 0.06€
DIOSLOKI1 9 folds
Tofini folds
TheRealWill collected 0.09€ from pot
*** SUMMARY ***
Total pot 0.09€ | No rake
Seat 6: TheRealWill (button) won 0.09€


Winamax Poker - HOLD-UP "Colorado" - HandId: #19116069-329084-1701433613 - Holdem no limit (0.01€/0.02€) - 2023/12/01 12:26:53 UTC
Table: 'Colorado' 6-max (real money) Seat #6 is the button
Seat 1: 1LEOPARDO (2.13€)
Seat 2: Fanfan21260 (2.23€)
Seat 3: Fried Berg (0.54€)
Seat 4: Blurran (1.29€)
Seat 5: Jeje27 (1.75€)
Seat 6: curiouz dje (2.01€)
*** ANTE/BLINDS ***
1LEOPARDO posts small blind 0.01€
Fanfan21260 posts big blind 0.02€
Dealt to Fried Berg [Qs Kc]
*** PRE-FLOP *** 
Fried Berg raises 0.04€ to 0.06€
Blurran folds
Jeje27 folds
curiouz dje folds
1LEOPARDO raises 2.07€ to 2.13€ and is all-in
Fanfan21260 folds
Fried Berg calls 0.48€ and is all-in
*** FLOP *** [2c 4s Kh]
*** TURN *** [2c 4s Kh][8c]
*** RIVER *** [2c 4s Kh 8c][4c]
*** SHOW DOWN ***
1LEOPARDO shows [5h 5d] (Two pairs : 5 and 4)
Fried Berg shows [Qs Kc] (Two pairs : Kings and 4)
Fried Berg collected 0.99€ from main pot
1LEOPARDO collected 1.59€ from side pot 1
*** SUMMARY ***
Total pot 2.58€ | Rake 0.11€
Board: [2c 4s Kh 8c 4c]
Seat 1: 1LEOPARDO (small blind) showed [5h 5d] and won 1.59€ with Two pairs : 5 and 4
Seat 3: Fried Berg showed [Qs Kc] and won 0.99€ with Two pairs : Kings and 4


Winamax Poker - HOLD-UP "Colorado" - HandId: #19116069-329238-1701433723 - Holdem no limit (0.01€/0.02€) - 2023/12/01 12:28:43 UTC
Table: 'Colorado' 6-max (real money) Seat #6 is the button
Seat 1: Fried Berg (0.99€)
Seat 2: Thor99 (3.33€)
Seat 3: FenderTolra (5.15€)
Seat 4: momoiheb (0.53€)
Seat 5: 1LEOPARDO (1.59€)
Seat 6: Caropitchoun (2.44€)
*** ANTE/BLINDS ***
Fried Berg posts small blind 0.01€
Thor99 posts big blind 0.02€
Dealt to Fried Berg [Kc Ts]
*** PRE-FLOP *** 
FenderTolra folds
momoiheb folds
1LEOPARDO raises 0.05€ to 0.07€
Caropitchoun folds
Fried Berg calls 0.06€
Thor99 folds
*** FLOP *** [9h 9d 8s]
Fried Berg checks
1LEOPARDO bets 0.06€
Fried Berg folds
1LEOPARDO collected 0.20€ from pot
*** SUMMARY ***
Total pot 0.20€ | Rake 0.02€
Board: [9h 9d 8s]
Seat 5: 1LEOPARDO won 0.20€


Winamax Poker - HOLD-UP "Colorado" - HandId: #19116069-329305-1701433771 - Holdem no limit (0.01€/0.02€) - 2023/12/01 12:29:31 UTC
Table: 'Colorado' 6-max (real money) Seat #6 is the button
Seat 1: FenderTolra (2.13€)
Seat 2: KON-2-PEUTE (2.44€)
Seat 3: Caropitchoun (2.17€)
Seat 4: taramango (1.99€)
Seat 5: papashark14 (1.94€)
Seat 6: Fried Berg (0.92€)
*** ANTE/BLINDS ***
FenderTolra posts small blind 0.01€
KON-2-PEUTE posts big blind 0.02€
Dealt to Fried Berg [9d Ts]
*** PRE-FLOP *** 
Caropitchoun folds
taramango folds
papashark14 folds
Fried Berg folds
FenderTolra folds
KON-2-PEUTE collected 0.03€ from pot
*** SUMMARY ***
Total pot 0.03€ | No rake
Seat 2: KON-2-PEUTE (big blind) won 0.03€


Winamax Poker - HOLD-UP "Colorado" - HandId: #19116069-329322-1701433783 - Holdem no limit (0.01€/0.02€) - 2023/12/01 12:29:43 UTC
Table: 'Colorado' 6-max (real money) Seat #6 is the button
Seat 1: Homer14510 (2.03€)
Seat 2: metamex (2€)
Seat 3: DigBick99 (2€)
Seat 4: Fried Berg (0.92€)
Seat 5: slowreplay (2€)
Seat 6: Thommynabo (2.22€)
Hold-up to Pot: total 0.50€
*** ANTE/BLINDS ***
Homer14510 posts small blind 0.01€
metamex posts big blind 0.02€
Dealt to Fried Berg [Qh 4d]
*** PRE-FLOP *** 
DigBick99 folds
Fried Berg folds
slowreplay folds
Thommynabo folds
Homer14510 folds
metamex collected 0.53€ from pot
*** SUMMARY ***
Total pot 0.53€ | No rake
Seat 2: metamex (big blind) won 0.53€


Winamax Poker - HOLD-UP "Colorado" - HandId: #19116069-329331-1701433789 - Holdem no limit (0.01€/0.02€) - 2023/12/01 12:29:49 UTC
Table: 'Colorado' 6-max (real money) Seat #6 is the button
Seat 1: Clemence75 (2€)
Seat 2: Fried Berg (0.92€)
Seat 3: momoiheb (0.46€)
Seat 4: x spoony (2.11€)
Seat 5: KKamarAAde (3.58€)
Seat 6: Charlise2 (1.74€)
*** ANTE/BLINDS ***
Clemence75 posts small blind 0.01€
Fried Berg posts big blind 0.02€
Dealt to Fried Berg [Qc 6c]
*** PRE-FLOP *** 
momoiheb folds
x spoony folds
KKamarAAde folds
Charlise2 folds
Clemence75 raises 0.04€ to 0.06€
Fried Berg calls 0.04€
*** FLOP *** [Ad 9s 8d]
Clemence75 bets 0.05€
Fried Berg folds
Clemence75 collected 0.16€ from pot
*** SUMMARY ***
Total pot 0.16€ | Rake 0.01€
Board: [Ad 9s 8d]
Seat 1: Clemence75 (small blind) won 0.16€


Winamax Poker - HOLD-UP "Colorado" - HandId: #19116069-329365-1701433812 - Holdem no limit (0.01€/0.02€) - 2023/12/01 12:30:12 UTC
Table: 'Colorado' 6-max (real money) Seat #6 is the button
Seat 1: Ju89400 (1.90€)
Seat 2: VinyPoker (2.02€)
Seat 3: Fried Berg (0.86€)
Seat 4: TheRealWill (2.18€)
Seat 5: Thor99 (3.92€)
Seat 6: Giucar (0.68€)
*** ANTE/BLINDS ***
Ju89400 posts small blind 0.01€
VinyPoker posts big blind 0.02€
Dealt to Fried Berg [Ah Td]
*** PRE-FLOP *** 
Fried Berg raises 0.02€ to 0.04€
TheRealWill folds
Thor99 folds
Giucar folds
Ju89400 calls 0.03€
VinyPoker folds
*** FLOP *** [2d Qc 7c]
Ju89400 bets 0.02€
Fried Berg calls 0.02€
*** TURN *** [2d Qc 7c][9d]
Ju89400 bets 0.02€
Fried Berg calls 0.02€
*** RIVER *** [2d Qc 7c 9d][3c]
Ju89400 checks
Fried Berg checks
*** SHOW DOWN ***
Fried Berg shows [Ah Td] (High card : Ace)
Ju89400 shows [Qh As] (One pair : Queens)
Ju89400 collected 0.16€ from pot
*** SUMMARY ***
Total pot 0.16€ | Rake 0.02€
Board: [2d Qc 7c 9d 3c]
Seat 1: Ju89400 (small blind) showed [Qh As] and won 0.16€ with One pair : Queens
Seat 3: Fried Berg showed [Ah Td] and lost with High card : Ace


Winamax Poker - HOLD-UP "Colorado" - HandId: #19116069-329409-1701433840 - Holdem no limit (0.01€/0.02€) - 2023/12/01 12:30:40 UTC
Table: 'Colorado' 6-max (real money) Seat #6 is the button
Seat 1: Fried Berg (0.78€)
Seat 2: Ju89400 (1.98€)
Seat 3: bastos2525 (2.43€)
Seat 4: Berig (1.97€)
Seat 5: Sucre10 (1.29€)
Seat 6: KON-2-PEUTE (2.38€)
*** ANTE/BLINDS ***
Fried Berg posts small blind 0.01€
Ju89400 posts big blind 0.02€
Dealt to Fried Berg [Qh 8h]
*** PRE-FLOP *** 
bastos2525 raises 0.05€ to 0.07€
Berig folds
Sucre10 folds
KON-2-PEUTE folds
Fried Berg calls 0.06€
Ju89400 folds
*** FLOP *** [Qs 2c Qc]
Fried Berg checks
bastos2525 bets 0.06€
Fried Berg calls 0.06€
*** TURN *** [Qs 2c Qc][9h]
Fried Berg checks
bastos2525 bets 0.10€
Fried Berg calls 0.10€
*** RIVER *** [Qs 2c Qc 9h][6d]
Fried Berg checks
bastos2525 checks
*** SHOW DOWN ***
bastos2525 shows [Jh Jc] (Two pairs : Queens and Jacks)
Fried Berg shows [Qh 8h] (Trips of Queens)
Fried Berg collected 0.43€ from pot
*** SUMMARY ***
Total pot 0.43€ | Rake 0.05€
Board: [Qs 2c Qc 9h 6d]
Seat 1: Fried Berg (small blind) showed [Qh 8h] and won 0.43€ with Trips of Queens
Seat 3: bastos2525 showed [Jh Jc] and lost with Two pairs : Queens and Jacks


Winamax Poker - HOLD-UP "Colorado" - HandId: #19116069-329495-1701433889 - Holdem no limit (0.01€/0.02€) - 2023/12/01 12:31:29 UTC
Table: 'Colorado' 6-max (real money) Seat #6 is the button
Seat 1: Fried Berg (0.98€)
Seat 2: bastos2525 (2.20€)
Seat 3: Polanskii (1.79€)
Seat 4: Clemence75 (2€)
Seat 5: Charlise2 (1.66€)
Seat 6: Tofini (2€)
*** ANTE/BLINDS ***
Fried Berg posts small blind 0.01€
bastos2525 posts big blind 0.02€
Dealt to Fried Berg [7d Tc]
*** PRE-FLOP *** 
Polanskii folds
Clemence75 folds
Charlise2 raises 0.04€ to 0.06€
Tofini folds
Fried Berg folds
bastos2525 folds
Charlise2 collected 0.09€ from pot
*** SUMMARY ***
Total pot 0.09€ | No rake
Seat 5: Charlise2 won 0.09€


Winamax Poker - HOLD-UP "Colorado" - HandId: #19116069-329525-1701433904 - Holdem no limit (0.01€/0.02€) - 2023/12/01 12:31:44 UTC
Table: 'Colorado' 6-max (real money) Seat #6 is the button
Seat 1: Berig (1.98€)
Seat 2: x spoony (2€)
Seat 3: ricki64 (4.02€)
Seat 4: LilRun (5.29€)
Seat 5: taecm (2.02€)
Seat 6: Fried Berg (0.97€)
*** ANTE/BLINDS ***
Berig posts small blind 0.01€
x spoony posts big blind 0.02€
Dealt to Fried Berg [9s Ad]
*** PRE-FLOP *** 
ricki64 folds
LilRun folds
taecm folds
Fried Berg raises 0.03€ to 0.05€
Berig folds
x spoony folds
Fried Berg collected 0.08€ from pot
*** SUMMARY ***
Total pot 0.08€ | No rake
Seat 6: Fried Berg (button) won 0.08€


Winamax Poker - HOLD-UP "Colorado" - HandId: #19116069-329557-1701433922 - Holdem no limit (0.01€/0.02€) - 2023/12/01 12:32:02 UTC
Table: 'Colorado' 6-max (real money) Seat #6 is the button
Seat 1: Clemence75 (2.01€)
Seat 2: ricki64 (4.04€)
Seat 3: Pop_hop_hop (1.91€)
Seat 4: Fried Berg (1€)
Seat 5: lut1dupoivre (0.55€)
Seat 6: slowreplay (4.86€)
*** ANTE/BLINDS ***
Clemence75 posts small blind 0.01€
ricki64 posts big blind 0.02€
Dealt to Fried Berg [Tc 3h]
*** PRE-FLOP *** 
Pop_hop_hop raises 0.03€ to 0.05€
Fried Berg folds
lut1dupoivre folds
slowreplay folds
Clemence75 folds
ricki64 calls 0.03€
*** FLOP *** [Kd 3s 3d]
ricki64 checks
Pop_hop_hop bets 0.04€
ricki64 folds
Pop_hop_hop collected 0.14€ from pot
*** SUMMARY ***
Total pot 0.14€ | Rake 0.01€
Board: [Kd 3s 3d]
Seat 3: Pop_hop_hop won 0.14€


Winamax Poker - HOLD-UP "Colorado" - HandId: #19116069-329565-1701433926 - Holdem no limit (0.01€/0.02€) - 2023/12/01 12:32:06 UTC
Table: 'Colorado' 6-max (real money) Seat #6 is the button
Seat 1: Mizoun (2.09€)
Seat 2: Myprincess (2€)
Seat 3: Caindymion99 (2.13€)
Seat 4: DosdeBras (0.62€)
Seat 5: Fried Berg (1€)
Seat 6: DonKmillo (7.99€)
*** ANTE/BLINDS ***
Mizoun posts small blind 0.01€
Myprincess posts big blind 0.02€
Dealt to Fried Berg [4h 2s]
*** PRE-FLOP *** 
Caindymion99 folds
DosdeBras folds
Fried Berg folds
DonKmillo folds
Mizoun folds
Myprincess collected 0.03€ from pot
*** SUMMARY ***
Total pot 0.03€ | No rake
Seat 2: Myprincess (big blind) won 0.03€


Winamax Poker - HOLD-UP "Colorado" - HandId: #19116069-329569-1701433928 - Holdem no limit (0.01€/0.02€) - 2023/12/01 12:32:08 UTC
Table: 'Colorado' 6-max (real money) Seat #6 is the button
Seat 1: curiouz dje (2.10€)
Seat 2: gostvision (2.17€)
Seat 3: DigBick99 (2€)
Seat 4: Pas 2 PeyroL (2€)
Seat 5: AMBM2729 (1.20€)
Seat 6: Fried Berg (1€)
*** ANTE/BLINDS ***
curiouz dje posts small blind 0.01€
gostvision posts big blind 0.02€
Dealt to Fried Berg [Kd Kh]
*** PRE-FLOP *** 
DigBick99 folds
Pas 2 PeyroL raises 0.03€ to 0.05€
AMBM2729 folds
Fried Berg raises 0.10€ to 0.15€
curiouz dje folds
gostvision folds
Pas 2 PeyroL calls 0.10€
*** FLOP *** [2c 3d Js]
Pas 2 PeyroL checks
Fried Berg bets 0.12€
Pas 2 PeyroL calls 0.12€
*** TURN *** [2c 3d Js][5d]
Pas 2 PeyroL bets 0.43€
Fried Berg raises 0.30€ to 0.73€ and is all-in
Pas 2 PeyroL calls 0.30€
*** RIVER *** [2c 3d Js 5d][3s]
*** SHOW DOWN ***
Pas 2 PeyroL shows [Qs Jd] (Two pairs : Jacks and 3)
Fried Berg shows [Kd Kh] (Two pairs : Kings and 3)
Fried Berg collected 1.83€ from pot
*** SUMMARY ***
Total pot 1.83€ | Rake 0.20€
Board: [2c 3d Js 5d 3s]
Seat 4: Pas 2 PeyroL showed [Qs Jd] and lost with Two pairs : Jacks and 3
Seat 6: Fried Berg (button) showed [Kd Kh] and won 1.83€ with Two pairs : Kings and 3


Winamax Poker - HOLD-UP "Colorado" - HandId: #19116069-329636-1701433973 - Holdem no limit (0.01€/0.02€) - 2023/12/01 12:32:53 UTC
Table: 'Colorado' 6-max (real money) Seat #6 is the button
Seat 1: VinyPoker (2.62€)
Seat 2: Fried Berg (1.83€)
Seat 3: curiouz dje (2.09€)
Seat 4: DosdeBras (0.60€)
Seat 5: x spoony (2€)
Seat 6: Mizoun (2.16€)
*** ANTE/BLINDS ***
VinyPoker posts small blind 0.01€
Fried Berg posts big blind 0.02€
Dealt to Fried Berg [3d 4d]
*** PRE-FLOP *** 
curiouz dje folds
DosdeBras folds
x spoony raises 0.04€ to 0.06€
Mizoun folds
VinyPoker folds
Fried Berg calls 0.04€
*** FLOP *** [Qs 6d Ks]
Fried Berg checks
x spoony checks
*** TURN *** [Qs 6d Ks][2c]
Fried Berg checks
x spoony checks
*** RIVER *** [Qs 6d Ks 2c][7c]
Fried Berg checks
x spoony checks
*** SHOW DOWN ***
Fried Berg shows [3d 4d] (High card : King)
x spoony shows [8h 8c] (One pair : 8)
x spoony collected 0.12€ from pot
*** SUMMARY ***
Total pot 0.12€ | Rake 0.01€
Board: [Qs 6d Ks 2c 7c]
Seat 2: Fried Berg (big blind) showed [3d 4d] and lost with High card : King
Seat 5: x spoony showed [8h 8c] and won 0.12€ with One pair : 8


Winamax Poker - HOLD-UP "Colorado" - HandId: #19116069-329698-1701434017 - Holdem no limit (0.01€/0.02€) - 2023/12/01 12:33:37 UTC
Table: 'Colorado' 6-max (real money) Seat #6 is the button
Seat 1: gostvision (2.67€)
Seat 2: DGG23 (0.27€)
Seat 3: Fried Berg (1.77€)
Seat 4: Clemence75 (2.21€)
Seat 5: Blurran (0.48€)
Seat 6: x spoony (2.06€)
*** ANTE/BLINDS ***
gostvision posts small blind 0.01€
DGG23 posts big blind 0.02€
Dealt to Fried Berg [3h Tc]
*** PRE-FLOP *** 
Fried Berg folds
Clemence75 folds
Blurran folds
x spoony folds
gostvision folds
DGG23 collected 0.03€ from pot
*** SUMMARY ***
Total pot 0.03€ | No rake
Seat 2: DGG23 (big blind) won 0.03€


Winamax Poker - HOLD-UP "Colorado" - HandId: #19116069-329701-1701434020 - Holdem no limit (0.01€/0.02€) - 2023/12/01 12:33:40 UTC
Table: 'Colorado' 6-max (real money) Seat #6 is the button
Seat 1: slowreplay (2.41€)
Seat 2: Tofini (2.03€)
Seat 3: TheRealWill (2.08€)
Seat 4: Mehney (1.57€)
Seat 5: Fried Berg (1.77€)
Seat 6: Hydramist (2€)
*** ANTE/BLINDS ***
slowreplay posts small blind 0.01€
Tofini posts big blind 0.02€
Dealt to Fried Berg [4s 4h]
*** PRE-FLOP *** 
TheRealWill folds
Mehney folds
Fried Berg calls 0.02€
Hydramist folds
slowreplay folds
Tofini checks
*** FLOP *** [7c 9h 6d]
Tofini bets 0.03€
Fried Berg calls 0.03€
*** TURN *** [7c 9h 6d][Kd]
Tofini bets 0.07€
Fried Berg calls 0.07€
*** RIVER *** [7c 9h 6d Kd][7h]
Tofini checks
Fried Berg checks
*** SHOW DOWN ***
Fried Berg shows [4s 4h] (Two pairs : 7 and 4)
Tofini shows [9c 6h] (Two pairs : 9 and 7)
Tofini collected 0.22€ from pot
*** SUMMARY ***
Total pot 0.22€ | Rake 0.03€
Board: [7c 9h 6d Kd 7h]
Seat 2: Tofini (big blind) showed [9c 6h] and won 0.22€ with Two pairs : 9 and 7
Seat 5: Fried Berg showed [4s 4h] and lost with Two pairs : 7 and 4


Winamax Poker - HOLD-UP "Colorado" - HandId: #19116069-329752-1701434049 - Holdem no limit (0.01€/0.02€) - 2023/12/01 12:34:09 UTC
Table: 'Colorado' 6-max (real money) Seat #6 is the button
Seat 1: Tofini (2.13€)
Seat 2: Pas 2 PeyroL (2.34€)
Seat 3: Rock-Bear (3.07€)
Seat 4: Alexisdpp (10.88€)
Seat 5: slowreplay (2.40€)
Seat 6: Fried Berg (1.65€)
*** ANTE/BLINDS ***
Tofini posts small blind 0.01€
Pas 2 PeyroL posts big blind 0.02€
Dealt to Fried Berg [8h 5c]
*** PRE-FLOP *** 
Rock-Bear folds
Alexisdpp folds
slowreplay folds
Fried Berg folds
Tofini folds
Pas 2 PeyroL collected 0.03€ from pot
*** SUMMARY ***
Total pot 0.03€ | No rake
Seat 2: Pas 2 PeyroL (big blind) won 0.03€


Winamax Poker - HOLD-UP "Colorado" - HandId: #19116069-329767-1701434060 - Holdem no limit (0.01€/0.02€) - 2023/12/01 12:34:20 UTC
Table: 'Colorado' 6-max (real money) Seat #6 is the button
Seat 1: Hydramist (3.17€)
Seat 2: DGG23 (0.27€)
Seat 3: KKamarAAde (3.57€)
Seat 4: Fried Berg (1.65€)
Seat 5: papashark14 (1.92€)
Seat 6: DonKmillo (8€)
*** ANTE/BLINDS ***
Hydramist posts small blind 0.01€
DGG23 posts big blind 0.02€
Dealt to Fried Berg [8s Qd]
*** PRE-FLOP *** 
KKamarAAde folds
Fried Berg folds
papashark14 folds
DonKmillo folds
Hydramist folds
DGG23 collected 0.03€ from pot
*** SUMMARY ***
Total pot 0.03€ | No rake
Seat 2: DGG23 (big blind) won 0.03€


Winamax Poker - HOLD-UP "Colorado" - HandId: #19116069-329782-1701434068 - Holdem no limit (0.01€/0.02€) - 2023/12/01 12:34:28 UTC
Table: 'Colorado' 6-max (real money) Seat #6 is the button
Seat 1: Gildus44 (1.84€)
Seat 2: KKamarAAde (3.70€)
Seat 3: Fried Berg (1.65€)
Seat 4: VinyPoker (2.13€)
Seat 5: Damspins (1.32€)
Seat 6: papashark14 (1.92€)
*** ANTE/BLINDS ***
Gildus44 posts small blind 0.01€
KKamarAAde posts big blind 0.02€
Dealt to Fried Berg [4d 2c]
*** PRE-FLOP *** 
Fried Berg folds
VinyPoker raises 0.04€ to 0.06€
Damspins folds
papashark14 folds
Gildus44 folds
KKamarAAde folds
VinyPoker collected 0.09€ from pot
*** SUMMARY ***
Total pot 0.09€ | No rake
Seat 4: VinyPoker won 0.09€


Winamax Poker - HOLD-UP "Colorado" - HandId: #19116069-329784-1701434070 - Holdem no limit (0.01€/0.02€) - 2023/12/01 12:34:30 UTC
Table: 'Colorado' 6-max (real money) Seat #6 is the button
Seat 1: Fried Berg (1.65€)
Seat 2: Clemence75 (2.30€)
Seat 3: Caropitchoun (2.46€)
Seat 4: curiouz dje (2.33€)
Seat 5: Damspins (1.32€)
Seat 6: slowreplay (4.27€)
*** ANTE/BLINDS ***
Fried Berg posts small blind 0.01€
Clemence75 posts big blind 0.02€
Dealt to Fried Berg [Jc 8d]
*** PRE-FLOP *** 
Caropitchoun raises 0.04€ to 0.06€
curiouz dje folds
Damspins folds
slowreplay folds
Fried Berg folds
Clemence75 folds
Caropitchoun collected 0.09€ from pot
*** SUMMARY ***
Total pot 0.09€ | No rake
Seat 3: Caropitchoun won 0.09€


Winamax Poker - HOLD-UP "Colorado" - HandId: #19116069-329807-1701434084 - Holdem no limit (0.01€/0.02€) - 2023/12/01 12:34:44 UTC
Table: 'Colorado' 6-max (real money) Seat #6 is the button
Seat 1: g8o8k8u (2.70€)
Seat 2: Fried Berg (1.64€)
Seat 3: MagicBast 1 (0.49€)
Seat 4: Blurran (0.56€)
Seat 5: Tounsi49 (0.96€)
Seat 6: AMBM2729 (1.40€)
Hold-up to Pot: total 0.10€
*** ANTE/BLINDS ***
g8o8k8u posts small blind 0.01€
Fried Berg posts big blind 0.02€
Dealt to Fried Berg [6c Qs]
*** PRE-FLOP *** 
MagicBast 1 calls 0.02€
Blurran folds
Tounsi49 calls 0.02€
AMBM2729 calls 0.02€
g8o8k8u calls 0.01€
Fried Berg checks
*** FLOP *** [6d 9h Td]
g8o8k8u checks
Fried Berg checks
MagicBast 1 checks
Tounsi49 bets 0.13€
AMBM2729 folds
g8o8k8u raises 0.46€ to 0.59€
Fried Berg folds
MagicBast 1 folds
Tounsi49 calls 0.46€
*** TURN *** [6d 9h Td][7h]
g8o8k8u bets 2.09€ and is all-in
Tounsi49 calls 0.35€ and is all-in
*** RIVER *** [6d 9h Td 7h][Tc]
*** SHOW DOWN ***
g8o8k8u shows [8s 7s] (Straight Ten high)
Tounsi49 shows [Jd 8h] (Straight Jack high)
Tounsi49 collected 1.88€ from main pot
g8o8k8u collected 1.74€ from side pot 1
*** SUMMARY ***
Total pot 3.62€ | Rake 0.20€
Board: [6d 9h Td 7h Tc]
Seat 1: g8o8k8u (small blind) showed [8s 7s] and won 1.74€ with Straight Ten high
Seat 5: Tounsi49 showed [Jd 8h] and won 1.88€ with Straight Jack high


Winamax Poker - HOLD-UP "Colorado" - HandId: #19116069-329880-1701434131 - Holdem no limit (0.01€/0.02€) - 2023/12/01 12:35:31 UTC
Table: 'Colorado' 6-max (real money) Seat #6 is the button
Seat 1: Afikomane55 (0.53€)
Seat 2: Rock-Bear (3.05€)
Seat 3: Hydramist (2.76€)
Seat 4: bastos2525 (2€)
Seat 5: Fried Berg (1.62€)
Seat 6: Tounsi49 (1.88€)
*** ANTE/BLINDS ***
Afikomane55 posts small blind 0.01€
Rock-Bear posts big blind 0.02€
Dealt to Fried Berg [9s 3s]
*** PRE-FLOP *** 
Hydramist folds
bastos2525 folds
Fried Berg folds
Tounsi49 folds
Afikomane55 calls 0.01€
Rock-Bear checks
*** FLOP *** [8d 5c Jd]
Afikomane55 bets 0.04€
Rock-Bear folds
Afikomane55 collected 0.08€ from pot
*** SUMMARY ***
Total pot 0.08€ | No rake
Board: [8d 5c Jd]
Seat 1: Afikomane55 (small blind) won 0.08€


Winamax Poker - HOLD-UP "Colorado" - HandId: #19116069-329895-1701434140 - Holdem no limit (0.01€/0.02€) - 2023/12/01 12:35:40 UTC
Table: 'Colorado' 6-max (real money) Seat #6 is the button
Seat 1: Fried Berg (1.62€)
Seat 2: LilRun (5.33€)
Seat 3: Tofini (2.08€)
Seat 4: AAdellKK (0.97€)
Seat 5: Mizoun (4€)
Seat 6: El Paellas (0.53€)
*** ANTE/BLINDS ***
Fried Berg posts small blind 0.01€
LilRun posts big blind 0.02€
Dealt to Fried Berg [7d 3c]
*** PRE-FLOP *** 
Tofini folds
AAdellKK folds
Mizoun folds
El Paellas folds
Fried Berg folds
LilRun collected 0.03€ from pot
*** SUMMARY ***
Total pot 0.03€ | No rake
Seat 2: LilRun (big blind) won 0.03€


Winamax Poker - HOLD-UP "Colorado" - HandId: #19116069-329900-1701434143 - Holdem no limit (0.01€/0.02€) - 2023/12/01 12:35:43 UTC
Table: 'Colorado' 6-max (real money) Seat #6 is the button
Seat 1: Max134Max (4.08€)
Seat 2: metamex (1.65€)
Seat 3: HERminia_er6 (0.94€)
Seat 4: bastos2525 (2.92€)
Seat 5: -Y4V- (2.64€)
Seat 6: Fried Berg (1.61€)
*** ANTE/BLINDS ***
Max134Max posts small blind 0.01€
metamex posts big blind 0.02€
Dealt to Fried Berg [7c 2s]
*** PRE-FLOP *** 
HERminia_er6 raises 0.92€ to 0.94€ and is all-in
bastos2525 folds
-Y4V- folds
Fried Berg folds
Max134Max raises 3.14€ to 4.08€ and is all-in
metamex folds
*** FLOP *** [Ah 8c 5h]
*** TURN *** [Ah 8c 5h][Qs]
*** RIVER *** [Ah 8c 5h Qs][6d]
*** SHOW DOWN ***
Max134Max shows [Jc Jh] (One pair : Jacks)
HERminia_er6 shows [5s 5c] (Trips of 5)
HERminia_er6 collected 1.71€ from main pot
Max134Max collected 3.14€ from side pot 1
*** SUMMARY ***
Total pot 4.85€ | Rake 0.19€
Board: [Ah 8c 5h Qs 6d]
Seat 1: Max134Max (small blind) showed [Jc Jh] and won 3.14€ with One pair : Jacks
Seat 3: HERminia_er6 showed [5s 5c] and won 1.71€ with Trips of 5


Winamax Poker - HOLD-UP "Colorado" - HandId: #19116069-329904-1701434146 - Holdem no limit (0.01€/0.02€) - 2023/12/01 12:35:46 UTC
Table: 'Colorado' 6-max (real money) Seat #6 is the button
Seat 1: DigBick99 (2.15€)
Seat 2: DIOSLOKI1 9 (1.66€)
Seat 3: slowreplay (2.42€)
Seat 4: Fried Berg (1.61€)
Seat 5: Eytrewq (1.49€)
Seat 6: Tofini (2.08€)
*** ANTE/BLINDS ***
DigBick99 posts small blind 0.01€
DIOSLOKI1 9 posts big blind 0.02€
Dealt to Fried Berg [8s 3d]
*** PRE-FLOP *** 
slowreplay folds
Fried Berg folds
Eytrewq folds
Tofini folds
DigBick99 raises 0.04€ to 0.06€
DIOSLOKI1 9 calls 0.04€
*** FLOP *** [3s Kh 4d]
DigBick99 bets 0.04€
DIOSLOKI1 9 calls 0.04€
*** TURN *** [3s Kh 4d][Jc]
DigBick99 bets 0.20€
DIOSLOKI1 9 folds
DigBick99 collected 0.38€ from pot
*** SUMMARY ***
Total pot 0.38€ | Rake 0.02€
Board: [3s Kh 4d Jc]
Seat 1: DigBick99 (small blind) won 0.38€


Winamax Poker - HOLD-UP "Colorado" - HandId: #19116069-329909-1701434149 - Holdem no limit (0.01€/0.02€) - 2023/12/01 12:35:49 UTC
Table: 'Colorado' 6-max (real money) Seat #6 is the button
Seat 1: Giucar (0.73€)
Seat 2: Fried Berg (1.61€)
Seat 3: x spoony (2€)
Seat 4: slowreplay (2.42€)
Seat 5: Salomon526 (0.07€)
Seat 6: curiouz dje (4.11€)
*** ANTE/BLINDS ***
Giucar posts small blind 0.01€
Fried Berg posts big blind 0.02€
Dealt to Fried Berg [Ks 3s]
*** PRE-FLOP *** 
x spoony folds
slowreplay folds
Salomon526 folds
curiouz dje folds
Giucar calls 0.01€
Fried Berg checks
*** FLOP *** [7s Jc 5h]
Giucar checks
Fried Berg checks
*** TURN *** [7s Jc 5h][4d]
Giucar checks
Fried Berg checks
*** RIVER *** [7s Jc 5h 4d][Kc]
Giucar checks
Fried Berg bets 0.04€
Giucar folds
Fried Berg collected 0.08€ from pot
*** SUMMARY ***
Total pot 0.08€ | No rake
Board: [7s Jc 5h 4d Kc]
Seat 2: Fried Berg (big blind) won 0.08€


Winamax Poker - HOLD-UP "Colorado" - HandId: #19116069-329946-1701434175 - Holdem no limit (0.01€/0.02€) - 2023/12/01 12:36:15 UTC
Table: 'Colorado' 6-max (real money) Seat #6 is the button
Seat 1: KON-2-PEUTE (3.03€)
Seat 2: Charlise2 (0.99€)
Seat 3: Fried Berg (1.63€)
Seat 4: Bilderbet (2€)
Seat 5: Espada59 (1.63€)
Seat 6: Caropitchoun (4.58€)
*** ANTE/BLINDS ***
KON-2-PEUTE posts small blind 0.01€
Charlise2 posts big blind 0.02€
Dealt to Fried Berg [Kc Qs]
*** PRE-FLOP *** 
Fried Berg raises 0.03€ to 0.05€
Bilderbet folds
Espada59 calls 0.05€
Caropitchoun folds
KON-2-PEUTE folds
Charlise2 folds
*** FLOP *** [8c 9s 8h]
Fried Berg checks
Espada59 bets 0.02€
Fried Berg calls 0.02€
*** TURN *** [8c 9s 8h][Ks]
Fried Berg checks
Espada59 bets 0.02€
Fried Berg calls 0.02€
*** RIVER *** [8c 9s 8h Ks][Ts]
Fried Berg checks
Espada59 bets 0.20€
Fried Berg calls 0.20€
*** SHOW DOWN ***
Fried Berg shows [Kc Qs] (Two pairs : Kings and 8)
Espada59 shows [8d Kd] (Full of 8 and Kings)
Espada59 collected 0.55€ from pot
*** SUMMARY ***
Total pot 0.55€ | Rake 0.06€
Board: [8c 9s 8h Ks Ts]
Seat 3: Fried Berg showed [Kc Qs] and lost with Two pairs : Kings and 8
Seat 5: Espada59 showed [8d Kd] and won 0.55€ with Full of 8 and Kings


Winamax Poker - HOLD-UP "Colorado" - HandId: #19116069-330039-1701434229 - Holdem no limit (0.01€/0.02€) - 2023/12/01 12:37:09 UTC
Table: 'Colorado' 6-max (real money) Seat #6 is the button
Seat 1: Bilderbet (2€)
Seat 2: VinyPoker (3.99€)
Seat 3: Clemence75 (2.03€)
Seat 4: TheRealWill (4.92€)
Seat 5: x spoony (2€)
Seat 6: Fried Berg (1.34€)
*** ANTE/BLINDS ***
Bilderbet posts small blind 0.01€
VinyPoker posts big blind 0.02€
Dealt to Fried Berg [Th 7d]
*** PRE-FLOP *** 
Clemence75 folds
TheRealWill folds
x spoony folds
Fried Berg folds
Bilderbet raises 0.04€ to 0.06€
VinyPoker calls 0.04€
*** FLOP *** [Ah 4d Tc]
Bilderbet checks
VinyPoker checks
*** TURN *** [Ah 4d Tc][Qd]
Bilderbet checks
VinyPoker checks
*** RIVER *** [Ah 4d Tc Qd][Jh]
Bilderbet checks
VinyPoker bets 0.02€
Bilderbet folds
VinyPoker collected 0.13€ from pot
*** SUMMARY ***
Total pot 0.13€ | Rake 0.01€
Board: [Ah 4d Tc Qd Jh]
Seat 2: VinyPoker (big blind) won 0.13€


Winamax Poker - HOLD-UP "Colorado" - HandId: #19116069-330061-1701434244 - Holdem no limit (0.01€/0.02€) - 2023/12/01 12:37:24 UTC
Table: 'Colorado' 6-max (real money) Seat #6 is the button
Seat 1: ironman33 (1.52€)
Seat 2: moussaillax (2.85€)
Seat 3: Astaril (2.18€)
Seat 4: Fried Berg (1.34€)
Seat 5: Hydramist (2.73€)
Seat 6: bastos2525 (1.80€)
*** ANTE/BLINDS ***
ironman33 posts small blind 0.01€
moussaillax posts big blind 0.02€
Dealt to Fried Berg [7s 7c]
*** PRE-FLOP *** 
Astaril folds
Fried Berg raises 0.03€ to 0.05€
Hydramist calls 0.05€
bastos2525 folds
ironman33 calls 0.04€
moussaillax folds
*** FLOP *** [3s Ah Jd]
ironman33 checks
Fried Berg bets 0.06€
Hydramist folds
ironman33 calls 0.06€
*** TURN *** [3s Ah Jd][Tc]
ironman33 checks
Fried Berg checks
*** RIVER *** [3s Ah Jd Tc][Jc]
ironman33 checks
Fried Berg checks
*** SHOW DOWN ***
ironman33 shows [Qd 3d] (Two pairs : Jacks and 3)
Fried Berg shows [7s 7c] (Two pairs : Jacks and 7)
Fried Berg collected 0.26€ from pot
*** SUMMARY ***
Total pot 0.26€ | Rake 0.03€
Board: [3s Ah Jd Tc Jc]
Seat 1: ironman33 (small blind) showed [Qd 3d] and lost with Two pairs : Jacks and 3
Seat 4: Fried Berg showed [7s 7c] and won 0.26€ with Two pairs : Jacks and 7


Winamax Poker - HOLD-UP "Colorado" - HandId: #19116069-330155-1701434299 - Holdem no limit (0.01€/0.02€) - 2023/12/01 12:38:19 UTC
Table: 'Colorado' 6-max (real money) Seat #6 is the button
Seat 1: TaBrEaMoI (2.04€)
Seat 2: DigBick99 (3.17€)
Seat 3: Clemence75 (2.03€)
Seat 4: TheRealWill (4.95€)
Seat 5: Charlise2 (1.27€)
Seat 6: Fried Berg (1.49€)
*** ANTE/BLINDS ***
TaBrEaMoI posts small blind 0.01€
DigBick99 posts big blind 0.02€
Dealt to Fried Berg [2c 2d]
*** PRE-FLOP *** 
Clemence75 folds
TheRealWill raises 0.04€ to 0.06€
Charlise2 calls 0.06€
Fried Berg folds
TaBrEaMoI folds
DigBick99 folds
*** FLOP *** [8d 2h 8c]
TheRealWill checks
Charlise2 bets 0.10€
TheRealWill folds
Charlise2 collected 0.23€ from pot
*** SUMMARY ***
Total pot 0.23€ | Rake 0.02€
Board: [8d 2h 8c]
Seat 5: Charlise2 won 0.23€


Winamax Poker - HOLD-UP "Colorado" - HandId: #19116069-330192-1701434324 - Holdem no limit (0.01€/0.02€) - 2023/12/01 12:38:44 UTC
Table: 'Colorado' 6-max (real money) Seat #6 is the button
Seat 1: Hydramist (3.05€)
Seat 2: Fried Berg (1.49€)
Seat 3: BlondBSE59 (1.97€)
Seat 4: metamex (1.57€)
Seat 5: Poulaouzeee (0.58€)
Seat 6: x spoony (2.38€)
*** ANTE/BLINDS ***
Hydramist posts small blind 0.01€
Fried Berg posts big blind 0.02€
Dealt to Fried Berg [3h Qh]
*** PRE-FLOP *** 
BlondBSE59 folds
metamex folds
Poulaouzeee folds
x spoony folds
Hydramist folds
Fried Berg collected 0.03€ from pot
*** SUMMARY ***
Total pot 0.03€ | No rake
Seat 2: Fried Berg (big blind) won 0.03€


Winamax Poker - HOLD-UP "Colorado" - HandId: #19116069-330209-1701434334 - Holdem no limit (0.01€/0.02€) - 2023/12/01 12:38:54 UTC
Table: 'Colorado' 6-max (real money) Seat #6 is the button
Seat 1: Fried Berg (1.50€)
Seat 2: El-suuupo (2.15€)
Seat 3: DGG23 (0.37€)
Seat 4: lut1dupoivre (0.83€)
Seat 5: Psrpro67 (0.66€)
Seat 6: DigBick99 (3.15€)
*** ANTE/BLINDS ***
Fried Berg posts small blind 0.01€
El-suuupo posts big blind 0.02€
Dealt to Fried Berg [Td Ac]
*** PRE-FLOP *** 
DGG23 folds
lut1dupoivre folds
Psrpro67 raises 0.64€ to 0.66€ and is all-in
DigBick99 folds
Fried Berg folds
El-suuupo folds
Psrpro67 collected 0.69€ from pot
*** SUMMARY ***
Total pot 0.69€ | No rake
Seat 5: Psrpro67 won 0.69€


Winamax Poker - HOLD-UP "Colorado" - HandId: #19116069-330235-1701434352 - Holdem no limit (0.01€/0.02€) - 2023/12/01 12:39:12 UTC
Table: 'Colorado' 6-max (real money) Seat #6 is the button
Seat 1: J.C Deuces.0 (2.15€)
Seat 2: Piiranha (2€)
Seat 3: Damspins (1.20€)
Seat 4: KKamarAAde (3.64€)
Seat 5: El Borador (0.61€)
Seat 6: Fried Berg (1.49€)
*** ANTE/BLINDS ***
J.C Deuces.0 posts small blind 0.01€
Piiranha posts big blind 0.02€
Dealt to Fried Berg [3s 9c]
*** PRE-FLOP *** 
Damspins folds
KKamarAAde folds
El Borador folds
Fried Berg folds
J.C Deuces.0 calls 0.01€
Piiranha checks
*** FLOP *** [7c Ts 2h]
J.C Deuces.0 checks
Piiranha bets 0.02€
J.C Deuces.0 calls 0.02€
*** TURN *** [7c Ts 2h][Jc]
J.C Deuces.0 checks
Piiranha checks
*** RIVER *** [7c Ts 2h Jc][8c]
J.C Deuces.0 bets 0.04€
Piiranha folds
J.C Deuces.0 collected 0.11€ from pot
*** SUMMARY ***
Total pot 0.11€ | Rake 0.01€
Board: [7c Ts 2h Jc 8c]
Seat 1: J.C Deuces.0 (small blind) won 0.11€


Winamax Poker - HOLD-UP "Colorado" - HandId: #19116069-330248-1701434358 - Holdem no limit (0.01€/0.02€) - 2023/12/01 12:39:18 UTC
Table: 'Colorado' 6-max (real money) Seat #6 is the button
Seat 1: VinyPoker (4.28€)
Seat 2: El Borador (0.60€)
Seat 3: Fried Berg (1.49€)
Seat 4: TaBrEaMoI (2€)
Seat 5: Psrpro67 (0.69€)
Seat 6: curiouz dje (3.86€)
Hold-up to Pot: total 0.10€
*** ANTE/BLINDS ***
VinyPoker posts small blind 0.01€
El Borador posts big blind 0.02€
Dealt to Fried Berg [Ah 9d]
*** PRE-FLOP *** 
Fried Berg raises 0.02€ to 0.04€
TaBrEaMoI folds
Psrpro67 folds
curiouz dje folds
VinyPoker folds
El Borador folds
Fried Berg collected 0.17€ from pot
*** SUMMARY ***
Total pot 0.17€ | No rake
Seat 3: Fried Berg won 0.17€


Winamax Poker - HOLD-UP "Colorado" - HandId: #19116069-330273-1701434371 - Holdem no limit (0.01€/0.02€) - 2023/12/01 12:39:31 UTC
Table: 'Colorado' 6-max (real money) Seat #6 is the button
Seat 1: El Paellas (0.59€)
Seat 2: Pas 2 PeyroL (2.28€)
Seat 3: LilRun (5.23€)
Seat 4: Clemence75 (2.06€)
Seat 5: Fried Berg (1.62€)
Seat 6: bastos2525 (1.27€)
*** ANTE/BLINDS ***
El Paellas posts small blind 0.01€
Pas 2 PeyroL posts big blind 0.02€
Dealt to Fried Berg [7c 7h]
*** PRE-FLOP *** 
LilRun folds
Clemence75 folds
Fried Berg raises 0.02€ to 0.04€
bastos2525 folds
El Paellas folds
Pas 2 PeyroL folds
Fried Berg collected 0.07€ from pot
*** SUMMARY ***
Total pot 0.07€ | No rake
Seat 5: Fried Berg won 0.07€


Winamax Poker - HOLD-UP "Colorado" - HandId: #19116069-330296-1701434387 - Holdem no limit (0.01€/0.02€) - 2023/12/01 12:39:47 UTC
Table: 'Colorado' 6-max (real money) Seat #6 is the button
Seat 1: Thommynabo (1.14€)
Seat 2: VM Condor908 (2.03€)
Seat 3: Hydramist (3.03€)
Seat 4: DigBick99 (3.12€)
Seat 5: Fried Berg (1.65€)
Seat 6: slowreplay (5.15€)
*** ANTE/BLINDS ***
Thommynabo posts small blind 0.01€
VM Condor908 posts big blind 0.02€
Dealt to Fried Berg [Js 6c]
*** PRE-FLOP *** 
Hydramist folds
DigBick99 folds
Fried Berg folds
slowreplay folds
Thommynabo folds
VM Condor908 collected 0.03€ from pot
*** SUMMARY ***
Total pot 0.03€ | No rake
Seat 2: VM Condor908 (big blind) won 0.03€


Winamax Poker - HOLD-UP "Colorado" - HandId: #19116069-330325-1701434405 - Holdem no limit (0.01€/0.02€) - 2023/12/01 12:40:05 UTC
Table: 'Colorado' 6-max (real money) Seat #6 is the button
Seat 1: Tofini (2€)
Seat 2: Fried Berg (1.65€)
Seat 3: gbtcorp (2€)
Seat 4: Seb bzh (0.51€)
Seat 5: Psrpro67 (0.60€)
Seat 6: DigBick99 (2.11€)
*** ANTE/BLINDS ***
Tofini posts small blind 0.01€
Fried Berg posts big blind 0.02€
Dealt to Fried Berg [Ad Qh]
*** PRE-FLOP *** 
gbtcorp folds
Seb bzh folds
Psrpro67 folds
DigBick99 raises 0.03€ to 0.05€
Tofini folds
Fried Berg raises 0.10€ to 0.15€
DigBick99 calls 0.10€
*** FLOP *** [Kh 8d 4s]
Fried Berg bets 0.02€
DigBick99 raises 0.10€ to 0.12€
Fried Berg calls 0.10€
*** TURN *** [Kh 8d 4s][7c]
Fried Berg checks
DigBick99 bets 0.38€
Fried Berg calls 0.38€
*** RIVER *** [Kh 8d 4s 7c][As]
Fried Berg checks
DigBick99 checks
*** SHOW DOWN ***
DigBick99 shows [Ks Qd] (One pair : Kings)
Fried Berg shows [Ad Qh] (One pair : Aces)
Fried Berg collected 1.18€ from pot
*** SUMMARY ***
Total pot 1.18€ | Rake 0.13€
Board: [Kh 8d 4s 7c As]
Seat 2: Fried Berg (big blind) showed [Ad Qh] and won 1.18€ with One pair : Aces
Seat 6: DigBick99 (button) showed [Ks Qd] and lost with One pair : Kings


Winamax Poker - HOLD-UP "Colorado" - HandId: #19116069-330425-1701434483 - Holdem no limit (0.01€/0.02€) - 2023/12/01 12:41:23 UTC
Table: 'Colorado' 6-max (real money) Seat #6 is the button
Seat 1: Clemence75 (2.02€)
Seat 2: _gonzai_ (2€)
Seat 3: DigBick99 (2€)
Seat 4: x spoony (2.83€)
Seat 5: Fried Berg (2.18€)
Seat 6: TheRealWill (5.22€)
*** ANTE/BLINDS ***
Clemence75 posts small blind 0.01€
_gonzai_ posts big blind 0.02€
Dealt to Fried Berg [8h As]
*** PRE-FLOP *** 
DigBick99 folds
x spoony folds
Fried Berg raises 0.04€ to 0.06€
TheRealWill calls 0.06€
Clemence75 folds
_gonzai_ folds
*** FLOP *** [6c 5h Ac]
Fried Berg checks
TheRealWill bets 0.05€
Fried Berg calls 0.05€
*** TURN *** [6c 5h Ac][5s]
Fried Berg checks
TheRealWill checks
*** RIVER *** [6c 5h Ac 5s][5c]
Fried Berg checks
TheRealWill checks
*** SHOW DOWN ***
TheRealWill shows [8c Kc] (Flush Ace high)
Fried Berg shows [8h As] (Full of 5 and Aces)
Fried Berg collected 0.22€ from pot
*** SUMMARY ***
Total pot 0.22€ | Rake 0.03€
Board: [6c 5h Ac 5s 5c]
Seat 5: Fried Berg showed [8h As] and won 0.22€ with Full of 5 and Aces
Seat 6: TheRealWill (button) showed [8c Kc] and lost with Flush Ace high


Winamax Poker - HOLD-UP "Colorado" - HandId: #19116069-330537-1701434561 - Holdem no limit (0.01€/0.02€) - 2023/12/01 12:42:41 UTC
Table: 'Colorado' 6-max (real money) Seat #6 is the button
Seat 1: gbtcorp (1.72€)
Seat 2: misterda (1.66€)
Seat 3: JahJah_PH (0.76€)
Seat 4: Fried Berg (2.29€)
Seat 5: Pas 2 PeyroL (3.36€)
Seat 6: TheRealWill (5.11€)
Hold-up to Pot: total 0.10€
*** ANTE/BLINDS ***
gbtcorp posts small blind 0.01€
misterda posts big blind 0.02€
Dealt to Fried Berg [3h Js]
*** PRE-FLOP *** 
JahJah_PH raises 0.15€ to 0.17€
Fried Berg folds
Pas 2 PeyroL calls 0.17€
TheRealWill folds
gbtcorp folds
misterda folds
*** FLOP *** [8h 4h 9d]
JahJah_PH bets 0.23€
Pas 2 PeyroL raises 0.23€ to 0.46€
JahJah_PH raises 0.13€ to 0.59€ and is all-in
Pas 2 PeyroL calls 0.13€
*** TURN *** [8h 4h 9d][8s]
*** RIVER *** [8h 4h 9d 8s][Jh]
*** SHOW DOWN ***
Pas 2 PeyroL shows [6c 6h] (Two pairs : 8 and 6)
JahJah_PH shows [Qd Qs] (Two pairs : Queens and 8)
JahJah_PH collected 1.49€ from pot
*** SUMMARY ***
Total pot 1.49€ | Rake 0.16€
Board: [8h 4h 9d 8s Jh]
Seat 3: JahJah_PH showed [Qd Qs] and won 1.49€ with Two pairs : Queens and 8
Seat 5: Pas 2 PeyroL showed [6c 6h] and lost with Two pairs : 8 and 6


Winamax Poker - HOLD-UP "Colorado" - HandId: #19116069-330547-1701434567 - Holdem no limit (0.01€/0.02€) - 2023/12/01 12:42:47 UTC
Table: 'Colorado' 6-max (real money) Seat #6 is the button
Seat 1: Fried Berg (2.29€)
Seat 2: vlalouloute (2€)
Seat 3: curiouz dje (4€)
Seat 4: JFSredbaron (2.44€)
Seat 5: El Paellas (0.50€)
Seat 6: Homer14510 (1.97€)
*** ANTE/BLINDS ***
Fried Berg posts small blind 0.01€
vlalouloute posts big blind 0.02€
Dealt to Fried Berg [Ts Qd]
*** PRE-FLOP *** 
curiouz dje folds
JFSredbaron raises 0.04€ to 0.06€
El Paellas folds
Homer14510 folds
Fried Berg folds
vlalouloute folds
JFSredbaron collected 0.09€ from pot
*** SUMMARY ***
Total pot 0.09€ | No rake
Seat 4: JFSredbaron won 0.09€


Winamax Poker - HOLD-UP "Colorado" - HandId: #19116069-330569-1701434580 - Holdem no limit (0.01€/0.02€) - 2023/12/01 12:43:00 UTC
Table: 'Colorado' 6-max (real money) Seat #6 is the button
Seat 1: Ju89400 (2.09€)
Seat 2: DigBick99 (2.03€)
Seat 3: El-suuupo (2.23€)
Seat 4: KKamarAAde (3.32€)
Seat 5: Fried Berg (2.28€)
Seat 6: Perf-31 (2.03€)
*** ANTE/BLINDS ***
Ju89400 posts small blind 0.01€
DigBick99 posts big blind 0.02€
Dealt to Fried Berg [2d Qd]
*** PRE-FLOP *** 
El-suuupo folds
KKamarAAde folds
Fried Berg raises 0.02€ to 0.04€
Perf-31 folds
Ju89400 calls 0.03€
DigBick99 folds
*** FLOP *** [Jc 9h 6s]
Ju89400 checks
Fried Berg checks
*** TURN *** [Jc 9h 6s][Kd]
Ju89400 checks
Fried Berg checks
*** RIVER *** [Jc 9h 6s Kd][Kh]
Ju89400 checks
Fried Berg checks
*** SHOW DOWN ***
Fried Berg shows [2d Qd] (One pair : Kings)
Ju89400 shows [5h Ah] (One pair : Kings)
Ju89400 collected 0.09€ from pot
*** SUMMARY ***
Total pot 0.09€ | Rake 0.01€
Board: [Jc 9h 6s Kd Kh]
Seat 1: Ju89400 (small blind) showed [5h Ah] and won 0.09€ with One pair : Kings
Seat 5: Fried Berg showed [2d Qd] and lost with One pair : Kings


Winamax Poker - HOLD-UP "Colorado" - HandId: #19116069-330650-1701434630 - Holdem no limit (0.01€/0.02€) - 2023/12/01 12:43:50 UTC
Table: 'Colorado' 6-max (real money) Seat #6 is the button
Seat 1: metamex (1.41€)
Seat 2: Fried Berg (2.24€)
Seat 3: GTO-Mieko (2.18€)
Seat 4: ViiKing (1.08€)
Seat 5: JFSredbaron (2.40€)
Seat 6: Homer14510 (1.96€)
*** ANTE/BLINDS ***
metamex posts small blind 0.01€
Fried Berg posts big blind 0.02€
Dealt to Fried Berg [Tc 2h]
*** PRE-FLOP *** 
GTO-Mieko folds
ViiKing folds
JFSredbaron folds
Homer14510 folds
metamex raises 0.02€ to 0.04€
Fried Berg folds
metamex collected 0.06€ from pot
*** SUMMARY ***
Total pot 0.06€ | No rake
Seat 1: metamex (small blind) won 0.06€


Winamax Poker - HOLD-UP "Colorado" - HandId: #19116069-330701-1701434656 - Holdem no limit (0.01€/0.02€) - 2023/12/01 12:44:16 UTC
Table: 'Colorado' 6-max (real money) Seat #6 is the button
Seat 1: JFSredbaron (2.06€)
Seat 2: Perf-31 (2.06€)
Seat 3: Fried Berg (2.22€)
Seat 4: Hydramist (2.55€)
Seat 5: x spoony (2.25€)
Seat 6: Astaril (2.16€)
*** ANTE/BLINDS ***
JFSredbaron posts small blind 0.01€
Perf-31 posts big blind 0.02€
Dealt to Fried Berg [Ad Ks]
*** PRE-FLOP *** 
Fried Berg raises 0.03€ to 0.05€
Hydramist folds
x spoony folds
Astaril folds
JFSredbaron folds
Perf-31 calls 0.03€
*** FLOP *** [Td 3h 5d]
Perf-31 checks
Fried Berg checks
*** TURN *** [Td 3h 5d][3d]
Perf-31 bets 0.07€
Fried Berg calls 0.07€
*** RIVER *** [Td 3h 5d 3d][Tc]
Perf-31 checks
Fried Berg checks
*** SHOW DOWN ***
Fried Berg shows [Ad Ks] (Two pairs : Tens and 3)
Perf-31 shows [6d Kd] (Flush King high)
Perf-31 collected 0.22€ from pot
*** SUMMARY ***
Total pot 0.22€ | Rake 0.03€
Board: [Td 3h 5d 3d Tc]
Seat 2: Perf-31 (big blind) showed [6d Kd] and won 0.22€ with Flush King high
Seat 3: Fried Berg showed [Ad Ks] and lost with Two pairs : Tens and 3


Winamax Poker - HOLD-UP "Colorado" - HandId: #19116069-330771-1701434693 - Holdem no limit (0.01€/0.02€) - 2023/12/01 12:44:53 UTC
Table: 'Colorado' 6-max (real money) Seat #6 is the button
Seat 1: Perf-31 (2.16€)
Seat 2: Clemence75 (2.01€)
Seat 3: Fried Berg (2.10€)
Seat 4: Pas 2 PeyroL (2.67€)
Seat 5: TaBrEaMoI (2.07€)
Seat 6: Charlise2 (1.40€)
*** ANTE/BLINDS ***
Perf-31 posts small blind 0.01€
Clemence75 posts big blind 0.02€
Dealt to Fried Berg [Tc 5d]
*** PRE-FLOP *** 
Fried Berg folds
Pas 2 PeyroL folds
TaBrEaMoI folds
Charlise2 folds
Perf-31 raises 0.04€ to 0.06€
Clemence75 raises 0.18€ to 0.24€
Perf-31 folds
Clemence75 collected 0.30€ from pot
*** SUMMARY ***
Total pot 0.30€ | No rake
Seat 2: Clemence75 (big blind) won 0.30€


Winamax Poker - HOLD-UP "Colorado" - HandId: #19116069-330777-1701434696 - Holdem no limit (0.01€/0.02€) - 2023/12/01 12:44:56 UTC
Table: 'Colorado' 6-max (real money) Seat #6 is the button
Seat 1: Fried Berg (2.10€)
Seat 2: ricki64 (1.08€)
Seat 3: El-suuupo (2.16€)
Seat 4: metamex (1.38€)
Seat 5: _gonzai_ (2.07€)
Seat 6: HiTxXx (2€)
*** ANTE/BLINDS ***
Fried Berg posts small blind 0.01€
ricki64 posts big blind 0.02€
Dealt to Fried Berg [6h 5c]
*** PRE-FLOP *** 
El-suuupo folds
metamex folds
_gonzai_ folds
HiTxXx folds
Fried Berg folds
ricki64 collected 0.03€ from pot
*** SUMMARY ***
Total pot 0.03€ | No rake
Seat 2: ricki64 (big blind) won 0.03€


Winamax Poker - HOLD-UP "Colorado" - HandId: #19116069-330788-1701434702 - Holdem no limit (0.01€/0.02€) - 2023/12/01 12:45:02 UTC
Table: 'Colorado' 6-max (real money) Seat #6 is the button
Seat 1: Caropitchoun (8.72€)
Seat 2: Thommynabo (3.95€)
Seat 3: Hydramist (3.32€)
Seat 4: Fried Berg (2.09€)
Seat 5: KKamarAAde (5.41€)
Seat 6: El Paellas (0.51€)
*** ANTE/BLINDS ***
Caropitchoun posts small blind 0.01€
Thommynabo posts big blind 0.02€
Dealt to Fried Berg [Qc 4h]
*** PRE-FLOP *** 
Hydramist folds
Fried Berg folds
KKamarAAde folds
El Paellas folds
Caropitchoun folds
Thommynabo collected 0.03€ from pot
*** SUMMARY ***
Total pot 0.03€ | No rake
Seat 2: Thommynabo (big blind) won 0.03€


Winamax Poker - HOLD-UP "Colorado" - HandId: #19116069-330796-1701434706 - Holdem no limit (0.01€/0.02€) - 2023/12/01 12:45:06 UTC
Table: 'Colorado' 6-max (real money) Seat #6 is the button
Seat 1: gbtcorp (2.55€)
Seat 2: x spoony (2.83€)
Seat 3: DGG23 (0.44€)
Seat 4: DosdeBras (0.93€)
Seat 5: Thor99 (2.21€)
Seat 6: Fried Berg (2.09€)
*** ANTE/BLINDS ***
gbtcorp posts small blind 0.01€
x spoony posts big blind 0.02€
Dealt to Fried Berg [8s 2c]
*** PRE-FLOP *** 
DGG23 folds
DosdeBras folds
Thor99 folds
Fried Berg folds
gbtcorp folds
x spoony collected 0.03€ from pot
*** SUMMARY ***
Total pot 0.03€ | No rake
Seat 2: x spoony (big blind) won 0.03€


Winamax Poker - HOLD-UP "Colorado" - HandId: #19116069-330804-1701434711 - Holdem no limit (0.01€/0.02€) - 2023/12/01 12:45:11 UTC
Table: 'Colorado' 6-max (real money) Seat #6 is the button
Seat 1: Fried Berg (2.09€)
Seat 2: Thor99 (2.21€)
Seat 3: Pas 2 PeyroL (2.18€)
Seat 4: JFSredbaron (2€)
Seat 5: Perf-31 (2.10€)
Seat 6: HiTxXx (2€)
*** ANTE/BLINDS ***
Fried Berg posts small blind 0.01€
Thor99 posts big blind 0.02€
Dealt to Fried Berg [6c 4s]
*** PRE-FLOP *** 
Pas 2 PeyroL folds
JFSredbaron raises 0.04€ to 0.06€
Perf-31 folds
HiTxXx folds
Fried Berg folds
Thor99 folds
JFSredbaron collected 0.09€ from pot
*** SUMMARY ***
Total pot 0.09€ | No rake
Seat 4: JFSredbaron won 0.09€


Winamax Poker - HOLD-UP "Colorado" - HandId: #19116069-330822-1701434721 - Holdem no limit (0.01€/0.02€) - 2023/12/01 12:45:21 UTC
Table: 'Colorado' 6-max (real money) Seat #6 is the button
Seat 1: Caropitchoun (8.69€)
Seat 2: papashark14 (1.87€)
Seat 3: Lumayou (0.92€)
Seat 4: solmer (2.18€)
Seat 5: bastos2525 (2.51€)
Seat 6: Fried Berg (2.08€)
*** ANTE/BLINDS ***
Caropitchoun posts small blind 0.01€
papashark14 posts big blind 0.02€
Dealt to Fried Berg [Qh 5d]
*** PRE-FLOP *** 
Lumayou folds
solmer raises 0.03€ to 0.05€
bastos2525 folds
Fried Berg folds
Caropitchoun calls 0.04€
papashark14 folds
*** FLOP *** [2c 9s 3h]
Caropitchoun checks
solmer bets 0.12€
Caropitchoun folds
solmer collected 0.23€ from pot
*** SUMMARY ***
Total pot 0.23€ | Rake 0.01€
Board: [2c 9s 3h]
Seat 4: solmer won 0.23€


Winamax Poker - HOLD-UP "Colorado" - HandId: #19116069-330833-1701434729 - Holdem no limit (0.01€/0.02€) - 2023/12/01 12:45:29 UTC
Table: 'Colorado' 6-max (real money) Seat #6 is the button
Seat 1: DigBick99 (4.89€)
Seat 2: Fried Berg (2.08€)
Seat 3: Tounsi49 (2.09€)
Seat 4: Pop_hop_hop (0.90€)
Seat 5: vlalouloute (2.46€)
Seat 6: DIOSLOKI1 9 (0.60€)
*** ANTE/BLINDS ***
DigBick99 posts small blind 0.01€
Fried Berg posts big blind 0.02€
Dealt to Fried Berg [4h Ah]
*** PRE-FLOP *** 
Tounsi49 folds
Pop_hop_hop folds
vlalouloute folds
DIOSLOKI1 9 raises 0.05€ to 0.07€
DigBick99 folds
Fried Berg calls 0.05€
*** FLOP *** [Ad As Ts]
Fried Berg checks
DIOSLOKI1 9 bets 0.15€
Fried Berg calls 0.15€
*** TURN *** [Ad As Ts][6d]
Fried Berg checks
DIOSLOKI1 9 checks
*** RIVER *** [Ad As Ts 6d][2s]
Fried Berg bets 0.16€
DIOSLOKI1 9 folds
Fried Berg collected 0.56€ from pot
*** SUMMARY ***
Total pot 0.56€ | Rake 0.05€
Board: [Ad As Ts 6d 2s]
Seat 2: Fried Berg (big blind) won 0.56€


Winamax Poker - HOLD-UP "Colorado" - HandId: #19116069-330913-1701434787 - Holdem no limit (0.01€/0.02€) - 2023/12/01 12:46:27 UTC
Table: 'Colorado' 6-max (real money) Seat #6 is the button
Seat 1: curiouz dje (2€)
Seat 2: DigBick99 (2.74€)
Seat 3: GTO-Mieko (2.13€)
Seat 4: Fried Berg (2.26€)
Seat 5: Thommynabo (4.15€)
Seat 6: Clemence75 (2.18€)
*** ANTE/BLINDS ***
curiouz dje posts small blind 0.01€
DigBick99 posts big blind 0.02€
Dealt to Fried Berg [Qc 3s]
*** PRE-FLOP *** 
GTO-Mieko raises 0.03€ to 0.05€
Fried Berg folds
Thommynabo folds
Clemence75 folds
curiouz dje folds
DigBick99 folds
GTO-Mieko collected 0.08€ from pot
*** SUMMARY ***
Total pot 0.08€ | No rake
Seat 3: GTO-Mieko won 0.08€


Winamax Poker - HOLD-UP "Colorado" - HandId: #19116069-330936-1701434804 - Holdem no limit (0.01€/0.02€) - 2023/12/01 12:46:44 UTC
Table: 'Colorado' 6-max (real money) Seat #6 is the button
Seat 1: Mr.gelillo (1.98€)
Seat 2: Fried Berg (2.26€)
Seat 3: KKamarAAde (5.54€)
Seat 4: J.C Deuces.0 (2.59€)
Seat 5: Gegebrayan (0.13€)
Seat 6: BlondBSE59 (1.94€)
*** ANTE/BLINDS ***
Mr.gelillo posts small blind 0.01€
Fried Berg posts big blind 0.02€
Dealt to Fried Berg [Ad 4s]
*** PRE-FLOP *** 
KKamarAAde folds
J.C Deuces.0 folds
Gegebrayan folds
BlondBSE59 folds
Mr.gelillo folds
Fried Berg collected 0.03€ from pot
*** SUMMARY ***
Total pot 0.03€ | No rake
Seat 2: Fried Berg (big blind) won 0.03€


Winamax Poker - HOLD-UP "Colorado" - HandId: #19116069-330962-1701434819 - Holdem no limit (0.01€/0.02€) - 2023/12/01 12:46:59 UTC
Table: 'Colorado' 6-max (real money) Seat #6 is the button
Seat 1: x spoony (2.10€)
Seat 2: KON-2-PEUTE (3.12€)
Seat 3: Fried Berg (2.27€)
Seat 4: DigBick99 (2.71€)
Seat 5: gbtcorp (2.18€)
Seat 6: TheRealWill (5.30€)
*** ANTE/BLINDS ***
x spoony posts small blind 0.01€
KON-2-PEUTE posts big blind 0.02€
Dealt to Fried Berg [9s Kc]
*** PRE-FLOP *** 
Fried Berg folds
DigBick99 folds
gbtcorp raises 0.04€ to 0.06€
TheRealWill folds
x spoony folds
KON-2-PEUTE calls 0.04€
*** FLOP *** [4c 6c Jh]
KON-2-PEUTE checks
gbtcorp checks
*** TURN *** [4c 6c Jh][As]
KON-2-PEUTE checks
gbtcorp checks
*** RIVER *** [4c 6c Jh As][2c]
KON-2-PEUTE checks
gbtcorp bets 0.07€
KON-2-PEUTE folds
gbtcorp collected 0.19€ from pot
*** SUMMARY ***
Total pot 0.19€ | Rake 0.01€
Board: [4c 6c Jh As 2c]
Seat 5: gbtcorp won 0.19€


Winamax Poker - HOLD-UP "Colorado" - HandId: #19116069-330966-1701434822 - Holdem no limit (0.01€/0.02€) - 2023/12/01 12:47:02 UTC
Table: 'Colorado' 6-max (real money) Seat #6 is the button
Seat 1: Mr.gelillo (1.49€)
Seat 2: vlalouloute (2.56€)
Seat 3: ECPulga (1.97€)
Seat 4: Evil Xav (1.98€)
Seat 5: Fried Berg (2.27€)
Seat 6: solmer (2.18€)
*** ANTE/BLINDS ***
Mr.gelillo posts small blind 0.01€
vlalouloute posts big blind 0.02€
Dealt to Fried Berg [Jd 7s]
*** PRE-FLOP *** 
ECPulga raises 0.03€ to 0.05€
Evil Xav calls 0.05€
Fried Berg folds
solmer folds
Mr.gelillo folds
vlalouloute folds
*** FLOP *** [8c 6c Qc]
ECPulga bets 0.05€
Evil Xav calls 0.05€
*** TURN *** [8c 6c Qc][6s]
ECPulga checks
Evil Xav checks
*** RIVER *** [8c 6c Qc 6s][7d]
ECPulga checks
Evil Xav checks
*** SHOW DOWN ***
ECPulga shows [Ts Ks] (One pair : 6)
Evil Xav shows [Ac 3d] (One pair : 6)
Evil Xav collected 0.21€ from pot
*** SUMMARY ***
Total pot 0.21€ | Rake 0.02€
Board: [8c 6c Qc 6s 7d]
Seat 3: ECPulga showed [Ts Ks] and lost with One pair : 6
Seat 4: Evil Xav showed [Ac 3d] and won 0.21€ with One pair : 6


Winamax Poker - HOLD-UP "Colorado" - HandId: #19116069-330972-1701434825 - Holdem no limit (0.01€/0.02€) - 2023/12/01 12:47:05 UTC
Table: 'Colorado' 6-max (real money) Seat #6 is the button
Seat 1: Fried Berg (2.27€)
Seat 2: x spoony (2.09€)
Seat 3: Obiwan70 (3.41€)
Seat 4: Astaril (3.11€)
Seat 5: Caropitchoun (8.66€)
Seat 6: papashark14 (0.98€)
Hold-up to Pot: total 0.10€
*** ANTE/BLINDS ***
Fried Berg posts small blind 0.01€
x spoony posts big blind 0.02€
Dealt to Fried Berg [Ac Jh]
*** PRE-FLOP *** 
Obiwan70 folds
Astaril folds
Caropitchoun raises 0.05€ to 0.07€
papashark14 folds
Fried Berg raises 0.14€ to 0.21€
x spoony folds
Caropitchoun folds
Fried Berg collected 0.40€ from pot
*** SUMMARY ***
Total pot 0.40€ | No rake
Seat 1: Fried Berg (small blind) won 0.40€


Winamax Poker - HOLD-UP "Colorado" - HandId: #19116069-331010-1701434849 - Holdem no limit (0.01€/0.02€) - 2023/12/01 12:47:29 UTC
Table: 'Colorado' 6-max (real money) Seat #6 is the button
Seat 1: toka30 (3.11€)
Seat 2: KKamarAAde (3.23€)
Seat 3: Fried Berg (2.46€)
Seat 4: bastos2525 (1.47€)
Seat 5: mea botellas (2.09€)
Seat 6: vlalouloute (2.53€)
*** ANTE/BLINDS ***
toka30 posts small blind 0.01€
KKamarAAde posts big blind 0.02€
Dealt to Fried Berg [6c 8s]
*** PRE-FLOP *** 
Fried Berg folds
bastos2525 folds
mea botellas folds
vlalouloute folds
toka30 folds
KKamarAAde collected 0.03€ from pot
*** SUMMARY ***
Total pot 0.03€ | No rake
Seat 2: KKamarAAde (big blind) won 0.03€


Winamax Poker - HOLD-UP "Colorado" - HandId: #19116069-331018-1701434855 - Holdem no limit (0.01€/0.02€) - 2023/12/01 12:47:35 UTC
Table: 'Colorado' 6-max (real money) Seat #6 is the button
Seat 1: BAAC0 (2.06€)
Seat 2: DigBick99 (2.12€)
Seat 3: Mr.gelillo (1.48€)
Seat 4: Clemence75 (2.38€)
Seat 5: Fried Berg (2.46€)
Seat 6: mea botellas (2.09€)
*** ANTE/BLINDS ***
BAAC0 posts small blind 0.01€
DigBick99 posts big blind 0.02€
Dealt to Fried Berg [Qh 4s]
*** PRE-FLOP *** 
Mr.gelillo folds
Clemence75 folds
Fried Berg folds
mea botellas raises 0.02€ to 0.04€
BAAC0 folds
DigBick99 folds
mea botellas collected 0.07€ from pot
*** SUMMARY ***
Total pot 0.07€ | No rake
Seat 6: mea botellas (button) won 0.07€


Winamax Poker - HOLD-UP "Colorado" - HandId: #19116069-331023-1701434859 - Holdem no limit (0.01€/0.02€) - 2023/12/01 12:47:39 UTC
Table: 'Colorado' 6-max (real money) Seat #6 is the button
Seat 1: Fried Berg (2.46€)
Seat 2: Bacardi34 (2.26€)
Seat 3: TaBrEaMoI (2.24€)
Seat 4: El-suuupo (2.36€)
Seat 5: El Paellas (0.50€)
Seat 6: metamex (1.21€)
*** ANTE/BLINDS ***
Fried Berg posts small blind 0.01€
Bacardi34 posts big blind 0.02€
Dealt to Fried Berg [3h 7c]
*** PRE-FLOP *** 
TaBrEaMoI raises 0.04€ to 0.06€
El-suuupo folds
El Paellas folds
metamex folds
Fried Berg folds
Bacardi34 calls 0.04€
*** FLOP *** [As Ac Js]
Bacardi34 checks
TaBrEaMoI checks
*** TURN *** [As Ac Js][4h]
Bacardi34 checks
TaBrEaMoI checks
*** RIVER *** [As Ac Js 4h][5s]
Bacardi34 bets 0.13€
TaBrEaMoI folds
Bacardi34 collected 0.25€ from pot
*** SUMMARY ***
Total pot 0.25€ | Rake 0.01€
Board: [As Ac Js 4h 5s]
Seat 2: Bacardi34 (big blind) won 0.25€


Winamax Poker - HOLD-UP "Colorado" - HandId: #19116069-331026-1701434862 - Holdem no limit (0.01€/0.02€) - 2023/12/01 12:47:42 UTC
Table: 'Colorado' 6-max (real money) Seat #6 is the button
Seat 1: vlalouloute (3.17€)
Seat 2: Fried Berg (2.45€)
Seat 3: JFSredbaron (3.39€)
Seat 4: metamex (1.21€)
Seat 5: KKamarAAde (3.24€)
Seat 6: Piiranha (2.09€)
*** ANTE/BLINDS ***
vlalouloute posts small blind 0.01€
Fried Berg posts big blind 0.02€
Dealt to Fried Berg [3h 2d]
*** PRE-FLOP *** 
JFSredbaron raises 0.04€ to 0.06€
metamex folds
KKamarAAde folds
Piiranha folds
vlalouloute folds
Fried Berg folds
JFSredbaron collected 0.09€ from pot
*** SUMMARY ***
Total pot 0.09€ | No rake
Seat 3: JFSredbaron won 0.09€


Winamax Poker - HOLD-UP "Colorado" - HandId: #19116069-331031-1701434867 - Holdem no limit (0.01€/0.02€) - 2023/12/01 12:47:47 UTC
Table: 'Colorado' 6-max (real money) Seat #6 is the button
Seat 1: Hydramist (3.89€)
Seat 2: Caropitchoun (3.90€)
Seat 3: Homer14510 (1.85€)
Seat 4: DGG23 (0.43€)
Seat 5: Fried Berg (2.43€)
Seat 6: metamex (1.21€)
*** ANTE/BLINDS ***
Hydramist posts small blind 0.01€
Caropitchoun posts big blind 0.02€
Dealt to Fried Berg [Tc 9d]
*** PRE-FLOP *** 
Homer14510 folds
DGG23 folds
Fried Berg folds
metamex folds
Hydramist folds
Caropitchoun collected 0.03€ from pot
*** SUMMARY ***
Total pot 0.03€ | No rake
Seat 2: Caropitchoun (big blind) won 0.03€


Winamax Poker - HOLD-UP "Colorado" - HandId: #19116069-331044-1701434875 - Holdem no limit (0.01€/0.02€) - 2023/12/01 12:47:55 UTC
Table: 'Colorado' 6-max (real money) Seat #6 is the button
Seat 1: Mr.gelillo (1.49€)
Seat 2: Myprincess (1.59€)
Seat 3: Fried Berg (2.43€)
Seat 4: Astaril (3.11€)
Seat 5: BlondBSE59 (1.72€)
Seat 6: DonKmillo (7.90€)
*** ANTE/BLINDS ***
Mr.gelillo posts small blind 0.01€
Myprincess posts big blind 0.02€
Dealt to Fried Berg [5c Jh]
*** PRE-FLOP *** 
Fried Berg folds
Astaril folds
BlondBSE59 folds
DonKmillo raises 0.04€ to 0.06€
Mr.gelillo folds
Myprincess folds
DonKmillo collected 0.09€ from pot
*** SUMMARY ***
Total pot 0.09€ | No rake
Seat 6: DonKmillo (button) won 0.09€


Winamax Poker - HOLD-UP "Colorado" - HandId: #19116069-331046-1701434877 - Holdem no limit (0.01€/0.02€) - 2023/12/01 12:47:57 UTC
Table: 'Colorado' 6-max (real money) Seat #6 is the button
Seat 1: JFSredbaron (3.42€)
Seat 2: bastos2525 (2.76€)
Seat 3: DGG23 (0.40€)
Seat 4: vlalouloute (3.16€)
Seat 5: KKamarAAde (3.23€)
Seat 6: Fried Berg (2.43€)
*** ANTE/BLINDS ***
JFSredbaron posts small blind 0.01€
bastos2525 posts big blind 0.02€
Dealt to Fried Berg [2s 4d]
*** PRE-FLOP *** 
DGG23 folds
vlalouloute folds
KKamarAAde folds
Fried Berg folds
JFSredbaron raises 0.04€ to 0.06€
bastos2525 calls 0.04€
*** FLOP *** [8d 5h 7c]
JFSredbaron bets 0.08€
bastos2525 folds
JFSredbaron collected 0.19€ from pot
*** SUMMARY ***
Total pot 0.19€ | Rake 0.01€
Board: [8d 5h 7c]
Seat 1: JFSredbaron (small blind) won 0.19€


Winamax Poker - HOLD-UP "Colorado" - HandId: #19116069-331050-1701434879 - Holdem no limit (0.01€/0.02€) - 2023/12/01 12:47:59 UTC
Table: 'Colorado' 6-max (real money) Seat #6 is the button
Seat 1: curiouz dje (3.10€)
Seat 2: Clemence75 (2.37€)
Seat 3: Seb bzh (0.34€)
Seat 4: DGG23 (0.40€)
Seat 5: MagicBast 1 (1.82€)
Seat 6: Fried Berg (2.43€)
*** ANTE/BLINDS ***
curiouz dje posts small blind 0.01€
Clemence75 posts big blind 0.02€
Dealt to Fried Berg [Kd 8c]
*** PRE-FLOP *** 
Seb bzh folds
DGG23 folds
MagicBast 1 folds
Fried Berg folds
curiouz dje folds
Clemence75 collected 0.03€ from pot
*** SUMMARY ***
Total pot 0.03€ | No rake
Seat 2: Clemence75 (big blind) won 0.03€


Winamax Poker - HOLD-UP "Colorado" - HandId: #19116069-331064-1701434888 - Holdem no limit (0.01€/0.02€) - 2023/12/01 12:48:08 UTC
Table: 'Colorado' 6-max (real money) Seat #6 is the button
Seat 1: Myprincess (1.57€)
Seat 2: vlalouloute (2.74€)
Seat 3: papashark14 (0.92€)
Seat 4: Homer14510 (1.85€)
Seat 5: GTO-Mieko (2.26€)
Seat 6: Fried Berg (2.43€)
*** ANTE/BLINDS ***
Myprincess posts small blind 0.01€
vlalouloute posts big blind 0.02€
Dealt to Fried Berg [6c Th]
*** PRE-FLOP *** 
papashark14 folds
Homer14510 folds
GTO-Mieko raises 0.03€ to 0.05€
Fried Berg folds
Myprincess raises 0.10€ to 0.15€
vlalouloute folds
GTO-Mieko calls 0.10€
*** FLOP *** [4h Jc 9c]
Myprincess bets 0.11€
GTO-Mieko calls 0.11€
*** TURN *** [4h Jc 9c][Ac]
Myprincess bets 0.19€
GTO-Mieko calls 0.19€
*** RIVER *** [4h Jc 9c Ac][2h]
Myprincess bets 0.60€
GTO-Mieko calls 0.60€
*** SHOW DOWN ***
Myprincess shows [As Kd] (One pair : Aces)
GTO-Mieko shows [4c 4s] (Trips of 4)
GTO-Mieko collected 1.91€ from pot
*** SUMMARY ***
Total pot 1.91€ | Rake 0.21€
Board: [4h Jc 9c Ac 2h]
Seat 1: Myprincess (small blind) showed [As Kd] and lost with One pair : Aces
Seat 5: GTO-Mieko showed [4c 4s] and won 1.91€ with Trips of 4


Winamax Poker - HOLD-UP "Colorado" - HandId: #19116069-331068-1701434891 - Holdem no limit (0.01€/0.02€) - 2023/12/01 12:48:11 UTC
Table: 'Colorado' 6-max (real money) Seat #6 is the button
Seat 1: Piiranha (2.07€)
Seat 2: C2LATAM (1€)
Seat 3: Fried Berg (2.43€)
Seat 4: TheRealWill (2.32€)
Seat 5: Savab1spaser (2.05€)
Seat 6: El Paellas (0.50€)
*** ANTE/BLINDS ***
Piiranha posts small blind 0.01€
C2LATAM posts big blind 0.02€
Dealt to Fried Berg [7c Jc]
*** PRE-FLOP *** 
Fried Berg folds
TheRealWill folds
Savab1spaser folds
El Paellas raises 0.03€ to 0.05€
Piiranha folds
C2LATAM calls 0.03€
*** FLOP *** [5s Jd 4s]
C2LATAM checks
El Paellas checks
*** TURN *** [5s Jd 4s][2h]
C2LATAM checks
El Paellas checks
*** RIVER *** [5s Jd 4s 2h][Kc]
C2LATAM bets 0.07€
El Paellas folds
C2LATAM collected 0.17€ from pot
*** SUMMARY ***
Total pot 0.17€ | Rake 0.01€
Board: [5s Jd 4s 2h Kc]
Seat 2: C2LATAM (big blind) won 0.17€


Winamax Poker - HOLD-UP "Colorado" - HandId: #19116069-331077-1701434895 - Holdem no limit (0.01€/0.02€) - 2023/12/01 12:48:15 UTC
Table: 'Colorado' 6-max (real money) Seat #6 is the button
Seat 1: colgate12 (1.70€)
Seat 2: Fried Berg (2.43€)
Seat 3: Hagreed (1.62€)
Seat 4: BAAC0 (2.05€)
Seat 5: curiouz dje (3.09€)
Seat 6: papashark14 (1.88€)
*** ANTE/BLINDS ***
colgate12 posts small blind 0.01€
Fried Berg posts big blind 0.02€
Dealt to Fried Berg [5c 8c]
*** PRE-FLOP *** 
Hagreed folds
BAAC0 folds
curiouz dje folds
papashark14 folds
colgate12 folds
Fried Berg collected 0.03€ from pot
*** SUMMARY ***
Total pot 0.03€ | No rake
Seat 2: Fried Berg (big blind) won 0.03€


Winamax Poker - HOLD-UP "Colorado" - HandId: #19116069-331088-1701434902 - Holdem no limit (0.01€/0.02€) - 2023/12/01 12:48:22 UTC
Table: 'Colorado' 6-max (real money) Seat #6 is the button
Seat 1: DigBick99 (2.10€)
Seat 2: Clemence75 (2.43€)
Seat 3: curiouz dje (4.02€)
Seat 4: Fried Berg (2.44€)
Seat 5: kRaSsNy (1.21€)
Seat 6: MagicBast 1 (1.82€)
*** ANTE/BLINDS ***
DigBick99 posts small blind 0.01€
Clemence75 posts big blind 0.02€
Dealt to Fried Berg [4s 5c]
*** PRE-FLOP *** 
curiouz dje folds
Fried Berg folds
kRaSsNy folds
MagicBast 1 raises 0.03€ to 0.05€
DigBick99 folds
Clemence75 folds
MagicBast 1 collected 0.08€ from pot
*** SUMMARY ***
Total pot 0.08€ | No rake
Seat 6: MagicBast 1 (button) won 0.08€


Winamax Poker - HOLD-UP "Colorado" - HandId: #19116069-331096-1701434907 - Holdem no limit (0.01€/0.02€) - 2023/12/01 12:48:27 UTC
Table: 'Colorado' 6-max (real money) Seat #6 is the button
Seat 1: curiouz dje (2.18€)
Seat 2: bastos2525 (0.94€)
Seat 3: x spoony (2.16€)
Seat 4: Fried Berg (2.44€)
Seat 5: Charlise2 (2.06€)
Seat 6: Mr.gelillo (1.48€)
*** ANTE/BLINDS ***
curiouz dje posts small blind 0.01€
bastos2525 posts big blind 0.02€
Dealt to Fried Berg [5s 7h]
*** PRE-FLOP *** 
x spoony folds
Fried Berg folds
Charlise2 raises 0.04€ to 0.06€
Mr.gelillo folds
curiouz dje folds
bastos2525 folds
Charlise2 collected 0.09€ from pot
*** SUMMARY ***
Total pot 0.09€ | No rake
Seat 5: Charlise2 won 0.09€


Winamax Poker - HOLD-UP "Colorado" - HandId: #19116069-331099-1701434909 - Holdem no limit (0.01€/0.02€) - 2023/12/01 12:48:29 UTC
Table: 'Colorado' 6-max (real money) Seat #6 is the button
Seat 1: Perf-31 (2.46€)
Seat 2: ilergeta (2.51€)
Seat 3: x spoony (2.16€)
Seat 4: Fried Berg (2.44€)
Seat 5: BAAC0 (2.03€)
Seat 6: KKamarAAde (5.58€)
*** ANTE/BLINDS ***
Perf-31 posts small blind 0.01€
ilergeta posts big blind 0.02€
Dealt to Fried Berg [6d 8s]
*** PRE-FLOP *** 
x spoony folds
Fried Berg folds
BAAC0 folds
KKamarAAde folds
Perf-31 folds
ilergeta collected 0.03€ from pot
*** SUMMARY ***
Total pot 0.03€ | No rake
Seat 2: ilergeta (big blind) won 0.03€


Winamax Poker - HOLD-UP "Colorado" - HandId: #19116069-331102-1701434912 - Holdem no limit (0.01€/0.02€) - 2023/12/01 12:48:32 UTC
Table: 'Colorado' 6-max (real money) Seat #6 is the button
Seat 1: Fried Berg (2.44€)
Seat 2: Pas 2 PeyroL (2€)
Seat 3: DGG23 (0.46€)
Seat 4: x spoony (2.16€)
Seat 5: TaBrEaMoI (2€)
Seat 6: Astaril (3.11€)
*** ANTE/BLINDS ***
Fried Berg posts small blind 0.01€
Pas 2 PeyroL posts big blind 0.02€
Dealt to Fried Berg [Ac 9s]
*** PRE-FLOP *** 
DGG23 folds
x spoony folds
TaBrEaMoI folds
Astaril folds
Fried Berg raises 0.04€ to 0.06€
Pas 2 PeyroL calls 0.04€
*** FLOP *** [3h Jh 5c]
Fried Berg checks
Pas 2 PeyroL bets 0.09€
Fried Berg folds
Pas 2 PeyroL collected 0.20€ from pot
*** SUMMARY ***
Total pot 0.20€ | Rake 0.01€
Board: [3h Jh 5c]
Seat 2: Pas 2 PeyroL (big blind) won 0.20€


Winamax Poker - HOLD-UP "Colorado" - HandId: #19116069-331147-1701434946 - Holdem no limit (0.01€/0.02€) - 2023/12/01 12:49:06 UTC
Table: 'Colorado' 6-max (real money) Seat #6 is the button
Seat 1: Brandoni (0.99€)
Seat 2: Fried Berg (2.38€)
Seat 3: DosdeBras (2.34€)
Seat 4: Thequeen1205 (2.44€)
Seat 5: x spoony (2.09€)
Seat 6: Caropitchoun (8.77€)
*** ANTE/BLINDS ***
Brandoni posts small blind 0.01€
Fried Berg posts big blind 0.02€
Dealt to Fried Berg [7h 8s]
*** PRE-FLOP *** 
DosdeBras folds
Thequeen1205 raises 0.02€ to 0.04€
x spoony folds
Caropitchoun folds
Brandoni folds
Fried Berg folds
Thequeen1205 collected 0.07€ from pot
*** SUMMARY ***
Total pot 0.07€ | No rake
Seat 4: Thequeen1205 won 0.07€


Winamax Poker - HOLD-UP "Colorado" - HandId: #19116069-331194-1701434989 - Holdem no limit (0.01€/0.02€) - 2023/12/01 12:49:49 UTC
Table: 'Colorado' 6-max (real money) Seat #6 is the button
Seat 1: _ilTulipano_ (2€)
Seat 2: x spoony (2.08€)
Seat 3: El Paellas (0.50€)
Seat 4: Fried Berg (2.36€)
Seat 5: vlalouloute (2.69€)
Seat 6: metamex (1.83€)
*** ANTE/BLINDS ***
_ilTulipano_ posts small blind 0.01€
x spoony posts big blind 0.02€
Dealt to Fried Berg [8d 2d]
*** PRE-FLOP *** 
El Paellas raises 0.03€ to 0.05€
Fried Berg folds
vlalouloute folds
metamex folds
_ilTulipano_ raises 0.12€ to 0.17€
x spoony folds
El Paellas folds
_ilTulipano_ collected 0.24€ from pot
*** SUMMARY ***
Total pot 0.24€ | No rake
Seat 1: _ilTulipano_ (small blind) won 0.24€


Winamax Poker - HOLD-UP "Colorado" - HandId: #19116069-331198-1701434991 - Holdem no limit (0.01€/0.02€) - 2023/12/01 12:49:51 UTC
Table: 'Colorado' 6-max (real money) Seat #6 is the button
Seat 1: KKamarAAde (3.23€)
Seat 2: DigBick99 (2.52€)
Seat 3: vlalouloute (2.69€)
Seat 4: Mr.gelillo (3.32€)
Seat 5: Fried Berg (2.36€)
Seat 6: metamex (1.83€)
*** ANTE/BLINDS ***
KKamarAAde posts small blind 0.01€
DigBick99 posts big blind 0.02€
Dealt to Fried Berg [Kc 7s]
*** PRE-FLOP *** 
vlalouloute folds
Mr.gelillo folds
Fried Berg folds
metamex raises 0.04€ to 0.06€
KKamarAAde calls 0.05€
DigBick99 folds
*** FLOP *** [4s Qs 3h]
KKamarAAde checks
metamex checks
*** TURN *** [4s Qs 3h][9d]
KKamarAAde checks
metamex checks
*** RIVER *** [4s Qs 3h 9d][Ac]
KKamarAAde bets 0.11€
metamex calls 0.11€
*** SHOW DOWN ***
metamex shows [Ah Jh] (One pair : Aces)
KKamarAAde shows [9s 9h] (Trips of 9)
KKamarAAde collected 0.32€ from pot
*** SUMMARY ***
Total pot 0.32€ | Rake 0.04€
Board: [4s Qs 3h 9d Ac]
Seat 1: KKamarAAde (small blind) showed [9s 9h] and won 0.32€ with Trips of 9
Seat 6: metamex (button) showed [Ah Jh] and lost with One pair : Aces


Winamax Poker - HOLD-UP "Colorado" - HandId: #19116069-331200-1701434994 - Holdem no limit (0.01€/0.02€) - 2023/12/01 12:49:54 UTC
Table: 'Colorado' 6-max (real money) Seat #6 is the button
Seat 1: MagicBast 1 (1.85€)
Seat 2: gbtcorp (1.74€)
Seat 3: Fried Berg (2.36€)
Seat 4: Hydramist (2.02€)
Seat 5: curiouz dje (3.06€)
Seat 6: Sucre10 (1.54€)
*** ANTE/BLINDS ***
MagicBast 1 posts small blind 0.01€
gbtcorp posts big blind 0.02€
Dealt to Fried Berg [3h 6c]
*** PRE-FLOP *** 
Fried Berg folds
Hydramist folds
curiouz dje folds
Sucre10 raises 0.03€ to 0.05€
MagicBast 1 calls 0.04€
gbtcorp folds
*** FLOP *** [5h 6s Kh]
MagicBast 1 bets 0.08€
Sucre10 raises 0.19€ to 0.27€
MagicBast 1 folds
Sucre10 collected 0.44€ from pot
*** SUMMARY ***
Total pot 0.44€ | Rake 0.03€
Board: [5h 6s Kh]
Seat 6: Sucre10 (button) won 0.44€


Winamax Poker - HOLD-UP "Colorado" - HandId: #19116069-331202-1701434997 - Holdem no limit (0.01€/0.02€) - 2023/12/01 12:49:57 UTC
Table: 'Colorado' 6-max (real money) Seat #6 is the button
Seat 1: ViiKing (1.39€)
Seat 2: Thequeen1205 (2€)
Seat 3: Myprincess (1.03€)
Seat 4: Clemence75 (2€)
Seat 5: Fried Berg (2.36€)
Seat 6: DGG23 (0.42€)
*** ANTE/BLINDS ***
ViiKing posts small blind 0.01€
Thequeen1205 posts big blind 0.02€
Dealt to Fried Berg [Qh 5h]
*** PRE-FLOP *** 
Myprincess folds
Clemence75 folds
Fried Berg folds
DGG23 calls 0.02€
ViiKing calls 0.01€
Thequeen1205 checks
*** FLOP *** [7d Ac 7s]
ViiKing checks
Thequeen1205 checks
DGG23 checks
*** TURN *** [7d Ac 7s][6h]
ViiKing checks
Thequeen1205 bets 0.02€
DGG23 calls 0.02€
ViiKing calls 0.02€
*** RIVER *** [7d Ac 7s 6h][5c]
ViiKing checks
Thequeen1205 bets 0.06€
DGG23 folds
ViiKing calls 0.06€
*** SHOW DOWN ***
ViiKing shows [5d 6s] (Two pairs : 7 and 6)
Thequeen1205 shows [7h 8s] (Trips of 7)
Thequeen1205 collected 0.22€ from pot
*** SUMMARY ***
Total pot 0.22€ | Rake 0.02€
Board: [7d Ac 7s 6h 5c]
Seat 1: ViiKing (small blind) showed [5d 6s] and lost with Two pairs : 7 and 6
Seat 2: Thequeen1205 (big blind) showed [7h 8s] and won 0.22€ with Trips of 7


Winamax Poker - HOLD-UP "Colorado" - HandId: #19116069-331221-1701435014 - Holdem no limit (0.01€/0.02€) - 2023/12/01 12:50:14 UTC
Table: 'Colorado' 6-max (real money) Seat #6 is the button
Seat 1: Fried Berg (2.36€)
Seat 2: Clemence75 (2.11€)
Seat 3: mea botellas (2.54€)
Seat 4: C2LATAM (0.97€)
Seat 5: _gonzai_ (2.19€)
Seat 6: vlalouloute (2.75€)
*** ANTE/BLINDS ***
Fried Berg posts small blind 0.01€
Clemence75 posts big blind 0.02€
Dealt to Fried Berg [Qh Tc]
*** PRE-FLOP *** 
mea botellas folds
C2LATAM folds
_gonzai_ folds
vlalouloute folds
Fried Berg calls 0.01€
Clemence75 checks
*** FLOP *** [6d 4d 2c]
Fried Berg checks
Clemence75 bets 0.04€
Fried Berg calls 0.04€
*** TURN *** [6d 4d 2c][Ah]
Fried Berg checks
Clemence75 bets 0.12€
Fried Berg folds
Clemence75 collected 0.23€ from pot
*** SUMMARY ***
Total pot 0.23€ | Rake 0.01€
Board: [6d 4d 2c Ah]
Seat 2: Clemence75 (big blind) won 0.23€


Winamax Poker - HOLD-UP "Colorado" - HandId: #19116069-331310-1701435077 - Holdem no limit (0.01€/0.02€) - 2023/12/01 12:51:17 UTC
Table: 'Colorado' 6-max (real money) Seat #6 is the button
Seat 1: OursDesMers (1.41€)
Seat 2: solmer (2.07€)
Seat 3: p4ppysl4m (1.10€)
Seat 4: lut1dupoivre (0.57€)
Seat 5: Theo_dnr (0.30€)
Seat 6: Fried Berg (2.30€)
*** ANTE/BLINDS ***
OursDesMers posts small blind 0.01€
solmer posts big blind 0.02€
Dealt to Fried Berg [3d 8d]
*** PRE-FLOP *** 
p4ppysl4m folds
lut1dupoivre folds
Theo_dnr calls 0.02€
Fried Berg folds
OursDesMers calls 0.01€
solmer checks
*** FLOP *** [3s Qh 5h]
OursDesMers checks
solmer checks
Theo_dnr checks
*** TURN *** [3s Qh 5h][9c]
OursDesMers checks
solmer checks
Theo_dnr checks
*** RIVER *** [3s Qh 5h 9c][2d]
OursDesMers checks
solmer checks
Theo_dnr checks
*** SHOW DOWN ***
solmer shows [Tc 8c] (High card : Queen)
Theo_dnr shows [2h Td] (One pair : 2)
OursDesMers shows [3c Kc] (One pair : 3)
OursDesMers collected 0.05€ from pot
*** SUMMARY ***
Total pot 0.05€ | Rake 0.01€
Board: [3s Qh 5h 9c 2d]
Seat 1: OursDesMers (small blind) showed [3c Kc] and won 0.05€ with One pair : 3
Seat 2: solmer (big blind) showed [Tc 8c] and lost with High card : Queen
Seat 5: Theo_dnr showed [2h Td] and lost with One pair : 2


Winamax Poker - HOLD-UP "Colorado" - HandId: #19116069-331330-1701435089 - Holdem no limit (0.01€/0.02€) - 2023/12/01 12:51:29 UTC
Table: 'Colorado' 6-max (real money) Seat #6 is the button
Seat 1: vlalouloute (2€)
Seat 2: ViiKing (1.36€)
Seat 3: Fried Berg (2.30€)
Seat 4: bastos2525 (2.45€)
Seat 5: moussaillax (2.57€)
Seat 6: gbtcorp (2.57€)
*** ANTE/BLINDS ***
vlalouloute posts small blind 0.01€
ViiKing posts big blind 0.02€
Dealt to Fried Berg [Kd Tc]
*** PRE-FLOP *** 
Fried Berg folds
bastos2525 folds
moussaillax folds
gbtcorp folds
vlalouloute raises 0.04€ to 0.06€
ViiKing calls 0.04€
*** FLOP *** [Qh Ks 7h]
vlalouloute bets 0.03€
ViiKing folds
vlalouloute collected 0.14€ from pot
*** SUMMARY ***
Total pot 0.14€ | Rake 0.01€
Board: [Qh Ks 7h]
Seat 1: vlalouloute (small blind) won 0.14€


Winamax Poker - HOLD-UP "Colorado" - HandId: #19116069-331338-1701435095 - Holdem no limit (0.01€/0.02€) - 2023/12/01 12:51:35 UTC
Table: 'Colorado' 6-max (real money) Seat #6 is the button
Seat 1: Thequeen1205 (2.30€)
Seat 2: Fried Berg (2.30€)
Seat 3: J.C Deuces.0 (2.95€)
Seat 4: curiouz dje (2.98€)
Seat 5: ironman33 (0.60€)
Seat 6: Gildus44 (1.67€)
*** ANTE/BLINDS ***
Thequeen1205 posts small blind 0.01€
Fried Berg posts big blind 0.02€
Dealt to Fried Berg [9h 7s]
*** PRE-FLOP *** 
J.C Deuces.0 folds
curiouz dje folds
ironman33 folds
Gildus44 raises 0.02€ to 0.04€
Thequeen1205 folds
Fried Berg folds
Gildus44 collected 0.07€ from pot
*** SUMMARY ***
Total pot 0.07€ | No rake
Seat 6: Gildus44 (button) won 0.07€


Winamax Poker - HOLD-UP "Colorado" - HandId: #19116069-331362-1701435112 - Holdem no limit (0.01€/0.02€) - 2023/12/01 12:51:52 UTC
Table: 'Colorado' 6-max (real money) Seat #6 is the button
Seat 1: KKamarAAde (3.45€)
Seat 2: TaBrEaMoI (2€)
Seat 3: bastos2525 (1.29€)
Seat 4: Fried Berg (2.28€)
Seat 5: Mr.gelillo (1.96€)
Seat 6: curiouz dje (4.24€)
Hold-up to Pot: total 0.10€
*** ANTE/BLINDS ***
KKamarAAde posts small blind 0.01€
TaBrEaMoI posts big blind 0.02€
Dealt to Fried Berg [2c Qd]
*** PRE-FLOP *** 
bastos2525 raises 0.15€ to 0.17€
Fried Berg folds
Mr.gelillo folds
curiouz dje folds
KKamarAAde folds
TaBrEaMoI folds
bastos2525 collected 0.30€ from pot
*** SUMMARY ***
Total pot 0.30€ | No rake
Seat 3: bastos2525 won 0.30€


Winamax Poker - HOLD-UP "Colorado" - HandId: #19116069-331373-1701435120 - Holdem no limit (0.01€/0.02€) - 2023/12/01 12:52:00 UTC
Table: 'Colorado' 6-max (real money) Seat #6 is the button
Seat 1: Fried Berg (2.28€)
Seat 2: Pierrof24 (2€)
Seat 3: strada2012 (2.06€)
Seat 4: J.C Deuces.0 (2.95€)
Seat 5: KKamarAAde (3.44€)
Seat 6: DonKmillo (8.19€)
*** ANTE/BLINDS ***
Fried Berg posts small blind 0.01€
Pierrof24 posts big blind 0.02€
Dealt to Fried Berg [9s 2c]
*** PRE-FLOP *** 
strada2012 folds
J.C Deuces.0 folds
KKamarAAde folds
DonKmillo folds
Fried Berg folds
Pierrof24 collected 0.03€ from pot
*** SUMMARY ***
Total pot 0.03€ | No rake
Seat 2: Pierrof24 (big blind) won 0.03€


Winamax Poker - HOLD-UP "Colorado" - HandId: #19116069-331378-1701435122 - Holdem no limit (0.01€/0.02€) - 2023/12/01 12:52:02 UTC
Table: 'Colorado' 6-max (real money) Seat #6 is the button
Seat 1: Caropitchoun (2.90€)
Seat 2: OursDesMers (1.44€)
Seat 3: DGG23 (0.26€)
Seat 4: x spoony (2€)
Seat 5: Fried Berg (2.27€)
Seat 6: curiouz dje (2.49€)
*** ANTE/BLINDS ***
Caropitchoun posts small blind 0.01€
OursDesMers posts big blind 0.02€
Dealt to Fried Berg [Jd 6h]
*** PRE-FLOP *** 
DGG23 folds
x spoony folds
Fried Berg folds
curiouz dje folds
Caropitchoun folds
OursDesMers collected 0.03€ from pot
*** SUMMARY ***
Total pot 0.03€ | No rake
Seat 2: OursDesMers (big blind) won 0.03€


Winamax Poker - HOLD-UP "Colorado" - HandId: #19116069-331382-1701435124 - Holdem no limit (0.01€/0.02€) - 2023/12/01 12:52:04 UTC
Table: 'Colorado' 6-max (real money) Seat #6 is the button
Seat 1: Alexisdpp (14.38€)
Seat 2: JFSredbaron (2.87€)
Seat 3: HERminia_er6 (0.92€)
Seat 4: Caropitchoun (2.89€)
Seat 5: Feelda1337 (2.05€)
Seat 6: Fried Berg (2.27€)
*** ANTE/BLINDS ***
Alexisdpp posts small blind 0.01€
JFSredbaron posts big blind 0.02€
Dealt to Fried Berg [7c Ac]
*** PRE-FLOP *** 
HERminia_er6 folds
Caropitchoun folds
Feelda1337 folds
Fried Berg raises 0.04€ to 0.06€
Alexisdpp calls 0.05€
JFSredbaron folds
*** FLOP *** [Kc Qd 5c]
Alexisdpp checks
Fried Berg checks
*** TURN *** [Kc Qd 5c][Kd]
Alexisdpp checks
Fried Berg checks
*** RIVER *** [Kc Qd 5c Kd][3s]
Alexisdpp checks
Fried Berg checks
*** SHOW DOWN ***
Alexisdpp shows [Tc Js] (One pair : Kings)
Fried Berg shows [7c Ac] (One pair : Kings)
Fried Berg collected 0.13€ from pot
*** SUMMARY ***
Total pot 0.13€ | Rake 0.01€
Board: [Kc Qd 5c Kd 3s]
Seat 1: Alexisdpp (small blind) showed [Tc Js] and lost with One pair : Kings
Seat 6: Fried Berg (button) showed [7c Ac] and won 0.13€ with One pair : Kings


Winamax Poker - HOLD-UP "Colorado" - HandId: #19116069-331442-1701435160 - Holdem no limit (0.01€/0.02€) - 2023/12/01 12:52:40 UTC
Table: 'Colorado' 6-max (real money) Seat #6 is the button
Seat 1: Zile741 (2.01€)
Seat 2: Papaiah (2€)
Seat 3: curiouz dje (2.97€)
Seat 4: Izy_River (2.41€)
Seat 5: Fried Berg (2.34€)
Seat 6: Alexisdpp (14.32€)
*** ANTE/BLINDS ***
Zile741 posts small blind 0.01€
Papaiah posts big blind 0.02€
Dealt to Fried Berg [7h 8s]
*** PRE-FLOP *** 
curiouz dje folds
Izy_River raises 0.02€ to 0.04€
Fried Berg folds
Alexisdpp raises 0.08€ to 0.12€
Zile741 folds
Papaiah folds
Izy_River calls 0.08€
*** FLOP *** [6c 5c 4s]
Izy_River checks
Alexisdpp bets 0.18€
Izy_River calls 0.18€
*** TURN *** [6c 5c 4s][4d]
Izy_River checks
Alexisdpp checks
*** RIVER *** [6c 5c 4s 4d][4c]
Izy_River checks
Alexisdpp checks
*** SHOW DOWN ***
Izy_River shows [Qs Kc] (Trips of 4)
Alexisdpp shows [Ts As] (Trips of 4)
Alexisdpp collected 0.57€ from pot
*** SUMMARY ***
Total pot 0.57€ | Rake 0.06€
Board: [6c 5c 4s 4d 4c]
Seat 4: Izy_River showed [Qs Kc] and lost with Trips of 4
Seat 6: Alexisdpp (button) showed [Ts As] and won 0.57€ with Trips of 4


Winamax Poker - HOLD-UP "Colorado" - HandId: #19116069-331452-1701435165 - Holdem no limit (0.01€/0.02€) - 2023/12/01 12:52:45 UTC
Table: 'Colorado' 6-max (real money) Seat #6 is the button
Seat 1: Piiranha (2.01€)
Seat 2: gbtcorp (2.38€)
Seat 3: Clemence75 (2€)
Seat 4: Obiwan70 (3.12€)
Seat 5: DigBick99 (2.20€)
Seat 6: Fried Berg (2.34€)
*** ANTE/BLINDS ***
Piiranha posts small blind 0.01€
gbtcorp posts big blind 0.02€
Dealt to Fried Berg [Ah Tc]
*** PRE-FLOP *** 
Clemence75 folds
Obiwan70 folds
DigBick99 raises 0.04€ to 0.06€
Fried Berg raises 0.12€ to 0.18€
Piiranha folds
gbtcorp folds
DigBick99 calls 0.12€
*** FLOP *** [Jd 8c 2d]
DigBick99 checks
Fried Berg checks
*** TURN *** [Jd 8c 2d][Ac]
DigBick99 bets 0.25€
Fried Berg calls 0.25€
*** RIVER *** [Jd 8c 2d Ac][6d]
DigBick99 checks
Fried Berg checks
*** SHOW DOWN ***
DigBick99 shows [Jc Kc] (One pair : Jacks)
Fried Berg shows [Ah Tc] (One pair : Aces)
Fried Berg collected 0.80€ from pot
*** SUMMARY ***
Total pot 0.80€ | Rake 0.09€
Board: [Jd 8c 2d Ac 6d]
Seat 5: DigBick99 showed [Jc Kc] and lost with One pair : Jacks
Seat 6: Fried Berg (button) showed [Ah Tc] and won 0.80€ with One pair : Aces


Winamax Poker - HOLD-UP "Colorado" - HandId: #19116069-331572-1701435239 - Holdem no limit (0.01€/0.02€) - 2023/12/01 12:53:59 UTC
Table: 'Colorado' 6-max (real money) Seat #6 is the button
Seat 1: moussaillax (2.64€)
Seat 2: PEPEKA (0.54€)
Seat 3: _gonzai_ (2.05€)
Seat 4: Fried Berg (2.71€)
Seat 5: DigBick99 (2.56€)
Seat 6: curiouz dje (2.95€)
*** ANTE/BLINDS ***
moussaillax posts small blind 0.01€
PEPEKA posts big blind 0.02€
Dealt to Fried Berg [Qd 4c]
*** PRE-FLOP *** 
_gonzai_ folds
Fried Berg folds
DigBick99 raises 0.04€ to 0.06€
curiouz dje calls 0.06€
moussaillax folds
PEPEKA folds
*** FLOP *** [Ac 2d Qc]
DigBick99 bets 0.05€
curiouz dje folds
DigBick99 collected 0.18€ from pot
*** SUMMARY ***
Total pot 0.18€ | Rake 0.02€
Board: [Ac 2d Qc]
Seat 5: DigBick99 won 0.18€


Winamax Poker - HOLD-UP "Colorado" - HandId: #19116069-331588-1701435248 - Holdem no limit (0.01€/0.02€) - 2023/12/01 12:54:08 UTC
Table: 'Colorado' 6-max (real money) Seat #6 is the button
Seat 1: Kaoky (2€)
Seat 2: LilRun (1.67€)
Seat 3: Fried Berg (2.71€)
Seat 4: El Paellas (0.62€)
Seat 5: Hydramist (3.45€)
Seat 6: Thequeen1205 (2€)
*** ANTE/BLINDS ***
Kaoky posts small blind 0.01€
LilRun posts big blind 0.02€
Dealt to Fried Berg [3s 9c]
*** PRE-FLOP *** 
Fried Berg folds
El Paellas folds
Hydramist folds
Thequeen1205 raises 0.03€ to 0.05€
Kaoky folds
LilRun calls 0.03€
*** FLOP *** [6h 8c 4d]
LilRun checks
Thequeen1205 bets 0.04€
LilRun raises 0.11€ to 0.15€
Thequeen1205 folds
LilRun collected 0.28€ from pot
*** SUMMARY ***
Total pot 0.28€ | Rake 0.02€
Board: [6h 8c 4d]
Seat 2: LilRun (big blind) won 0.28€


Winamax Poker - HOLD-UP "Colorado" - HandId: #19116069-331593-1701435249 - Holdem no limit (0.01€/0.02€) - 2023/12/01 12:54:09 UTC
Table: 'Colorado' 6-max (real money) Seat #6 is the button
Seat 1: KKamarAAde (3.53€)
Seat 2: Fried Berg (2.71€)
Seat 3: Clemence75 (2€)
Seat 4: Hagreed (1.84€)
Seat 5: JFSredbaron (3.57€)
Seat 6: bastos2525 (1.31€)
*** ANTE/BLINDS ***
KKamarAAde posts small blind 0.01€
Fried Berg posts big blind 0.02€
Dealt to Fried Berg [Qc Jd]
*** PRE-FLOP *** 
Clemence75 folds
Hagreed folds
JFSredbaron folds
bastos2525 folds
KKamarAAde folds
Fried Berg collected 0.03€ from pot
*** SUMMARY ***
Total pot 0.03€ | No rake
Seat 2: Fried Berg (big blind) won 0.03€


Winamax Poker - HOLD-UP "Colorado" - HandId: #19116069-331607-1701435258 - Holdem no limit (0.01€/0.02€) - 2023/12/01 12:54:18 UTC
Table: 'Colorado' 6-max (real money) Seat #6 is the button
Seat 1: Zile741 (2.06€)
Seat 2: DGG23 (0.50€)
Seat 3: IbetYouMuck (2.07€)
Seat 4: Obiwan70 (3.10€)
Seat 5: DonKmillo (7.93€)
Seat 6: Fried Berg (2.72€)
*** ANTE/BLINDS ***
Zile741 posts small blind 0.01€
DGG23 posts big blind 0.02€
Dealt to Fried Berg [2s Jd]
*** PRE-FLOP *** 
IbetYouMuck raises 0.05€ to 0.07€
Obiwan70 folds
DonKmillo folds
Fried Berg folds
Zile741 folds
DGG23 folds
IbetYouMuck collected 0.10€ from pot
*** SUMMARY ***
Total pot 0.10€ | No rake
Seat 3: IbetYouMuck won 0.10€


Winamax Poker - HOLD-UP "Colorado" - HandId: #19116069-331612-1701435263 - Holdem no limit (0.01€/0.02€) - 2023/12/01 12:54:23 UTC
Table: 'Colorado' 6-max (real money) Seat #6 is the button
Seat 1: Fried Berg (2.72€)
Seat 2: El Paellas (0.50€)
Seat 3: Obiwan70 (3.10€)
Seat 4: KKamarAAde (5.92€)
Seat 5: Kaoky (2€)
Seat 6: vlalouloute (2.76€)
*** ANTE/BLINDS ***
Fried Berg posts small blind 0.01€
El Paellas posts big blind 0.02€
Dealt to Fried Berg [2d Tc]
*** PRE-FLOP *** 
Obiwan70 folds
KKamarAAde raises 0.04€ to 0.06€
Kaoky calls 0.06€
vlalouloute folds
Fried Berg folds
El Paellas folds
*** FLOP *** [Ac Jc 7c]
KKamarAAde checks
Kaoky checks
*** TURN *** [Ac Jc 7c][9d]
KKamarAAde checks
Kaoky checks
*** RIVER *** [Ac Jc 7c 9d][2s]
KKamarAAde checks
Kaoky checks
*** SHOW DOWN ***
Kaoky shows [Ts Ks] (High card : Ace)
KKamarAAde shows [4s 4h] (One pair : 4)
KKamarAAde collected 0.13€ from pot
*** SUMMARY ***
Total pot 0.13€ | Rake 0.02€
Board: [Ac Jc 7c 9d 2s]
Seat 4: KKamarAAde showed [4s 4h] and won 0.13€ with One pair : 4
Seat 5: Kaoky showed [Ts Ks] and lost with High card : Ace


Winamax Poker - HOLD-UP "Colorado" - HandId: #19116069-331615-1701435265 - Holdem no limit (0.01€/0.02€) - 2023/12/01 12:54:25 UTC
Table: 'Colorado' 6-max (real money) Seat #6 is the button
Seat 1: alfombra4 (0.50€)
Seat 2: Fried Berg (2.71€)
Seat 3: misterda (3.91€)
Seat 4: 63Paul (2.11€)
Seat 5: ironman33 (0.60€)
Seat 6: Obiwan70 (3.10€)
*** ANTE/BLINDS ***
alfombra4 posts small blind 0.01€
Fried Berg posts big blind 0.02€
Dealt to Fried Berg [5h As]
*** PRE-FLOP *** 
misterda folds
63Paul folds
ironman33 calls 0.02€
Obiwan70 folds
alfombra4 folds
Fried Berg checks
*** FLOP *** [4h 2h 3d]
Fried Berg checks
ironman33 checks
*** TURN *** [4h 2h 3d][Js]
Fried Berg checks
ironman33 checks
*** RIVER *** [4h 2h 3d Js][Qd]
Fried Berg bets 0.04€
ironman33 folds
Fried Berg collected 0.08€ from pot
*** SUMMARY ***
Total pot 0.08€ | Rake 0.01€
Board: [4h 2h 3d Js Qd]
Seat 2: Fried Berg (big blind) won 0.08€


Winamax Poker - HOLD-UP "Colorado" - HandId: #19116069-331659-1701435296 - Holdem no limit (0.01€/0.02€) - 2023/12/01 12:54:56 UTC
Table: 'Colorado' 6-max (real money) Seat #6 is the button
Seat 1: Fried Berg (2.73€)
Seat 2: DGG23 (0.36€)
Seat 3: wAAlterrr (1.88€)
Seat 4: _ilTulipano_ (2.43€)
Seat 5: DIOSLOKI1 9 (1.57€)
Seat 6: x spoony (2€)
*** ANTE/BLINDS ***
Fried Berg posts small blind 0.01€
DGG23 posts big blind 0.02€
Dealt to Fried Berg [4d Qc]
*** PRE-FLOP *** 
wAAlterrr folds
_ilTulipano_ folds
DIOSLOKI1 9 folds
x spoony folds
Fried Berg folds
DGG23 collected 0.03€ from pot
*** SUMMARY ***
Total pot 0.03€ | No rake
Seat 2: DGG23 (big blind) won 0.03€


Winamax Poker - HOLD-UP "Colorado" - HandId: #19116069-331670-1701435303 - Holdem no limit (0.01€/0.02€) - 2023/12/01 12:55:03 UTC
Table: 'Colorado' 6-max (real money) Seat #6 is the button
Seat 1: Pierrof24 (2.13€)
Seat 2: OnceUpoNaTym (2€)
Seat 3: Zile741 (2.48€)
Seat 4: magicfido (0.95€)
Seat 5: Thequeen1205 (2.03€)
Seat 6: Fried Berg (2.72€)
*** ANTE/BLINDS ***
Pierrof24 posts small blind 0.01€
OnceUpoNaTym posts big blind 0.02€
Dealt to Fried Berg [6c Qd]
*** PRE-FLOP *** 
Zile741 folds
magicfido raises 0.04€ to 0.06€
Thequeen1205 raises 0.12€ to 0.18€
Fried Berg folds
Pierrof24 folds
OnceUpoNaTym folds
magicfido calls 0.12€
*** FLOP *** [Js 9c 4d]
magicfido checks
Thequeen1205 bets 0.20€
magicfido folds
Thequeen1205 collected 0.55€ from pot
*** SUMMARY ***
Total pot 0.55€ | Rake 0.04€
Board: [Js 9c 4d]
Seat 5: Thequeen1205 won 0.55€


Winamax Poker - HOLD-UP "Colorado" - HandId: #19116069-331673-1701435306 - Holdem no limit (0.01€/0.02€) - 2023/12/01 12:55:06 UTC
Table: 'Colorado' 6-max (real money) Seat #6 is the button
Seat 1: Mr.gelillo (2.01€)
Seat 2: x spoony (2€)
Seat 3: TaBrEaMoI (2€)
Seat 4: ECPulga (2.13€)
Seat 5: _gonzai_ (2.01€)
Seat 6: Fried Berg (2.72€)
*** ANTE/BLINDS ***
Mr.gelillo posts small blind 0.01€
x spoony posts big blind 0.02€
Dealt to Fried Berg [7c 5s]
*** PRE-FLOP *** 
TaBrEaMoI raises 0.04€ to 0.06€
ECPulga folds
_gonzai_ folds
Fried Berg folds
Mr.gelillo folds
x spoony folds
TaBrEaMoI collected 0.09€ from pot
*** SUMMARY ***
Total pot 0.09€ | No rake
Seat 3: TaBrEaMoI won 0.09€


Winamax Poker - HOLD-UP "Colorado" - HandId: #19116069-331693-1701435318 - Holdem no limit (0.01€/0.02€) - 2023/12/01 12:55:18 UTC
Table: 'Colorado' 6-max (real money) Seat #6 is the button
Seat 1: _ilTulipano_ (2€)
Seat 2: curiouz dje (2€)
Seat 3: DGG23 (0.34€)
Seat 4: Perf-31 (3.07€)
Seat 5: Fried Berg (2.72€)
Seat 6: DosdeBras (2.40€)
*** ANTE/BLINDS ***
_ilTulipano_ posts small blind 0.01€
curiouz dje posts big blind 0.02€
Dealt to Fried Berg [4s 3d]
*** PRE-FLOP *** 
DGG23 folds
Perf-31 folds
Fried Berg folds
DosdeBras folds
_ilTulipano_ folds
curiouz dje collected 0.03€ from pot
*** SUMMARY ***
Total pot 0.03€ | No rake
Seat 2: curiouz dje (big blind) won 0.03€


Winamax Poker - HOLD-UP "Colorado" - HandId: #19116069-331696-1701435320 - Holdem no limit (0.01€/0.02€) - 2023/12/01 12:55:20 UTC
Table: 'Colorado' 6-max (real money) Seat #6 is the button
Seat 1: Fried Berg (2.72€)
Seat 2: DosdeBras (2.40€)
Seat 3: Feelda1337 (3.71€)
Seat 4: Piiranha (2€)
Seat 5: Charlise2 (1.94€)
Seat 6: JFSredbaron (3.19€)
*** ANTE/BLINDS ***
Fried Berg posts small blind 0.01€
DosdeBras posts big blind 0.02€
Dealt to Fried Berg [Qh Ks]
*** PRE-FLOP *** 
Feelda1337 raises 0.04€ to 0.06€
Piiranha folds
Charlise2 folds
JFSredbaron folds
Fried Berg calls 0.05€
DosdeBras folds
*** FLOP *** [Kc 2c 9c]
Fried Berg checks
Feelda1337 checks
*** TURN *** [Kc 2c 9c][5c]
Fried Berg checks
Feelda1337 checks
*** RIVER *** [Kc 2c 9c 5c][4s]
Fried Berg bets 0.04€
Feelda1337 calls 0.04€
*** SHOW DOWN ***
Fried Berg shows [Qh Ks] (One pair : Kings)
Feelda1337 shows [8s 8c] (Flush King high)
Feelda1337 collected 0.20€ from pot
*** SUMMARY ***
Total pot 0.20€ | Rake 0.02€
Board: [Kc 2c 9c 5c 4s]
Seat 1: Fried Berg (small blind) showed [Qh Ks] and lost with One pair : Kings
Seat 3: Feelda1337 showed [8s 8c] and won 0.20€ with Flush King high


Winamax Poker - HOLD-UP "Colorado" - HandId: #19116069-331800-1701435378 - Holdem no limit (0.01€/0.02€) - 2023/12/01 12:56:18 UTC
Table: 'Colorado' 6-max (real money) Seat #6 is the button
Seat 1: x spoony (2.01€)
Seat 2: Fried Berg (2.62€)
Seat 3: El Paellas (0.50€)
Seat 4: dAArk_hAAnd (2.14€)
Seat 5: OnceUpoNaTym (1.97€)
Seat 6: Feelda1337 (2€)
*** ANTE/BLINDS ***
x spoony posts small blind 0.01€
Fried Berg posts big blind 0.02€
Dealt to Fried Berg [Qc Ac]
*** PRE-FLOP *** 
El Paellas folds
dAArk_hAAnd folds
OnceUpoNaTym folds
Feelda1337 folds
x spoony folds
Fried Berg collected 0.03€ from pot
*** SUMMARY ***
Total pot 0.03€ | No rake
Seat 2: Fried Berg (big blind) won 0.03€


Winamax Poker - HOLD-UP "Colorado" - HandId: #19116069-331849-1701435407 - Holdem no limit (0.01€/0.02€) - 2023/12/01 12:56:47 UTC
Table: 'Colorado' 6-max (real money) Seat #6 is the button
Seat 1: Hydramist (2.04€)
Seat 2: Thequeen1205 (2€)
Seat 3: DGG23 (0.50€)
Seat 4: Gafe2018 (2€)
Seat 5: Fried Berg (2.63€)
Seat 6: BAAC0 (1.95€)
*** ANTE/BLINDS ***
Hydramist posts small blind 0.01€
Thequeen1205 posts big blind 0.02€
Dealt to Fried Berg [Ac 9c]
*** PRE-FLOP *** 
DGG23 folds
Gafe2018 folds
Fried Berg raises 0.04€ to 0.06€
BAAC0 folds
Hydramist folds
Thequeen1205 calls 0.04€
*** FLOP *** [9d 7d 7c]
Thequeen1205 checks
Fried Berg bets 0.08€
Thequeen1205 folds
Fried Berg collected 0.20€ from pot
*** SUMMARY ***
Total pot 0.20€ | Rake 0.01€
Board: [9d 7d 7c]
Seat 5: Fried Berg won 0.20€


Winamax Poker - HOLD-UP "Colorado" - HandId: #19116069-331903-1701435439 - Holdem no limit (0.01€/0.02€) - 2023/12/01 12:57:19 UTC
Table: 'Colorado' 6-max (real money) Seat #6 is the button
Seat 1: Thequeen1205 (2€)
Seat 2: x spoony (2€)
Seat 3: _ilTulipano_ (2.34€)
Seat 4: Fried Berg (2.69€)
Seat 5: _gonzai_ (2.25€)
Seat 6: Papaiah (2€)
*** ANTE/BLINDS ***
Thequeen1205 posts small blind 0.01€
x spoony posts big blind 0.02€
Dealt to Fried Berg [8h 2c]
*** PRE-FLOP *** 
_ilTulipano_ raises 0.04€ to 0.06€
Fried Berg folds
_gonzai_ folds
Papaiah folds
Thequeen1205 folds
x spoony folds
_ilTulipano_ collected 0.09€ from pot
*** SUMMARY ***
Total pot 0.09€ | No rake
Seat 3: _ilTulipano_ won 0.09€


Winamax Poker - HOLD-UP "Colorado" - HandId: #19116069-331917-1701435446 - Holdem no limit (0.01€/0.02€) - 2023/12/01 12:57:26 UTC
Table: 'Colorado' 6-max (real money) Seat #6 is the button
Seat 1: ilergeta (2.54€)
Seat 2: Maitre fo (1.46€)
Seat 3: Fried Berg (2.69€)
Seat 4: Zile741 (2.13€)
Seat 5: DGG23 (0.25€)
Seat 6: Thequeen1205 (2.75€)
*** ANTE/BLINDS ***
ilergeta posts small blind 0.01€
Maitre fo posts big blind 0.02€
Dealt to Fried Berg [Tc Jd]
*** PRE-FLOP *** 
Fried Berg raises 0.02€ to 0.04€
Zile741 folds
DGG23 folds
Thequeen1205 folds
ilergeta folds
Maitre fo folds
Fried Berg collected 0.07€ from pot
*** SUMMARY ***
Total pot 0.07€ | No rake
Seat 3: Fried Berg won 0.07€


Winamax Poker - HOLD-UP "Colorado" - HandId: #19116069-331935-1701435455 - Holdem no limit (0.01€/0.02€) - 2023/12/01 12:57:35 UTC
Table: 'Colorado' 6-max (real money) Seat #6 is the button
Seat 1: PEPEKA (0.57€)
Seat 2: JFSredbaron (3.19€)
Seat 3: ilergeta (2.63€)
Seat 4: C2LATAM (0.38€)
Seat 5: Fried Berg (2.72€)
Seat 6: metamex (1.96€)
*** ANTE/BLINDS ***
PEPEKA posts small blind 0.01€
JFSredbaron posts big blind 0.02€
Dealt to Fried Berg [5h Kc]
*** PRE-FLOP *** 
ilergeta folds
C2LATAM folds
Fried Berg folds
metamex folds
PEPEKA raises 0.02€ to 0.04€
JFSredbaron folds
PEPEKA collected 0.06€ from pot
*** SUMMARY ***
Total pot 0.06€ | No rake
Seat 1: PEPEKA (small blind) won 0.06€


Winamax Poker - HOLD-UP "Colorado" - HandId: #19116069-331943-1701435459 - Holdem no limit (0.01€/0.02€) - 2023/12/01 12:57:39 UTC
Table: 'Colorado' 6-max (real money) Seat #6 is the button
Seat 1: El Paellas (0.96€)
Seat 2: Zile741 (2.34€)
Seat 3: Fried Berg (2.72€)
Seat 4: x spoony (2€)
Seat 5: Tofini (2.04€)
Seat 6: Feelda1337 (2.36€)
*** ANTE/BLINDS ***
El Paellas posts small blind 0.01€
Zile741 posts big blind 0.02€
Dealt to Fried Berg [5s 6d]
*** PRE-FLOP *** 
Fried Berg folds
x spoony folds
Tofini folds
Feelda1337 folds
El Paellas folds
Zile741 collected 0.03€ from pot
*** SUMMARY ***
Total pot 0.03€ | No rake
Seat 2: Zile741 (big blind) won 0.03€


Winamax Poker - HOLD-UP "Colorado" - HandId: #19116069-331945-1701435461 - Holdem no limit (0.01€/0.02€) - 2023/12/01 12:57:41 UTC
Table: 'Colorado' 6-max (real money) Seat #6 is the button
Seat 1: Feelda1337 (2.36€)
Seat 2: Gafe2018 (2.03€)
Seat 3: Bilderbet (2€)
Seat 4: ilergeta (2.63€)
Seat 5: DigBick99 (2.72€)
Seat 6: Fried Berg (2.72€)
*** ANTE/BLINDS ***
Feelda1337 posts small blind 0.01€
Gafe2018 posts big blind 0.02€
Dealt to Fried Berg [Ah Ac]
*** PRE-FLOP *** 
Bilderbet folds
ilergeta folds
DigBick99 raises 0.04€ to 0.06€
Fried Berg raises 0.12€ to 0.18€
Feelda1337 folds
Gafe2018 folds
DigBick99 calls 0.12€
*** FLOP *** [6c 7s Ks]
DigBick99 checks
Fried Berg bets 0.10€
DigBick99 calls 0.10€
*** TURN *** [6c 7s Ks][4s]
DigBick99 checks
Fried Berg checks
*** RIVER *** [6c 7s Ks 4s][Td]
DigBick99 bets 0.38€
Fried Berg calls 0.38€
*** SHOW DOWN ***
DigBick99 shows [Qh Kh] (One pair : Kings)
Fried Berg shows [Ah Ac] (One pair : Aces)
Fried Berg collected 1.21€ from pot
*** SUMMARY ***
Total pot 1.21€ | Rake 0.14€
Board: [6c 7s Ks 4s Td]
Seat 5: DigBick99 showed [Qh Kh] and lost with One pair : Kings
Seat 6: Fried Berg (button) showed [Ah Ac] and won 1.21€ with One pair : Aces


Winamax Poker - HOLD-UP "Colorado" - HandId: #19116069-332155-1701435583 - Holdem no limit (0.01€/0.02€) - 2023/12/01 12:59:43 UTC
Table: 'Colorado' 6-max (real money) Seat #6 is the button
Seat 1: Izy_River (0.48€)
Seat 2: Fried Berg (3.27€)
Seat 3: DigBick99 (2.06€)
Seat 4: Caropitchoun (7.89€)
Seat 5: Tofini (2€)
Seat 6: El Paellas (1€)
*** ANTE/BLINDS ***
Izy_River posts small blind 0.01€
Fried Berg posts big blind 0.02€
Dealt to Fried Berg [Ks 5s]
*** PRE-FLOP *** 
DigBick99 folds
Caropitchoun folds
Tofini folds
El Paellas folds
Izy_River folds
Fried Berg collected 0.03€ from pot
*** SUMMARY ***
Total pot 0.03€ | No rake
Seat 2: Fried Berg (big blind) won 0.03€


Winamax Poker - HOLD-UP "Colorado" - HandId: #19116069-332181-1701435597 - Holdem no limit (0.01€/0.02€) - 2023/12/01 12:59:57 UTC
Table: 'Colorado' 6-max (real money) Seat #6 is the button
Seat 1: Max134Max (2.05€)
Seat 2: metamex (2€)
Seat 3: Fried Berg (3.28€)
Seat 4: x spoony (2€)
Seat 5: Caropitchoun (7.87€)
Seat 6: DigBick99 (2.06€)
*** ANTE/BLINDS ***
Max134Max posts small blind 0.01€
metamex posts big blind 0.02€
Dealt to Fried Berg [3c Qh]
*** PRE-FLOP *** 
Fried Berg folds
x spoony folds
Caropitchoun folds
DigBick99 folds
Max134Max raises 0.04€ to 0.06€
metamex folds
Max134Max collected 0.08€ from pot
*** SUMMARY ***
Total pot 0.08€ | No rake
Seat 1: Max134Max (small blind) won 0.08€


Winamax Poker - HOLD-UP "Colorado" - HandId: #19116069-332192-1701435603 - Holdem no limit (0.01€/0.02€) - 2023/12/01 13:00:03 UTC
Table: 'Colorado' 6-max (real money) Seat #6 is the button
Seat 1: Feelda1337 (3.37€)
Seat 2: Izy_River (0.47€)
Seat 3: OnceUpoNaTym (2.19€)
Seat 4: Fried Berg (3.28€)
Seat 5: _ilTulipano_ (4.08€)
Seat 6: JFSredbaron (6.33€)
*** ANTE/BLINDS ***
Feelda1337 posts small blind 0.01€
Izy_River posts big blind 0.02€
Dealt to Fried Berg [5d 3h]
*** PRE-FLOP *** 
OnceUpoNaTym folds
Fried Berg folds
_ilTulipano_ folds
JFSredbaron folds
Feelda1337 folds
Izy_River collected 0.03€ from pot
*** SUMMARY ***
Total pot 0.03€ | No rake
Seat 2: Izy_River (big blind) won 0.03€


Winamax Poker - HOLD-UP "Colorado" - HandId: #19116069-332198-1701435606 - Holdem no limit (0.01€/0.02€) - 2023/12/01 13:00:06 UTC
Table: 'Colorado' 6-max (real money) Seat #6 is the button
Seat 1: Fried Berg (3.28€)
Seat 2: x spoony (2.14€)
Seat 3: Tofini (2€)
Seat 4: Thequeen1205 (2.99€)
Seat 5: ECPulga (5.77€)
Seat 6: GTO-Mieko (2.25€)
*** ANTE/BLINDS ***
Fried Berg posts small blind 0.01€
x spoony posts big blind 0.02€
Dealt to Fried Berg [7d 5d]
*** PRE-FLOP *** 
Tofini folds
Thequeen1205 folds
ECPulga folds
GTO-Mieko folds
Fried Berg raises 0.02€ to 0.04€
x spoony raises 0.08€ to 0.12€
Fried Berg calls 0.08€
*** FLOP *** [Ad Qd 4c]
Fried Berg checks
x spoony checks
*** TURN *** [Ad Qd 4c][9s]
Fried Berg checks
x spoony bets 0.18€
Fried Berg calls 0.18€
*** RIVER *** [Ad Qd 4c 9s][Qh]
Fried Berg checks
x spoony bets 0.30€
Fried Berg folds
x spoony collected 0.84€ from pot
*** SUMMARY ***
Total pot 0.84€ | Rake 0.06€
Board: [Ad Qd 4c 9s Qh]
Seat 2: x spoony (big blind) won 0.84€


Winamax Poker - HOLD-UP "Colorado" - HandId: #19116069-332286-1701435658 - Holdem no limit (0.01€/0.02€) - 2023/12/01 13:00:58 UTC
Table: 'Colorado' 6-max (real money) Seat #6 is the button
Seat 1: Astaril (6.59€)
Seat 2: Kaoky (2.13€)
Seat 3: Fried Berg (2.98€)
Seat 4: Kiff9180 (0.46€)
Seat 5: moussaillax (2.63€)
Seat 6: DGG23 (0.49€)
*** ANTE/BLINDS ***
Astaril posts small blind 0.01€
Kaoky posts big blind 0.02€
Dealt to Fried Berg [6d 3h]
*** PRE-FLOP *** 
Fried Berg folds
Kiff9180 folds
moussaillax folds
DGG23 folds
Astaril raises 0.04€ to 0.06€
Kaoky folds
Astaril collected 0.08€ from pot
*** SUMMARY ***
Total pot 0.08€ | No rake
Seat 1: Astaril (small blind) won 0.08€


Winamax Poker - HOLD-UP "Colorado" - HandId: #19116069-332291-1701435660 - Holdem no limit (0.01€/0.02€) - 2023/12/01 13:01:00 UTC
Table: 'Colorado' 6-max (real money) Seat #6 is the button
Seat 1: Papaiah (2.15€)
Seat 2: JissEl1te (0.90€)
Seat 3: x spoony (2.03€)
Seat 4: Fried Berg (2.98€)
Seat 5: KKamarAAde (4.96€)
Seat 6: JFSredbaron (6.13€)
*** ANTE/BLINDS ***
Papaiah posts small blind 0.01€
JissEl1te posts big blind 0.02€
Dealt to Fried Berg [6h Kh]
*** PRE-FLOP *** 
x spoony folds
Fried Berg raises 0.02€ to 0.04€
KKamarAAde folds
JFSredbaron folds
Papaiah folds
JissEl1te folds
Fried Berg collected 0.07€ from pot
*** SUMMARY ***
Total pot 0.07€ | No rake
Seat 4: Fried Berg won 0.07€


Winamax Poker - HOLD-UP "Colorado" - HandId: #19116069-332315-1701435674 - Holdem no limit (0.01€/0.02€) - 2023/12/01 13:01:14 UTC
Table: 'Colorado' 6-max (real money) Seat #6 is the button
Seat 1: ECPulga (6.07€)
Seat 2: Frekk (2.11€)
Seat 3: Papaiah (2.14€)
Seat 4: Fried Berg (3.01€)
Seat 5: x spoony (2€)
Seat 6: JissEl1te (0.87€)
*** ANTE/BLINDS ***
ECPulga posts small blind 0.01€
Frekk posts big blind 0.02€
Dealt to Fried Berg [9d 4s]
*** PRE-FLOP *** 
Papaiah folds
Fried Berg folds
x spoony raises 0.04€ to 0.06€
JissEl1te calls 0.06€
ECPulga calls 0.05€
Frekk calls 0.04€
*** FLOP *** [Ts Jc 2d]
ECPulga checks
Frekk checks
x spoony checks
JissEl1te checks
*** TURN *** [Ts Jc 2d][Js]
ECPulga checks
Frekk bets 0.08€
x spoony folds
JissEl1te folds
ECPulga folds
Frekk collected 0.30€ from pot
*** SUMMARY ***
Total pot 0.30€ | Rake 0.02€
Board: [Ts Jc 2d Js]
Seat 2: Frekk (big blind) won 0.30€


Winamax Poker - HOLD-UP "Colorado" - HandId: #19116069-332320-1701435678 - Holdem no limit (0.01€/0.02€) - 2023/12/01 13:01:18 UTC
Table: 'Colorado' 6-max (real money) Seat #6 is the button
Seat 1: gsxr72220 (2.07€)
Seat 2: Papaiah (2.14€)
Seat 3: g8o8k8u (2.37€)
Seat 4: Lumayou (2.14€)
Seat 5: Fried Berg (3.01€)
Seat 6: _gonzai_ (2.09€)
*** ANTE/BLINDS ***
gsxr72220 posts small blind 0.01€
Papaiah posts big blind 0.02€
Dealt to Fried Berg [6d 8c]
*** PRE-FLOP *** 
g8o8k8u folds
Lumayou folds
Fried Berg folds
_gonzai_ raises 0.04€ to 0.06€
gsxr72220 folds
Papaiah folds
_gonzai_ collected 0.09€ from pot
*** SUMMARY ***
Total pot 0.09€ | No rake
Seat 6: _gonzai_ (button) won 0.09€


Winamax Poker - HOLD-UP "Colorado" - HandId: #19116069-332324-1701435681 - Holdem no limit (0.01€/0.02€) - 2023/12/01 13:01:21 UTC
Table: 'Colorado' 6-max (real money) Seat #6 is the button
Seat 1: _ilTulipano_ (2.49€)
Seat 2: Fried Berg (3.01€)
Seat 3: DigBick99 (2.09€)
Seat 4: Caropitchoun (7.84€)
Seat 5: Feelda1337 (4.39€)
Seat 6: DonKmillo (7.52€)
Hold-up to Pot: total 0.10€
*** ANTE/BLINDS ***
_ilTulipano_ posts small blind 0.01€
Fried Berg posts big blind 0.02€
Dealt to Fried Berg [7s 6c]
*** PRE-FLOP *** 
DigBick99 raises 0.04€ to 0.06€
Caropitchoun raises 0.09€ to 0.15€
Feelda1337 folds
DonKmillo folds
_ilTulipano_ folds
Fried Berg folds
DigBick99 calls 0.09€
*** FLOP *** [Th 4h 6s]
DigBick99 checks
Caropitchoun checks
*** TURN *** [Th 4h 6s][3h]
DigBick99 bets 0.30€
Caropitchoun raises 0.30€ to 0.60€
DigBick99 folds
Caropitchoun collected 1.24€ from pot
*** SUMMARY ***
Total pot 1.24€ | Rake 0.09€
Board: [Th 4h 6s 3h]
Seat 4: Caropitchoun won 1.24€


Winamax Poker - HOLD-UP "Colorado" - HandId: #19116069-332335-1701435689 - Holdem no limit (0.01€/0.02€) - 2023/12/01 13:01:29 UTC
Table: 'Colorado' 6-max (real money) Seat #6 is the button
Seat 1: Fried Berg (2.99€)
Seat 2: Hydramist (4.29€)
Seat 3: ilergeta (2.90€)
Seat 4: TaBrEaMoI (2.12€)
Seat 5: Abec16 (1.74€)
Seat 6: bastos2525 (1.41€)
*** ANTE/BLINDS ***
Fried Berg posts small blind 0.01€
Hydramist posts big blind 0.02€
Dealt to Fried Berg [Kh Jh]
*** PRE-FLOP *** 
ilergeta folds
TaBrEaMoI folds
Abec16 folds
bastos2525 folds
Fried Berg raises 0.04€ to 0.06€
Hydramist folds
Fried Berg collected 0.08€ from pot
*** SUMMARY ***
Total pot 0.08€ | No rake
Seat 1: Fried Berg (small blind) won 0.08€


Winamax Poker - HOLD-UP "Colorado" - HandId: #19116069-332373-1701435712 - Holdem no limit (0.01€/0.02€) - 2023/12/01 13:01:52 UTC
Table: 'Colorado' 6-max (real money) Seat #6 is the button
Seat 1: TaBrEaMoI (2€)
Seat 2: Zile741 (2.77€)
Seat 3: DGG23 (0.49€)
Seat 4: Tofini (2.03€)
Seat 5: JFSredbaron (2.23€)
Seat 6: Fried Berg (3.01€)
*** ANTE/BLINDS ***
TaBrEaMoI posts small blind 0.01€
Zile741 posts big blind 0.02€
Dealt to Fried Berg [As 2c]
*** PRE-FLOP *** 
DGG23 folds
Tofini folds
JFSredbaron folds
Fried Berg raises 0.02€ to 0.04€
TaBrEaMoI folds
Zile741 calls 0.02€
*** FLOP *** [5d Ts 5c]
Zile741 checks
Fried Berg checks
*** TURN *** [5d Ts 5c][Qd]
Zile741 checks
Fried Berg checks
*** RIVER *** [5d Ts 5c Qd][Qc]
Zile741 checks
Fried Berg checks
*** SHOW DOWN ***
Zile741 shows [6d Ad] (Two pairs : Queens and 5)
Fried Berg shows [As 2c] (Two pairs : Queens and 5)
Fried Berg collected 0.04€ from pot
Zile741 collected 0.04€ from pot
*** SUMMARY ***
Total pot 0.08€ | Rake 0.01€
Board: [5d Ts 5c Qd Qc]
Seat 2: Zile741 (big blind) showed [6d Ad] and won 0.04€ with Two pairs : Queens and 5
Seat 6: Fried Berg (button) showed [As 2c] and won 0.04€ with Two pairs : Queens and 5


Winamax Poker - HOLD-UP "Colorado" - HandId: #19116069-332447-1701435754 - Holdem no limit (0.01€/0.02€) - 2023/12/01 13:02:34 UTC
Table: 'Colorado' 6-max (real money) Seat #6 is the button
Seat 1: rick26 (1.95€)
Seat 2: Fried Berg (3.01€)
Seat 3: Zile741 (2.01€)
Seat 4: Hydramist (3.86€)
Seat 5: Gafe2018 (2.19€)
Seat 6: muespachois1 (1.64€)
*** ANTE/BLINDS ***
rick26 posts small blind 0.01€
Fried Berg posts big blind 0.02€
Dealt to Fried Berg [Qc Ks]
*** PRE-FLOP *** 
Zile741 raises 0.04€ to 0.06€
Hydramist folds
Gafe2018 folds
muespachois1 folds
rick26 folds
Fried Berg calls 0.04€
*** FLOP *** [Ac 5h 9c]
Fried Berg checks
Zile741 bets 0.05€
Fried Berg calls 0.05€
*** TURN *** [Ac 5h 9c][6h]
Fried Berg checks
Zile741 checks
*** RIVER *** [Ac 5h 9c 6h][6c]
Fried Berg bets 0.12€
Zile741 folds
Fried Berg collected 0.33€ from pot
*** SUMMARY ***
Total pot 0.33€ | Rake 0.02€
Board: [Ac 5h 9c 6h 6c]
Seat 2: Fried Berg (big blind) won 0.33€


Winamax Poker - HOLD-UP "Colorado" - HandId: #19116069-332564-1701435824 - Holdem no limit (0.01€/0.02€) - 2023/12/01 13:03:44 UTC
Table: 'Colorado' 6-max (real money) Seat #6 is the button
Seat 1: Fried Berg (3.11€)
Seat 2: mea botellas (3.06€)
Seat 3: rick26 (1.94€)
Seat 4: Mr.gelillo (1.64€)
Seat 5: Zile741 (2€)
Seat 6: Alex.Lorenzo (1.96€)
*** ANTE/BLINDS ***
Fried Berg posts small blind 0.01€
mea botellas posts big blind 0.02€
Dealt to Fried Berg [3s Th]
*** PRE-FLOP *** 
rick26 calls 0.02€
Mr.gelillo raises 0.08€ to 0.10€
Zile741 folds
Alex.Lorenzo folds
Fried Berg folds
mea botellas folds
rick26 folds
Mr.gelillo collected 0.15€ from pot
*** SUMMARY ***
Total pot 0.15€ | No rake
Seat 4: Mr.gelillo won 0.15€


Winamax Poker - HOLD-UP "Colorado" - HandId: #19116069-332580-1701435839 - Holdem no limit (0.01€/0.02€) - 2023/12/01 13:03:59 UTC
Table: 'Colorado' 6-max (real money) Seat #6 is the button
Seat 1: Fried Berg (3.10€)
Seat 2: JavitoCaro (0.66€)
Seat 3: ECPulga (5.76€)
Seat 4: g8o8k8u (2.68€)
Seat 5: Thequeen1205 (3.09€)
Seat 6: Charlise2 (0.65€)
*** ANTE/BLINDS ***
Fried Berg posts small blind 0.01€
JavitoCaro posts big blind 0.02€
Dealt to Fried Berg [Jh 4h]
*** PRE-FLOP *** 
ECPulga folds
g8o8k8u folds
Thequeen1205 folds
Charlise2 calls 0.02€
Fried Berg calls 0.01€
JavitoCaro checks
*** FLOP *** [Kd Ac 4c]
Fried Berg checks
JavitoCaro checks
Charlise2 checks
*** TURN *** [Kd Ac 4c][5s]
Fried Berg checks
JavitoCaro checks
Charlise2 checks
*** RIVER *** [Kd Ac 4c 5s][3s]
Fried Berg checks
JavitoCaro checks
Charlise2 checks
*** SHOW DOWN ***
Fried Berg shows [Jh 4h] (One pair : 4)
JavitoCaro shows [8c 3h] (One pair : 3)
Charlise2 shows [Ks 9h] (One pair : Kings)
Charlise2 collected 0.05€ from pot
*** SUMMARY ***
Total pot 0.05€ | Rake 0.01€
Board: [Kd Ac 4c 5s 3s]
Seat 1: Fried Berg (small blind) showed [Jh 4h] and lost with One pair : 4
Seat 2: JavitoCaro (big blind) showed [8c 3h] and lost with One pair : 3
Seat 6: Charlise2 (button) showed [Ks 9h] and won 0.05€ with One pair : Kings


Winamax Poker - HOLD-UP "Colorado" - HandId: #19116069-332661-1701435891 - Holdem no limit (0.01€/0.02€) - 2023/12/01 13:04:51 UTC
Table: 'Colorado' 6-max (real money) Seat #6 is the button
Seat 1: DGG23 (0.24€)
Seat 2: Tofini (2.20€)
Seat 3: TaBrEaMoI (2.68€)
Seat 4: Fried Berg (3.08€)
Seat 5: Charlise2 (0.68€)
Seat 6: Thequeen1205 (3.17€)
*** ANTE/BLINDS ***
DGG23 posts small blind 0.01€
Tofini posts big blind 0.02€
Dealt to Fried Berg [3d 8d]
*** PRE-FLOP *** 
TaBrEaMoI folds
Fried Berg folds
Charlise2 folds
Thequeen1205 folds
DGG23 folds
Tofini collected 0.03€ from pot
*** SUMMARY ***
Total pot 0.03€ | No rake
Seat 2: Tofini (big blind) won 0.03€


Winamax Poker - HOLD-UP "Colorado" - HandId: #19116069-332680-1701435900 - Holdem no limit (0.01€/0.02€) - 2023/12/01 13:05:00 UTC
Table: 'Colorado' 6-max (real money) Seat #6 is the button
Seat 1: Thequeen1205 (3.17€)
Seat 2: Kaoky (2.12€)
Seat 3: Fried Berg (3.08€)
Seat 4: Feelda1337 (3.29€)
Seat 5: Pierrof24 (1.63€)
Seat 6: Quoiconbet (2€)
*** ANTE/BLINDS ***
Thequeen1205 posts small blind 0.01€
Kaoky posts big blind 0.02€
Dealt to Fried Berg [4h Qh]
*** PRE-FLOP *** 
Fried Berg folds
Feelda1337 folds
Pierrof24 folds
Quoiconbet raises 0.02€ to 0.04€
Thequeen1205 calls 0.03€
Kaoky folds
*** FLOP *** [6d 4c Js]
Thequeen1205 checks
Quoiconbet checks
*** TURN *** [6d 4c Js][Jc]
Thequeen1205 checks
Quoiconbet checks
*** RIVER *** [6d 4c Js Jc][Qd]
Thequeen1205 checks
Quoiconbet checks
*** SHOW DOWN ***
Quoiconbet shows [Ah 8d] (One pair : Jacks)
Thequeen1205 shows [2d 2c] (Two pairs : Jacks and 2)
Thequeen1205 collected 0.09€ from pot
*** SUMMARY ***
Total pot 0.09€ | Rake 0.01€
Board: [6d 4c Js Jc Qd]
Seat 1: Thequeen1205 (small blind) showed [2d 2c] and won 0.09€ with Two pairs : Jacks and 2
Seat 6: Quoiconbet (button) showed [Ah 8d] and lost with One pair : Jacks


Winamax Poker - HOLD-UP "Colorado" - HandId: #19116069-332687-1701435906 - Holdem no limit (0.01€/0.02€) - 2023/12/01 13:05:06 UTC
Table: 'Colorado' 6-max (real money) Seat #6 is the button
Seat 1: Zile741 (2.01€)
Seat 2: JG813 (0.20€)
Seat 3: DGG23 (0.30€)
Seat 4: Fried Berg (3.08€)
Seat 5: x spoony (2.01€)
Seat 6: Max134Max (2.06€)
*** ANTE/BLINDS ***
Zile741 posts small blind 0.01€
JG813 posts big blind 0.02€
Dealt to Fried Berg [Qc 4s]
*** PRE-FLOP *** 
DGG23 folds
Fried Berg folds
x spoony folds
Max134Max folds
Zile741 folds
JG813 collected 0.03€ from pot
*** SUMMARY ***
Total pot 0.03€ | No rake
Seat 2: JG813 (big blind) won 0.03€


Winamax Poker - HOLD-UP "Colorado" - HandId: #19116069-332692-1701435908 - Holdem no limit (0.01€/0.02€) - 2023/12/01 13:05:08 UTC
Table: 'Colorado' 6-max (real money) Seat #6 is the button
Seat 1: ilergeta (2.14€)
Seat 2: DGG23 (0.30€)
Seat 3: Fried Berg (3.08€)
Seat 4: _ilTulipano_ (3.28€)
Seat 5: Feelda1337 (3.62€)
Seat 6: _gonzai_ (2.23€)
Hold-up to Pot: total 0.10€
*** ANTE/BLINDS ***
ilergeta posts small blind 0.01€
DGG23 posts big blind 0.02€
Dealt to Fried Berg [3h 6d]
*** PRE-FLOP *** 
Fried Berg folds
_ilTulipano_ raises 0.15€ to 0.17€
Feelda1337 calls 0.17€
_gonzai_ folds
ilergeta folds
DGG23 folds
*** FLOP *** [2c 7d 4c]
_ilTulipano_ bets 0.16€
Feelda1337 folds
_ilTulipano_ collected 0.59€ from pot
*** SUMMARY ***
Total pot 0.59€ | Rake 0.04€
Board: [2c 7d 4c]
Seat 4: _ilTulipano_ won 0.59€


Winamax Poker - HOLD-UP "Colorado" - HandId: #19116069-333503-1701436397 - Holdem no limit (0.01€/0.02€) - 2023/12/01 13:13:17 UTC
Table: 'Colorado' 6-max (real money) Seat #6 is the button
Seat 1: _TAISEZVOUS_ (2.09€)
Seat 2: Fried Berg (0.50€)
Seat 3: ilergeta (2.01€)
Seat 4: _ilTulipano_ (3.05€)
Seat 5: x spoony (2.71€)
Seat 6: Papaiah (2.47€)
*** ANTE/BLINDS ***
_TAISEZVOUS_ posts small blind 0.01€
Fried Berg posts big blind 0.02€
Dealt to Fried Berg [8c 8h]
*** PRE-FLOP *** 
ilergeta folds
_ilTulipano_ folds
x spoony folds
Papaiah folds
_TAISEZVOUS_ folds
Fried Berg collected 0.03€ from pot
*** SUMMARY ***
Total pot 0.03€ | No rake
Seat 2: Fried Berg (big blind) won 0.03€


Winamax Poker - HOLD-UP "Colorado" - HandId: #19116069-333525-1701436410 - Holdem no limit (0.01€/0.02€) - 2023/12/01 13:13:30 UTC
Table: 'Colorado' 6-max (real money) Seat #6 is the button
Seat 1: Fried Berg (0.51€)
Seat 2: _ilTulipano_ (2.55€)
Seat 3: LimpDoud (2€)
Seat 4: DGG23 (0.44€)
Seat 5: Remy_Lord265 (0.61€)
Seat 6: haouuum28 (1.41€)
*** ANTE/BLINDS ***
Fried Berg posts small blind 0.01€
_ilTulipano_ posts big blind 0.02€
Dealt to Fried Berg [8h 9c]
*** PRE-FLOP *** 
LimpDoud folds
DGG23 folds
Remy_Lord265 folds
haouuum28 folds
Fried Berg raises 0.02€ to 0.04€
_ilTulipano_ raises 0.12€ to 0.16€
Fried Berg folds
_ilTulipano_ collected 0.20€ from pot
*** SUMMARY ***
Total pot 0.20€ | No rake
Seat 2: _ilTulipano_ (big blind) won 0.20€


Winamax Poker - HOLD-UP "Colorado" - HandId: #19116069-333571-1701436436 - Holdem no limit (0.01€/0.02€) - 2023/12/01 13:13:56 UTC
Table: 'Colorado' 6-max (real money) Seat #6 is the button
Seat 1: Polanskii (1.93€)
Seat 2: Upswing11 (2€)
Seat 3: Fried Berg (0.47€)
Seat 4: zozo6750 (1.67€)
Seat 5: Thequeen1205 (4.19€)
Seat 6: Kaoky (2€)
*** ANTE/BLINDS ***
Polanskii posts small blind 0.01€
Upswing11 posts big blind 0.02€
Dealt to Fried Berg [9h Td]
*** PRE-FLOP *** 
Fried Berg folds
zozo6750 folds
Thequeen1205 folds
Kaoky folds
Polanskii folds
Upswing11 collected 0.03€ from pot
*** SUMMARY ***
Total pot 0.03€ | No rake
Seat 2: Upswing11 (big blind) won 0.03€


Winamax Poker - HOLD-UP "Colorado" - HandId: #19116069-333580-1701436440 - Holdem no limit (0.01€/0.02€) - 2023/12/01 13:14:00 UTC
Table: 'Colorado' 6-max (real money) Seat #6 is the button
Seat 1: LimpDoud (2.24€)
Seat 2: haouuum28 (1.69€)
Seat 3: _ilTulipano_ (2.59€)
Seat 4: Fried Berg (0.47€)
Seat 5: SnellRojas (2.72€)
Seat 6: Lunahez (0.30€)
*** ANTE/BLINDS ***
LimpDoud posts small blind 0.01€
haouuum28 posts big blind 0.02€
Dealt to Fried Berg [5s 3s]
*** PRE-FLOP *** 
_ilTulipano_ folds
Fried Berg folds
SnellRojas raises 0.03€ to 0.05€
Lunahez folds
LimpDoud raises 0.12€ to 0.17€
haouuum28 folds
SnellRojas folds
LimpDoud collected 0.24€ from pot
*** SUMMARY ***
Total pot 0.24€ | No rake
Seat 1: LimpDoud (small blind) won 0.24€


Winamax Poker - HOLD-UP "Colorado" - HandId: #19116069-333588-1701436445 - Holdem no limit (0.01€/0.02€) - 2023/12/01 13:14:05 UTC
Table: 'Colorado' 6-max (real money) Seat #6 is the button
Seat 1: Zile741 (2.10€)
Seat 2: Abec16 (2.92€)
Seat 3: FC_Ghost1 (2.42€)
Seat 4: x spoony (2.12€)
Seat 5: Fried Berg (0.47€)
Seat 6: Feelda1337 (2.62€)
*** ANTE/BLINDS ***
Zile741 posts small blind 0.01€
Abec16 posts big blind 0.02€
Dealt to Fried Berg [6s 7d]
*** PRE-FLOP *** 
FC_Ghost1 calls 0.02€
x spoony folds
Fried Berg folds
Feelda1337 folds
Zile741 folds
Abec16 checks
*** FLOP *** [Qs Th 4h]
Abec16 checks
FC_Ghost1 checks
*** TURN *** [Qs Th 4h][9d]
Abec16 checks
FC_Ghost1 checks
*** RIVER *** [Qs Th 4h 9d][Kh]
Abec16 bets 0.06€
FC_Ghost1 folds
Abec16 collected 0.10€ from pot
*** SUMMARY ***
Total pot 0.10€ | Rake 0.01€
Board: [Qs Th 4h 9d Kh]
Seat 2: Abec16 (big blind) won 0.10€


Winamax Poker - HOLD-UP "Colorado" - HandId: #19116069-333599-1701436451 - Holdem no limit (0.01€/0.02€) - 2023/12/01 13:14:11 UTC
Table: 'Colorado' 6-max (real money) Seat #6 is the button
Seat 1: _gonzai_ (2.40€)
Seat 2: vlalouloute (4€)
Seat 3: haouuum28 (1.67€)
Seat 4: g8o8k8u (2.01€)
Seat 5: Ertorko (2.96€)
Seat 6: Fried Berg (0.47€)
*** ANTE/BLINDS ***
_gonzai_ posts small blind 0.01€
vlalouloute posts big blind 0.02€
Dealt to Fried Berg [8c Qs]
*** PRE-FLOP *** 
haouuum28 folds
g8o8k8u folds
Ertorko folds
Fried Berg folds
_gonzai_ folds
vlalouloute collected 0.03€ from pot
*** SUMMARY ***
Total pot 0.03€ | No rake
Seat 2: vlalouloute (big blind) won 0.03€


Winamax Poker - HOLD-UP "Colorado" - HandId: #19116069-333606-1701436454 - Holdem no limit (0.01€/0.02€) - 2023/12/01 13:14:14 UTC
Table: 'Colorado' 6-max (real money) Seat #6 is the button
Seat 1: Feelda1337 (2.75€)
Seat 2: bastos2525 (2€)
Seat 3: Polanskii (1.93€)
Seat 4: Fried Berg (0.47€)
Seat 5: cdcb (1.69€)
Seat 6: g8o8k8u (2.01€)
*** ANTE/BLINDS ***
Feelda1337 posts small blind 0.01€
bastos2525 posts big blind 0.02€
Dealt to Fried Berg [8c 5s]
*** PRE-FLOP *** 
Polanskii folds
Fried Berg folds
cdcb calls 0.02€
g8o8k8u folds
Feelda1337 folds
bastos2525 checks
*** FLOP *** [Kh Ah 6d]
bastos2525 checks
cdcb checks
*** TURN *** [Kh Ah 6d][9h]
bastos2525 checks
cdcb checks
*** RIVER *** [Kh Ah 6d 9h][7d]
bastos2525 folds
cdcb collected 0.04€ from pot
*** SUMMARY ***
Total pot 0.04€ | Rake 0.01€
Board: [Kh Ah 6d 9h 7d]
Seat 5: cdcb won 0.04€


Winamax Poker - HOLD-UP "Colorado" - HandId: #19116069-333613-1701436457 - Holdem no limit (0.01€/0.02€) - 2023/12/01 13:14:17 UTC
Table: 'Colorado' 6-max (real money) Seat #6 is the button
Seat 1: gsxr72220 (1.05€)
Seat 2: Fried Berg (0.47€)
Seat 3: Homer14510 (2.08€)
Seat 4: LaTilteuse (2.91€)
Seat 5: Kaoky (3.64€)
Seat 6: Mr.gelillo (1.70€)
*** ANTE/BLINDS ***
gsxr72220 posts small blind 0.01€
Fried Berg posts big blind 0.02€
Dealt to Fried Berg [Ad 2s]
*** PRE-FLOP *** 
Homer14510 raises 0.05€ to 0.07€
LaTilteuse folds
Kaoky folds
Mr.gelillo folds
gsxr72220 calls 0.06€
Fried Berg folds
*** FLOP *** [6c Qc Jc]
gsxr72220 checks
Homer14510 checks
*** TURN *** [6c Qc Jc][Js]
gsxr72220 checks
Homer14510 checks
*** RIVER *** [6c Qc Jc Js][5h]
gsxr72220 checks
Homer14510 bets 0.06€
gsxr72220 folds
Homer14510 collected 0.20€ from pot
*** SUMMARY ***
Total pot 0.20€ | Rake 0.02€
Board: [6c Qc Jc Js 5h]
Seat 3: Homer14510 won 0.20€


Winamax Poker - HOLD-UP "Colorado" - HandId: #19116069-333631-1701436468 - Holdem no limit (0.01€/0.02€) - 2023/12/01 13:14:28 UTC
Table: 'Colorado' 6-max (real money) Seat #6 is the button
Seat 1: Fried Berg (0.45€)
Seat 2: ilergeta (2.32€)
Seat 3: joli45600352 (0.20€)
Seat 4: zozo6750 (1.51€)
Seat 5: Kaoky (2€)
Seat 6: Thequeen1205 (2.71€)
*** ANTE/BLINDS ***
Fried Berg posts small blind 0.01€
ilergeta posts big blind 0.02€
Dealt to Fried Berg [2c 4c]
*** PRE-FLOP *** 
joli45600352 folds
zozo6750 raises 0.05€ to 0.07€
Kaoky folds
Thequeen1205 folds
Fried Berg folds
ilergeta folds
zozo6750 collected 0.10€ from pot
*** SUMMARY ***
Total pot 0.10€ | No rake
Seat 4: zozo6750 won 0.10€


Winamax Poker - HOLD-UP "Colorado" - HandId: #19116069-333641-1701436473 - Holdem no limit (0.01€/0.02€) - 2023/12/01 13:14:33 UTC
Table: 'Colorado' 6-max (real money) Seat #6 is the button
Seat 1: LaTilteuse (2€)
Seat 2: _gonzai_ (2.40€)
Seat 3: Fried Berg (0.44€)
Seat 4: vlalouloute (3.44€)
Seat 5: haouuum28 (1.61€)
Seat 6: cdcb (1.71€)
*** ANTE/BLINDS ***
LaTilteuse posts small blind 0.01€
_gonzai_ posts big blind 0.02€
Dealt to Fried Berg [9d 5c]
*** PRE-FLOP *** 
Fried Berg folds
vlalouloute folds
haouuum28 folds
cdcb folds
LaTilteuse folds
_gonzai_ collected 0.03€ from pot
*** SUMMARY ***
Total pot 0.03€ | No rake
Seat 2: _gonzai_ (big blind) won 0.03€


Winamax Poker - HOLD-UP "Colorado" - HandId: #19116069-333644-1701436475 - Holdem no limit (0.01€/0.02€) - 2023/12/01 13:14:35 UTC
Table: 'Colorado' 6-max (real money) Seat #6 is the button
Seat 1: TaBrEaMoI (3.31€)
Seat 2: Tino-10 wnm (2.34€)
Seat 3: Kaoky (2.71€)
Seat 4: kameleon73 (2.67€)
Seat 5: Upswing11 (2€)
Seat 6: Fried Berg (0.44€)
*** ANTE/BLINDS ***
TaBrEaMoI posts small blind 0.01€
Tino-10 wnm posts big blind 0.02€
Dealt to Fried Berg [As 4s]
*** PRE-FLOP *** 
Kaoky folds
kameleon73 calls 0.02€
Upswing11 calls 0.02€
Fried Berg raises 0.04€ to 0.06€
TaBrEaMoI folds
Tino-10 wnm folds
kameleon73 folds
Upswing11 calls 0.04€
*** FLOP *** [Qc 7d Js]
Upswing11 checks
Fried Berg checks
*** TURN *** [Qc 7d Js][7c]
Upswing11 bets 0.09€
Fried Berg folds
Upswing11 collected 0.24€ from pot
*** SUMMARY ***
Total pot 0.24€ | Rake 0.02€
Board: [Qc 7d Js 7c]
Seat 5: Upswing11 won 0.24€


Winamax Poker - HOLD-UP "Colorado" - HandId: #19116069-333735-1701436526 - Holdem no limit (0.01€/0.02€) - 2023/12/01 13:15:26 UTC
Table: 'Colorado' 6-max (real money) Seat #6 is the button
Seat 1: crush game (2.84€)
Seat 2: Wolfert (2.04€)
Seat 3: vlalouloute (3.82€)
Seat 4: _ilTulipano_ (2.55€)
Seat 5: Fried Berg (0.38€)
Seat 6: LimpDoud (2.15€)
*** ANTE/BLINDS ***
crush game posts small blind 0.01€
Wolfert posts big blind 0.02€
Dealt to Fried Berg [Ts Tc]
*** PRE-FLOP *** 
vlalouloute folds
_ilTulipano_ folds
Fried Berg raises 0.03€ to 0.05€
LimpDoud folds
crush game folds
Wolfert raises 0.08€ to 0.13€
Fried Berg raises 0.25€ to 0.38€ and is all-in
Wolfert calls 0.25€
*** FLOP *** [Kh 3s 6c]
*** TURN *** [Kh 3s 6c][5h]
*** RIVER *** [Kh 3s 6c 5h][9d]
*** SHOW DOWN ***
Fried Berg shows [Ts Tc] (One pair : Tens)
Wolfert shows [Qh Qd] (One pair : Queens)
Wolfert collected 0.69€ from pot
*** SUMMARY ***
Total pot 0.69€ | Rake 0.08€
Board: [Kh 3s 6c 5h 9d]
Seat 2: Wolfert (big blind) showed [Qh Qd] and won 0.69€ with One pair : Queens
Seat 5: Fried Berg showed [Ts Tc] and lost with One pair : Tens


Winamax Poker - HOLD-UP "Colorado" - HandId: #19116069-333818-1701436574 - Holdem no limit (0.01€/0.02€) - 2023/12/01 13:16:14 UTC
Table: 'Colorado' 6-max (real money) Seat #6 is the button
Seat 1: _gonzai_ (2.88€)
Seat 2: wmx-ces1vxc (0.90€)
Seat 3: Lumayou (5.39€)
Seat 4: Kaoky (2€)
Seat 5: Fried Berg (0.50€)
Seat 6: Quoiconbet (3.86€)
*** ANTE/BLINDS ***
_gonzai_ posts small blind 0.01€
wmx-ces1vxc posts big blind 0.02€
Dealt to Fried Berg [Qc 4s]
*** PRE-FLOP *** 
Lumayou folds
Kaoky folds
Fried Berg folds
Quoiconbet folds
_gonzai_ folds
wmx-ces1vxc collected 0.03€ from pot
*** SUMMARY ***
Total pot 0.03€ | No rake
Seat 2: wmx-ces1vxc (big blind) won 0.03€


Winamax Poker - HOLD-UP "Colorado" - HandId: #19116069-333825-1701436578 - Holdem no limit (0.01€/0.02€) - 2023/12/01 13:16:18 UTC
Table: 'Colorado' 6-max (real money) Seat #6 is the button
Seat 1: Fried Berg (0.50€)
Seat 2: LimpDoud (2.15€)
Seat 3: misterda (1.91€)
Seat 4: KKamarAAde (2.93€)
Seat 5: Kaoky (2.91€)
Seat 6: Feelda1337 (2.77€)
*** ANTE/BLINDS ***
Fried Berg posts small blind 0.01€
LimpDoud posts big blind 0.02€
Dealt to Fried Berg [8s 2h]
*** PRE-FLOP *** 
misterda raises 0.04€ to 0.06€
KKamarAAde calls 0.06€
Kaoky folds
Feelda1337 raises 0.12€ to 0.18€
Fried Berg folds
LimpDoud folds
misterda calls 0.12€
KKamarAAde calls 0.12€
*** FLOP *** [4d Th 9d]
misterda bets 0.20€
KKamarAAde folds
Feelda1337 raises 0.38€ to 0.58€
misterda folds
Feelda1337 collected 1.25€ from pot
*** SUMMARY ***
Total pot 1.25€ | Rake 0.10€
Board: [4d Th 9d]
Seat 6: Feelda1337 (button) won 1.25€


Winamax Poker - HOLD-UP "Colorado" - HandId: #19116069-333830-1701436581 - Holdem no limit (0.01€/0.02€) - 2023/12/01 13:16:21 UTC
Table: 'Colorado' 6-max (real money) Seat #6 is the button
Seat 1: wmx-ces1vxc (0.91€)
Seat 2: Fried Berg (0.49€)
Seat 3: _TAISEZVOUS_ (2.34€)
Seat 4: bastos2525 (2.23€)
Seat 5: vlalouloute (3.41€)
Seat 6: _gonzai_ (2.87€)
*** ANTE/BLINDS ***
wmx-ces1vxc posts small blind 0.01€
Fried Berg posts big blind 0.02€
Dealt to Fried Berg [2s Kh]
*** PRE-FLOP *** 
_TAISEZVOUS_ folds
bastos2525 folds
vlalouloute raises 0.03€ to 0.05€
_gonzai_ calls 0.05€
wmx-ces1vxc folds
Fried Berg folds
*** FLOP *** [6d 6c 7c]
vlalouloute bets 0.03€
_gonzai_ calls 0.03€
*** TURN *** [6d 6c 7c][5s]
vlalouloute bets 0.24€
_gonzai_ calls 0.24€
*** RIVER *** [6d 6c 7c 5s][9s]
vlalouloute checks
_gonzai_ checks
*** SHOW DOWN ***
vlalouloute shows [Kd Qh] (One pair : 6)
_gonzai_ shows [9c Ac] (Two pairs : 9 and 6)
_gonzai_ collected 0.60€ from pot
*** SUMMARY ***
Total pot 0.60€ | Rake 0.07€
Board: [6d 6c 7c 5s 9s]
Seat 5: vlalouloute showed [Kd Qh] and lost with One pair : 6
Seat 6: _gonzai_ (button) showed [9c Ac] and won 0.60€ with Two pairs : 9 and 6


Winamax Poker - HOLD-UP "Colorado" - HandId: #19116069-333856-1701436596 - Holdem no limit (0.01€/0.02€) - 2023/12/01 13:16:36 UTC
Table: 'Colorado' 6-max (real money) Seat #6 is the button
Seat 1: bastos2525 (1.88€)
Seat 2: x spoony (2.09€)
Seat 3: Fried Berg (0.47€)
Seat 4: raptor01 (2.36€)
Seat 5: _Croute_ (2€)
Seat 6: TaBrEaMoI (2€)
*** ANTE/BLINDS ***
bastos2525 posts small blind 0.01€
x spoony posts big blind 0.02€
Dealt to Fried Berg [9c 5s]
*** PRE-FLOP *** 
Fried Berg folds
raptor01 folds
_Croute_ raises 0.04€ to 0.06€
TaBrEaMoI folds
bastos2525 folds
x spoony folds
_Croute_ collected 0.09€ from pot
*** SUMMARY ***
Total pot 0.09€ | No rake
Seat 5: _Croute_ won 0.09€


Winamax Poker - HOLD-UP "Colorado" - HandId: #19116069-333864-1701436600 - Holdem no limit (0.01€/0.02€) - 2023/12/01 13:16:40 UTC
Table: 'Colorado' 6-max (real money) Seat #6 is the button
Seat 1: FC_Ghost1 (1.87€)
Seat 2: diego2874 (2.13€)
Seat 3: Thequeen1205 (4.01€)
Seat 4: Fried Berg (0.47€)
Seat 5: mea botellas (5.67€)
Seat 6: TaBrEaMoI (2.67€)
*** ANTE/BLINDS ***
FC_Ghost1 posts small blind 0.01€
diego2874 posts big blind 0.02€
Dealt to Fried Berg [As Ah]
*** PRE-FLOP *** 
Thequeen1205 folds
Fried Berg raises 0.03€ to 0.05€
mea botellas folds
TaBrEaMoI folds
FC_Ghost1 folds
diego2874 folds
Fried Berg collected 0.08€ from pot
*** SUMMARY ***
Total pot 0.08€ | No rake
Seat 4: Fried Berg won 0.08€


Winamax Poker - HOLD-UP "Colorado" - HandId: #19116069-333899-1701436619 - Holdem no limit (0.01€/0.02€) - 2023/12/01 13:16:59 UTC
Table: 'Colorado' 6-max (real money) Seat #6 is the button
Seat 1: thagilo9 (1.21€)
Seat 2: crush game (2.98€)
Seat 3: TaBrEaMoI (2.04€)
Seat 4: g8o8k8u (2.06€)
Seat 5: gagnejamais4 (4.88€)
Seat 6: Fried Berg (0.50€)
*** ANTE/BLINDS ***
thagilo9 posts small blind 0.01€
crush game posts big blind 0.02€
Dealt to Fried Berg [7c Td]
*** PRE-FLOP *** 
TaBrEaMoI folds
g8o8k8u folds
gagnejamais4 folds
Fried Berg folds
thagilo9 folds
crush game collected 0.03€ from pot
*** SUMMARY ***
Total pot 0.03€ | No rake
Seat 2: crush game (big blind) won 0.03€


Winamax Poker - HOLD-UP "Colorado" - HandId: #19116069-333917-1701436628 - Holdem no limit (0.01€/0.02€) - 2023/12/01 13:17:08 UTC
Table: 'Colorado' 6-max (real money) Seat #6 is the button
Seat 1: Thequeen1205 (2.65€)
Seat 2: haouuum28 (1.85€)
Seat 3: LimpDoud (2.12€)
Seat 4: kameleon73 (2.65€)
Seat 5: CHANGAS (1.95€)
Seat 6: Fried Berg (0.50€)
*** ANTE/BLINDS ***
Thequeen1205 posts small blind 0.01€
haouuum28 posts big blind 0.02€
Dealt to Fried Berg [3s 7d]
*** PRE-FLOP *** 
LimpDoud folds
kameleon73 raises 0.05€ to 0.07€
CHANGAS folds
Fried Berg folds
Thequeen1205 folds
haouuum28 folds
kameleon73 collected 0.10€ from pot
*** SUMMARY ***
Total pot 0.10€ | No rake
Seat 4: kameleon73 won 0.10€


Winamax Poker - HOLD-UP "Colorado" - HandId: #19116069-333940-1701436640 - Holdem no limit (0.01€/0.02€) - 2023/12/01 13:17:20 UTC
Table: 'Colorado' 6-max (real money) Seat #6 is the button
Seat 1: JFSredbaron (2€)
Seat 2: Fried Berg (0.50€)
Seat 3: Tino-10 wnm (2.27€)
Seat 4: TaBrEaMoI (2.64€)
Seat 5: Mr.gelillo (2.17€)
Seat 6: Zile741 (2€)
*** ANTE/BLINDS ***
JFSredbaron posts small blind 0.01€
Fried Berg posts big blind 0.02€
Dealt to Fried Berg [Kh 9c]
*** PRE-FLOP *** 
Tino-10 wnm folds
TaBrEaMoI folds
Mr.gelillo folds
Zile741 folds
JFSredbaron folds
Fried Berg collected 0.03€ from pot
*** SUMMARY ***
Total pot 0.03€ | No rake
Seat 2: Fried Berg (big blind) won 0.03€


Winamax Poker - HOLD-UP "Colorado" - HandId: #19116069-333962-1701436651 - Holdem no limit (0.01€/0.02€) - 2023/12/01 13:17:31 UTC
Table: 'Colorado' 6-max (real money) Seat #6 is the button
Seat 1: Evla45 (1.98€)
Seat 2: JT72 (0.25€)
Seat 3: Fried Berg (0.51€)
Seat 4: JFSredbaron (2€)
Seat 5: Bilderbet (3.30€)
Seat 6: _gonzai_ (2.16€)
Hold-up to Pot: total 0.10€
*** ANTE/BLINDS ***
Evla45 posts small blind 0.01€
JT72 posts big blind 0.02€
Dealt to Fried Berg [5s 3h]
*** PRE-FLOP *** 
Fried Berg folds
JFSredbaron folds
Bilderbet raises 0.04€ to 0.06€
_gonzai_ calls 0.06€
Evla45 calls 0.05€
JT72 folds
*** FLOP *** [3c Ah 5h]
Evla45 checks
Bilderbet checks
_gonzai_ checks
*** TURN *** [3c Ah 5h][Js]
Evla45 bets 0.02€
Bilderbet folds
_gonzai_ calls 0.02€
*** RIVER *** [3c Ah 5h Js][Ac]
Evla45 bets 0.12€
_gonzai_ folds
Evla45 collected 0.44€ from pot
*** SUMMARY ***
Total pot 0.44€ | Rake 0.02€
Board: [3c Ah 5h Js Ac]
Seat 1: Evla45 (small blind) won 0.44€


Winamax Poker - HOLD-UP "Colorado" - HandId: #19116069-333978-1701436659 - Holdem no limit (0.01€/0.02€) - 2023/12/01 13:17:39 UTC
Table: 'Colorado' 6-max (real money) Seat #6 is the button
Seat 1: Fried Berg (0.51€)
Seat 2: haouuum28 (1.71€)
Seat 3: wAAlterrr (3.77€)
Seat 4: Quoiconbet (2.77€)
Seat 5: Tino-10 wnm (2.27€)
Seat 6: gsxr72220 (0.70€)
*** ANTE/BLINDS ***
Fried Berg posts small blind 0.01€
haouuum28 posts big blind 0.02€
Dealt to Fried Berg [Js Jc]
*** PRE-FLOP *** 
wAAlterrr folds
Quoiconbet folds
Tino-10 wnm calls 0.02€
gsxr72220 raises 0.68€ to 0.70€ and is all-in
Fried Berg calls 0.50€ and is all-in
haouuum28 folds
Tino-10 wnm folds
*** FLOP *** [Ah Kd Ks]
*** TURN *** [Ah Kd Ks][9c]
*** RIVER *** [Ah Kd Ks 9c][5d]
*** SHOW DOWN ***
Fried Berg shows [Js Jc] (Two pairs : Kings and Jacks)
gsxr72220 shows [7s 7c] (Two pairs : Kings and 7)
gsxr72220 collected 0.19€ from side pot 1
Fried Berg collected 0.95€ from main pot
*** SUMMARY ***
Total pot 1.14€ | Rake 0.11€
Board: [Ah Kd Ks 9c 5d]
Seat 1: Fried Berg (small blind) showed [Js Jc] and won 0.95€ with Two pairs : Kings and Jacks
Seat 6: gsxr72220 (button) showed [7s 7c] and won 0.19€ with Two pairs : Kings and 7


Winamax Poker - HOLD-UP "Colorado" - HandId: #19116069-334071-1701436709 - Holdem no limit (0.01€/0.02€) - 2023/12/01 13:18:29 UTC
Table: 'Colorado' 6-max (real money) Seat #6 is the button
Seat 1: KKamarAAde (4.71€)
Seat 2: Tino-10 wnm (2.25€)
Seat 3: _TAISEZVOUS_ (2.30€)
Seat 4: Fried Berg (0.95€)
Seat 5: Kaoky (2.43€)
Seat 6: gsxr72220 (0.19€)
*** ANTE/BLINDS ***
KKamarAAde posts small blind 0.01€
Tino-10 wnm posts big blind 0.02€
Dealt to Fried Berg [5c 7d]
*** PRE-FLOP *** 
_TAISEZVOUS_ raises 0.03€ to 0.05€
Fried Berg folds
Kaoky folds
gsxr72220 folds
KKamarAAde folds
Tino-10 wnm calls 0.03€
*** FLOP *** [2c Ts 4c]
Tino-10 wnm checks
_TAISEZVOUS_ bets 0.04€
Tino-10 wnm calls 0.04€
*** TURN *** [2c Ts 4c][4h]
Tino-10 wnm checks
_TAISEZVOUS_ bets 0.13€
Tino-10 wnm calls 0.13€
*** RIVER *** [2c Ts 4c 4h][Jd]
Tino-10 wnm bets 0.45€
_TAISEZVOUS_ calls 0.45€
*** SHOW DOWN ***
Tino-10 wnm shows [Jh Th] (Two pairs : Jacks and Tens)
_TAISEZVOUS_ shows [Qs Qc] (Two pairs : Queens and 4)
_TAISEZVOUS_ collected 1.21€ from pot
*** SUMMARY ***
Total pot 1.21€ | Rake 0.14€
Board: [2c Ts 4c 4h Jd]
Seat 2: Tino-10 wnm (big blind) showed [Jh Th] and lost with Two pairs : Jacks and Tens
Seat 3: _TAISEZVOUS_ showed [Qs Qc] and won 1.21€ with Two pairs : Queens and 4


Winamax Poker - HOLD-UP "Colorado" - HandId: #19116069-334081-1701436715 - Holdem no limit (0.01€/0.02€) - 2023/12/01 13:18:35 UTC
Table: 'Colorado' 6-max (real money) Seat #6 is the button
Seat 1: CHANGAS (1.95€)
Seat 2: ANG55 (1.28€)
Seat 3: Mr.gelillo (2.21€)
Seat 4: kameleon73 (2.69€)
Seat 5: Fried Berg (0.95€)
Seat 6: zozo6750 (0.54€)
*** ANTE/BLINDS ***
CHANGAS posts small blind 0.01€
ANG55 posts big blind 0.02€
Dealt to Fried Berg [5s 2h]
*** PRE-FLOP *** 
Mr.gelillo folds
kameleon73 raises 0.02€ to 0.04€
Fried Berg folds
zozo6750 folds
CHANGAS folds
ANG55 calls 0.02€
*** FLOP *** [7c 3c 6c]
ANG55 checks
kameleon73 checks
*** TURN *** [7c 3c 6c][8d]
ANG55 bets 0.07€
kameleon73 folds
ANG55 collected 0.15€ from pot
*** SUMMARY ***
Total pot 0.15€ | Rake 0.01€
Board: [7c 3c 6c 8d]
Seat 2: ANG55 (big blind) won 0.15€


Winamax Poker - HOLD-UP "Colorado" - HandId: #19116069-334093-1701436721 - Holdem no limit (0.01€/0.02€) - 2023/12/01 13:18:41 UTC
Table: 'Colorado' 6-max (real money) Seat #6 is the button
Seat 1: Evla45 (2.23€)
Seat 2: fero4225 (0.50€)
Seat 3: CHANGAS (1.95€)
Seat 4: Fried Berg (0.95€)
Seat 5: KLeeMerHaut (2€)
Seat 6: TaBrEaMoI (2.69€)
*** ANTE/BLINDS ***
Evla45 posts small blind 0.01€
fero4225 posts big blind 0.02€
Dealt to Fried Berg [2s Ac]
*** PRE-FLOP *** 
CHANGAS folds
Fried Berg folds
KLeeMerHaut folds
TaBrEaMoI folds
Evla45 calls 0.01€
fero4225 checks
*** FLOP *** [7d Ah 6h]
Evla45 checks
fero4225 checks
*** TURN *** [7d Ah 6h][Kh]
Evla45 checks
fero4225 checks
*** RIVER *** [7d Ah 6h Kh][Qd]
Evla45 checks
fero4225 checks
*** SHOW DOWN ***
fero4225 shows [Td Th] (One pair : Tens)
Evla45 shows [Jc Qs] (One pair : Queens)
Evla45 collected 0.04€ from pot
*** SUMMARY ***
Total pot 0.04€ | No rake
Board: [7d Ah 6h Kh Qd]
Seat 1: Evla45 (small blind) showed [Jc Qs] and won 0.04€ with One pair : Queens
Seat 2: fero4225 (big blind) showed [Td Th] and lost with One pair : Tens


Winamax Poker - HOLD-UP "Colorado" - HandId: #19116069-334101-1701436727 - Holdem no limit (0.01€/0.02€) - 2023/12/01 13:18:47 UTC
Table: 'Colorado' 6-max (real money) Seat #6 is the button
Seat 1: _gonzai_ (3.32€)
Seat 2: Fried Berg (0.95€)
Seat 3: TaBrEaMoI (2€)
Seat 4: LeDoc51 (1.92€)
Seat 5: LimpDoud (2.55€)
Seat 6: --kate-- (1.05€)
*** ANTE/BLINDS ***
_gonzai_ posts small blind 0.01€
Fried Berg posts big blind 0.02€
Dealt to Fried Berg [8s Ts]
*** PRE-FLOP *** 
TaBrEaMoI folds
LeDoc51 folds
LimpDoud folds
--kate-- folds
_gonzai_ raises 0.04€ to 0.06€
Fried Berg calls 0.04€
*** FLOP *** [5c 7h 9c]
_gonzai_ checks
Fried Berg checks
*** TURN *** [5c 7h 9c][Th]
_gonzai_ bets 0.08€
Fried Berg calls 0.08€
*** RIVER *** [5c 7h 9c Th][6d]
_gonzai_ checks
Fried Berg checks
*** SHOW DOWN ***
_gonzai_ shows [Jh Qd] (High card : Queen)
Fried Berg shows [8s Ts] (Straight Ten high)
Fried Berg collected 0.25€ from pot
*** SUMMARY ***
Total pot 0.25€ | Rake 0.03€
Board: [5c 7h 9c Th 6d]
Seat 1: _gonzai_ (small blind) showed [Jh Qd] and lost with High card : Queen
Seat 2: Fried Berg (big blind) showed [8s Ts] and won 0.25€ with Straight Ten high


Winamax Poker - HOLD-UP "Colorado" - HandId: #19116069-334409-1701436895 - Holdem no limit (0.01€/0.02€) - 2023/12/01 13:21:35 UTC
Table: 'Colorado' 6-max (real money) Seat #6 is the button
Seat 1: Fried Berg (1.06€)
Seat 2: _gonzai_ (3.18€)
Seat 3: Ertorko (3.31€)
Seat 4: Max134Max (2.68€)
Seat 5: Mr.gelillo (2.32€)
Seat 6: Zile741 (3.78€)
*** ANTE/BLINDS ***
Fried Berg posts small blind 0.01€
_gonzai_ posts big blind 0.02€
Dealt to Fried Berg [Qh 5c]
*** PRE-FLOP *** 
Ertorko folds
Max134Max folds
Mr.gelillo folds
Zile741 raises 0.03€ to 0.05€
Fried Berg folds
_gonzai_ folds
Zile741 collected 0.08€ from pot
*** SUMMARY ***
Total pot 0.08€ | No rake
Seat 6: Zile741 (button) won 0.08€


Winamax Poker - HOLD-UP "Colorado" - HandId: #19116069-334458-1701436918 - Holdem no limit (0.01€/0.02€) - 2023/12/01 13:21:58 UTC
Table: 'Colorado' 6-max (real money) Seat #6 is the button
Seat 1: Xnikos2X (2.20€)
Seat 2: Aisaia (0.64€)
Seat 3: Fried Berg (1.05€)
Seat 4: Thequeen1205 (4.53€)
Seat 5: _gonzai_ (3.16€)
Seat 6: KLeeMerHaut (3.21€)
*** ANTE/BLINDS ***
Xnikos2X posts small blind 0.01€
Aisaia posts big blind 0.02€
Dealt to Fried Berg [Ad Qh]
*** PRE-FLOP *** 
Fried Berg raises 0.02€ to 0.04€
Thequeen1205 folds
_gonzai_ folds
KLeeMerHaut calls 0.04€
Xnikos2X folds
Aisaia folds
*** FLOP *** [4s 6h 7c]
Fried Berg checks
KLeeMerHaut checks
*** TURN *** [4s 6h 7c][7s]
Fried Berg checks
KLeeMerHaut checks
*** RIVER *** [4s 6h 7c 7s][2d]
Fried Berg checks
KLeeMerHaut checks
*** SHOW DOWN ***
KLeeMerHaut shows [Kh 9h] (One pair : 7)
Fried Berg shows [Ad Qh] (One pair : 7)
Fried Berg collected 0.10€ from pot
*** SUMMARY ***
Total pot 0.10€ | Rake 0.01€
Board: [4s 6h 7c 7s 2d]
Seat 3: Fried Berg showed [Ad Qh] and won 0.10€ with One pair : 7
Seat 6: KLeeMerHaut (button) showed [Kh 9h] and lost with One pair : 7


Winamax Poker - HOLD-UP "Colorado" - HandId: #19116069-334534-1701436958 - Holdem no limit (0.01€/0.02€) - 2023/12/01 13:22:38 UTC
Table: 'Colorado' 6-max (real money) Seat #6 is the button
Seat 1: metamex (1.98€)
Seat 2: nanass25440 (1.65€)
Seat 3: KLeeMerHaut (3.17€)
Seat 4: Pierrof24 (2.87€)
Seat 5: Fried Berg (1.11€)
Seat 6: LimpDoud (2.16€)
*** ANTE/BLINDS ***
metamex posts small blind 0.01€
nanass25440 posts big blind 0.02€
Dealt to Fried Berg [Ks Ac]
*** PRE-FLOP *** 
KLeeMerHaut raises 0.04€ to 0.06€
Pierrof24 folds
Fried Berg calls 0.06€
LimpDoud folds
metamex folds
nanass25440 calls 0.04€
*** FLOP *** [3s 4s 9h]
nanass25440 checks
KLeeMerHaut checks
Fried Berg checks
*** TURN *** [3s 4s 9h][3h]
nanass25440 checks
KLeeMerHaut checks
Fried Berg checks
*** RIVER *** [3s 4s 9h 3h][Qc]
nanass25440 checks
KLeeMerHaut checks
Fried Berg checks
*** SHOW DOWN ***
nanass25440 shows [8d 5d] (One pair : 3)
KLeeMerHaut shows [Js Kc] (One pair : 3)
Fried Berg shows [Ks Ac] (One pair : 3)
Fried Berg collected 0.17€ from pot
*** SUMMARY ***
Total pot 0.17€ | Rake 0.02€
Board: [3s 4s 9h 3h Qc]
Seat 2: nanass25440 (big blind) showed [8d 5d] and lost with One pair : 3
Seat 3: KLeeMerHaut showed [Js Kc] and lost with One pair : 3
Seat 5: Fried Berg showed [Ks Ac] and won 0.17€ with One pair : 3


Winamax Poker - HOLD-UP "Colorado" - HandId: #19116069-334630-1701437007 - Holdem no limit (0.01€/0.02€) - 2023/12/01 13:23:27 UTC
Table: 'Colorado' 6-max (real money) Seat #6 is the button
Seat 1: x spoony (2.64€)
Seat 2: Clemence75 (2.09€)
Seat 3: nanass25440 (1.59€)
Seat 4: Myprincess (1.87€)
Seat 5: KLeeMerHaut (3.11€)
Seat 6: Fried Berg (1.22€)
*** ANTE/BLINDS ***
x spoony posts small blind 0.01€
Clemence75 posts big blind 0.02€
Dealt to Fried Berg [3s 8h]
*** PRE-FLOP *** 
nanass25440 folds
Myprincess folds
KLeeMerHaut folds
Fried Berg folds
x spoony folds
Clemence75 collected 0.03€ from pot
*** SUMMARY ***
Total pot 0.03€ | No rake
Seat 2: Clemence75 (big blind) won 0.03€


Winamax Poker - HOLD-UP "Colorado" - HandId: #19116069-334643-1701437015 - Holdem no limit (0.01€/0.02€) - 2023/12/01 13:23:35 UTC
Table: 'Colorado' 6-max (real money) Seat #6 is the button
Seat 1: Tino-10 wnm (3.01€)
Seat 2: _gonzai_ (2€)
Seat 3: x spoony (2.13€)
Seat 4: TuMensTanT (1.96€)
Seat 5: Fried Berg (1.22€)
Seat 6: Quoiconbet (2.08€)
*** ANTE/BLINDS ***
Tino-10 wnm posts small blind 0.01€
_gonzai_ posts big blind 0.02€
Dealt to Fried Berg [2c 4s]
*** PRE-FLOP *** 
x spoony folds
TuMensTanT folds
Fried Berg folds
Quoiconbet folds
Tino-10 wnm folds
_gonzai_ collected 0.03€ from pot
*** SUMMARY ***
Total pot 0.03€ | No rake
Seat 2: _gonzai_ (big blind) won 0.03€


Winamax Poker - HOLD-UP "Colorado" - HandId: #19116069-334650-1701437018 - Holdem no limit (0.01€/0.02€) - 2023/12/01 13:23:38 UTC
Table: 'Colorado' 6-max (real money) Seat #6 is the button
Seat 1: haouuum28 (2.35€)
Seat 2: CHOPATATE-44 (2€)
Seat 3: Fried Berg (1.22€)
Seat 4: Xnikos2X (2.05€)
Seat 5: wmx-ces1vxc (1.17€)
Seat 6: Thequeen1205 (2.31€)
*** ANTE/BLINDS ***
haouuum28 posts small blind 0.01€
CHOPATATE-44 posts big blind 0.02€
Dealt to Fried Berg [Ac Ad]
*** PRE-FLOP *** 
Fried Berg raises 0.04€ to 0.06€
Xnikos2X folds
wmx-ces1vxc calls 0.06€
Thequeen1205 calls 0.06€
haouuum28 calls 0.05€
CHOPATATE-44 folds
*** FLOP *** [3h 6h 2h]
haouuum28 checks
Fried Berg bets 0.02€
wmx-ces1vxc calls 0.02€
Thequeen1205 raises 0.10€ to 0.12€
haouuum28 folds
Fried Berg raises 0.10€ to 0.22€
wmx-ces1vxc folds
Thequeen1205 raises 0.19€ to 0.41€
Fried Berg folds
Thequeen1205 collected 0.84€ from pot
*** SUMMARY ***
Total pot 0.84€ | Rake 0.07€
Board: [3h 6h 2h]
Seat 6: Thequeen1205 (button) won 0.84€


Winamax Poker - HOLD-UP "Colorado" - HandId: #19116069-334831-1701437115 - Holdem no limit (0.01€/0.02€) - 2023/12/01 13:25:15 UTC
Table: 'Colorado' 6-max (real money) Seat #6 is the button
Seat 1: Homer14510 (1.46€)
Seat 2: Fried Berg (0.94€)
Seat 3: Ertorko (3.93€)
Seat 4: Mr.gelillo (2.33€)
Seat 5: corm973 (1.93€)
Seat 6: Savab1spaser (3.24€)
*** ANTE/BLINDS ***
Homer14510 posts small blind 0.01€
Fried Berg posts big blind 0.02€
Dealt to Fried Berg [Kc Ac]
*** PRE-FLOP *** 
Ertorko raises 0.03€ to 0.05€
Mr.gelillo folds
corm973 raises 0.10€ to 0.15€
Savab1spaser folds
Homer14510 folds
Fried Berg calls 0.13€
Ertorko folds
*** FLOP *** [Th 2d 7h]
Fried Berg checks
corm973 bets 0.13€
Fried Berg calls 0.13€
*** TURN *** [Th 2d 7h][8d]
Fried Berg checks
corm973 checks
*** RIVER *** [Th 2d 7h 8d][2h]
Fried Berg bets 0.16€
corm973 raises 1.49€ to 1.65€ and is all-in
Fried Berg calls 0.50€ and is all-in
*** SHOW DOWN ***
Fried Berg shows [Kc Ac] (One pair : 2)
corm973 shows [Kh Ah] (Flush Ace high)
corm973 collected 2.74€ from pot
*** SUMMARY ***
Total pot 2.74€ | Rake 0.19€
Board: [Th 2d 7h 8d 2h]
Seat 2: Fried Berg (big blind) showed [Kc Ac] and lost with One pair : 2
Seat 5: corm973 showed [Kh Ah] and won 2.74€ with Flush Ace high


Winamax Poker - HOLD-UP "Colorado" - HandId: #19116069-335043-1701437222 - Holdem no limit (0.01€/0.02€) - 2023/12/01 13:27:02 UTC
Table: 'Colorado' 6-max (real money) Seat #6 is the button
Seat 1: Fried Berg (0.50€)
Seat 2: Abec16 (2€)
Seat 3: OnceUpoNaTym (2.07€)
Seat 4: Petit.King53 (0.70€)
Seat 5: juanktyga (2€)
Seat 6: gagnejamais4 (7.65€)
*** ANTE/BLINDS ***
Fried Berg posts small blind 0.01€
Abec16 posts big blind 0.02€
Dealt to Fried Berg [Qd 7c]
*** PRE-FLOP *** 
OnceUpoNaTym folds
Petit.King53 raises 0.03€ to 0.05€
juanktyga folds
gagnejamais4 folds
Fried Berg folds
Abec16 folds
Petit.King53 collected 0.08€ from pot
*** SUMMARY ***
Total pot 0.08€ | No rake
Seat 4: Petit.King53 won 0.08€


Winamax Poker - HOLD-UP "Colorado" - HandId: #19116069-335052-1701437227 - Holdem no limit (0.01€/0.02€) - 2023/12/01 13:27:07 UTC
Table: 'Colorado' 6-max (real money) Seat #6 is the button
Seat 1: Damspins (1.88€)
Seat 2: OnceUpoNaTym (2.07€)
Seat 3: metamex (1.81€)
Seat 4: Fried Berg (0.49€)
Seat 5: CHOPATATE-44 (2€)
Seat 6: Zile741 (2.23€)
*** ANTE/BLINDS ***
Damspins posts small blind 0.01€
OnceUpoNaTym posts big blind 0.02€
Dealt to Fried Berg [5c Ac]
*** PRE-FLOP *** 
metamex folds
Fried Berg raises 0.02€ to 0.04€
CHOPATATE-44 folds
Zile741 calls 0.04€
Damspins folds
OnceUpoNaTym folds
*** FLOP *** [Kh 9d Jh]
Fried Berg checks
Zile741 bets 0.07€
Fried Berg folds
Zile741 collected 0.17€ from pot
*** SUMMARY ***
Total pot 0.17€ | Rake 0.01€
Board: [Kh 9d Jh]
Seat 6: Zile741 (button) won 0.17€


Winamax Poker - HOLD-UP "Colorado" - HandId: #19116069-335142-1701437275 - Holdem no limit (0.01€/0.02€) - 2023/12/01 13:27:55 UTC
Table: 'Colorado' 6-max (real money) Seat #6 is the button
Seat 1: Ertorko (2.16€)
Seat 2: Max134Max (2.60€)
Seat 3: Mr.zak (0.23€)
Seat 4: haouuum28 (1.87€)
Seat 5: caarloosgb (1.76€)
Seat 6: Fried Berg (0.45€)
Hold-up to Pot: total 0.20€
*** ANTE/BLINDS ***
Ertorko posts small blind 0.01€
Max134Max posts big blind 0.02€
Dealt to Fried Berg [5d 6d]
*** PRE-FLOP *** 
Mr.zak folds
haouuum28 folds
caarloosgb raises 0.07€ to 0.09€
Fried Berg calls 0.09€
Ertorko calls 0.08€
Max134Max calls 0.07€
*** FLOP *** [5h Td 8c]
Ertorko checks
Max134Max checks
caarloosgb checks
Fried Berg checks
*** TURN *** [5h Td 8c][8s]
Ertorko checks
Max134Max bets 0.22€
caarloosgb folds
Fried Berg raises 0.14€ to 0.36€ and is all-in
Ertorko folds
Max134Max calls 0.14€
*** RIVER *** [5h Td 8c 8s][Ac]
*** SHOW DOWN ***
Fried Berg shows [5d 6d] (Two pairs : 8 and 5)
Max134Max shows [Th Qd] (Two pairs : Tens and 8)
Max134Max collected 1.17€ from pot
*** SUMMARY ***
Total pot 1.17€ | Rake 0.11€
Board: [5h Td 8c 8s Ac]
Seat 2: Max134Max (big blind) showed [Th Qd] and won 1.17€ with Two pairs : Tens and 8
Seat 6: Fried Berg (button) showed [5d 6d] and lost with Two pairs : 8 and 5


Winamax Poker - HOLD-UP "Colorado" - HandId: #19116069-335278-1701437346 - Holdem no limit (0.01€/0.02€) - 2023/12/01 13:29:06 UTC
Table: 'Colorado' 6-max (real money) Seat #6 is the button
Seat 1: metamex (1.47€)
Seat 2: KKamarAAde (2.97€)
Seat 3: Clemence75 (2.02€)
Seat 4: Mr.zak (1.66€)
Seat 5: Fried Berg (0.50€)
Seat 6: Lumayou (10.92€)
*** ANTE/BLINDS ***
metamex posts small blind 0.01€
KKamarAAde posts big blind 0.02€
Dealt to Fried Berg [Qh 2d]
*** PRE-FLOP *** 
Clemence75 folds
Mr.zak calls 0.02€
Fried Berg folds
Lumayou folds
metamex calls 0.01€
KKamarAAde checks
*** FLOP *** [6h 8d 2s]
metamex checks
KKamarAAde checks
Mr.zak checks
*** TURN *** [6h 8d 2s][9h]
metamex bets 0.06€
KKamarAAde calls 0.06€
Mr.zak folds
*** RIVER *** [6h 8d 2s 9h][Jd]
metamex checks
KKamarAAde checks
*** SHOW DOWN ***
KKamarAAde shows [7c 7d] (One pair : 7)
metamex shows [Kc 9d] (One pair : 9)
metamex collected 0.16€ from pot
*** SUMMARY ***
Total pot 0.16€ | Rake 0.02€
Board: [6h 8d 2s 9h Jd]
Seat 1: metamex (small blind) showed [Kc 9d] and won 0.16€ with One pair : 9
Seat 2: KKamarAAde (big blind) showed [7c 7d] and lost with One pair : 7


Winamax Poker - HOLD-UP "Colorado" - HandId: #19116069-335290-1701437354 - Holdem no limit (0.01€/0.02€) - 2023/12/01 13:29:14 UTC
Table: 'Colorado' 6-max (real money) Seat #6 is the button
Seat 1: Fried Berg (0.50€)
Seat 2: corm973 (1.89€)
Seat 3: Xnikos2X (2.44€)
Seat 4: Thequeen1205 (5.31€)
Seat 5: _TAISEZVOUS_ (3.33€)
Seat 6: CHOPATATE-44 (2.06€)
*** ANTE/BLINDS ***
Fried Berg posts small blind 0.01€
corm973 posts big blind 0.02€
Dealt to Fried Berg [8s Qc]
*** PRE-FLOP *** 
Xnikos2X folds
Thequeen1205 folds
_TAISEZVOUS_ raises 0.03€ to 0.05€
CHOPATATE-44 raises 0.10€ to 0.15€
Fried Berg folds
corm973 folds
_TAISEZVOUS_ folds
CHOPATATE-44 collected 0.23€ from pot
*** SUMMARY ***
Total pot 0.23€ | No rake
Seat 6: CHOPATATE-44 (button) won 0.23€


Winamax Poker - HOLD-UP "Colorado" - HandId: #19116069-335316-1701437366 - Holdem no limit (0.01€/0.02€) - 2023/12/01 13:29:26 UTC
Table: 'Colorado' 6-max (real money) Seat #6 is the button
Seat 1: rick26 (3.06€)
Seat 2: Fried Berg (0.49€)
Seat 3: Damspins (1.75€)
Seat 4: DGG23 (0.22€)
Seat 5: ProfduFold (2.10€)
Seat 6: x spoony (2.54€)
*** ANTE/BLINDS ***
rick26 posts small blind 0.01€
Fried Berg posts big blind 0.02€
Dealt to Fried Berg [Jh 4d]
*** PRE-FLOP *** 
Damspins folds
DGG23 calls 0.02€
ProfduFold folds
x spoony folds
rick26 folds
Fried Berg checks
*** FLOP *** [5s Ad Td]
Fried Berg checks
DGG23 checks
*** TURN *** [5s Ad Td][Kc]
Fried Berg checks
DGG23 checks
*** RIVER *** [5s Ad Td Kc][Qs]
Fried Berg bets 0.02€
DGG23 raises 0.12€ to 0.14€
Fried Berg raises 0.12€ to 0.26€
DGG23 calls 0.06€ and is all-in
*** SHOW DOWN ***
Fried Berg shows [Jh 4d] (Straight Ace high)
DGG23 shows [Ac Jd] (Straight Ace high)
DGG23 collected 0.20€ from main pot
Fried Berg collected 0.26€ from side pot 1
*** SUMMARY ***
Total pot 0.46€ | Rake 0.05€
Board: [5s Ad Td Kc Qs]
Seat 2: Fried Berg (big blind) showed [Jh 4d] and won 0.26€ with Straight Ace high
Seat 4: DGG23 showed [Ac Jd] and won 0.20€ with Straight Ace high


Winamax Poker - HOLD-UP "Colorado" - HandId: #19116069-335411-1701437421 - Holdem no limit (0.01€/0.02€) - 2023/12/01 13:30:21 UTC
Table: 'Colorado' 6-max (real money) Seat #6 is the button
Seat 1: Brut2pok (2.02€)
Seat 2: lyric1969 (2.18€)
Seat 3: Fried Berg (0.47€)
Seat 4: bastos2525 (2.49€)
Seat 5: Analov (2.36€)
Seat 6: rick26 (3.05€)
*** ANTE/BLINDS ***
Brut2pok posts small blind 0.01€
lyric1969 posts big blind 0.02€
Dealt to Fried Berg [Qc 2d]
*** PRE-FLOP *** 
Fried Berg folds
bastos2525 raises 0.05€ to 0.07€
Analov folds
rick26 folds
Brut2pok folds
lyric1969 calls 0.05€
*** FLOP *** [5s Tc Td]
lyric1969 checks
bastos2525 bets 0.05€
lyric1969 calls 0.05€
*** TURN *** [5s Tc Td][Kd]
lyric1969 checks
bastos2525 checks
*** RIVER *** [5s Tc Td Kd][Ts]
lyric1969 bets 0.16€
bastos2525 folds
lyric1969 collected 0.38€ from pot
*** SUMMARY ***
Total pot 0.38€ | Rake 0.03€
Board: [5s Tc Td Kd Ts]
Seat 2: lyric1969 (big blind) won 0.38€


Winamax Poker - HOLD-UP "Colorado" - HandId: #19116069-335421-1701437428 - Holdem no limit (0.01€/0.02€) - 2023/12/01 13:30:28 UTC
Table: 'Colorado' 6-max (real money) Seat #6 is the button
Seat 1: mea botellas (4.19€)
Seat 2: TuMensTanT (2.16€)
Seat 3: _ilTulipano_ (4.86€)
Seat 4: Fried Berg (0.47€)
Seat 5: TaBrEaMoI (2.48€)
Seat 6: KKamarAAde (12.19€)
*** ANTE/BLINDS ***
mea botellas posts small blind 0.01€
TuMensTanT posts big blind 0.02€
Dealt to Fried Berg [7h Qs]
*** PRE-FLOP *** 
_ilTulipano_ folds
Fried Berg folds
TaBrEaMoI folds
KKamarAAde folds
mea botellas raises 0.04€ to 0.06€
TuMensTanT folds
mea botellas collected 0.08€ from pot
*** SUMMARY ***
Total pot 0.08€ | No rake
Seat 1: mea botellas (small blind) won 0.08€


Winamax Poker - HOLD-UP "Colorado" - HandId: #19116069-335428-1701437431 - Holdem no limit (0.01€/0.02€) - 2023/12/01 13:30:31 UTC
Table: 'Colorado' 6-max (real money) Seat #6 is the button
Seat 1: _ilTulipano_ (2.43€)
Seat 2: Puma24644584 (1.55€)
Seat 3: kameleon73 (2.72€)
Seat 4: Clemence75 (2.13€)
Seat 5: Fried Berg (0.47€)
Seat 6: oliveponcar (2.32€)
*** ANTE/BLINDS ***
_ilTulipano_ posts small blind 0.01€
Puma24644584 posts big blind 0.02€
Dealt to Fried Berg [2s 3d]
*** PRE-FLOP *** 
kameleon73 folds
Clemence75 folds
Fried Berg folds
oliveponcar raises 0.03€ to 0.05€
_ilTulipano_ folds
Puma24644584 calls 0.03€
*** FLOP *** [5s Qd 2h]
Puma24644584 checks
oliveponcar bets 0.03€
Puma24644584 folds
oliveponcar collected 0.13€ from pot
*** SUMMARY ***
Total pot 0.13€ | Rake 0.01€
Board: [5s Qd 2h]
Seat 6: oliveponcar (button) won 0.13€


Winamax Poker - HOLD-UP "Colorado" - HandId: #19116069-335432-1701437433 - Holdem no limit (0.01€/0.02€) - 2023/12/01 13:30:33 UTC
Table: 'Colorado' 6-max (real money) Seat #6 is the button
Seat 1: LimpDoud (2.17€)
Seat 2: Clemence75 (2.13€)
Seat 3: Fried Berg (0.47€)
Seat 4: wmx-ces1vxc (1.39€)
Seat 5: CHANGAS (1.84€)
Seat 6: x spoony (2.49€)
*** ANTE/BLINDS ***
LimpDoud posts small blind 0.01€
Clemence75 posts big blind 0.02€
Dealt to Fried Berg [Td 2d]
*** PRE-FLOP *** 
Fried Berg folds
wmx-ces1vxc calls 0.02€
CHANGAS folds
x spoony folds
LimpDoud folds
Clemence75 checks
*** FLOP *** [Ac 6h Js]
Clemence75 checks
wmx-ces1vxc bets 0.02€
Clemence75 folds
wmx-ces1vxc collected 0.06€ from pot
*** SUMMARY ***
Total pot 0.06€ | Rake 0.01€
Board: [Ac 6h Js]
Seat 4: wmx-ces1vxc won 0.06€


Winamax Poker - HOLD-UP "Colorado" - HandId: #19116069-335435-1701437434 - Holdem no limit (0.01€/0.02€) - 2023/12/01 13:30:34 UTC
Table: 'Colorado' 6-max (real money) Seat #6 is the button
Seat 1: _Sephi (3.56€)
Seat 2: Fried Berg (0.47€)
Seat 3: Brut2pok (2.29€)
Seat 4: kameleon73 (2.72€)
Seat 5: KLeeMerHaut (3.77€)
Seat 6: haouuum28 (1.88€)
*** ANTE/BLINDS ***
_Sephi posts small blind 0.01€
Fried Berg posts big blind 0.02€
Dealt to Fried Berg [Jd 3h]
*** PRE-FLOP *** 
Brut2pok folds
kameleon73 folds
KLeeMerHaut folds
haouuum28 raises 0.03€ to 0.05€
_Sephi raises 0.12€ to 0.17€
Fried Berg folds
haouuum28 calls 0.12€
*** FLOP *** [5d Qh Ts]
_Sephi checks
haouuum28 bets 0.36€
_Sephi raises 3.03€ to 3.39€ and is all-in
haouuum28 calls 1.35€ and is all-in
*** TURN *** [5d Qh Ts][5c]
*** RIVER *** [5d Qh Ts 5c][Tc]
*** SHOW DOWN ***
_Sephi shows [Ad Qc] (Two pairs : Queens and Tens)
haouuum28 shows [Qd Ah] (Two pairs : Queens and Tens)
haouuum28 collected 1.70€ from main pot
_Sephi collected 3.38€ from side pot 1
*** SUMMARY ***
Total pot 5.08€ | Rake 0.38€
Board: [5d Qh Ts 5c Tc]
Seat 1: _Sephi (small blind) showed [Ad Qc] and won 3.38€ with Two pairs : Queens and Tens
Seat 6: haouuum28 (button) showed [Qd Ah] and won 1.70€ with Two pairs : Queens and Tens


Winamax Poker - HOLD-UP "Colorado" - HandId: #19116069-335452-1701437444 - Holdem no limit (0.01€/0.02€) - 2023/12/01 13:30:44 UTC
Table: 'Colorado' 6-max (real money) Seat #6 is the button
Seat 1: Fried Berg (0.45€)
Seat 2: Damspins (1.69€)
Seat 3: KKamarAAde (5.60€)
Seat 4: Papaiah (2€)
Seat 5: LimpDoud (2€)
Seat 6: juanktyga (3.86€)
*** ANTE/BLINDS ***
Fried Berg posts small blind 0.01€
Damspins posts big blind 0.02€
Dealt to Fried Berg [5h 4s]
*** PRE-FLOP *** 
KKamarAAde raises 0.04€ to 0.06€
Papaiah folds
LimpDoud folds
juanktyga folds
Fried Berg folds
Damspins folds
KKamarAAde collected 0.09€ from pot
*** SUMMARY ***
Total pot 0.09€ | No rake
Seat 3: KKamarAAde won 0.09€


Winamax Poker - HOLD-UP "Colorado" - HandId: #19116069-335456-1701437445 - Holdem no limit (0.01€/0.02€) - 2023/12/01 13:30:45 UTC
Table: 'Colorado' 6-max (real money) Seat #6 is the button
Seat 1: CHANGAS (1.84€)
Seat 2: JissEl1te (2€)
Seat 3: wmx-ces1vxc (1.41€)
Seat 4: Fried Berg (0.44€)
Seat 5: Papaiah (2€)
Seat 6: x spoony (2.61€)
*** ANTE/BLINDS ***
CHANGAS posts small blind 0.01€
JissEl1te posts big blind 0.02€
Dealt to Fried Berg [7d 9d]
*** PRE-FLOP *** 
wmx-ces1vxc calls 0.02€
Fried Berg folds
Papaiah folds
x spoony folds
CHANGAS folds
JissEl1te checks
*** FLOP *** [8c 7h Qd]
JissEl1te checks
wmx-ces1vxc checks
*** TURN *** [8c 7h Qd][Ac]
JissEl1te checks
wmx-ces1vxc checks
*** RIVER *** [8c 7h Qd Ac][6s]
JissEl1te checks
wmx-ces1vxc checks
*** SHOW DOWN ***
JissEl1te shows [Jc 5c] (High card : Ace)
wmx-ces1vxc shows [9s Jd] (High card : Ace)
wmx-ces1vxc collected 0.04€ from pot
*** SUMMARY ***
Total pot 0.04€ | Rake 0.01€
Board: [8c 7h Qd Ac 6s]
Seat 2: JissEl1te (big blind) showed [Jc 5c] and lost with High card : Ace
Seat 3: wmx-ces1vxc showed [9s Jd] and won 0.04€ with High card : Ace


Winamax Poker - HOLD-UP "Colorado" - HandId: #19116069-335468-1701437452 - Holdem no limit (0.01€/0.02€) - 2023/12/01 13:30:52 UTC
Table: 'Colorado' 6-max (real money) Seat #6 is the button
Seat 1: kamikazzz51 (0.71€)
Seat 2: bastos2525 (2.37€)
Seat 3: Zile741 (3.67€)
Seat 4: stuart79 (4.47€)
Seat 5: Ertorko (3.64€)
Seat 6: Fried Berg (0.44€)
*** ANTE/BLINDS ***
kamikazzz51 posts small blind 0.01€
bastos2525 posts big blind 0.02€
Dealt to Fried Berg [5d 7s]
*** PRE-FLOP *** 
Zile741 folds
stuart79 folds
Ertorko folds
Fried Berg folds
kamikazzz51 folds
bastos2525 collected 0.03€ from pot
*** SUMMARY ***
Total pot 0.03€ | No rake
Seat 2: bastos2525 (big blind) won 0.03€


Winamax Poker - HOLD-UP "Colorado" - HandId: #19116069-335476-1701437455 - Holdem no limit (0.01€/0.02€) - 2023/12/01 13:30:55 UTC
Table: 'Colorado' 6-max (real money) Seat #6 is the button
Seat 1: Analov (2.37€)
Seat 2: Zile741 (2.16€)
Seat 3: TaBrEaMoI (2.05€)
Seat 4: x spoony (2.61€)
Seat 5: CHOPATATE-44 (2€)
Seat 6: Fried Berg (0.44€)
*** ANTE/BLINDS ***
Analov posts small blind 0.01€
Zile741 posts big blind 0.02€
Dealt to Fried Berg [4s 7c]
*** PRE-FLOP *** 
TaBrEaMoI folds
x spoony folds
CHOPATATE-44 folds
Fried Berg folds
Analov folds
Zile741 collected 0.03€ from pot
*** SUMMARY ***
Total pot 0.03€ | No rake
Seat 2: Zile741 (big blind) won 0.03€


Winamax Poker - HOLD-UP "Colorado" - HandId: #19116069-335481-1701437457 - Holdem no limit (0.01€/0.02€) - 2023/12/01 13:30:57 UTC
Table: 'Colorado' 6-max (real money) Seat #6 is the button
Seat 1: TaBrEaMoI (2.28€)
Seat 2: cdcb (1.74€)
Seat 3: toka30 (4.09€)
Seat 4: Xnikos2X (2.18€)
Seat 5: Tonystres14 (1.77€)
Seat 6: Fried Berg (0.44€)
Hold-up to Pot: total 0.20€
*** ANTE/BLINDS ***
TaBrEaMoI posts small blind 0.01€
cdcb posts big blind 0.02€
Dealt to Fried Berg [9s Qs]
*** PRE-FLOP *** 
toka30 folds
Xnikos2X folds
Tonystres14 calls 0.02€
Fried Berg calls 0.02€
TaBrEaMoI calls 0.01€
cdcb checks
*** FLOP *** [Td 2h Tc]
TaBrEaMoI checks
cdcb checks
Tonystres14 checks
Fried Berg checks
*** TURN *** [Td 2h Tc][Jh]
TaBrEaMoI checks
cdcb checks
Tonystres14 checks
Fried Berg checks
*** RIVER *** [Td 2h Tc Jh][As]
TaBrEaMoI checks
cdcb bets 0.18€
Tonystres14 folds
Fried Berg folds
TaBrEaMoI folds
cdcb collected 0.45€ from pot
*** SUMMARY ***
Total pot 0.45€ | Rake 0.01€
Board: [Td 2h Tc Jh As]
Seat 2: cdcb (big blind) won 0.45€


Winamax Poker - HOLD-UP "Colorado" - HandId: #19116069-335580-1701437514 - Holdem no limit (0.01€/0.02€) - 2023/12/01 13:31:54 UTC
Table: 'Colorado' 6-max (real money) Seat #6 is the button
Seat 1: Fried Berg (0.42€)
Seat 2: oliveponcar (2.22€)
Seat 3: ricki64 (2.97€)
Seat 4: thagilo9 (1.83€)
Seat 5: _ilTulipano_ (4.68€)
Seat 6: nanass25440 (1.82€)
*** ANTE/BLINDS ***
Fried Berg posts small blind 0.01€
oliveponcar posts big blind 0.02€
Dealt to Fried Berg [2d As]
*** PRE-FLOP *** 
ricki64 folds
thagilo9 folds
_ilTulipano_ raises 0.04€ to 0.06€
nanass25440 folds
Fried Berg folds
oliveponcar calls 0.04€
*** FLOP *** [2c 5d 3h]
oliveponcar checks
_ilTulipano_ bets 0.08€
oliveponcar folds
_ilTulipano_ collected 0.20€ from pot
*** SUMMARY ***
Total pot 0.20€ | Rake 0.01€
Board: [2c 5d 3h]
Seat 5: _ilTulipano_ won 0.20€


Winamax Poker - HOLD-UP "Colorado" - HandId: #19116069-335615-1701437532 - Holdem no limit (0.01€/0.02€) - 2023/12/01 13:32:12 UTC
Table: 'Colorado' 6-max (real money) Seat #6 is the button
Seat 1: Petit.King53 (0.71€)
Seat 2: Fried Berg (0.41€)
Seat 3: CHOPATATE-44 (2€)
Seat 4: x spoony (2.44€)
Seat 5: mea botellas (4.21€)
Seat 6: Erenox (2.21€)
*** ANTE/BLINDS ***
Petit.King53 posts small blind 0.01€
Fried Berg posts big blind 0.02€
Dealt to Fried Berg [5d Ac]
*** PRE-FLOP *** 
CHOPATATE-44 raises 0.05€ to 0.07€
x spoony folds
mea botellas folds
Erenox folds
Petit.King53 folds
Fried Berg folds
CHOPATATE-44 collected 0.10€ from pot
*** SUMMARY ***
Total pot 0.10€ | No rake
Seat 3: CHOPATATE-44 won 0.10€


Winamax Poker - HOLD-UP "Colorado" - HandId: #19116069-335622-1701437536 - Holdem no limit (0.01€/0.02€) - 2023/12/01 13:32:16 UTC
Table: 'Colorado' 6-max (real money) Seat #6 is the button
Seat 1: Zile741 (4.93€)
Seat 2: Critical30 (1.54€)
Seat 3: lyric1969 (2.27€)
Seat 4: Fried Berg (0.39€)
Seat 5: Pierrof24 (2.54€)
Seat 6: zozo6750 (4.86€)
*** ANTE/BLINDS ***
Zile741 posts small blind 0.01€
Critical30 posts big blind 0.02€
Dealt to Fried Berg [Th 5c]
*** PRE-FLOP *** 
lyric1969 calls 0.02€
Fried Berg folds
Pierrof24 folds
zozo6750 folds
Zile741 folds
Critical30 checks
*** FLOP *** [Jh Jd Qh]
Critical30 checks
lyric1969 bets 0.02€
Critical30 calls 0.02€
*** TURN *** [Jh Jd Qh][8c]
Critical30 checks
lyric1969 checks
*** RIVER *** [Jh Jd Qh 8c][4h]
Critical30 bets 0.02€
lyric1969 calls 0.02€
*** SHOW DOWN ***
lyric1969 shows [Qd Td] (Two pairs : Queens and Jacks)
Critical30 shows [7h 3h] (Flush Queen high)
Critical30 collected 0.12€ from pot
*** SUMMARY ***
Total pot 0.12€ | Rake 0.01€
Board: [Jh Jd Qh 8c 4h]
Seat 2: Critical30 (big blind) showed [7h 3h] and won 0.12€ with Flush Queen high
Seat 3: lyric1969 showed [Qd Td] and lost with Two pairs : Queens and Jacks


Winamax Poker - HOLD-UP "Colorado" - HandId: #19116069-335625-1701437537 - Holdem no limit (0.01€/0.02€) - 2023/12/01 13:32:17 UTC
Table: 'Colorado' 6-max (real money) Seat #6 is the button
Seat 1: x spoony (2.44€)
Seat 2: FuLL-chatte (1.53€)
Seat 3: Fried Berg (0.39€)
Seat 4: Clemence75 (2.17€)
Seat 5: TaBrEaMoI (2.26€)
Seat 6: thagilo9 (1.87€)
*** ANTE/BLINDS ***
x spoony posts small blind 0.01€
FuLL-chatte posts big blind 0.02€
Dealt to Fried Berg [6c Qs]
*** PRE-FLOP *** 
Fried Berg folds
Clemence75 folds
TaBrEaMoI folds
thagilo9 folds
x spoony folds
FuLL-chatte collected 0.03€ from pot
*** SUMMARY ***
Total pot 0.03€ | No rake
Seat 2: FuLL-chatte (big blind) won 0.03€


Winamax Poker - HOLD-UP "Colorado" - HandId: #19116069-335629-1701437539 - Holdem no limit (0.01€/0.02€) - 2023/12/01 13:32:19 UTC
Table: 'Colorado' 6-max (real money) Seat #6 is the button
Seat 1: antien1963 (2.59€)
Seat 2: LimpDoud (2.62€)
Seat 3: Clemence75 (2.17€)
Seat 4: gostvision (2.08€)
Seat 5: El Paellas (0.92€)
Seat 6: Fried Berg (0.39€)
*** ANTE/BLINDS ***
antien1963 posts small blind 0.01€
LimpDoud posts big blind 0.02€
Dealt to Fried Berg [2c 7d]
*** PRE-FLOP *** 
Clemence75 folds
gostvision raises 0.04€ to 0.06€
El Paellas folds
Fried Berg folds
antien1963 calls 0.05€
LimpDoud folds
*** FLOP *** [9s 5h 7h]
antien1963 checks
gostvision bets 0.04€
antien1963 calls 0.04€
*** TURN *** [9s 5h 7h][Td]
antien1963 checks
gostvision bets 0.06€
antien1963 calls 0.06€
*** RIVER *** [9s 5h 7h Td][6s]
antien1963 checks
gostvision checks
*** SHOW DOWN ***
gostvision shows [Kd Ks] (One pair : Kings)
antien1963 shows [9c 6c] (Two pairs : 9 and 6)
antien1963 collected 0.31€ from pot
*** SUMMARY ***
Total pot 0.31€ | Rake 0.03€
Board: [9s 5h 7h Td 6s]
Seat 1: antien1963 (small blind) showed [9c 6c] and won 0.31€ with Two pairs : 9 and 6
Seat 4: gostvision showed [Kd Ks] and lost with One pair : Kings


Winamax Poker - HOLD-UP "Colorado" - HandId: #19116069-335632-1701437541 - Holdem no limit (0.01€/0.02€) - 2023/12/01 13:32:21 UTC
Table: 'Colorado' 6-max (real money) Seat #6 is the button
Seat 1: x spoony (2.43€)
Seat 2: Adrianohhhh (2€)
Seat 3: timePLZ (2€)
Seat 4: Brut2pok (2€)
Seat 5: Petit.King53 (0.70€)
Seat 6: Fried Berg (0.39€)
*** ANTE/BLINDS ***
x spoony posts small blind 0.01€
Adrianohhhh posts big blind 0.02€
Dealt to Fried Berg [2h 6d]
*** PRE-FLOP *** 
timePLZ folds
Brut2pok folds
Petit.King53 folds
Fried Berg folds
x spoony folds
Adrianohhhh collected 0.03€ from pot
*** SUMMARY ***
Total pot 0.03€ | No rake
Seat 2: Adrianohhhh (big blind) won 0.03€


Winamax Poker - HOLD-UP "Colorado" - HandId: #19116069-335637-1701437543 - Holdem no limit (0.01€/0.02€) - 2023/12/01 13:32:23 UTC
Table: 'Colorado' 6-max (real money) Seat #6 is the button
Seat 1: oliveponcar (3.82€)
Seat 2: Fried Berg (0.39€)
Seat 3: FuLL-chatte (1.54€)
Seat 4: KLeeMerHaut (2.34€)
Seat 5: rick26 (1.74€)
Seat 6: Max134Max (1.49€)
*** ANTE/BLINDS ***
oliveponcar posts small blind 0.01€
Fried Berg posts big blind 0.02€
Dealt to Fried Berg [5s 2d]
*** PRE-FLOP *** 
FuLL-chatte folds
KLeeMerHaut folds
rick26 folds
Max134Max folds
oliveponcar raises 0.04€ to 0.06€
Fried Berg folds
oliveponcar collected 0.08€ from pot
*** SUMMARY ***
Total pot 0.08€ | No rake
Seat 1: oliveponcar (small blind) won 0.08€


Winamax Poker - HOLD-UP "Colorado" - HandId: #19116069-335650-1701437549 - Holdem no limit (0.01€/0.02€) - 2023/12/01 13:32:29 UTC
Table: 'Colorado' 6-max (real money) Seat #6 is the button
Seat 1: Fried Berg (0.37€)
Seat 2: crush game (2.85€)
Seat 3: DONpere (1.60€)
Seat 4: LimpDoud (2€)
Seat 5: SharkAKK (3.74€)
Seat 6: Brut2pok (2€)
*** ANTE/BLINDS ***
Fried Berg posts small blind 0.01€
crush game posts big blind 0.02€
Dealt to Fried Berg [6d As]
*** PRE-FLOP *** 
DONpere folds
LimpDoud folds
SharkAKK folds
Brut2pok folds
Fried Berg raises 0.02€ to 0.04€
crush game calls 0.02€
*** FLOP *** [9d 9c 7d]
Fried Berg checks
crush game checks
*** TURN *** [9d 9c 7d][Jh]
Fried Berg checks
crush game bets 0.03€
Fried Berg calls 0.03€
*** RIVER *** [9d 9c 7d Jh][6c]
Fried Berg checks
crush game bets 0.14€
Fried Berg calls 0.14€
*** SHOW DOWN ***
crush game shows [4d Td] (One pair : 9)
Fried Berg shows [6d As] (Two pairs : 9 and 6)
Fried Berg collected 0.38€ from pot
*** SUMMARY ***
Total pot 0.38€ | Rake 0.04€
Board: [9d 9c 7d Jh 6c]
Seat 1: Fried Berg (small blind) showed [6d As] and won 0.38€ with Two pairs : 9 and 6
Seat 2: crush game (big blind) showed [4d Td] and lost with One pair : 9


Winamax Poker - HOLD-UP "Colorado" - HandId: #19116069-335714-1701437581 - Holdem no limit (0.01€/0.02€) - 2023/12/01 13:33:01 UTC
Table: 'Colorado' 6-max (real money) Seat #6 is the button
Seat 1: kameleon73 (2€)
Seat 2: Damspins (1.57€)
Seat 3: dan.doc (1.97€)
Seat 4: Fried Berg (0.54€)
Seat 5: Papaiah (2€)
Seat 6: crush game (2.64€)
*** ANTE/BLINDS ***
kameleon73 posts small blind 0.01€
Damspins posts big blind 0.02€
Dealt to Fried Berg [2h 5c]
*** PRE-FLOP *** 
dan.doc raises 0.02€ to 0.04€
Fried Berg folds
Papaiah folds
crush game folds
kameleon73 calls 0.03€
Damspins folds
*** FLOP *** [5h Qh Td]
kameleon73 bets 0.06€
dan.doc folds
kameleon73 collected 0.15€ from pot
*** SUMMARY ***
Total pot 0.15€ | Rake 0.01€
Board: [5h Qh Td]
Seat 1: kameleon73 (small blind) won 0.15€


Winamax Poker - HOLD-UP "Colorado" - HandId: #19116069-335719-1701437584 - Holdem no limit (0.01€/0.02€) - 2023/12/01 13:33:04 UTC
Table: 'Colorado' 6-max (real money) Seat #6 is the button
Seat 1: bastos2525 (2.05€)
Seat 2: Thequeen1205 (4.23€)
Seat 3: timePLZ (2€)
Seat 4: _Sephi (2.94€)
Seat 5: Fried Berg (0.54€)
Seat 6: metamex (1.86€)
*** ANTE/BLINDS ***
bastos2525 posts small blind 0.01€
Thequeen1205 posts big blind 0.02€
Dealt to Fried Berg [6s Th]
*** PRE-FLOP *** 
timePLZ folds
_Sephi folds
Fried Berg folds
metamex folds
bastos2525 calls 0.01€
Thequeen1205 checks
*** FLOP *** [Ts 9d 2d]
bastos2525 bets 0.03€
Thequeen1205 calls 0.03€
*** TURN *** [Ts 9d 2d][3d]
bastos2525 bets 0.03€
Thequeen1205 calls 0.03€
*** RIVER *** [Ts 9d 2d 3d][5h]
bastos2525 checks
Thequeen1205 bets 0.08€
bastos2525 calls 0.08€
*** SHOW DOWN ***
bastos2525 shows [9s Ac] (One pair : 9)
Thequeen1205 shows [9h 5d] (Two pairs : 9 and 5)
Thequeen1205 collected 0.29€ from pot
*** SUMMARY ***
Total pot 0.29€ | Rake 0.03€
Board: [Ts 9d 2d 3d 5h]
Seat 1: bastos2525 (small blind) showed [9s Ac] and lost with One pair : 9
Seat 2: Thequeen1205 (big blind) showed [9h 5d] and won 0.29€ with Two pairs : 9 and 5


Winamax Poker - HOLD-UP "Colorado" - HandId: #19116069-335731-1701437592 - Holdem no limit (0.01€/0.02€) - 2023/12/01 13:33:12 UTC
Table: 'Colorado' 6-max (real money) Seat #6 is the button
Seat 1: FuLL-chatte (1.63€)
Seat 2: KKamarAAde (2.87€)
Seat 3: Fried Berg (0.54€)
Seat 4: Prudempoker (1.90€)
Seat 5: Fulloflop359 (1.51€)
Seat 6: Adrianohhhh (2.03€)
*** ANTE/BLINDS ***
FuLL-chatte posts small blind 0.01€
KKamarAAde posts big blind 0.02€
Dealt to Fried Berg [Ad 8s]
*** PRE-FLOP *** 
Fried Berg raises 0.02€ to 0.04€
Prudempoker folds
Fulloflop359 folds
Adrianohhhh calls 0.04€
FuLL-chatte folds
KKamarAAde folds
*** FLOP *** [7d 8d Ks]
Fried Berg checks
Adrianohhhh checks
*** TURN *** [7d 8d Ks][7s]
Fried Berg checks
Adrianohhhh bets 0.04€
Fried Berg calls 0.04€
*** RIVER *** [7d 8d Ks 7s][Qd]
Fried Berg checks
Adrianohhhh checks
*** SHOW DOWN ***
Adrianohhhh shows [6d 6c] (Two pairs : 7 and 6)
Fried Berg shows [Ad 8s] (Two pairs : 8 and 7)
Fried Berg collected 0.17€ from pot
*** SUMMARY ***
Total pot 0.17€ | Rake 0.02€
Board: [7d 8d Ks 7s Qd]
Seat 3: Fried Berg showed [Ad 8s] and won 0.17€ with Two pairs : 8 and 7
Seat 6: Adrianohhhh (button) showed [6d 6c] and lost with Two pairs : 7 and 6


Winamax Poker - HOLD-UP "Colorado" - HandId: #19116069-335861-1701437652 - Holdem no limit (0.01€/0.02€) - 2023/12/01 13:34:12 UTC
Table: 'Colorado' 6-max (real money) Seat #6 is the button
Seat 1: Tr0-_-L3urr3 (2.01€)
Seat 2: Adrianohhhh (2€)
Seat 3: TJ Podoli II (1.01€)
Seat 4: Wolfert (4.24€)
Seat 5: Fried Berg (0.63€)
Seat 6: zozo6750 (4.86€)
*** ANTE/BLINDS ***
Tr0-_-L3urr3 posts small blind 0.01€
Adrianohhhh posts big blind 0.02€
Dealt to Fried Berg [Qc Tc]
*** PRE-FLOP *** 
TJ Podoli II folds
Wolfert folds
Fried Berg raises 0.02€ to 0.04€
zozo6750 raises 4.82€ to 4.86€ and is all-in
Tr0-_-L3urr3 folds
Adrianohhhh folds
Fried Berg folds
zozo6750 collected 4.93€ from pot
*** SUMMARY ***
Total pot 4.93€ | No rake
Seat 6: zozo6750 (button) won 4.93€


Winamax Poker - HOLD-UP "Colorado" - HandId: #19116069-335911-1701437676 - Holdem no limit (0.01€/0.02€) - 2023/12/01 13:34:36 UTC
Table: 'Colorado' 6-max (real money) Seat #6 is the button
Seat 1: gagnejamais4 (7.55€)
Seat 2: Fried Berg (0.59€)
Seat 3: bills135 (0.49€)
Seat 4: gostvision (2.03€)
Seat 5: Tr0-_-L3urr3 (2.09€)
Seat 6: Fulloflop359 (1.38€)
*** ANTE/BLINDS ***
gagnejamais4 posts small blind 0.01€
Fried Berg posts big blind 0.02€
Dealt to Fried Berg [6d Td]
*** PRE-FLOP *** 
bills135 raises 0.02€ to 0.04€
gostvision folds
Tr0-_-L3urr3 folds
Fulloflop359 calls 0.04€
gagnejamais4 raises 2.26€ to 2.30€
Fried Berg folds
bills135 calls 0.45€ and is all-in
Fulloflop359 folds
*** FLOP *** [Kh 6h 4s]
*** TURN *** [Kh 6h 4s][4d]
*** RIVER *** [Kh 6h 4s 4d][7s]
*** SHOW DOWN ***
bills135 shows [Ah 8c] (One pair : 4)
gagnejamais4 shows [Qc Qd] (Two pairs : Queens and 4)
gagnejamais4 collected 2.75€ from pot
*** SUMMARY ***
Total pot 2.75€ | Rake 0.10€
Board: [Kh 6h 4s 4d 7s]
Seat 1: gagnejamais4 (small blind) showed [Qc Qd] and won 2.75€ with Two pairs : Queens and 4
Seat 3: bills135 showed [Ah 8c] and lost with One pair : 4


Winamax Poker - HOLD-UP "Colorado" - HandId: #19116069-335947-1701437699 - Holdem no limit (0.01€/0.02€) - 2023/12/01 13:34:59 UTC
Table: 'Colorado' 6-max (real money) Seat #6 is the button
Seat 1: oliveponcar (3.95€)
Seat 2: Pazos 81 (1.84€)
Seat 3: Fried Berg (0.57€)
Seat 4: kameleon73 (3.99€)
Seat 5: Erenox (3.31€)
Seat 6: gostvision (2.06€)
*** ANTE/BLINDS ***
oliveponcar posts small blind 0.01€
Pazos 81 posts big blind 0.02€
Dealt to Fried Berg [Jc 9c]
*** PRE-FLOP *** 
Fried Berg folds
kameleon73 folds
Erenox raises 0.04€ to 0.06€
gostvision folds
oliveponcar folds
Pazos 81 calls 0.04€
*** FLOP *** [7s Kd Ks]
Pazos 81 checks
Erenox bets 0.07€
Pazos 81 folds
Erenox collected 0.19€ from pot
*** SUMMARY ***
Total pot 0.19€ | Rake 0.01€
Board: [7s Kd Ks]
Seat 5: Erenox won 0.19€


Winamax Poker - HOLD-UP "Colorado" - HandId: #19116069-335964-1701437708 - Holdem no limit (0.01€/0.02€) - 2023/12/01 13:35:08 UTC
Table: 'Colorado' 6-max (real money) Seat #6 is the button
Seat 1: Fried Berg (0.57€)
Seat 2: x spoony (2.26€)
Seat 3: El Paellas (0.91€)
Seat 4: FuLL-chatte (2.30€)
Seat 5: kameleon73 (2.13€)
Seat 6: CHANGAS (2.12€)
*** ANTE/BLINDS ***
Fried Berg posts small blind 0.01€
x spoony posts big blind 0.02€
Dealt to Fried Berg [Kd Qc]
*** PRE-FLOP *** 
El Paellas raises 0.03€ to 0.05€
FuLL-chatte folds
kameleon73 folds
CHANGAS folds
Fried Berg raises 0.10€ to 0.15€
x spoony calls 0.13€
El Paellas folds
*** FLOP *** [Ah Qh 6h]
Fried Berg bets 0.42€ and is all-in
x spoony calls 0.42€
*** TURN *** [Ah Qh 6h][Jd]
*** RIVER *** [Ah Qh 6h Jd][6c]
*** SHOW DOWN ***
Fried Berg shows [Kd Qc] (Two pairs : Queens and 6)
x spoony shows [Ac Kh] (Two pairs : Aces and 6)
x spoony collected 1.07€ from pot
*** SUMMARY ***
Total pot 1.07€ | Rake 0.12€
Board: [Ah Qh 6h Jd 6c]
Seat 1: Fried Berg (small blind) showed [Kd Qc] and lost with Two pairs : Queens and 6
Seat 2: x spoony (big blind) showed [Ac Kh] and won 1.07€ with Two pairs : Aces and 6


Winamax Poker - HOLD-UP "Colorado" - HandId: #19116069-336103-1701437779 - Holdem no limit (0.01€/0.02€) - 2023/12/01 13:36:19 UTC
Table: 'Colorado' 6-max (real money) Seat #6 is the button
Seat 1: wAAlterrr (2.01€)
Seat 2: Savab1spaser (4.89€)
Seat 3: Wolfert (3.49€)
Seat 4: Fried Berg (0.50€)
Seat 5: FuLL-chatte (5.15€)
Seat 6: Kaoky (3.43€)
*** ANTE/BLINDS ***
wAAlterrr posts small blind 0.01€
Savab1spaser posts big blind 0.02€
Dealt to Fried Berg [Qd 9h]
*** PRE-FLOP *** 
Wolfert raises 0.03€ to 0.05€
Fried Berg folds
FuLL-chatte folds
Kaoky folds
wAAlterrr folds
Savab1spaser calls 0.03€
*** FLOP *** [Js 6h Ad]
Savab1spaser checks
Wolfert checks
*** TURN *** [Js 6h Ad][Ks]
Savab1spaser checks
Wolfert bets 0.04€
Savab1spaser folds
Wolfert collected 0.14€ from pot
*** SUMMARY ***
Total pot 0.14€ | Rake 0.01€
Board: [Js 6h Ad Ks]
Seat 3: Wolfert won 0.14€


Winamax Poker - HOLD-UP "Colorado" - HandId: #19116069-336110-1701437784 - Holdem no limit (0.01€/0.02€) - 2023/12/01 13:36:24 UTC
Table: 'Colorado' 6-max (real money) Seat #6 is the button
Seat 1: CHANGAS (1.26€)
Seat 2: haouuum28 (2.09€)
Seat 3: Max134Max (1.38€)
Seat 4: Pazos 81 (1.80€)
Seat 5: Fried Berg (0.50€)
Seat 6: rick26 (2.97€)
*** ANTE/BLINDS ***
CHANGAS posts small blind 0.01€
haouuum28 posts big blind 0.02€
Dealt to Fried Berg [As 7h]
*** PRE-FLOP *** 
Max134Max folds
Pazos 81 raises 0.02€ to 0.04€
Fried Berg calls 0.04€
rick26 folds
CHANGAS calls 0.03€
haouuum28 calls 0.02€
*** FLOP *** [4s Th 7c]
CHANGAS checks
haouuum28 checks
Pazos 81 checks
Fried Berg checks
*** TURN *** [4s Th 7c][3s]
CHANGAS checks
haouuum28 checks
Pazos 81 checks
Fried Berg checks
*** RIVER *** [4s Th 7c 3s][9d]
CHANGAS checks
haouuum28 bets 0.03€
Pazos 81 folds
Fried Berg calls 0.03€
CHANGAS folds
*** SHOW DOWN ***
Fried Berg shows [As 7h] (One pair : 7)
haouuum28 shows [9s Kh] (One pair : 9)
haouuum28 collected 0.20€ from pot
*** SUMMARY ***
Total pot 0.20€ | Rake 0.02€
Board: [4s Th 7c 3s 9d]
Seat 2: haouuum28 (big blind) showed [9s Kh] and won 0.20€ with One pair : 9
Seat 5: Fried Berg showed [As 7h] and lost with One pair : 7


Winamax Poker - HOLD-UP "Colorado" - HandId: #19116069-336257-1701437864 - Holdem no limit (0.01€/0.02€) - 2023/12/01 13:37:44 UTC
Table: 'Colorado' 6-max (real money) Seat #6 is the button
Seat 1: Pierrof24 (2.21€)
Seat 2: x spoony (2.43€)
Seat 3: FuLL-chatte (1.65€)
Seat 4: Fried Berg (0.43€)
Seat 5: divin.Ange64 (2.04€)
Seat 6: CHANGAS (1.22€)
*** ANTE/BLINDS ***
Pierrof24 posts small blind 0.01€
x spoony posts big blind 0.02€
Dealt to Fried Berg [8s Ad]
*** PRE-FLOP *** 
FuLL-chatte folds
Fried Berg raises 0.02€ to 0.04€
divin.Ange64 folds
CHANGAS calls 0.04€
Pierrof24 raises 0.14€ to 0.18€
x spoony folds
Fried Berg folds
CHANGAS folds
Pierrof24 collected 0.28€ from pot
*** SUMMARY ***
Total pot 0.28€ | No rake
Seat 1: Pierrof24 (small blind) won 0.28€


Winamax Poker - HOLD-UP "Colorado" - HandId: #19116069-336338-1701437910 - Holdem no limit (0.01€/0.02€) - 2023/12/01 13:38:30 UTC
Table: 'Colorado' 6-max (real money) Seat #6 is the button
Seat 1: divin.Ange64 (2.02€)
Seat 2: TuMensTanT (2.09€)
Seat 3: Tr0-_-L3urr3 (2€)
Seat 4: gagnejamais4 (8.77€)
Seat 5: lyric1969 (1.98€)
Seat 6: Fried Berg (0.39€)
*** ANTE/BLINDS ***
divin.Ange64 posts small blind 0.01€
TuMensTanT posts big blind 0.02€
Dealt to Fried Berg [6s Tc]
*** PRE-FLOP *** 
Tr0-_-L3urr3 folds
gagnejamais4 raises 0.04€ to 0.06€
lyric1969 folds
Fried Berg folds
divin.Ange64 folds
TuMensTanT raises 0.18€ to 0.24€
gagnejamais4 calls 0.18€
*** FLOP *** [As Js Qd]
TuMensTanT bets 0.49€
gagnejamais4 folds
TuMensTanT collected 0.93€ from pot
*** SUMMARY ***
Total pot 0.93€ | Rake 0.05€
Board: [As Js Qd]
Seat 2: TuMensTanT (big blind) won 0.93€


Winamax Poker - HOLD-UP "Colorado" - HandId: #19116069-336341-1701437913 - Holdem no limit (0.01€/0.02€) - 2023/12/01 13:38:33 UTC
Table: 'Colorado' 6-max (real money) Seat #6 is the button
Seat 1: _TAISEZVOUS_ (2.73€)
Seat 2: Mansell33 (2€)
Seat 3: Fried Berg (0.39€)
Seat 4: TaBrEaMoI (2.41€)
Seat 5: KKamarAAde (2.73€)
Seat 6: SharkAKK (3.58€)
*** ANTE/BLINDS ***
_TAISEZVOUS_ posts small blind 0.01€
Mansell33 posts big blind 0.02€
Dealt to Fried Berg [8h 7s]
*** PRE-FLOP *** 
Fried Berg folds
TaBrEaMoI folds
KKamarAAde raises 0.04€ to 0.06€
SharkAKK folds
_TAISEZVOUS_ folds
Mansell33 calls 0.04€
*** FLOP *** [Jd 5s 4c]
Mansell33 checks
KKamarAAde bets 0.08€
Mansell33 calls 0.08€
*** TURN *** [Jd 5s 4c][6c]
Mansell33 checks
KKamarAAde bets 0.19€
Mansell33 folds
KKamarAAde collected 0.45€ from pot
*** SUMMARY ***
Total pot 0.45€ | Rake 0.03€
Board: [Jd 5s 4c 6c]
Seat 5: KKamarAAde won 0.45€


Winamax Poker - HOLD-UP "Colorado" - HandId: #19116069-336347-1701437915 - Holdem no limit (0.01€/0.02€) - 2023/12/01 13:38:35 UTC
Table: 'Colorado' 6-max (real money) Seat #6 is the button
Seat 1: Fried Berg (0.39€)
Seat 2: Tr0-_-L3urr3 (2.93€)
Seat 3: zozo6750 (5.13€)
Seat 4: MaryBo (0.88€)
Seat 5: FuLL-chatte (5.60€)
Seat 6: nanass25440 (0.82€)
*** ANTE/BLINDS ***
Fried Berg posts small blind 0.01€
Tr0-_-L3urr3 posts big blind 0.02€
Dealt to Fried Berg [7s Js]
*** PRE-FLOP *** 
zozo6750 raises 0.04€ to 0.06€
MaryBo folds
FuLL-chatte folds
nanass25440 folds
Fried Berg calls 0.05€
Tr0-_-L3urr3 folds
*** FLOP *** [Ac 4d Ts]
Fried Berg checks
zozo6750 checks
*** TURN *** [Ac 4d Ts][5s]
Fried Berg checks
zozo6750 checks
*** RIVER *** [Ac 4d Ts 5s][Td]
Fried Berg checks
zozo6750 bets 0.09€
Fried Berg folds
zozo6750 collected 0.22€ from pot
*** SUMMARY ***
Total pot 0.22€ | Rake 0.01€
Board: [Ac 4d Ts 5s Td]
Seat 3: zozo6750 won 0.22€


Winamax Poker - HOLD-UP "Colorado" - HandId: #19116069-336418-1701437951 - Holdem no limit (0.01€/0.02€) - 2023/12/01 13:39:11 UTC
Table: 'Colorado' 6-max (real money) Seat #6 is the button
Seat 1: KKamarAAde (2.85€)
Seat 2: Fried Berg (0.33€)
Seat 3: _ilTulipano_ (2.13€)
Seat 4: corm973 (1.37€)
Seat 5: Papaiah (2.04€)
Seat 6: CHANGAS (1.17€)
*** ANTE/BLINDS ***
KKamarAAde posts small blind 0.01€
Fried Berg posts big blind 0.02€
Dealt to Fried Berg [5c 7h]
*** PRE-FLOP *** 
_ilTulipano_ folds
corm973 folds
Papaiah folds
CHANGAS folds
KKamarAAde folds
Fried Berg collected 0.03€ from pot
*** SUMMARY ***
Total pot 0.03€ | No rake
Seat 2: Fried Berg (big blind) won 0.03€


Winamax Poker - HOLD-UP "Colorado" - HandId: #19116069-336444-1701437963 - Holdem no limit (0.01€/0.02€) - 2023/12/01 13:39:23 UTC
Table: 'Colorado' 6-max (real money) Seat #6 is the button
Seat 1: Pierrof24 (2.42€)
Seat 2: Adrianohhhh (3.01€)
Seat 3: LimpDoud (4.11€)
Seat 4: ChaT_all_iN (1.81€)
Seat 5: Fried Berg (0.34€)
Seat 6: cdcb (0.52€)
*** ANTE/BLINDS ***
Pierrof24 posts small blind 0.01€
Adrianohhhh posts big blind 0.02€
Dealt to Fried Berg [5h 8c]
*** PRE-FLOP *** 
LimpDoud folds
ChaT_all_iN raises 0.05€ to 0.07€
Fried Berg folds
cdcb folds
Pierrof24 folds
Adrianohhhh raises 0.18€ to 0.25€
ChaT_all_iN calls 0.18€
*** FLOP *** [7s 4h 5c]
Adrianohhhh checks
ChaT_all_iN checks
*** TURN *** [7s 4h 5c][Kd]
Adrianohhhh bets 0.18€
ChaT_all_iN calls 0.18€
*** RIVER *** [7s 4h 5c Kd][6h]
Adrianohhhh bets 0.36€
ChaT_all_iN calls 0.36€
*** SHOW DOWN ***
ChaT_all_iN shows [Qd 5d] (One pair : 5)
Adrianohhhh shows [Qs Ks] (One pair : Kings)
Adrianohhhh collected 1.43€ from pot
*** SUMMARY ***
Total pot 1.43€ | Rake 0.16€
Board: [7s 4h 5c Kd 6h]
Seat 2: Adrianohhhh (big blind) showed [Qs Ks] and won 1.43€ with One pair : Kings
Seat 4: ChaT_all_iN showed [Qd 5d] and lost with One pair : 5


Winamax Poker - HOLD-UP "Colorado" - HandId: #19116069-336448-1701437965 - Holdem no limit (0.01€/0.02€) - 2023/12/01 13:39:25 UTC
Table: 'Colorado' 6-max (real money) Seat #6 is the button
Seat 1: Raging.Full (1.96€)
Seat 2: x spoony (2.91€)
Seat 3: Fried Berg (0.34€)
Seat 4: LimpDoud (4.11€)
Seat 5: cdcb (0.52€)
Seat 6: Papaiah (2.04€)
*** ANTE/BLINDS ***
Raging.Full posts small blind 0.01€
x spoony posts big blind 0.02€
Dealt to Fried Berg [9h Jc]
*** PRE-FLOP *** 
Fried Berg folds
LimpDoud folds
cdcb folds
Papaiah folds
Raging.Full calls 0.01€
x spoony checks
*** FLOP *** [4d 4c 5d]
Raging.Full bets 0.04€
x spoony folds
Raging.Full collected 0.08€ from pot
*** SUMMARY ***
Total pot 0.08€ | No rake
Board: [4d 4c 5d]
Seat 1: Raging.Full (small blind) won 0.08€


Winamax Poker - HOLD-UP "Colorado" - HandId: #19116069-336451-1701437967 - Holdem no limit (0.01€/0.02€) - 2023/12/01 13:39:27 UTC
Table: 'Colorado' 6-max (real money) Seat #6 is the button
Seat 1: Thequeen1205 (4.54€)
Seat 2: J.C Deuces.0 (1.65€)
Seat 3: corm973 (1.37€)
Seat 4: Fried Berg (0.34€)
Seat 5: TaBrEaMoI (2.27€)
Seat 6: Eytrewq (1.67€)
Hold-up to Pot: total 0.10€
*** ANTE/BLINDS ***
Thequeen1205 posts small blind 0.01€
J.C Deuces.0 posts big blind 0.02€
Dealt to Fried Berg [3c Ac]
*** PRE-FLOP *** 
corm973 calls 0.02€
Fried Berg raises 0.32€ to 0.34€ and is all-in
TaBrEaMoI folds
Eytrewq calls 0.34€
Thequeen1205 folds
J.C Deuces.0 folds
corm973 folds
*** FLOP *** [Ts 5c Ah]
*** TURN *** [Ts 5c Ah][6h]
*** RIVER *** [Ts 5c Ah 6h][Kd]
*** SHOW DOWN ***
Fried Berg shows [3c Ac] (One pair : Aces)
Eytrewq shows [5h 5s] (Trips of 5)
Eytrewq collected 0.76€ from pot
*** SUMMARY ***
Total pot 0.76€ | Rake 0.07€
Board: [Ts 5c Ah 6h Kd]
Seat 4: Fried Berg showed [3c Ac] and lost with One pair : Aces
Seat 6: Eytrewq (button) showed [5h 5s] and won 0.76€ with Trips of 5


Winamax Poker - HOLD-UP "Colorado" - HandId: #19116069-336560-1701438035 - Holdem no limit (0.01€/0.02€) - 2023/12/01 13:40:35 UTC
Table: 'Colorado' 6-max (real money) Seat #6 is the button
Seat 1: Adame199623 (2€)
Seat 2: Fripon_77201 (2.85€)
Seat 3: El Paellas (0.64€)
Seat 4: CHOPATATE-44 (2€)
Seat 5: Fried Berg (0.50€)
Seat 6: juanktyga (3.77€)
*** ANTE/BLINDS ***
Adame199623 posts small blind 0.01€
Fripon_77201 posts big blind 0.02€
Dealt to Fried Berg [3h 2s]
*** PRE-FLOP *** 
El Paellas folds
CHOPATATE-44 folds
Fried Berg folds
juanktyga folds
Adame199623 folds
Fripon_77201 collected 0.03€ from pot
*** SUMMARY ***
Total pot 0.03€ | No rake
Seat 2: Fripon_77201 (big blind) won 0.03€


Winamax Poker - HOLD-UP "Colorado" - HandId: #19116069-336577-1701438046 - Holdem no limit (0.01€/0.02€) - 2023/12/01 13:40:46 UTC
Table: 'Colorado' 6-max (real money) Seat #6 is the button
Seat 1: Fried Berg (0.50€)
Seat 2: Tofini (2€)
Seat 3: 3Bet4Chouffe (3.94€)
Seat 4: AlexMata1103 (2.10€)
Seat 5: Max134Max (2€)
Seat 6: 2high4you (0.84€)
*** ANTE/BLINDS ***
Fried Berg posts small blind 0.01€
Tofini posts big blind 0.02€
Dealt to Fried Berg [9d 8c]
*** PRE-FLOP *** 
3Bet4Chouffe folds
AlexMata1103 folds
Max134Max folds
2high4you folds
Fried Berg folds
Tofini collected 0.03€ from pot
*** SUMMARY ***
Total pot 0.03€ | No rake
Seat 2: Tofini (big blind) won 0.03€


Winamax Poker - HOLD-UP "Colorado" - HandId: #19116069-336584-1701438051 - Holdem no limit (0.01€/0.02€) - 2023/12/01 13:40:51 UTC
Table: 'Colorado' 6-max (real money) Seat #6 is the button
Seat 1: Perf-31 (3.91€)
Seat 2: Fried Berg (0.49€)
Seat 3: gostvision (2€)
Seat 4: Kaoky (3.85€)
Seat 5: MENDOSA-31 (0.39€)
Seat 6: LimpDoud (2.64€)
*** ANTE/BLINDS ***
Perf-31 posts small blind 0.01€
Fried Berg posts big blind 0.02€
Dealt to Fried Berg [2c 2s]
*** PRE-FLOP *** 
gostvision folds
Kaoky folds
MENDOSA-31 folds
LimpDoud folds
Perf-31 calls 0.01€
Fried Berg checks
*** FLOP *** [3d Tc 8d]
Perf-31 bets 0.04€
Fried Berg folds
Perf-31 collected 0.08€ from pot
*** SUMMARY ***
Total pot 0.08€ | No rake
Board: [3d Tc 8d]
Seat 1: Perf-31 (small blind) won 0.08€


Winamax Poker - HOLD-UP "Colorado" - HandId: #19116069-336641-1701438082 - Holdem no limit (0.01€/0.02€) - 2023/12/01 13:41:22 UTC
Table: 'Colorado' 6-max (real money) Seat #6 is the button
Seat 1: _ilTulipano_ (3.34€)
Seat 2: Eytrewq (1.92€)
Seat 3: MENDOSA-31 (0.64€)
Seat 4: Fried Berg (0.47€)
Seat 5: zozo6750 (5.25€)
Seat 6: Adrianohhhh (3.91€)
*** ANTE/BLINDS ***
_ilTulipano_ posts small blind 0.01€
Eytrewq posts big blind 0.02€
Dealt to Fried Berg [9h Jc]
*** PRE-FLOP *** 
MENDOSA-31 folds
Fried Berg folds
zozo6750 folds
Adrianohhhh folds
_ilTulipano_ folds
Eytrewq collected 0.03€ from pot
*** SUMMARY ***
Total pot 0.03€ | No rake
Seat 2: Eytrewq (big blind) won 0.03€


Winamax Poker - HOLD-UP "Colorado" - HandId: #19116069-336647-1701438085 - Holdem no limit (0.01€/0.02€) - 2023/12/01 13:41:25 UTC
Table: 'Colorado' 6-max (real money) Seat #6 is the button
Seat 1: Erenox (3.36€)
Seat 2: Kaoky (3.87€)
Seat 3: Fried Berg (0.47€)
Seat 4: _ilTulipano_ (3.33€)
Seat 5: Adrianohhhh (3.91€)
Seat 6: Mansell33 (3.04€)
*** ANTE/BLINDS ***
Erenox posts small blind 0.01€
Kaoky posts big blind 0.02€
Dealt to Fried Berg [6d Qh]
*** PRE-FLOP *** 
Fried Berg folds
_ilTulipano_ raises 0.04€ to 0.06€
Adrianohhhh calls 0.06€
Mansell33 folds
Erenox folds
Kaoky folds
*** FLOP *** [7d 2s 9d]
_ilTulipano_ bets 0.08€
Adrianohhhh calls 0.08€
*** TURN *** [7d 2s 9d][8h]
_ilTulipano_ bets 0.16€
Adrianohhhh calls 0.16€
*** RIVER *** [7d 2s 9d 8h][3d]
_ilTulipano_ checks
Adrianohhhh bets 0.26€
_ilTulipano_ folds
Adrianohhhh collected 0.83€ from pot
*** SUMMARY ***
Total pot 0.83€ | Rake 0.06€
Board: [7d 2s 9d 8h 3d]
Seat 5: Adrianohhhh won 0.83€


Winamax Poker - HOLD-UP "Colorado" - HandId: #19116069-336651-1701438087 - Holdem no limit (0.01€/0.02€) - 2023/12/01 13:41:27 UTC
Table: 'Colorado' 6-max (real money) Seat #6 is the button
Seat 1: loncholoncho (1.91€)
Seat 2: Ludal001 (2.97€)
Seat 3: Pierrof24 (2.39€)
Seat 4: MENDOSA-31 (0.64€)
Seat 5: Fried Berg (0.47€)
Seat 6: AAdriAAn (1.46€)
*** ANTE/BLINDS ***
loncholoncho posts small blind 0.01€
Ludal001 posts big blind 0.02€
Dealt to Fried Berg [Td 4d]
*** PRE-FLOP *** 
Pierrof24 folds
MENDOSA-31 folds
Fried Berg folds
AAdriAAn folds
loncholoncho raises 0.02€ to 0.04€
Ludal001 calls 0.02€
*** FLOP *** [3h Kc Qc]
loncholoncho checks
Ludal001 checks
*** TURN *** [3h Kc Qc][Jh]
loncholoncho bets 0.08€
Ludal001 folds
loncholoncho collected 0.15€ from pot
*** SUMMARY ***
Total pot 0.15€ | Rake 0.01€
Board: [3h Kc Qc Jh]
Seat 1: loncholoncho (small blind) won 0.15€


Winamax Poker - HOLD-UP "Colorado" - HandId: #19116069-336658-1701438089 - Holdem no limit (0.01€/0.02€) - 2023/12/01 13:41:29 UTC
Table: 'Colorado' 6-max (real money) Seat #6 is the button
Seat 1: TaBrEaMoI (2.12€)
Seat 2: Tofini (2.07€)
Seat 3: crepu-bzh (0.47€)
Seat 4: El Paellas (0.50€)
Seat 5: haouuum28 (3.40€)
Seat 6: Fried Berg (0.47€)
*** ANTE/BLINDS ***
TaBrEaMoI posts small blind 0.01€
Tofini posts big blind 0.02€
Dealt to Fried Berg [4c Js]
*** PRE-FLOP *** 
crepu-bzh calls 0.02€
El Paellas folds
haouuum28 raises 0.02€ to 0.04€
Fried Berg folds
TaBrEaMoI folds
Tofini calls 0.02€
crepu-bzh calls 0.02€
*** FLOP *** [Th 8d 3c]
Tofini checks
crepu-bzh checks
haouuum28 bets 0.07€
Tofini folds
crepu-bzh calls 0.07€
*** TURN *** [Th 8d 3c][9c]
crepu-bzh bets 0.18€
haouuum28 calls 0.18€
*** RIVER *** [Th 8d 3c 9c][6s]
crepu-bzh bets 0.18€ and is all-in
haouuum28 calls 0.18€
*** SHOW DOWN ***
haouuum28 shows [Ad 9h] (One pair : 9)
crepu-bzh shows [Qs Jc] (Straight Queen high)
crepu-bzh collected 0.89€ from pot
*** SUMMARY ***
Total pot 0.89€ | Rake 0.10€
Board: [Th 8d 3c 9c 6s]
Seat 3: crepu-bzh showed [Qs Jc] and won 0.89€ with Straight Queen high
Seat 5: haouuum28 showed [Ad 9h] and lost with One pair : 9


Winamax Poker - HOLD-UP "Colorado" - HandId: #19116069-336661-1701438091 - Holdem no limit (0.01€/0.02€) - 2023/12/01 13:41:31 UTC
Table: 'Colorado' 6-max (real money) Seat #6 is the button
Seat 1: Faramiix57 (2.17€)
Seat 2: Fried Berg (0.47€)
Seat 3: Mansell33 (3.04€)
Seat 4: J.C Deuces.0 (2.53€)
Seat 5: juanktyga (2.18€)
Seat 6: misterda (2.02€)
*** ANTE/BLINDS ***
Faramiix57 posts small blind 0.01€
Fried Berg posts big blind 0.02€
Dealt to Fried Berg [5h 7s]
*** PRE-FLOP *** 
Mansell33 folds
J.C Deuces.0 raises 0.04€ to 0.06€
juanktyga raises 0.12€ to 0.18€
misterda folds
Faramiix57 folds
Fried Berg folds
J.C Deuces.0 folds
juanktyga collected 0.27€ from pot
*** SUMMARY ***
Total pot 0.27€ | No rake
Seat 5: juanktyga won 0.27€


Winamax Poker - HOLD-UP "Colorado" - HandId: #19116069-336675-1701438098 - Holdem no limit (0.01€/0.02€) - 2023/12/01 13:41:38 UTC
Table: 'Colorado' 6-max (real money) Seat #6 is the button
Seat 1: Fried Berg (0.45€)
Seat 2: magnumbenji (0.50€)
Seat 3: gostvision (2.88€)
Seat 4: timePLZ (4.30€)
Seat 5: kameleon73 (2€)
Seat 6: KKamarAAde (2.90€)
*** ANTE/BLINDS ***
Fried Berg posts small blind 0.01€
magnumbenji posts big blind 0.02€
Dealt to Fried Berg [Js Jd]
*** PRE-FLOP *** 
gostvision raises 0.03€ to 0.05€
timePLZ folds
kameleon73 folds
KKamarAAde folds
Fried Berg raises 0.40€ to 0.45€ and is all-in
magnumbenji folds
gostvision calls 0.40€
*** FLOP *** [9h 8s 7c]
*** TURN *** [9h 8s 7c][2d]
*** RIVER *** [9h 8s 7c 2d][3h]
*** SHOW DOWN ***
gostvision shows [Qs As] (High card : Ace)
Fried Berg shows [Js Jd] (One pair : Jacks)
Fried Berg collected 0.83€ from pot
*** SUMMARY ***
Total pot 0.83€ | Rake 0.09€
Board: [9h 8s 7c 2d 3h]
Seat 1: Fried Berg (small blind) showed [Js Jd] and won 0.83€ with One pair : Jacks
Seat 3: gostvision showed [Qs As] and lost with High card : Ace


Winamax Poker - HOLD-UP "Colorado" - HandId: #19116069-336725-1701438124 - Holdem no limit (0.01€/0.02€) - 2023/12/01 13:42:04 UTC
Table: 'Colorado' 6-max (real money) Seat #6 is the button
Seat 1: Pierrof24 (1.98€)
Seat 2: gostvision (2.28€)
Seat 3: El Paellas (0.50€)
Seat 4: Clemence75 (2.51€)
Seat 5: Tr0-_-L3urr3 (2.09€)
Seat 6: Fried Berg (0.83€)
Hold-up to Pot: total 0.20€
*** ANTE/BLINDS ***
Pierrof24 posts small blind 0.01€
gostvision posts big blind 0.02€
Dealt to Fried Berg [7d Qc]
*** PRE-FLOP *** 
El Paellas folds
Clemence75 folds
Tr0-_-L3urr3 folds
Fried Berg folds
Pierrof24 raises 0.02€ to 0.04€
gostvision folds
Pierrof24 collected 0.26€ from pot
*** SUMMARY ***
Total pot 0.26€ | No rake
Seat 1: Pierrof24 (small blind) won 0.26€


Winamax Poker - HOLD-UP "Colorado" - HandId: #19116069-336758-1701438145 - Holdem no limit (0.01€/0.02€) - 2023/12/01 13:42:25 UTC
Table: 'Colorado' 6-max (real money) Seat #6 is the button
Seat 1: Papaiah (2.23€)
Seat 2: Ludal001 (3.06€)
Seat 3: JFSredbaron (2€)
Seat 4: Zile741 (2.90€)
Seat 5: Fried Berg (0.83€)
Seat 6: Thequeen1205 (4.23€)
*** ANTE/BLINDS ***
Papaiah posts small blind 0.01€
Ludal001 posts big blind 0.02€
Dealt to Fried Berg [Ad 4s]
*** PRE-FLOP *** 
JFSredbaron folds
Zile741 folds
Fried Berg folds
Thequeen1205 folds
Papaiah folds
Ludal001 collected 0.03€ from pot
*** SUMMARY ***
Total pot 0.03€ | No rake
Seat 2: Ludal001 (big blind) won 0.03€


Winamax Poker - HOLD-UP "Colorado" - HandId: #19116069-336774-1701438158 - Holdem no limit (0.01€/0.02€) - 2023/12/01 13:42:38 UTC
Table: 'Colorado' 6-max (real money) Seat #6 is the button
Seat 1: _ilTulipano_ (3.04€)
Seat 2: kameleon73 (4.63€)
Seat 3: Fried Berg (0.83€)
Seat 4: AlexMata1103 (2.05€)
Seat 5: Wolfert (3.74€)
Seat 6: KKamarAAde (7.31€)
*** ANTE/BLINDS ***
_ilTulipano_ posts small blind 0.01€
kameleon73 posts big blind 0.02€
Dealt to Fried Berg [5d Tc]
*** PRE-FLOP *** 
Fried Berg folds
AlexMata1103 calls 0.02€
Wolfert raises 0.04€ to 0.06€
KKamarAAde folds
_ilTulipano_ calls 0.05€
kameleon73 folds
AlexMata1103 calls 0.04€
*** FLOP *** [Qc 2s 7s]
_ilTulipano_ bets 0.10€
AlexMata1103 folds
Wolfert calls 0.10€
*** TURN *** [Qc 2s 7s][Qs]
_ilTulipano_ checks
Wolfert checks
*** RIVER *** [Qc 2s 7s Qs][8c]
_ilTulipano_ bets 0.20€
Wolfert raises 0.45€ to 0.65€
_ilTulipano_ calls 0.45€
*** SHOW DOWN ***
_ilTulipano_ shows [Qd Js] (Trips of Queens)
Wolfert shows [8s As] (Flush Ace high)
Wolfert collected 1.53€ from pot
*** SUMMARY ***
Total pot 1.53€ | Rake 0.17€
Board: [Qc 2s 7s Qs 8c]
Seat 1: _ilTulipano_ (small blind) showed [Qd Js] and lost with Trips of Queens
Seat 5: Wolfert showed [8s As] and won 1.53€ with Flush Ace high


Winamax Poker - HOLD-UP "Colorado" - HandId: #19116069-336778-1701438160 - Holdem no limit (0.01€/0.02€) - 2023/12/01 13:42:40 UTC
Table: 'Colorado' 6-max (real money) Seat #6 is the button
Seat 1: Fried Berg (0.83€)
Seat 2: Tr0-_-L3urr3 (2.36€)
Seat 3: Ertorko (2.53€)
Seat 4: Adame199623 (2.11€)
Seat 5: El Paellas (0.56€)
Seat 6: oliveponcar (2€)
*** ANTE/BLINDS ***
Fried Berg posts small blind 0.01€
Tr0-_-L3urr3 posts big blind 0.02€
Dealt to Fried Berg [Ad Qh]
*** PRE-FLOP *** 
Ertorko folds
Adame199623 raises 0.06€ to 0.08€
El Paellas folds
oliveponcar folds
Fried Berg calls 0.07€
Tr0-_-L3urr3 folds
*** FLOP *** [2h 6h 2s]
Fried Berg checks
Adame199623 checks
*** TURN *** [2h 6h 2s][4d]
Fried Berg checks
Adame199623 checks
*** RIVER *** [2h 6h 2s 4d][Ah]
Fried Berg bets 0.04€
Adame199623 calls 0.04€
*** SHOW DOWN ***
Fried Berg shows [Ad Qh] (Two pairs : Aces and 2)
Adame199623 shows [As Kd] (Two pairs : Aces and 2)
Adame199623 collected 0.23€ from pot
*** SUMMARY ***
Total pot 0.23€ | Rake 0.03€
Board: [2h 6h 2s 4d Ah]
Seat 1: Fried Berg (small blind) showed [Ad Qh] and lost with Two pairs : Aces and 2
Seat 4: Adame199623 showed [As Kd] and won 0.23€ with Two pairs : Aces and 2


Winamax Poker - HOLD-UP "Colorado" - HandId: #19116069-336836-1701438188 - Holdem no limit (0.01€/0.02€) - 2023/12/01 13:43:08 UTC
Table: 'Colorado' 6-max (real money) Seat #6 is the button
Seat 1: Clemence75 (3.02€)
Seat 2: cdcb (2.14€)
Seat 3: Fried Berg (0.71€)
Seat 4: Stun72 (2€)
Seat 5: Goupil02 (2.63€)
Seat 6: Adame199623 (2.22€)
Hold-up to Pot: total 0.10€
*** ANTE/BLINDS ***
Clemence75 posts small blind 0.01€
cdcb posts big blind 0.02€
Dealt to Fried Berg [Ks As]
*** PRE-FLOP *** 
Fried Berg raises 0.69€ to 0.71€ and is all-in
Stun72 raises 0.69€ to 1.40€
Goupil02 folds
Adame199623 folds
Clemence75 folds
cdcb folds
*** FLOP *** [7c 5h 8c]
*** TURN *** [7c 5h 8c][9c]
*** RIVER *** [7c 5h 8c 9c][6c]
*** SHOW DOWN ***
Fried Berg shows [Ks As] (Straight 9 high)
Stun72 shows [8d 8h] (Straight 9 high)
Stun72 collected 1.39€ from side pot 1
Fried Berg collected 0.70€ from main pot
*** SUMMARY ***
Total pot 2.09€ | Rake 0.15€
Board: [7c 5h 8c 9c 6c]
Seat 3: Fried Berg showed [Ks As] and won 0.70€ with Straight 9 high
Seat 4: Stun72 showed [8d 8h] and won 1.39€ with Straight 9 high


Winamax Poker - HOLD-UP "Colorado" - HandId: #19116069-336882-1701438215 - Holdem no limit (0.01€/0.02€) - 2023/12/01 13:43:35 UTC
Table: 'Colorado' 6-max (real money) Seat #6 is the button
Seat 1: Goupil02 (2.66€)
Seat 2: Fried Berg (0.70€)
Seat 3: LimpDoud (3.21€)
Seat 4: Clemence75 (3.01€)
Seat 5: Stun72 (2€)
Seat 6: TJ Podoli II (0.25€)
*** ANTE/BLINDS ***
Goupil02 posts small blind 0.01€
Fried Berg posts big blind 0.02€
Dealt to Fried Berg [9h 6h]
*** PRE-FLOP *** 
LimpDoud raises 0.03€ to 0.05€
Clemence75 folds
Stun72 folds
TJ Podoli II raises 0.20€ to 0.25€ and is all-in
Goupil02 folds
Fried Berg folds
LimpDoud calls 0.20€
*** FLOP *** [Kd 3c 4d]
*** TURN *** [Kd 3c 4d][3h]
*** RIVER *** [Kd 3c 4d 3h][Jd]
*** SHOW DOWN ***
LimpDoud shows [Qs Jh] (Two pairs : Jacks and 3)
TJ Podoli II shows [Ac Kc] (Two pairs : Kings and 3)
TJ Podoli II collected 0.48€ from pot
*** SUMMARY ***
Total pot 0.48€ | Rake 0.05€
Board: [Kd 3c 4d 3h Jd]
Seat 3: LimpDoud showed [Qs Jh] and lost with Two pairs : Jacks and 3
Seat 6: TJ Podoli II (button) showed [Ac Kc] and won 0.48€ with Two pairs : Kings and 3


Winamax Poker - HOLD-UP "Colorado" - HandId: #19116069-336904-1701438227 - Holdem no limit (0.01€/0.02€) - 2023/12/01 13:43:47 UTC
Table: 'Colorado' 6-max (real money) Seat #6 is the button
Seat 1: KKamarAAde (2€)
Seat 2: Majuta (2.62€)
Seat 3: Tofini (2.24€)
Seat 4: loncholoncho (2.72€)
Seat 5: hello7585 (2.02€)
Seat 6: Fried Berg (0.68€)
*** ANTE/BLINDS ***
KKamarAAde posts small blind 0.01€
Majuta posts big blind 0.02€
Dealt to Fried Berg [7c Ts]
*** PRE-FLOP *** 
Tofini folds
loncholoncho folds
hello7585 folds
Fried Berg folds
KKamarAAde folds
Majuta collected 0.03€ from pot
*** SUMMARY ***
Total pot 0.03€ | No rake
Seat 2: Majuta (big blind) won 0.03€


Winamax Poker - HOLD-UP "Colorado" - HandId: #19116069-336907-1701438228 - Holdem no limit (0.01€/0.02€) - 2023/12/01 13:43:48 UTC
Table: 'Colorado' 6-max (real money) Seat #6 is the button
Seat 1: MENDOSA-31 (0.84€)
Seat 2: Damspins (1.58€)
Seat 3: Tr0-_-L3urr3 (2.34€)
Seat 4: Fried Berg (0.68€)
Seat 5: AAdriAAn (0.70€)
Seat 6: Clemence75 (2.42€)
*** ANTE/BLINDS ***
MENDOSA-31 posts small blind 0.01€
Damspins posts big blind 0.02€
Dealt to Fried Berg [Jd Qh]
*** PRE-FLOP *** 
Tr0-_-L3urr3 folds
Fried Berg raises 0.02€ to 0.04€
AAdriAAn folds
Clemence75 folds
MENDOSA-31 folds
Damspins calls 0.02€
*** FLOP *** [4c 5c 4h]
Damspins checks
Fried Berg checks
*** TURN *** [4c 5c 4h][9d]
Damspins checks
Fried Berg checks
*** RIVER *** [4c 5c 4h 9d][3h]
Damspins checks
Fried Berg checks
*** SHOW DOWN ***
Damspins shows [Js Td] (One pair : 4)
Fried Berg shows [Jd Qh] (One pair : 4)
Fried Berg collected 0.08€ from pot
*** SUMMARY ***
Total pot 0.08€ | Rake 0.01€
Board: [4c 5c 4h 9d 3h]
Seat 2: Damspins (big blind) showed [Js Td] and lost with One pair : 4
Seat 4: Fried Berg showed [Jd Qh] and won 0.08€ with One pair : 4


Winamax Poker - HOLD-UP "Colorado" - HandId: #19116069-337143-1701438351 - Holdem no limit (0.01€/0.02€) - 2023/12/01 13:45:51 UTC
Table: 'Colorado' 6-max (real money) Seat #6 is the button
Seat 1: Clemence75 (2.64€)
Seat 2: Thequeen1205 (2.05€)
Seat 3: kameleon73 (5.39€)
Seat 4: Fried Berg (0.72€)
Seat 5: crepu-bzh (0.50€)
Seat 6: rick26 (2.97€)
*** ANTE/BLINDS ***
Clemence75 posts small blind 0.01€
Thequeen1205 posts big blind 0.02€
Dealt to Fried Berg [7d 8d]
*** PRE-FLOP *** 
kameleon73 folds
Fried Berg raises 0.02€ to 0.04€
crepu-bzh folds
rick26 folds
Clemence75 raises 0.12€ to 0.16€
Thequeen1205 calls 0.14€
Fried Berg calls 0.12€
*** FLOP *** [8s 7c 6s]
Clemence75 bets 0.16€
Thequeen1205 calls 0.16€
Fried Berg calls 0.16€
*** TURN *** [8s 7c 6s][6d]
Clemence75 checks
Thequeen1205 checks
Fried Berg checks
*** RIVER *** [8s 7c 6s 6d][8h]
Clemence75 checks
Thequeen1205 checks
Fried Berg bets 0.40€ and is all-in
Clemence75 folds
Thequeen1205 calls 0.40€
*** SHOW DOWN ***
Thequeen1205 shows [9c 9h] (Two pairs : 9 and 8)
Fried Berg shows [7d 8d] (Full of 8 and 7)
Fried Berg collected 1.58€ from pot
*** SUMMARY ***
Total pot 1.58€ | Rake 0.18€
Board: [8s 7c 6s 6d 8h]
Seat 2: Thequeen1205 (big blind) showed [9c 9h] and lost with Two pairs : 9 and 8
Seat 4: Fried Berg showed [7d 8d] and won 1.58€ with Full of 8 and 7


Winamax Poker - HOLD-UP "Colorado" - HandId: #19116069-337217-1701438396 - Holdem no limit (0.01€/0.02€) - 2023/12/01 13:46:36 UTC
Table: 'Colorado' 6-max (real money) Seat #6 is the button
Seat 1: Fried Berg (1.58€)
Seat 2: The Qualm (2€)
Seat 3: vegifish (1.87€)
Seat 4: 3Bet4Chouffe (3.24€)
Seat 5: Jneb34b (0.69€)
Seat 6: Kaoky (6.18€)
*** ANTE/BLINDS ***
Fried Berg posts small blind 0.01€
The Qualm posts big blind 0.02€
Dealt to Fried Berg [Jd Ks]
*** PRE-FLOP *** 
vegifish raises 0.03€ to 0.05€
3Bet4Chouffe folds
Jneb34b folds
Kaoky folds
Fried Berg calls 0.04€
The Qualm calls 0.03€
*** FLOP *** [Kd 4d 2c]
Fried Berg bets 0.04€
The Qualm folds
vegifish calls 0.04€
*** TURN *** [Kd 4d 2c][7d]
Fried Berg checks
vegifish bets 0.12€
Fried Berg calls 0.12€
*** RIVER *** [Kd 4d 2c 7d][9s]
Fried Berg checks
vegifish bets 0.31€
Fried Berg calls 0.31€
*** SHOW DOWN ***
Fried Berg shows [Jd Ks] (One pair : Kings)
vegifish shows [Td 9d] (Flush King high)
vegifish collected 0.98€ from pot
*** SUMMARY ***
Total pot 0.98€ | Rake 0.11€
Board: [Kd 4d 2c 7d 9s]
Seat 1: Fried Berg (small blind) showed [Jd Ks] and lost with One pair : Kings
Seat 3: vegifish showed [Td 9d] and won 0.98€ with Flush King high


Winamax Poker - HOLD-UP "Colorado" - HandId: #19116069-337383-1701438490 - Holdem no limit (0.01€/0.02€) - 2023/12/01 13:48:10 UTC
Table: 'Colorado' 6-max (real money) Seat #6 is the button
Seat 1: Jneb34b (0.63€)
Seat 2: Fried Berg (1.06€)
Seat 3: rick26 (2.89€)
Seat 4: vegifish (2.33€)
Seat 5: crepu-bzh (0.42€)
Seat 6: DGG23 (0.43€)
*** ANTE/BLINDS ***
Jneb34b posts small blind 0.01€
Fried Berg posts big blind 0.02€
Dealt to Fried Berg [4c Tc]
*** PRE-FLOP *** 
rick26 calls 0.02€
vegifish folds
crepu-bzh folds
DGG23 folds
Jneb34b calls 0.01€
Fried Berg checks
*** FLOP *** [3d 5c 5s]
Jneb34b checks
Fried Berg checks
rick26 bets 0.02€
Jneb34b calls 0.02€
Fried Berg folds
*** TURN *** [3d 5c 5s][Kh]
Jneb34b checks
rick26 bets 0.02€
Jneb34b folds
rick26 collected 0.11€ from pot
*** SUMMARY ***
Total pot 0.11€ | Rake 0.01€
Board: [3d 5c 5s Kh]
Seat 3: rick26 won 0.11€


Winamax Poker - HOLD-UP "Colorado" - HandId: #19116069-337449-1701438526 - Holdem no limit (0.01€/0.02€) - 2023/12/01 13:48:46 UTC
Table: 'Colorado' 6-max (real money) Seat #6 is the button
Seat 1: haouuum28 (3.64€)
Seat 2: Eytrewq (1.90€)
Seat 3: Pierrof24 (1.71€)
Seat 4: Papaiah (3.14€)
Seat 5: Fried Berg (1.04€)
Seat 6: Faramiix57 (2.98€)
*** ANTE/BLINDS ***
haouuum28 posts small blind 0.01€
Eytrewq posts big blind 0.02€
Dealt to Fried Berg [5d 4s]
*** PRE-FLOP *** 
Pierrof24 folds
Papaiah folds
Fried Berg folds
Faramiix57 folds
haouuum28 folds
Eytrewq collected 0.03€ from pot
*** SUMMARY ***
Total pot 0.03€ | No rake
Seat 2: Eytrewq (big blind) won 0.03€


Winamax Poker - HOLD-UP "Colorado" - HandId: #19116069-337456-1701438529 - Holdem no limit (0.01€/0.02€) - 2023/12/01 13:48:49 UTC
Table: 'Colorado' 6-max (real money) Seat #6 is the button
Seat 1: TaBrEaMoI (1.96€)
Seat 2: Papaiah (3.13€)
Seat 3: 3Bet4Chouffe (3.15€)
Seat 4: dan.doc (2.94€)
Seat 5: MENDOSA-31 (0.50€)
Seat 6: Fried Berg (1.04€)
*** ANTE/BLINDS ***
TaBrEaMoI posts small blind 0.01€
Papaiah posts big blind 0.02€
Dealt to Fried Berg [8h 5d]
*** PRE-FLOP *** 
3Bet4Chouffe folds
dan.doc folds
MENDOSA-31 folds
Fried Berg folds
TaBrEaMoI folds
Papaiah collected 0.03€ from pot
*** SUMMARY ***
Total pot 0.03€ | No rake
Seat 2: Papaiah (big blind) won 0.03€


Winamax Poker - HOLD-UP "Colorado" - HandId: #19116069-337460-1701438531 - Holdem no limit (0.01€/0.02€) - 2023/12/01 13:48:51 UTC
Table: 'Colorado' 6-max (real money) Seat #6 is the button
Seat 1: Eytrewq (1.91€)
Seat 2: KKamarAAde (11.31€)
Seat 3: kameleon73 (5.46€)
Seat 4: Fried Berg (1.04€)
Seat 5: curiouz dje (2€)
Seat 6: MENDOSA-31 (0.50€)
*** ANTE/BLINDS ***
Eytrewq posts small blind 0.01€
KKamarAAde posts big blind 0.02€
Dealt to Fried Berg [Th 6s]
*** PRE-FLOP *** 
kameleon73 folds
Fried Berg folds
curiouz dje folds
MENDOSA-31 folds
Eytrewq raises 0.04€ to 0.06€
KKamarAAde folds
Eytrewq collected 0.08€ from pot
*** SUMMARY ***
Total pot 0.08€ | No rake
Seat 1: Eytrewq (small blind) won 0.08€


Winamax Poker - HOLD-UP "Colorado" - HandId: #19116069-337471-1701438536 - Holdem no limit (0.01€/0.02€) - 2023/12/01 13:48:56 UTC
Table: 'Colorado' 6-max (real money) Seat #6 is the button
Seat 1: CHOPATATE-44 (2.92€)
Seat 2: haouuum28 (1.94€)
Seat 3: gostvision (2€)
Seat 4: SharkAKK (4.03€)
Seat 5: Ggteker (2.17€)
Seat 6: Fried Berg (1.04€)
*** ANTE/BLINDS ***
CHOPATATE-44 posts small blind 0.01€
haouuum28 posts big blind 0.02€
Dealt to Fried Berg [6c 3c]
*** PRE-FLOP *** 
gostvision folds
SharkAKK folds
Ggteker raises 0.04€ to 0.06€
Fried Berg folds
CHOPATATE-44 folds
haouuum28 folds
Ggteker collected 0.09€ from pot
*** SUMMARY ***
Total pot 0.09€ | No rake
Seat 5: Ggteker won 0.09€


Winamax Poker - HOLD-UP "Colorado" - HandId: #19116069-337486-1701438544 - Holdem no limit (0.01€/0.02€) - 2023/12/01 13:49:04 UTC
Table: 'Colorado' 6-max (real money) Seat #6 is the button
Seat 1: Fried Berg (1.04€)
Seat 2: mohamed_bkt (0.50€)
Seat 3: gostvision (2.03€)
Seat 4: tobytom (2€)
Seat 5: PtitDidine (1.74€)
Seat 6: Stun72 (3.31€)
*** ANTE/BLINDS ***
Fried Berg posts small blind 0.01€
mohamed_bkt posts big blind 0.02€
Dealt to Fried Berg [Jc Ad]
*** PRE-FLOP *** 
gostvision folds
tobytom folds
PtitDidine calls 0.02€
Stun72 folds
Fried Berg raises 0.04€ to 0.06€
mohamed_bkt folds
PtitDidine calls 0.04€
*** FLOP *** [7c 2h Qc]
Fried Berg checks
PtitDidine checks
*** TURN *** [7c 2h Qc][9c]
Fried Berg checks
PtitDidine bets 0.05€
Fried Berg calls 0.05€
*** RIVER *** [7c 2h Qc 9c][4s]
Fried Berg bets 0.08€
PtitDidine folds
Fried Berg collected 0.30€ from pot
*** SUMMARY ***
Total pot 0.30€ | Rake 0.02€
Board: [7c 2h Qc 9c 4s]
Seat 1: Fried Berg (small blind) won 0.30€


Winamax Poker - HOLD-UP "Colorado" - HandId: #19116069-337603-1701438615 - Holdem no limit (0.01€/0.02€) - 2023/12/01 13:50:15 UTC
Table: 'Colorado' 6-max (real money) Seat #6 is the button
Seat 1: TaBrEaMoI (2€)
Seat 2: Fried Berg (1.15€)
Seat 3: Scr.squirrel (2.55€)
Seat 4: Maestro 6885 (0.95€)
Seat 5: Tr0-_-L3urr3 (2€)
Seat 6: tom-2981 (0.51€)
*** ANTE/BLINDS ***
TaBrEaMoI posts small blind 0.01€
Fried Berg posts big blind 0.02€
Dealt to Fried Berg [7s 6d]
*** PRE-FLOP *** 
Scr.squirrel raises 0.04€ to 0.06€
Maestro 6885 folds
Tr0-_-L3urr3 folds
tom-2981 folds
TaBrEaMoI folds
Fried Berg folds
Scr.squirrel collected 0.09€ from pot
*** SUMMARY ***
Total pot 0.09€ | No rake
Seat 3: Scr.squirrel won 0.09€


Winamax Poker - HOLD-UP "Colorado" - HandId: #19116069-337622-1701438625 - Holdem no limit (0.01€/0.02€) - 2023/12/01 13:50:25 UTC
Table: 'Colorado' 6-max (real money) Seat #6 is the button
Seat 1: Maestro 6885 (0.93€)
Seat 2: J.C Deuces.0 (2€)
Seat 3: Fried Berg (1.13€)
Seat 4: Stun72 (2.28€)
Seat 5: Eytrewq (1.93€)
Seat 6: JissEl1te (3.44€)
Hold-up to Pot: total 0.10€
*** ANTE/BLINDS ***
Maestro 6885 posts small blind 0.01€
J.C Deuces.0 posts big blind 0.02€
Dealt to Fried Berg [Ac 9d]
*** PRE-FLOP *** 
Fried Berg raises 0.02€ to 0.04€
Stun72 folds
Eytrewq folds
JissEl1te raises 0.21€ to 0.25€
Maestro 6885 folds
J.C Deuces.0 folds
Fried Berg folds
JissEl1te collected 0.42€ from pot
*** SUMMARY ***
Total pot 0.42€ | No rake
Seat 6: JissEl1te (button) won 0.42€


Winamax Poker - HOLD-UP "Colorado" - HandId: #19116069-337676-1701438659 - Holdem no limit (0.01€/0.02€) - 2023/12/01 13:50:59 UTC
Table: 'Colorado' 6-max (real money) Seat #6 is the button
Seat 1: haouuum28 (1.55€)
Seat 2: YoSoyPablo17 (0.61€)
Seat 3: Fried Berg (1.09€)
Seat 4: ChaT_all_iN (2.09€)
Seat 5: DavidVillanu (3.96€)
Seat 6: JFSredbaron (2€)
*** ANTE/BLINDS ***
haouuum28 posts small blind 0.01€
YoSoyPablo17 posts big blind 0.02€
Dealt to Fried Berg [4s 6s]
*** PRE-FLOP *** 
Fried Berg folds
ChaT_all_iN folds
DavidVillanu folds
JFSredbaron folds
haouuum28 raises 1.53€ to 1.55€ and is all-in
YoSoyPablo17 folds
haouuum28 collected 1.57€ from pot
*** SUMMARY ***
Total pot 1.57€ | No rake
Seat 1: haouuum28 (small blind) won 1.57€


Winamax Poker - HOLD-UP "Colorado" - HandId: #19116069-337680-1701438662 - Holdem no limit (0.01€/0.02€) - 2023/12/01 13:51:02 UTC
Table: 'Colorado' 6-max (real money) Seat #6 is the button
Seat 1: JissEl1te (3.61€)
Seat 2: Fried Berg (1.09€)
Seat 3: Erenox (3.22€)
Seat 4: Savab1spaser (3.73€)
Seat 5: DGG23 (0.44€)
Seat 6: B&CLYDE (0.51€)
*** ANTE/BLINDS ***
JissEl1te posts small blind 0.01€
Fried Berg posts big blind 0.02€
Dealt to Fried Berg [2c 5s]
*** PRE-FLOP *** 
Erenox raises 0.04€ to 0.06€
Savab1spaser calls 0.06€
DGG23 folds
B&CLYDE folds
JissEl1te folds
Fried Berg folds
*** FLOP *** [6d 6c Kh]
Erenox bets 0.08€
Savab1spaser folds
Erenox collected 0.21€ from pot
*** SUMMARY ***
Total pot 0.21€ | Rake 0.02€
Board: [6d 6c Kh]
Seat 3: Erenox won 0.21€


Winamax Poker - HOLD-UP "Colorado" - HandId: #19116069-337686-1701438666 - Holdem no limit (0.01€/0.02€) - 2023/12/01 13:51:06 UTC
Table: 'Colorado' 6-max (real money) Seat #6 is the button
Seat 1: Thequeen1205 (3.75€)
Seat 2: Jneb34b (0.67€)
Seat 3: Alwarrior (2.12€)
Seat 4: Fried Berg (1.07€)
Seat 5: Stun72 (2.25€)
Seat 6: hello7585 (4.30€)
Hold-up to Pot: total 0.10€
*** ANTE/BLINDS ***
Thequeen1205 posts small blind 0.01€
Jneb34b posts big blind 0.02€
Dealt to Fried Berg [3h 9c]
*** PRE-FLOP *** 
Alwarrior folds
Fried Berg folds
Stun72 folds
hello7585 raises 0.04€ to 0.06€
Thequeen1205 folds
Jneb34b calls 0.04€
*** FLOP *** [4c Ks 4d]
Jneb34b checks
hello7585 bets 0.15€
Jneb34b folds
hello7585 collected 0.37€ from pot
*** SUMMARY ***
Total pot 0.37€ | Rake 0.01€
Board: [4c Ks 4d]
Seat 6: hello7585 (button) won 0.37€


Winamax Poker - HOLD-UP "Colorado" - HandId: #19116069-337693-1701438672 - Holdem no limit (0.01€/0.02€) - 2023/12/01 13:51:12 UTC
Table: 'Colorado' 6-max (real money) Seat #6 is the button
Seat 1: Tr0-_-L3urr3 (2€)
Seat 2: B&CLYDE (0.51€)
Seat 3: Thequeen1205 (3.74€)
Seat 4: vegifish (2.30€)
Seat 5: Fried Berg (1.07€)
Seat 6: Ertorko (2.07€)
*** ANTE/BLINDS ***
Tr0-_-L3urr3 posts small blind 0.01€
B&CLYDE posts big blind 0.02€
Dealt to Fried Berg [7d Jh]
*** PRE-FLOP *** 
Thequeen1205 folds
vegifish raises 0.03€ to 0.05€
Fried Berg folds
Ertorko folds
Tr0-_-L3urr3 raises 0.22€ to 0.27€
B&CLYDE folds
vegifish folds
Tr0-_-L3urr3 collected 0.34€ from pot
*** SUMMARY ***
Total pot 0.34€ | No rake
Seat 1: Tr0-_-L3urr3 (small blind) won 0.34€


Winamax Poker - HOLD-UP "Colorado" - HandId: #19116069-337703-1701438678 - Holdem no limit (0.01€/0.02€) - 2023/12/01 13:51:18 UTC
Table: 'Colorado' 6-max (real money) Seat #6 is the button
Seat 1: Srt.momo (1.89€)
Seat 2: Pierrof24 (2.33€)
Seat 3: Kaoky (4.11€)
Seat 4: joli45600352 (1.63€)
Seat 5: Lilichr (0.37€)
Seat 6: Fried Berg (1.07€)
*** ANTE/BLINDS ***
Srt.momo posts small blind 0.01€
Pierrof24 posts big blind 0.02€
Dealt to Fried Berg [9s Ks]
*** PRE-FLOP *** 
Kaoky folds
joli45600352 calls 0.02€
Lilichr folds
Fried Berg raises 0.02€ to 0.04€
Srt.momo folds
Pierrof24 folds
joli45600352 calls 0.02€
*** FLOP *** [4d Qh 8s]
joli45600352 checks
Fried Berg checks
*** TURN *** [4d Qh 8s][7d]
joli45600352 checks
Fried Berg checks
*** RIVER *** [4d Qh 8s 7d][8d]
joli45600352 checks
Fried Berg checks
*** SHOW DOWN ***
Fried Berg shows [9s Ks] (One pair : 8)
joli45600352 shows [Kc Th] (One pair : 8)
joli45600352 collected 0.10€ from pot
*** SUMMARY ***
Total pot 0.10€ | Rake 0.01€
Board: [4d Qh 8s 7d 8d]
Seat 4: joli45600352 showed [Kc Th] and won 0.10€ with One pair : 8
Seat 6: Fried Berg (button) showed [9s Ks] and lost with One pair : 8


Winamax Poker - HOLD-UP "Colorado" - HandId: #19116069-337771-1701438715 - Holdem no limit (0.01€/0.02€) - 2023/12/01 13:51:55 UTC
Table: 'Colorado' 6-max (real money) Seat #6 is the button
Seat 1: lyric1969 (1.37€)
Seat 2: JissEl1te (3.57€)
Seat 3: Fried Berg (1.03€)
Seat 4: Faramiix57 (3.39€)
Seat 5: joli45600352 (1.69€)
Seat 6: Ludal001 (2.78€)
*** ANTE/BLINDS ***
lyric1969 posts small blind 0.01€
JissEl1te posts big blind 0.02€
Dealt to Fried Berg [Kc 3d]
*** PRE-FLOP *** 
Fried Berg folds
Faramiix57 raises 0.04€ to 0.06€
joli45600352 folds
Ludal001 folds
lyric1969 folds
JissEl1te folds
Faramiix57 collected 0.09€ from pot
*** SUMMARY ***
Total pot 0.09€ | No rake
Seat 4: Faramiix57 won 0.09€


Winamax Poker - HOLD-UP "Colorado" - HandId: #19116069-337776-1701438718 - Holdem no limit (0.01€/0.02€) - 2023/12/01 13:51:58 UTC
Table: 'Colorado' 6-max (real money) Seat #6 is the button
Seat 1: NICO L AS 2 (2.10€)
Seat 2: LeDoc51 (3.73€)
Seat 3: lyric1969 (1.36€)
Seat 4: _ilTulipano_ (4.67€)
Seat 5: Douou (2.29€)
Seat 6: Fried Berg (1.03€)
*** ANTE/BLINDS ***
NICO L AS 2 posts small blind 0.01€
LeDoc51 posts big blind 0.02€
Dealt to Fried Berg [2h Jd]
*** PRE-FLOP *** 
lyric1969 folds
_ilTulipano_ raises 0.04€ to 0.06€
Douou folds
Fried Berg folds
NICO L AS 2 folds
LeDoc51 folds
_ilTulipano_ collected 0.09€ from pot
*** SUMMARY ***
Total pot 0.09€ | No rake
Seat 4: _ilTulipano_ won 0.09€


Winamax Poker - HOLD-UP "Colorado" - HandId: #19116069-337780-1701438720 - Holdem no limit (0.01€/0.02€) - 2023/12/01 13:52:00 UTC
Table: 'Colorado' 6-max (real money) Seat #6 is the button
Seat 1: Fried Berg (1.03€)
Seat 2: momoiheb (0.50€)
Seat 3: NICO L AS 2 (2.09€)
Seat 4: Thequeen1205 (3.68€)
Seat 5: Pierrof24 (3.20€)
Seat 6: Tr0-_-L3urr3 (2.23€)
*** ANTE/BLINDS ***
Fried Berg posts small blind 0.01€
momoiheb posts big blind 0.02€
Dealt to Fried Berg [As 2c]
*** PRE-FLOP *** 
NICO L AS 2 folds
Thequeen1205 folds
Pierrof24 folds
Tr0-_-L3urr3 raises 0.03€ to 0.05€
Fried Berg raises 0.10€ to 0.15€
momoiheb folds
Tr0-_-L3urr3 calls 0.10€
*** FLOP *** [8s Js Ks]
Fried Berg checks
Tr0-_-L3urr3 checks
*** TURN *** [8s Js Ks][5s]
Fried Berg checks
Tr0-_-L3urr3 bets 0.43€
Fried Berg calls 0.43€
*** RIVER *** [8s Js Ks 5s][Kc]
Fried Berg checks
Tr0-_-L3urr3 checks
*** SHOW DOWN ***
Tr0-_-L3urr3 shows [Qh 7h] (One pair : Kings)
Fried Berg shows [As 2c] (Flush Ace high)
Fried Berg collected 1.06€ from pot
*** SUMMARY ***
Total pot 1.06€ | Rake 0.12€
Board: [8s Js Ks 5s Kc]
Seat 1: Fried Berg (small blind) showed [As 2c] and won 1.06€ with Flush Ace high
Seat 6: Tr0-_-L3urr3 (button) showed [Qh 7h] and lost with One pair : Kings


Winamax Poker - HOLD-UP "Colorado" - HandId: #19116069-337888-1701438781 - Holdem no limit (0.01€/0.02€) - 2023/12/01 13:53:01 UTC
Table: 'Colorado' 6-max (real money) Seat #6 is the button
Seat 1: Fried Berg (1.51€)
Seat 2: Stun72 (2.13€)
Seat 3: Papaiah (2€)
Seat 4: Coconutz242 (2€)
Seat 5: Tr0-_-L3urr3 (2€)
Seat 6: _ilTulipano_ (4.09€)
*** ANTE/BLINDS ***
Fried Berg posts small blind 0.01€
Stun72 posts big blind 0.02€
Dealt to Fried Berg [7s 2d]
*** PRE-FLOP *** 
Papaiah folds
Coconutz242 folds
Tr0-_-L3urr3 raises 0.03€ to 0.05€
_ilTulipano_ folds
Fried Berg folds
Stun72 folds
Tr0-_-L3urr3 collected 0.08€ from pot
*** SUMMARY ***
Total pot 0.08€ | No rake
Seat 5: Tr0-_-L3urr3 won 0.08€


Winamax Poker - HOLD-UP "Colorado" - HandId: #19116069-337898-1701438787 - Holdem no limit (0.01€/0.02€) - 2023/12/01 13:53:07 UTC
Table: 'Colorado' 6-max (real money) Seat #6 is the button
Seat 1: Pierrof24 (3.16€)
Seat 2: Fried Berg (1.50€)
Seat 3: Harrys31 (0.86€)
Seat 4: Jneb34b (0.42€)
Seat 5: Tofini (2€)
Seat 6: rick26 (0.63€)
Hold-up to Pot: total 0.10€
*** ANTE/BLINDS ***
Pierrof24 posts small blind 0.01€
Fried Berg posts big blind 0.02€
Dealt to Fried Berg [Th 6h]
*** PRE-FLOP *** 
Harrys31 calls 0.02€
Jneb34b raises 0.40€ to 0.42€ and is all-in
Tofini folds
rick26 folds
Pierrof24 folds
Fried Berg folds
Harrys31 folds
Jneb34b collected 0.57€ from pot
*** SUMMARY ***
Total pot 0.57€ | No rake
Seat 4: Jneb34b won 0.57€


Winamax Poker - HOLD-UP "Colorado" - HandId: #19116069-337911-1701438796 - Holdem no limit (0.01€/0.02€) - 2023/12/01 13:53:16 UTC
Table: 'Colorado' 6-max (real money) Seat #6 is the button
Seat 1: Kaoky (6.09€)
Seat 2: Wolfert (4.19€)
Seat 3: DGG23 (0.16€)
Seat 4: curiouz dje (2.27€)
Seat 5: Fried Berg (1.48€)
Seat 6: tobytom (2€)
*** ANTE/BLINDS ***
Kaoky posts small blind 0.01€
Wolfert posts big blind 0.02€
Dealt to Fried Berg [6d Qd]
*** PRE-FLOP *** 
DGG23 folds
curiouz dje raises 0.03€ to 0.05€
Fried Berg folds
tobytom folds
Kaoky folds
Wolfert folds
curiouz dje collected 0.08€ from pot
*** SUMMARY ***
Total pot 0.08€ | No rake
Seat 4: curiouz dje won 0.08€


Winamax Poker - HOLD-UP "Colorado" - HandId: #19116069-337944-1701438814 - Holdem no limit (0.01€/0.02€) - 2023/12/01 13:53:34 UTC
Table: 'Colorado' 6-max (real money) Seat #6 is the button
Seat 1: J.C Deuces.0 (2.14€)
Seat 2: Savab1spaser (3.55€)
Seat 3: oliveponcar (2.13€)
Seat 4: Fried Berg (1.48€)
Seat 5: kamikazzz51 (0.55€)
Seat 6: Eytrewq (1.84€)
*** ANTE/BLINDS ***
J.C Deuces.0 posts small blind 0.01€
Savab1spaser posts big blind 0.02€
Dealt to Fried Berg [7c Qc]
*** PRE-FLOP *** 
oliveponcar folds
Fried Berg raises 0.02€ to 0.04€
kamikazzz51 calls 0.04€
Eytrewq folds
J.C Deuces.0 calls 0.03€
Savab1spaser folds
*** FLOP *** [7d 4s 9h]
J.C Deuces.0 checks
Fried Berg checks
kamikazzz51 bets 0.02€
J.C Deuces.0 calls 0.02€
Fried Berg calls 0.02€
*** TURN *** [7d 4s 9h][2c]
J.C Deuces.0 checks
Fried Berg checks
kamikazzz51 bets 0.02€
J.C Deuces.0 calls 0.02€
Fried Berg calls 0.02€
*** RIVER *** [7d 4s 9h 2c][Tc]
J.C Deuces.0 checks
Fried Berg checks
kamikazzz51 bets 0.02€
J.C Deuces.0 raises 0.04€ to 0.06€
Fried Berg folds
kamikazzz51 calls 0.04€
*** SHOW DOWN ***
kamikazzz51 shows [Kd 4d] (One pair : 4)
J.C Deuces.0 shows [Ts Qs] (One pair : Tens)
J.C Deuces.0 collected 0.34€ from pot
*** SUMMARY ***
Total pot 0.34€ | Rake 0.04€
Board: [7d 4s 9h 2c Tc]
Seat 1: J.C Deuces.0 (small blind) showed [Ts Qs] and won 0.34€ with One pair : Tens
Seat 5: kamikazzz51 showed [Kd 4d] and lost with One pair : 4


Winamax Poker - HOLD-UP "Colorado" - HandId: #19116069-338080-1701438894 - Holdem no limit (0.01€/0.02€) - 2023/12/01 13:54:54 UTC
Table: 'Colorado' 6-max (real money) Seat #6 is the button
Seat 1: Ludal001 (2.69€)
Seat 2: DGG23 (0.50€)
Seat 3: kameleon73 (5.56€)
Seat 4: Pierrof24 (1.60€)
Seat 5: Tofini (2.57€)
Seat 6: Fried Berg (1.40€)
*** ANTE/BLINDS ***
Ludal001 posts small blind 0.01€
DGG23 posts big blind 0.02€
Dealt to Fried Berg [7s 4c]
*** PRE-FLOP *** 
kameleon73 folds
Pierrof24 folds
Tofini raises 0.03€ to 0.05€
Fried Berg folds
Ludal001 raises 0.10€ to 0.15€
DGG23 folds
Tofini calls 0.10€
*** FLOP *** [6s 2s 3s]
Ludal001 bets 0.16€
Tofini calls 0.16€
*** TURN *** [6s 2s 3s][4h]
Ludal001 checks
Tofini checks
*** RIVER *** [6s 2s 3s 4h][Qc]
Ludal001 checks
Tofini checks
*** SHOW DOWN ***
Ludal001 shows [Kd Ah] (High card : Ace)
Tofini shows [Tc Th] (One pair : Tens)
Tofini collected 0.58€ from pot
*** SUMMARY ***
Total pot 0.58€ | Rake 0.06€
Board: [6s 2s 3s 4h Qc]
Seat 1: Ludal001 (small blind) showed [Kd Ah] and lost with High card : Ace
Seat 5: Tofini showed [Tc Th] and won 0.58€ with One pair : Tens


Winamax Poker - HOLD-UP "Colorado" - HandId: #19116069-338090-1701438899 - Holdem no limit (0.01€/0.02€) - 2023/12/01 13:54:59 UTC
Table: 'Colorado' 6-max (real money) Seat #6 is the button
Seat 1: 8Tourinho (0.25€)
Seat 2: Fried Berg (1.40€)
Seat 3: Tr0-_-L3urr3 (2.53€)
Seat 4: LimpDoud (2€)
Seat 5: Coconutz242 (2.12€)
Seat 6: KKamarAAde (10.45€)
*** ANTE/BLINDS ***
8Tourinho posts small blind 0.01€
Fried Berg posts big blind 0.02€
Dealt to Fried Berg [8d 5s]
*** PRE-FLOP *** 
Tr0-_-L3urr3 folds
LimpDoud folds
Coconutz242 folds
KKamarAAde folds
8Tourinho folds
Fried Berg collected 0.03€ from pot
*** SUMMARY ***
Total pot 0.03€ | No rake
Seat 2: Fried Berg (big blind) won 0.03€


Winamax Poker - HOLD-UP "Colorado" - HandId: #19116069-338122-1701438919 - Holdem no limit (0.01€/0.02€) - 2023/12/01 13:55:19 UTC
Table: 'Colorado' 6-max (real money) Seat #6 is the button
Seat 1: Papaiah (2.03€)
Seat 2: hello7585 (2.58€)
Seat 3: Bback (2.01€)
Seat 4: Coconutz242 (2.06€)
Seat 5: Fried Berg (1.41€)
Seat 6: _ilTulipano_ (8.96€)
*** ANTE/BLINDS ***
Papaiah posts small blind 0.01€
hello7585 posts big blind 0.02€
Dealt to Fried Berg [Ad Ac]
*** PRE-FLOP *** 
Bback folds
Coconutz242 folds
Fried Berg raises 0.04€ to 0.06€
_ilTulipano_ folds
Papaiah folds
hello7585 folds
Fried Berg collected 0.09€ from pot
*** SUMMARY ***
Total pot 0.09€ | No rake
Seat 5: Fried Berg won 0.09€


Winamax Poker - HOLD-UP "Colorado" - HandId: #19116069-338158-1701438938 - Holdem no limit (0.01€/0.02€) - 2023/12/01 13:55:38 UTC
Table: 'Colorado' 6-max (real money) Seat #6 is the button
Seat 1: Yondaime M (4.66€)
Seat 2: JFSredbaron (2.19€)
Seat 3: Fried Berg (1.44€)
Seat 4: _ilTulipano_ (3.16€)
Seat 5: Tr0-_-L3urr3 (2.56€)
Seat 6: tobytom (3.56€)
*** ANTE/BLINDS ***
Yondaime M posts small blind 0.01€
JFSredbaron posts big blind 0.02€
Dealt to Fried Berg [4d Qh]
*** PRE-FLOP *** 
Fried Berg folds
_ilTulipano_ raises 0.04€ to 0.06€
Tr0-_-L3urr3 folds
tobytom folds
Yondaime M calls 0.05€
JFSredbaron folds
*** FLOP *** [9s 7d 6c]
Yondaime M checks
_ilTulipano_ bets 0.07€
Yondaime M calls 0.07€
*** TURN *** [9s 7d 6c][4c]
Yondaime M checks
_ilTulipano_ checks
*** RIVER *** [9s 7d 6c 4c][9d]
Yondaime M bets 0.22€
_ilTulipano_ folds
Yondaime M collected 0.47€ from pot
*** SUMMARY ***
Total pot 0.47€ | Rake 0.03€
Board: [9s 7d 6c 4c 9d]
Seat 1: Yondaime M (small blind) won 0.47€


Winamax Poker - HOLD-UP "Colorado" - HandId: #19116069-338163-1701438941 - Holdem no limit (0.01€/0.02€) - 2023/12/01 13:55:41 UTC
Table: 'Colorado' 6-max (real money) Seat #6 is the button
Seat 1: Ertorko (2.08€)
Seat 2: -_Galius_- (1.17€)
Seat 3: magnumbenji (0.69€)
Seat 4: Fried Berg (1.44€)
Seat 5: Jneb34b (0.52€)
Seat 6: Kaoky (2.35€)
*** ANTE/BLINDS ***
Ertorko posts small blind 0.01€
-_Galius_- posts big blind 0.02€
Dealt to Fried Berg [6c 5d]
*** PRE-FLOP *** 
magnumbenji folds
Fried Berg folds
Jneb34b folds
Kaoky folds
Ertorko raises 0.05€ to 0.07€
-_Galius_- folds
Ertorko collected 0.09€ from pot
*** SUMMARY ***
Total pot 0.09€ | No rake
Seat 1: Ertorko (small blind) won 0.09€


Winamax Poker - HOLD-UP "Colorado" - HandId: #19116069-338168-1701438944 - Holdem no limit (0.01€/0.02€) - 2023/12/01 13:55:44 UTC
Table: 'Colorado' 6-max (real money) Seat #6 is the button
Seat 1: haouuum28 (1.30€)
Seat 2: SashaTDouss (2.05€)
Seat 3: curiouz dje (2.04€)
Seat 4: Jneb34b (0.52€)
Seat 5: Odieux Car4 (1.47€)
Seat 6: Fried Berg (1.44€)
*** ANTE/BLINDS ***
haouuum28 posts small blind 0.01€
SashaTDouss posts big blind 0.02€
Dealt to Fried Berg [Qc Jh]
*** PRE-FLOP *** 
curiouz dje folds
Jneb34b folds
Odieux Car4 folds
Fried Berg raises 0.04€ to 0.06€
haouuum28 folds
SashaTDouss folds
Fried Berg collected 0.09€ from pot
*** SUMMARY ***
Total pot 0.09€ | No rake
Seat 6: Fried Berg (button) won 0.09€


Winamax Poker - HOLD-UP "Colorado" - HandId: #19116069-338179-1701438952 - Holdem no limit (0.01€/0.02€) - 2023/12/01 13:55:52 UTC
Table: 'Colorado' 6-max (real money) Seat #6 is the button
Seat 1: Fripon_77201 (2.94€)
Seat 2: tobytom (3.56€)
Seat 3: haouuum28 (1.29€)
Seat 4: Dzil77220 (0.42€)
Seat 5: Fried Berg (1.47€)
Seat 6: Damspins (2.23€)
*** ANTE/BLINDS ***
Fripon_77201 posts small blind 0.01€
tobytom posts big blind 0.02€
Dealt to Fried Berg [3s Qc]
*** PRE-FLOP *** 
haouuum28 folds
Dzil77220 folds
Fried Berg folds
Damspins calls 0.02€
Fripon_77201 raises 0.05€ to 0.07€
tobytom folds
Damspins calls 0.05€
*** FLOP *** [7c Kh 2h]
Fripon_77201 checks
Damspins checks
*** TURN *** [7c Kh 2h][Ks]
Fripon_77201 checks
Damspins checks
*** RIVER *** [7c Kh 2h Ks][9d]
Fripon_77201 bets 0.13€
Damspins folds
Fripon_77201 collected 0.27€ from pot
*** SUMMARY ***
Total pot 0.27€ | Rake 0.02€
Board: [7c Kh 2h Ks 9d]
Seat 1: Fripon_77201 (small blind) won 0.27€


Winamax Poker - HOLD-UP "Colorado" - HandId: #19116069-338187-1701438957 - Holdem no limit (0.01€/0.02€) - 2023/12/01 13:55:57 UTC
Table: 'Colorado' 6-max (real money) Seat #6 is the button
Seat 1: FreeLouisias (2€)
Seat 2: Falco69 (0.76€)
Seat 3: Puma24644584 (2.43€)
Seat 4: Eytrewq (1.80€)
Seat 5: J.C Deuces.0 (2.43€)
Seat 6: Fried Berg (1.47€)
*** ANTE/BLINDS ***
FreeLouisias posts small blind 0.01€
Falco69 posts big blind 0.02€
Dealt to Fried Berg [4c 2s]
*** PRE-FLOP *** 
Puma24644584 folds
Eytrewq folds
J.C Deuces.0 raises 0.04€ to 0.06€
Fried Berg folds
FreeLouisias folds
Falco69 folds
J.C Deuces.0 collected 0.09€ from pot
*** SUMMARY ***
Total pot 0.09€ | No rake
Seat 5: J.C Deuces.0 won 0.09€


Winamax Poker - HOLD-UP "Colorado" - HandId: #19116069-338190-1701438958 - Holdem no limit (0.01€/0.02€) - 2023/12/01 13:55:58 UTC
Table: 'Colorado' 6-max (real money) Seat #6 is the button
Seat 1: MCGHansen (2€)
Seat 2: Fried Berg (1.47€)
Seat 3: SashaTDouss (2.02€)
Seat 4: strada2012 (2.07€)
Seat 5: CHOPATATE-44 (2.09€)
Seat 6: Erenox (1.60€)
*** ANTE/BLINDS ***
MCGHansen posts small blind 0.01€
Fried Berg posts big blind 0.02€
Dealt to Fried Berg [5c 3h]
*** PRE-FLOP *** 
SashaTDouss folds
strada2012 folds
CHOPATATE-44 folds
Erenox folds
MCGHansen raises 0.03€ to 0.05€
Fried Berg folds
MCGHansen collected 0.07€ from pot
*** SUMMARY ***
Total pot 0.07€ | No rake
Seat 1: MCGHansen (small blind) won 0.07€


Winamax Poker - HOLD-UP "Colorado" - HandId: #19116069-338229-1701438980 - Holdem no limit (0.01€/0.02€) - 2023/12/01 13:56:20 UTC
Table: 'Colorado' 6-max (real money) Seat #6 is the button
Seat 1: tobytom (3.54€)
Seat 2: CTMieuxAvant (2€)
Seat 3: Fried Berg (1.45€)
Seat 4: J.C Deuces.0 (2.24€)
Seat 5: magnumbenji (0.63€)
Seat 6: Coconutz242 (2.12€)
*** ANTE/BLINDS ***
tobytom posts small blind 0.01€
CTMieuxAvant posts big blind 0.02€
Dealt to Fried Berg [Qc Qs]
*** PRE-FLOP *** 
Fried Berg raises 0.04€ to 0.06€
J.C Deuces.0 folds
magnumbenji folds
Coconutz242 folds
tobytom folds
CTMieuxAvant folds
Fried Berg collected 0.09€ from pot
*** SUMMARY ***
Total pot 0.09€ | No rake
Seat 3: Fried Berg won 0.09€


Winamax Poker - HOLD-UP "Colorado" - HandId: #19116069-338250-1701438991 - Holdem no limit (0.01€/0.02€) - 2023/12/01 13:56:31 UTC
Table: 'Colorado' 6-max (real money) Seat #6 is the button
Seat 1: strada2012 (3.14€)
Seat 2: vegifish (2.24€)
Seat 3: Yondaime M (4.76€)
Seat 4: Fried Berg (1.48€)
Seat 5: CTMieuxAvant (1.97€)
Seat 6: Puma24644584 (2.22€)
*** ANTE/BLINDS ***
strada2012 posts small blind 0.01€
vegifish posts big blind 0.02€
Dealt to Fried Berg [Kd 6d]
*** PRE-FLOP *** 
Yondaime M folds
Fried Berg raises 0.02€ to 0.04€
CTMieuxAvant folds
Puma24644584 folds
strada2012 folds
vegifish calls 0.02€
*** FLOP *** [9c 4c Ad]
vegifish checks
Fried Berg checks
*** TURN *** [9c 4c Ad][Ah]
vegifish checks
Fried Berg checks
*** RIVER *** [9c 4c Ad Ah][Jh]
vegifish checks
Fried Berg checks
*** SHOW DOWN ***
vegifish shows [2d Ks] (One pair : Aces)
Fried Berg shows [Kd 6d] (One pair : Aces)
Fried Berg collected 0.04€ from pot
vegifish collected 0.04€ from pot
*** SUMMARY ***
Total pot 0.08€ | Rake 0.01€
Board: [9c 4c Ad Ah Jh]
Seat 2: vegifish (big blind) showed [2d Ks] and won 0.04€ with One pair : Aces
Seat 4: Fried Berg showed [Kd 6d] and won 0.04€ with One pair : Aces


Winamax Poker - HOLD-UP "Colorado" - HandId: #19116069-338283-1701439012 - Holdem no limit (0.01€/0.02€) - 2023/12/01 13:56:52 UTC
Table: 'Colorado' 6-max (real money) Seat #6 is the button
Seat 1: Fried Berg (1.48€)
Seat 2: LimpDoud (6.06€)
Seat 3: oliveponcar (2€)
Seat 4: B&CLYDE (0.36€)
Seat 5: CTMieuxAvant (1.97€)
Seat 6: SashaTDouss (2.05€)
*** ANTE/BLINDS ***
Fried Berg posts small blind 0.01€
LimpDoud posts big blind 0.02€
Dealt to Fried Berg [9h 3s]
*** PRE-FLOP *** 
oliveponcar raises 0.04€ to 0.06€
B&CLYDE folds
CTMieuxAvant folds
SashaTDouss folds
Fried Berg folds
LimpDoud folds
oliveponcar collected 0.09€ from pot
*** SUMMARY ***
Total pot 0.09€ | No rake
Seat 3: oliveponcar won 0.09€


Winamax Poker - HOLD-UP "Colorado" - HandId: #19116069-338289-1701439015 - Holdem no limit (0.01€/0.02€) - 2023/12/01 13:56:55 UTC
Table: 'Colorado' 6-max (real money) Seat #6 is the button
Seat 1: Fripon_77201 (2.42€)
Seat 2: toxi-show (2.58€)
Seat 3: Kaoky (2€)
Seat 4: Fried Berg (1.47€)
Seat 5: DGG23 (0.48€)
Seat 6: Erenox (2.53€)
*** ANTE/BLINDS ***
Fripon_77201 posts small blind 0.01€
toxi-show posts big blind 0.02€
Dealt to Fried Berg [Ad 7s]
*** PRE-FLOP *** 
Kaoky folds
Fried Berg raises 0.02€ to 0.04€
DGG23 folds
Erenox raises 0.08€ to 0.12€
Fripon_77201 folds
toxi-show calls 0.10€
Fried Berg folds
*** FLOP *** [6h 7c Js]
toxi-show checks
Erenox bets 0.14€
toxi-show calls 0.14€
*** TURN *** [6h 7c Js][9c]
toxi-show checks
Erenox checks
*** RIVER *** [6h 7c Js 9c][Jh]
toxi-show bets 0.37€
Erenox folds
toxi-show collected 0.88€ from pot
*** SUMMARY ***
Total pot 0.88€ | Rake 0.06€
Board: [6h 7c Js 9c Jh]
Seat 2: toxi-show (big blind) won 0.88€


Winamax Poker - HOLD-UP "Colorado" - HandId: #19116069-338321-1701439034 - Holdem no limit (0.01€/0.02€) - 2023/12/01 13:57:14 UTC
Table: 'Colorado' 6-max (real money) Seat #6 is the button
Seat 1: Fried Berg (1.43€)
Seat 2: haouuum28 (2€)
Seat 3: Ertorko (2.02€)
Seat 4: tobytom (2€)
Seat 5: Stun72 (2.28€)
Seat 6: hello7585 (4.35€)
*** ANTE/BLINDS ***
Fried Berg posts small blind 0.01€
haouuum28 posts big blind 0.02€
Dealt to Fried Berg [As 9s]
*** PRE-FLOP *** 
Ertorko raises 0.03€ to 0.05€
tobytom folds
Stun72 folds
hello7585 folds
Fried Berg calls 0.04€
haouuum28 folds
*** FLOP *** [Ad Ac 6d]
Fried Berg checks
Ertorko bets 0.04€
Fried Berg calls 0.04€
*** TURN *** [Ad Ac 6d][3d]
Fried Berg checks
Ertorko checks
*** RIVER *** [Ad Ac 6d 3d][5d]
Fried Berg checks
Ertorko bets 0.06€
Fried Berg calls 0.06€
*** SHOW DOWN ***
Fried Berg shows [As 9s] (Trips of Aces)
Ertorko shows [Qs Jd] (Flush Ace high)
Ertorko collected 0.29€ from pot
*** SUMMARY ***
Total pot 0.29€ | Rake 0.03€
Board: [Ad Ac 6d 3d 5d]
Seat 1: Fried Berg (small blind) showed [As 9s] and lost with Trips of Aces
Seat 3: Ertorko showed [Qs Jd] and won 0.29€ with Flush Ace high


Winamax Poker - HOLD-UP "Colorado" - HandId: #19116069-338409-1701439089 - Holdem no limit (0.01€/0.02€) - 2023/12/01 13:58:09 UTC
Table: 'Colorado' 6-max (real money) Seat #6 is the button
Seat 1: Jneb34b (0.42€)
Seat 2: Ertorko (2.16€)
Seat 3: toka30 (2.94€)
Seat 4: LimpDoud (2.32€)
Seat 5: Fried Berg (1.28€)
Seat 6: Bback (2.03€)
*** ANTE/BLINDS ***
Jneb34b posts small blind 0.01€
Ertorko posts big blind 0.02€
Dealt to Fried Berg [5s 6s]
*** PRE-FLOP *** 
toka30 raises 0.03€ to 0.05€
LimpDoud calls 0.05€
Fried Berg calls 0.05€
Bback raises 0.30€ to 0.35€
Jneb34b folds
Ertorko folds
toka30 folds
LimpDoud folds
Fried Berg folds
Bback collected 0.53€ from pot
*** SUMMARY ***
Total pot 0.53€ | No rake
Seat 6: Bback (button) won 0.53€


Winamax Poker - HOLD-UP "Colorado" - HandId: #19116069-338470-1701439129 - Holdem no limit (0.01€/0.02€) - 2023/12/01 13:58:49 UTC
Table: 'Colorado' 6-max (real money) Seat #6 is the button
Seat 1: Yondaime M (4.39€)
Seat 2: curiouz dje (2.15€)
Seat 3: Stinnay (0.59€)
Seat 4: KKamarAAde (10.51€)
Seat 5: Fried Berg (1.23€)
Seat 6: lefraisier (2.40€)
Hold-up to Pot: total 0.50€
*** ANTE/BLINDS ***
Yondaime M posts small blind 0.01€
curiouz dje posts big blind 0.02€
Dealt to Fried Berg [7c Ah]
*** PRE-FLOP *** 
Stinnay raises 0.03€ to 0.05€
KKamarAAde folds
Fried Berg calls 0.05€
lefraisier calls 0.05€
Yondaime M folds
curiouz dje calls 0.03€
*** FLOP *** [Qc 9c 4h]
curiouz dje checks
Stinnay bets 0.18€
Fried Berg folds
lefraisier raises 0.26€ to 0.44€
curiouz dje folds
Stinnay calls 0.26€
*** TURN *** [Qc 9c 4h][Ts]
Stinnay checks
lefraisier bets 0.56€
Stinnay calls 0.10€ and is all-in
*** RIVER *** [Qc 9c 4h Ts][6s]
*** SHOW DOWN ***
Stinnay shows [4c Ad] (One pair : 4)
lefraisier shows [7d Qs] (One pair : Queens)
lefraisier collected 2.12€ from pot
*** SUMMARY ***
Total pot 2.12€ | Rake 0.13€
Board: [Qc 9c 4h Ts 6s]
Seat 3: Stinnay showed [4c Ad] and lost with One pair : 4
Seat 6: lefraisier (button) showed [7d Qs] and won 2.12€ with One pair : Queens


Winamax Poker - HOLD-UP "Colorado" - HandId: #19116069-338530-1701439163 - Holdem no limit (0.01€/0.02€) - 2023/12/01 13:59:23 UTC
Table: 'Colorado' 6-max (real money) Seat #6 is the button
Seat 1: Falco69 (0.80€)
Seat 2: Fried Berg (1.18€)
Seat 3: divin.Ange64 (2.06€)
Seat 4: Critical30 (2.29€)
Seat 5: oliveponcar (2.22€)
Seat 6: ChaT_all_iN (3.19€)
*** ANTE/BLINDS ***
Falco69 posts small blind 0.01€
Fried Berg posts big blind 0.02€
Dealt to Fried Berg [2c Td]
*** PRE-FLOP *** 
divin.Ange64 folds
Critical30 calls 0.02€
oliveponcar folds
ChaT_all_iN folds
Falco69 raises 0.08€ to 0.10€
Fried Berg folds
Critical30 calls 0.08€
*** FLOP *** [Th 3d 7h]
Falco69 checks
Critical30 bets 0.02€
Falco69 calls 0.02€
*** TURN *** [Th 3d 7h][Js]
Falco69 bets 0.05€
Critical30 calls 0.05€
*** RIVER *** [Th 3d 7h Js][Jd]
Falco69 bets 0.50€
Critical30 folds
Falco69 collected 0.82€ from pot
*** SUMMARY ***
Total pot 0.82€ | Rake 0.04€
Board: [Th 3d 7h Js Jd]
Seat 1: Falco69 (small blind) won 0.82€


Winamax Poker - HOLD-UP "Colorado" - HandId: #19116069-338540-1701439169 - Holdem no limit (0.01€/0.02€) - 2023/12/01 13:59:29 UTC
Table: 'Colorado' 6-max (real money) Seat #6 is the button
Seat 1: Ggteker (4.83€)
Seat 2: MH Warrior14 (1.63€)
Seat 3: Fried Berg (1.16€)
Seat 4: GTO-Mieko (2€)
Seat 5: Erenox (2.34€)
Seat 6: _ilTulipano_ (2.17€)
*** ANTE/BLINDS ***
Ggteker posts small blind 0.01€
MH Warrior14 posts big blind 0.02€
Dealt to Fried Berg [5c Qc]
*** PRE-FLOP *** 
Fried Berg folds
GTO-Mieko folds
Erenox folds
_ilTulipano_ raises 0.04€ to 0.06€
Ggteker calls 0.05€
MH Warrior14 calls 0.04€
*** FLOP *** [Jd Qd 4s]
Ggteker bets 0.12€
MH Warrior14 calls 0.12€
_ilTulipano_ folds
*** TURN *** [Jd Qd 4s][As]
Ggteker bets 0.20€
MH Warrior14 calls 0.20€
*** RIVER *** [Jd Qd 4s As][7s]
Ggteker checks
MH Warrior14 checks
*** SHOW DOWN ***
MH Warrior14 shows [3h Qs] (One pair : Queens)
Ggteker shows [Kh Qh] (One pair : Queens)
Ggteker collected 0.74€ from pot
*** SUMMARY ***
Total pot 0.74€ | Rake 0.08€
Board: [Jd Qd 4s As 7s]
Seat 1: Ggteker (small blind) showed [Kh Qh] and won 0.74€ with One pair : Queens
Seat 2: MH Warrior14 (big blind) showed [3h Qs] and lost with One pair : Queens


Winamax Poker - HOLD-UP "Colorado" - HandId: #19116069-338557-1701439177 - Holdem no limit (0.01€/0.02€) - 2023/12/01 13:59:37 UTC
Table: 'Colorado' 6-max (real money) Seat #6 is the button
Seat 1: muespachois1 (1.77€)
Seat 2: juanktyga (4.52€)
Seat 3: Papaiah (2.04€)
Seat 4: Yondaime M (2€)
Seat 5: Fried Berg (1.16€)
Seat 6: arkiond3 (1.97€)
*** ANTE/BLINDS ***
muespachois1 posts small blind 0.01€
juanktyga posts big blind 0.02€
Dealt to Fried Berg [Tc As]
*** PRE-FLOP *** 
Papaiah folds
Yondaime M folds
Fried Berg raises 0.02€ to 0.04€
arkiond3 folds
muespachois1 calls 0.03€
juanktyga folds
*** FLOP *** [Ad 9h 5h]
muespachois1 checks
Fried Berg checks
*** TURN *** [Ad 9h 5h][2s]
muespachois1 checks
Fried Berg checks
*** RIVER *** [Ad 9h 5h 2s][4c]
muespachois1 checks
Fried Berg bets 0.04€
muespachois1 folds
Fried Berg collected 0.13€ from pot
*** SUMMARY ***
Total pot 0.13€ | Rake 0.01€
Board: [Ad 9h 5h 2s 4c]
Seat 5: Fried Berg won 0.13€


Winamax Poker - HOLD-UP "Colorado" - HandId: #19116069-338590-1701439199 - Holdem no limit (0.01€/0.02€) - 2023/12/01 13:59:59 UTC
Table: 'Colorado' 6-max (real money) Seat #6 is the button
Seat 1: Fried Berg (1.21€)
Seat 2: Jneb34b (0.40€)
Seat 3: Douou (2.87€)
Seat 4: LimpDoud (3.09€)
Seat 5: Savab1spaser (4.40€)
Seat 6: tobytom (2.04€)
*** ANTE/BLINDS ***
Fried Berg posts small blind 0.01€
Jneb34b posts big blind 0.02€
Dealt to Fried Berg [7d 5d]
*** PRE-FLOP *** 
Douou folds
LimpDoud folds
Savab1spaser folds
tobytom folds
Fried Berg raises 0.02€ to 0.04€
Jneb34b calls 0.02€
*** FLOP *** [9h 5c Kh]
Fried Berg checks
Jneb34b checks
*** TURN *** [9h 5c Kh][6c]
Fried Berg checks
Jneb34b checks
*** RIVER *** [9h 5c Kh 6c][4h]
Fried Berg checks
Jneb34b checks
*** SHOW DOWN ***
Jneb34b shows [Tc 8h] (High card : King)
Fried Berg shows [7d 5d] (One pair : 5)
Fried Berg collected 0.07€ from pot
*** SUMMARY ***
Total pot 0.07€ | Rake 0.01€
Board: [9h 5c Kh 6c 4h]
Seat 1: Fried Berg (small blind) showed [7d 5d] and won 0.07€ with One pair : 5
Seat 2: Jneb34b (big blind) showed [Tc 8h] and lost with High card : King


Winamax Poker - HOLD-UP "Colorado" - HandId: #19116069-338702-1701439257 - Holdem no limit (0.01€/0.02€) - 2023/12/01 14:00:57 UTC
Table: 'Colorado' 6-max (real money) Seat #6 is the button
Seat 1: Douou (2.98€)
Seat 2: Fried Berg (1.24€)
Seat 3: Titine543 (3.22€)
Seat 4: GTO-Mieko (2.30€)
Seat 5: Ertorko (2€)
Seat 6: Thequeen1205 (3.63€)
Hold-up to Pot: total 0.10€
*** ANTE/BLINDS ***
Douou posts small blind 0.01€
Fried Berg posts big blind 0.02€
Dealt to Fried Berg [6d Ks]
*** PRE-FLOP *** 
Titine543 folds
GTO-Mieko folds
Ertorko folds
Thequeen1205 folds
Douou calls 0.01€
Fried Berg checks
*** FLOP *** [Ah 8d 7h]
Douou bets 0.05€
Fried Berg folds
Douou collected 0.19€ from pot
*** SUMMARY ***
Total pot 0.19€ | No rake
Board: [Ah 8d 7h]
Seat 1: Douou (small blind) won 0.19€


Winamax Poker - HOLD-UP "Colorado" - HandId: #19116069-338863-1701439362 - Holdem no limit (0.01€/0.02€) - 2023/12/01 14:02:42 UTC
Table: 'Colorado' 6-max (real money) Seat #6 is the button
Seat 1: Jneb34b (0.96€)
Seat 2: Fripon_77201 (3.73€)
Seat 3: Tr0-_-L3urr3 (2.30€)
Seat 4: Fried Berg (1.22€)
Seat 5: Ertorko (2.05€)
Seat 6: KON-2-PEUTE (2€)
Hold-up to Pot: total 0.10€
*** ANTE/BLINDS ***
Jneb34b posts small blind 0.01€
Fripon_77201 posts big blind 0.02€
Dealt to Fried Berg [4c 3d]
*** PRE-FLOP *** 
Tr0-_-L3urr3 raises 0.15€ to 0.17€
Fried Berg folds
Ertorko folds
KON-2-PEUTE folds
Jneb34b folds
Fripon_77201 calls 0.15€
*** FLOP *** [8s Kh 9h]
Fripon_77201 checks
Tr0-_-L3urr3 bets 0.36€
Fripon_77201 calls 0.36€
*** TURN *** [8s Kh 9h][8d]
Fripon_77201 checks
Tr0-_-L3urr3 bets 0.94€
Fripon_77201 folds
Tr0-_-L3urr3 collected 2€ from pot
*** SUMMARY ***
Total pot 2€ | Rake 0.11€
Board: [8s Kh 9h 8d]
Seat 3: Tr0-_-L3urr3 won 2€


Winamax Poker - HOLD-UP "Colorado" - HandId: #19116069-338869-1701439366 - Holdem no limit (0.01€/0.02€) - 2023/12/01 14:02:46 UTC
Table: 'Colorado' 6-max (real money) Seat #6 is the button
Seat 1: Fried Berg (1.22€)
Seat 2: Jneb34b (0.95€)
Seat 3: LimpDoud (2.17€)
Seat 4: curiouz dje (2.20€)
Seat 5: Savab1spaser (4.11€)
Seat 6: Kaoky (3.58€)
Hold-up to Pot: total 0.10€
*** ANTE/BLINDS ***
Fried Berg posts small blind 0.01€
Jneb34b posts big blind 0.02€
Dealt to Fried Berg [5c 6s]
*** PRE-FLOP *** 
LimpDoud raises 0.02€ to 0.04€
curiouz dje calls 0.04€
Savab1spaser folds
Kaoky folds
Fried Berg folds
Jneb34b calls 0.02€
*** FLOP *** [Th 6c 8d]
Jneb34b checks
LimpDoud checks
curiouz dje checks
*** TURN *** [Th 6c 8d][8h]
Jneb34b bets 0.15€
LimpDoud folds
curiouz dje folds
Jneb34b collected 0.37€ from pot
*** SUMMARY ***
Total pot 0.37€ | Rake 0.01€
Board: [Th 6c 8d 8h]
Seat 2: Jneb34b (big blind) won 0.37€


Winamax Poker - HOLD-UP "Colorado" - HandId: #19116069-338895-1701439384 - Holdem no limit (0.01€/0.02€) - 2023/12/01 14:03:04 UTC
Table: 'Colorado' 6-max (real money) Seat #6 is the button
Seat 1: Coconutz242 (2.39€)
Seat 2: Sir21500 (0.50€)
Seat 3: Fried Berg (1.21€)
Seat 4: FreeLouisias (2.56€)
Seat 5: Erenox (1.83€)
Seat 6: Kaoky (4.25€)
*** ANTE/BLINDS ***
Coconutz242 posts small blind 0.01€
Sir21500 posts big blind 0.02€
Dealt to Fried Berg [Qs 8s]
*** PRE-FLOP *** 
Fried Berg folds
FreeLouisias folds
Erenox folds
Kaoky folds
Coconutz242 raises 0.04€ to 0.06€
Sir21500 folds
Coconutz242 collected 0.08€ from pot
*** SUMMARY ***
Total pot 0.08€ | No rake
Seat 1: Coconutz242 (small blind) won 0.08€


Winamax Poker - HOLD-UP "Colorado" - HandId: #19116069-338908-1701439390 - Holdem no limit (0.01€/0.02€) - 2023/12/01 14:03:10 UTC
Table: 'Colorado' 6-max (real money) Seat #6 is the button
Seat 1: CTMieuxAvant (0.67€)
Seat 2: Cejargordas (2€)
Seat 3: Thequeen1205 (3.70€)
Seat 4: Fried Berg (1.21€)
Seat 5: Adame199623 (2.02€)
Seat 6: kameleon73 (2€)
*** ANTE/BLINDS ***
CTMieuxAvant posts small blind 0.01€
Cejargordas posts big blind 0.02€
Dealt to Fried Berg [Jh Qd]
*** PRE-FLOP *** 
Thequeen1205 folds
Fried Berg raises 0.02€ to 0.04€
Adame199623 raises 0.16€ to 0.20€
kameleon73 folds
CTMieuxAvant folds
Cejargordas folds
Fried Berg calls 0.16€
*** FLOP *** [Jd Tc 2d]
Fried Berg checks
Adame199623 bets 0.14€
Fried Berg calls 0.14€
*** TURN *** [Jd Tc 2d][9s]
Fried Berg checks
Adame199623 bets 0.53€
Fried Berg folds
Adame199623 collected 1.17€ from pot
*** SUMMARY ***
Total pot 1.17€ | Rake 0.07€
Board: [Jd Tc 2d 9s]
Seat 5: Adame199623 won 1.17€


Winamax Poker - HOLD-UP "Colorado" - HandId: #19116069-339031-1701439460 - Holdem no limit (0.01€/0.02€) - 2023/12/01 14:04:20 UTC
Table: 'Colorado' 6-max (real money) Seat #6 is the button
Seat 1: DGG23 (0.62€)
Seat 2: Cejargordas (2.03€)
Seat 3: CTMieuxAvant (3.52€)
Seat 4: g8o8k8u (2€)
Seat 5: Stun72 (2.34€)
Seat 6: Fried Berg (0.87€)
*** ANTE/BLINDS ***
DGG23 posts small blind 0.01€
Cejargordas posts big blind 0.02€
Dealt to Fried Berg [9s Ad]
*** PRE-FLOP *** 
CTMieuxAvant folds
g8o8k8u folds
Stun72 folds
Fried Berg raises 0.02€ to 0.04€
DGG23 calls 0.03€
Cejargordas folds
*** FLOP *** [4c Jc 2s]
DGG23 checks
Fried Berg checks
*** TURN *** [4c Jc 2s][4d]
DGG23 bets 0.58€ and is all-in
Fried Berg folds
DGG23 collected 0.67€ from pot
*** SUMMARY ***
Total pot 0.67€ | Rake 0.01€
Board: [4c Jc 2s 4d]
Seat 1: DGG23 (small blind) won 0.67€


Winamax Poker - HOLD-UP "Colorado" - HandId: #19116069-339118-1701439512 - Holdem no limit (0.01€/0.02€) - 2023/12/01 14:05:12 UTC
Table: 'Colorado' 6-max (real money) Seat #6 is the button
Seat 1: toka30 (4.54€)
Seat 2: Fried Berg (0.83€)
Seat 3: CTMieuxAvant (3.06€)
Seat 4: LimpDoud (3.41€)
Seat 5: Stun72 (2.34€)
Seat 6: g8o8k8u (2.03€)
*** ANTE/BLINDS ***
toka30 posts small blind 0.01€
Fried Berg posts big blind 0.02€
Dealt to Fried Berg [2c 6d]
*** PRE-FLOP *** 
CTMieuxAvant folds
LimpDoud folds
Stun72 folds
g8o8k8u folds
toka30 raises 0.03€ to 0.05€
Fried Berg folds
toka30 collected 0.07€ from pot
*** SUMMARY ***
Total pot 0.07€ | No rake
Seat 1: toka30 (small blind) won 0.07€


Winamax Poker - HOLD-UP "Colorado" - HandId: #19116069-339130-1701439517 - Holdem no limit (0.01€/0.02€) - 2023/12/01 14:05:17 UTC
Table: 'Colorado' 6-max (real money) Seat #6 is the button
Seat 1: haouuum28 (1.65€)
Seat 2: KON-2-PEUTE (2.30€)
Seat 3: CTMieuxAvant (1.84€)
Seat 4: Coconutz242 (2.04€)
Seat 5: Fried Berg (0.81€)
Seat 6: veve 13 (0.83€)
*** ANTE/BLINDS ***
haouuum28 posts small blind 0.01€
KON-2-PEUTE posts big blind 0.02€
Dealt to Fried Berg [Jc 9c]
*** PRE-FLOP *** 
CTMieuxAvant raises 0.03€ to 0.05€
Coconutz242 folds
Fried Berg calls 0.05€
veve 13 folds
haouuum28 folds
KON-2-PEUTE calls 0.03€
*** FLOP *** [5d Kd 7c]
KON-2-PEUTE bets 0.06€
CTMieuxAvant folds
Fried Berg folds
KON-2-PEUTE collected 0.20€ from pot
*** SUMMARY ***
Total pot 0.20€ | Rake 0.02€
Board: [5d Kd 7c]
Seat 2: KON-2-PEUTE (big blind) won 0.20€


Winamax Poker - HOLD-UP "Colorado" - HandId: #19116069-339187-1701439546 - Holdem no limit (0.01€/0.02€) - 2023/12/01 14:05:46 UTC
Table: 'Colorado' 6-max (real money) Seat #6 is the button
Seat 1: Fried Berg (0.76€)
Seat 2: Fripon_77201 (3.03€)
Seat 3: Adame199623 (2€)
Seat 4: Erenox (4.80€)
Seat 5: FreeLouisias (2.92€)
Seat 6: Sirtrezze (2.08€)
*** ANTE/BLINDS ***
Fried Berg posts small blind 0.01€
Fripon_77201 posts big blind 0.02€
Dealt to Fried Berg [8d 9h]
*** PRE-FLOP *** 
Adame199623 folds
Erenox folds
FreeLouisias folds
Sirtrezze folds
Fried Berg folds
Fripon_77201 collected 0.03€ from pot
*** SUMMARY ***
Total pot 0.03€ | No rake
Seat 2: Fripon_77201 (big blind) won 0.03€


Winamax Poker - HOLD-UP "Colorado" - HandId: #19116069-339202-1701439556 - Holdem no limit (0.01€/0.02€) - 2023/12/01 14:05:56 UTC
Table: 'Colorado' 6-max (real money) Seat #6 is the button
Seat 1: KON-2-PEUTE (2.38€)
Seat 2: Falco69 (1.60€)
Seat 3: Fried Berg (0.75€)
Seat 4: Upswing11 (2.18€)
Seat 5: FreeLouisias (3.04€)
Seat 6: _Lilli Rush (1.19€)
*** ANTE/BLINDS ***
KON-2-PEUTE posts small blind 0.01€
Falco69 posts big blind 0.02€
Dealt to Fried Berg [2s Ts]
*** PRE-FLOP *** 
Fried Berg folds
Upswing11 raises 0.04€ to 0.06€
FreeLouisias folds
_Lilli Rush folds
KON-2-PEUTE folds
Falco69 folds
Upswing11 collected 0.09€ from pot
*** SUMMARY ***
Total pot 0.09€ | No rake
Seat 4: Upswing11 won 0.09€


Winamax Poker - HOLD-UP "Colorado" - HandId: #19116069-339206-1701439558 - Holdem no limit (0.01€/0.02€) - 2023/12/01 14:05:58 UTC
Table: 'Colorado' 6-max (real money) Seat #6 is the button
Seat 1: Stun72 (3.26€)
Seat 2: Kaoky (6.43€)
Seat 3: Tr0-_-L3urr3 (3.09€)
Seat 4: Binu72 (4.72€)
Seat 5: FreeLouisias (3.04€)
Seat 6: Fried Berg (0.75€)
*** ANTE/BLINDS ***
Stun72 posts small blind 0.01€
Kaoky posts big blind 0.02€
Dealt to Fried Berg [Jc Ac]
*** PRE-FLOP *** 
Tr0-_-L3urr3 folds
Binu72 folds
FreeLouisias raises 0.03€ to 0.05€
Fried Berg calls 0.05€
Stun72 folds
Kaoky folds
*** FLOP *** [4h Jd 5c]
FreeLouisias bets 0.07€
Fried Berg calls 0.07€
*** TURN *** [4h Jd 5c][6h]
FreeLouisias checks
Fried Berg checks
*** RIVER *** [4h Jd 5c 6h][8h]
FreeLouisias bets 0.19€
Fried Berg calls 0.19€
*** SHOW DOWN ***
FreeLouisias shows [Tc Jh] (One pair : Jacks)
Fried Berg shows [Jc Ac] (One pair : Jacks)
Fried Berg collected 0.58€ from pot
*** SUMMARY ***
Total pot 0.58€ | Rake 0.07€
Board: [4h Jd 5c 6h 8h]
Seat 5: FreeLouisias showed [Tc Jh] and lost with One pair : Jacks
Seat 6: Fried Berg (button) showed [Jc Ac] and won 0.58€ with One pair : Jacks


Winamax Poker - HOLD-UP "Colorado" - HandId: #19116069-339283-1701439601 - Holdem no limit (0.01€/0.02€) - 2023/12/01 14:06:41 UTC
Table: 'Colorado' 6-max (real money) Seat #6 is the button
Seat 1: Kalendula (1.09€)
Seat 2: FreeLouisias (2.73€)
Seat 3: Fried Berg (1.02€)
Seat 4: CTMieuxAvant (0.48€)
Seat 5: Jneb34b (1.04€)
Seat 6: NICO L AS 2 (3.28€)
*** ANTE/BLINDS ***
Kalendula posts small blind 0.01€
FreeLouisias posts big blind 0.02€
Dealt to Fried Berg [8d 4s]
*** PRE-FLOP *** 
Fried Berg folds
CTMieuxAvant folds
Jneb34b folds
NICO L AS 2 folds
Kalendula folds
FreeLouisias collected 0.03€ from pot
*** SUMMARY ***
Total pot 0.03€ | No rake
Seat 2: FreeLouisias (big blind) won 0.03€


Winamax Poker - HOLD-UP "Colorado" - HandId: #19116069-339291-1701439606 - Holdem no limit (0.01€/0.02€) - 2023/12/01 14:06:46 UTC
Table: 'Colorado' 6-max (real money) Seat #6 is the button
Seat 1: _ilTulipano_ (2.72€)
Seat 2: CHOPATATE-44 (4.15€)
Seat 3: Papaiah (2.21€)
Seat 4: Fried Berg (1.02€)
Seat 5: Tofini (2.29€)
Seat 6: tobytom (2.01€)
*** ANTE/BLINDS ***
_ilTulipano_ posts small blind 0.01€
CHOPATATE-44 posts big blind 0.02€
Dealt to Fried Berg [6c Tc]
*** PRE-FLOP *** 
Papaiah folds
Fried Berg folds
Tofini folds
tobytom folds
_ilTulipano_ raises 0.04€ to 0.06€
CHOPATATE-44 folds
_ilTulipano_ collected 0.08€ from pot
*** SUMMARY ***
Total pot 0.08€ | No rake
Seat 1: _ilTulipano_ (small blind) won 0.08€


Winamax Poker - HOLD-UP "Colorado" - HandId: #19116069-339296-1701439610 - Holdem no limit (0.01€/0.02€) - 2023/12/01 14:06:50 UTC
Table: 'Colorado' 6-max (real money) Seat #6 is the button
Seat 1: Coconutz242 (2.11€)
Seat 2: NICO L AS 2 (3.28€)
Seat 3: Papaiah (2.21€)
Seat 4: Ertorko (2.31€)
Seat 5: Fried Berg (1.02€)
Seat 6: LimpDoud (6€)
*** ANTE/BLINDS ***
Coconutz242 posts small blind 0.01€
NICO L AS 2 posts big blind 0.02€
Dealt to Fried Berg [7h 4s]
*** PRE-FLOP *** 
Papaiah folds
Ertorko folds
Fried Berg folds
LimpDoud folds
Coconutz242 calls 0.01€
NICO L AS 2 checks
*** FLOP *** [Ah Td 7d]
Coconutz242 checks
NICO L AS 2 bets 0.02€
Coconutz242 calls 0.02€
*** TURN *** [Ah Td 7d][Js]
Coconutz242 checks
NICO L AS 2 checks
*** RIVER *** [Ah Td 7d Js][As]
Coconutz242 checks
NICO L AS 2 bets 0.02€
Coconutz242 folds
NICO L AS 2 collected 0.09€ from pot
*** SUMMARY ***
Total pot 0.09€ | Rake 0.01€
Board: [Ah Td 7d Js As]
Seat 2: NICO L AS 2 (big blind) won 0.09€


Winamax Poker - HOLD-UP "Colorado" - HandId: #19116069-339302-1701439612 - Holdem no limit (0.01€/0.02€) - 2023/12/01 14:06:52 UTC
Table: 'Colorado' 6-max (real money) Seat #6 is the button
Seat 1: Ertorko (2.31€)
Seat 2: Fried Berg (1.02€)
Seat 3: Kaoky (4.05€)
Seat 4: Papaiah (2.21€)
Seat 5: Stun72 (3.23€)
Seat 6: LimpDoud (2.06€)
*** ANTE/BLINDS ***
Ertorko posts small blind 0.01€
Fried Berg posts big blind 0.02€
Dealt to Fried Berg [6d 3s]
*** PRE-FLOP *** 
Kaoky folds
Papaiah folds
Stun72 folds
LimpDoud raises 0.04€ to 0.06€
Ertorko calls 0.05€
Fried Berg folds
*** FLOP *** [5c 2h 8c]
Ertorko checks
LimpDoud bets 0.09€
Ertorko folds
LimpDoud collected 0.22€ from pot
*** SUMMARY ***
Total pot 0.22€ | Rake 0.01€
Board: [5c 2h 8c]
Seat 6: LimpDoud (button) won 0.22€


Winamax Poker - HOLD-UP "Colorado" - HandId: #19116069-339313-1701439618 - Holdem no limit (0.01€/0.02€) - 2023/12/01 14:06:58 UTC
Table: 'Colorado' 6-max (real money) Seat #6 is the button
Seat 1: Fried Berg (1€)
Seat 2: zozo6750 (0.36€)
Seat 3: haouuum28 (1.21€)
Seat 4: juanktyga (3.46€)
Seat 5: tobytom (2.01€)
Seat 6: Kaoky (4.05€)
*** ANTE/BLINDS ***
Fried Berg posts small blind 0.01€
zozo6750 posts big blind 0.02€
Dealt to Fried Berg [9h 2d]
*** PRE-FLOP *** 
haouuum28 raises 0.02€ to 0.04€
juanktyga folds
tobytom folds
Kaoky calls 0.04€
Fried Berg folds
zozo6750 raises 0.32€ to 0.36€ and is all-in
haouuum28 folds
Kaoky folds
zozo6750 collected 0.45€ from pot
*** SUMMARY ***
Total pot 0.45€ | No rake
Seat 2: zozo6750 (big blind) won 0.45€


Winamax Poker - HOLD-UP "Colorado" - HandId: #19116069-339317-1701439621 - Holdem no limit (0.01€/0.02€) - 2023/12/01 14:07:01 UTC
Table: 'Colorado' 6-max (real money) Seat #6 is the button
Seat 1: g8o8k8u (2.04€)
Seat 2: Tofini (2.01€)
Seat 3: Bback (2.64€)
Seat 4: curiouz dje (2.79€)
Seat 5: Adame199623 (2€)
Seat 6: Fried Berg (0.99€)
*** ANTE/BLINDS ***
g8o8k8u posts small blind 0.01€
Tofini posts big blind 0.02€
Dealt to Fried Berg [2c 4d]
*** PRE-FLOP *** 
Bback folds
curiouz dje folds
Adame199623 raises 0.06€ to 0.08€
Fried Berg folds
g8o8k8u folds
Tofini folds
Adame199623 collected 0.11€ from pot
*** SUMMARY ***
Total pot 0.11€ | No rake
Seat 5: Adame199623 won 0.11€


Winamax Poker - HOLD-UP "Colorado" - HandId: #19116069-339320-1701439623 - Holdem no limit (0.01€/0.02€) - 2023/12/01 14:07:03 UTC
Table: 'Colorado' 6-max (real money) Seat #6 is the button
Seat 1: Fried Berg (0.99€)
Seat 2: Bback (2.64€)
Seat 3: Cejargordas (2.22€)
Seat 4: loncholoncho (2.58€)
Seat 5: Trevize (3.14€)
Seat 6: Br3izh_P0k3r (2€)
*** ANTE/BLINDS ***
Fried Berg posts small blind 0.01€
Bback posts big blind 0.02€
Dealt to Fried Berg [7s 3c]
*** PRE-FLOP *** 
Cejargordas raises 0.03€ to 0.05€
loncholoncho calls 0.05€
Trevize folds
Br3izh_P0k3r calls 0.05€
Fried Berg folds
Bback folds
*** FLOP *** [Kc 3d Th]
Cejargordas checks
loncholoncho bets 0.13€
Br3izh_P0k3r folds
Cejargordas folds
loncholoncho collected 0.29€ from pot
*** SUMMARY ***
Total pot 0.29€ | Rake 0.02€
Board: [Kc 3d Th]
Seat 4: loncholoncho won 0.29€


Winamax Poker - HOLD-UP "Colorado" - HandId: #19116069-339324-1701439625 - Holdem no limit (0.01€/0.02€) - 2023/12/01 14:07:05 UTC
Table: 'Colorado' 6-max (real money) Seat #6 is the button
Seat 1: juanktyga (3.46€)
Seat 2: KKamarAAde (3.68€)
Seat 3: Fried Berg (0.98€)
Seat 4: Yondaime M (3.55€)
Seat 5: PtitDidine (2.22€)
Seat 6: Tr0-_-L3urr3 (2.84€)
*** ANTE/BLINDS ***
juanktyga posts small blind 0.01€
KKamarAAde posts big blind 0.02€
Dealt to Fried Berg [Kh Th]
*** PRE-FLOP *** 
Fried Berg raises 0.02€ to 0.04€
Yondaime M folds
PtitDidine folds
Tr0-_-L3urr3 calls 0.04€
juanktyga folds
KKamarAAde folds
*** FLOP *** [4h Jc 2d]
Fried Berg checks
Tr0-_-L3urr3 checks
*** TURN *** [4h Jc 2d][Ts]
Fried Berg checks
Tr0-_-L3urr3 checks
*** RIVER *** [4h Jc 2d Ts][Qc]
Fried Berg checks
Tr0-_-L3urr3 checks
*** SHOW DOWN ***
Tr0-_-L3urr3 shows [5s As] (High card : Ace)
Fried Berg shows [Kh Th] (One pair : Tens)
Fried Berg collected 0.10€ from pot
*** SUMMARY ***
Total pot 0.10€ | Rake 0.01€
Board: [4h Jc 2d Ts Qc]
Seat 3: Fried Berg showed [Kh Th] and won 0.10€ with One pair : Tens
Seat 6: Tr0-_-L3urr3 (button) showed [5s As] and lost with High card : Ace


Winamax Poker - HOLD-UP "Colorado" - HandId: #19116069-339400-1701439669 - Holdem no limit (0.01€/0.02€) - 2023/12/01 14:07:49 UTC
Table: 'Colorado' 6-max (real money) Seat #6 is the button
Seat 1: Coconutz242 (2.19€)
Seat 2: Cejargordas (2.16€)
Seat 3: Tr0-_-L3urr3 (2.80€)
Seat 4: Fried Berg (1.04€)
Seat 5: vuesurmer (2€)
Seat 6: curiouz dje (2.12€)
*** ANTE/BLINDS ***
Coconutz242 posts small blind 0.01€
Cejargordas posts big blind 0.02€
Dealt to Fried Berg [3s Kh]
*** PRE-FLOP *** 
Tr0-_-L3urr3 raises 0.03€ to 0.05€
Fried Berg folds
vuesurmer folds
curiouz dje folds
Coconutz242 folds
Cejargordas folds
Tr0-_-L3urr3 collected 0.08€ from pot
*** SUMMARY ***
Total pot 0.08€ | No rake
Seat 3: Tr0-_-L3urr3 won 0.08€


Winamax Poker - HOLD-UP "Colorado" - HandId: #19116069-339416-1701439678 - Holdem no limit (0.01€/0.02€) - 2023/12/01 14:07:58 UTC
Table: 'Colorado' 6-max (real money) Seat #6 is the button
Seat 1: DGG23 (0.46€)
Seat 2: Ddm8 (2€)
Seat 3: 121 (2€)
Seat 4: Tofini (2.48€)
Seat 5: Fried Berg (1.04€)
Seat 6: curiouz dje (2.73€)
*** ANTE/BLINDS ***
DGG23 posts small blind 0.01€
Ddm8 posts big blind 0.02€
Dealt to Fried Berg [4d 3h]
*** PRE-FLOP *** 
121 folds
Tofini raises 0.03€ to 0.05€
Fried Berg folds
curiouz dje folds
DGG23 folds
Ddm8 folds
Tofini collected 0.08€ from pot
*** SUMMARY ***
Total pot 0.08€ | No rake
Seat 4: Tofini won 0.08€


Winamax Poker - HOLD-UP "Colorado" - HandId: #19116069-339422-1701439680 - Holdem no limit (0.01€/0.02€) - 2023/12/01 14:08:00 UTC
Table: 'Colorado' 6-max (real money) Seat #6 is the button
Seat 1: Falco69 (1.21€)
Seat 2: Fried Berg (1.04€)
Seat 3: Adame199623 (2.34€)
Seat 4: curiouz dje (2€)
Seat 5: LimpDoud (2.13€)
Seat 6: Br3izh_P0k3r (2.03€)
*** ANTE/BLINDS ***
Falco69 posts small blind 0.01€
Fried Berg posts big blind 0.02€
Dealt to Fried Berg [As Qs]
*** PRE-FLOP *** 
Adame199623 folds
curiouz dje folds
LimpDoud folds
Br3izh_P0k3r raises 0.04€ to 0.06€
Falco69 folds
Fried Berg raises 0.12€ to 0.18€
Br3izh_P0k3r raises 0.72€ to 0.90€
Fried Berg raises 0.14€ to 1.04€ and is all-in
Br3izh_P0k3r calls 0.14€
*** FLOP *** [Th 3h 4h]
*** TURN *** [Th 3h 4h][Kd]
*** RIVER *** [Th 3h 4h Kd][Ah]
*** SHOW DOWN ***
Fried Berg shows [As Qs] (One pair : Aces)
Br3izh_P0k3r shows [Qh Qc] (Flush Ace high)
Br3izh_P0k3r collected 1.88€ from pot
*** SUMMARY ***
Total pot 1.88€ | Rake 0.21€
Board: [Th 3h 4h Kd Ah]
Seat 2: Fried Berg (big blind) showed [As Qs] and lost with One pair : Aces
Seat 6: Br3izh_P0k3r (button) showed [Qh Qc] and won 1.88€ with Flush Ace high


Winamax Poker - HOLD-UP "Colorado" - HandId: #19116069-339528-1701439752 - Holdem no limit (0.01€/0.02€) - 2023/12/01 14:09:12 UTC
Table: 'Colorado' 6-max (real money) Seat #6 is the button
Seat 1: Myriamneuf (1.12€)
Seat 2: KKamarAAde (7.15€)
Seat 3: Falco69 (1.04€)
Seat 4: Tofini (2€)
Seat 5: Thequeen1205 (3.86€)
Seat 6: Fried Berg (0.50€)
*** ANTE/BLINDS ***
Myriamneuf posts small blind 0.01€
KKamarAAde posts big blind 0.02€
Dealt to Fried Berg [Jh 9h]
*** PRE-FLOP *** 
Falco69 calls 0.02€
Tofini folds
Thequeen1205 folds
Fried Berg raises 0.04€ to 0.06€
Myriamneuf calls 0.05€
KKamarAAde folds
Falco69 calls 0.04€
*** FLOP *** [Kh 8c 9c]
Myriamneuf bets 0.07€
Falco69 folds
Fried Berg folds
Myriamneuf collected 0.25€ from pot
*** SUMMARY ***
Total pot 0.25€ | Rake 0.02€
Board: [Kh 8c 9c]
Seat 1: Myriamneuf (small blind) won 0.25€


Winamax Poker - HOLD-UP "Colorado" - HandId: #19116069-339596-1701439788 - Holdem no limit (0.01€/0.02€) - 2023/12/01 14:09:48 UTC
Table: 'Colorado' 6-max (real money) Seat #6 is the button
Seat 1: _ilTulipano_ (3.77€)
Seat 2: Tofini (2.17€)
Seat 3: Fried Berg (0.44€)
Seat 4: Br3izh_P0k3r (2.90€)
Seat 5: Cejargordas (2.05€)
Seat 6: g8o8k8u (2€)
*** ANTE/BLINDS ***
_ilTulipano_ posts small blind 0.01€
Tofini posts big blind 0.02€
Dealt to Fried Berg [4h Js]
*** PRE-FLOP *** 
Fried Berg folds
Br3izh_P0k3r folds
Cejargordas folds
g8o8k8u raises 0.04€ to 0.06€
_ilTulipano_ folds
Tofini raises 0.12€ to 0.18€
g8o8k8u folds
Tofini collected 0.25€ from pot
*** SUMMARY ***
Total pot 0.25€ | No rake
Seat 2: Tofini (big blind) won 0.25€


Winamax Poker - HOLD-UP "Colorado" - HandId: #19116069-339600-1701439791 - Holdem no limit (0.01€/0.02€) - 2023/12/01 14:09:51 UTC
Table: 'Colorado' 6-max (real money) Seat #6 is the button
Seat 1: LilRun (1.27€)
Seat 2: Cejargordas (2.05€)
Seat 3: tobytom (2.08€)
Seat 4: Stun72 (3.74€)
Seat 5: Fried Berg (0.44€)
Seat 6: JissEl1te (4.31€)
*** ANTE/BLINDS ***
LilRun posts small blind 0.01€
Cejargordas posts big blind 0.02€
Dealt to Fried Berg [Td 4h]
*** PRE-FLOP *** 
tobytom folds
Stun72 folds
Fried Berg folds
JissEl1te folds
LilRun calls 0.01€
Cejargordas checks
*** FLOP *** [2c 7h 8h]
LilRun bets 0.04€
Cejargordas folds
LilRun collected 0.08€ from pot
*** SUMMARY ***
Total pot 0.08€ | No rake
Board: [2c 7h 8h]
Seat 1: LilRun (small blind) won 0.08€


Winamax Poker - HOLD-UP "Colorado" - HandId: #19116069-339603-1701439792 - Holdem no limit (0.01€/0.02€) - 2023/12/01 14:09:52 UTC
Table: 'Colorado' 6-max (real money) Seat #6 is the button
Seat 1: widow974 (0.42€)
Seat 2: Sirtrezze (2.19€)
Seat 3: Stun72 (3.74€)
Seat 4: Fried Berg (0.44€)
Seat 5: CTMieuxAvant (1.72€)
Seat 6: tobytom (2.08€)
*** ANTE/BLINDS ***
widow974 posts small blind 0.01€
Sirtrezze posts big blind 0.02€
Dealt to Fried Berg [2s 6s]
*** PRE-FLOP *** 
Stun72 folds
Fried Berg folds
CTMieuxAvant folds
tobytom folds
widow974 folds
Sirtrezze collected 0.03€ from pot
*** SUMMARY ***
Total pot 0.03€ | No rake
Seat 2: Sirtrezze (big blind) won 0.03€


Winamax Poker - HOLD-UP "Colorado" - HandId: #19116069-339608-1701439795 - Holdem no limit (0.01€/0.02€) - 2023/12/01 14:09:55 UTC
Table: 'Colorado' 6-max (real money) Seat #6 is the button
Seat 1: Max134Max (2.05€)
Seat 2: magnumbenji (0.69€)
Seat 3: curiouz dje (2€)
Seat 4: Douou (2.61€)
Seat 5: Fried Berg (0.44€)
Seat 6: KKamarAAde (10.96€)
*** ANTE/BLINDS ***
Max134Max posts small blind 0.01€
magnumbenji posts big blind 0.02€
Dealt to Fried Berg [4d Jh]
*** PRE-FLOP *** 
curiouz dje folds
Douou folds
Fried Berg folds
KKamarAAde folds
Max134Max folds
magnumbenji collected 0.03€ from pot
*** SUMMARY ***
Total pot 0.03€ | No rake
Seat 2: magnumbenji (big blind) won 0.03€


Winamax Poker - HOLD-UP "Colorado" - HandId: #19116069-339612-1701439796 - Holdem no limit (0.01€/0.02€) - 2023/12/01 14:09:56 UTC
Table: 'Colorado' 6-max (real money) Seat #6 is the button
Seat 1: Fried Berg (0.44€)
Seat 2: Stun72 (3.74€)
Seat 3: Jneb34b (0.90€)
Seat 4: Thequeen1205 (3.91€)
Seat 5: widow974 (0.41€)
Seat 6: bastos2525 (1.90€)
*** ANTE/BLINDS ***
Fried Berg posts small blind 0.01€
Stun72 posts big blind 0.02€
Dealt to Fried Berg [Js As]
*** PRE-FLOP *** 
Jneb34b folds
Thequeen1205 folds
widow974 folds
bastos2525 raises 0.05€ to 0.07€
Fried Berg raises 0.14€ to 0.21€
Stun72 folds
bastos2525 calls 0.14€
*** FLOP *** [4d 7c Tc]
Fried Berg bets 0.15€
bastos2525 raises 0.16€ to 0.31€
Fried Berg calls 0.08€ and is all-in
*** TURN *** [4d 7c Tc][7d]
*** RIVER *** [4d 7c Tc 7d][9h]
*** SHOW DOWN ***
Fried Berg shows [Js As] (One pair : 7)
bastos2525 shows [4c Ac] (Two pairs : 7 and 4)
bastos2525 collected 0.89€ from pot
*** SUMMARY ***
Total pot 0.89€ | Rake 0.09€
Board: [4d 7c Tc 7d 9h]
Seat 1: Fried Berg (small blind) showed [Js As] and lost with One pair : 7
Seat 6: bastos2525 (button) showed [4c Ac] and won 0.89€ with Two pairs : 7 and 4


Winamax Poker - HOLD-UP "Colorado" - HandId: #19116069-339693-1701439849 - Holdem no limit (0.01€/0.02€) - 2023/12/01 14:10:49 UTC
Table: 'Colorado' 6-max (real money) Seat #6 is the button
Seat 1: Cejargordas (4.74€)
Seat 2: Critical30 (0.57€)
Seat 3: _Chloe58 (2.99€)
Seat 4: J.C Deuces.0 (3.05€)
Seat 5: JissEl1te (4.55€)
Seat 6: Fried Berg (0.50€)
*** ANTE/BLINDS ***
Cejargordas posts small blind 0.01€
Critical30 posts big blind 0.02€
Dealt to Fried Berg [Qs 4h]
*** PRE-FLOP *** 
_Chloe58 folds
J.C Deuces.0 folds
JissEl1te folds
Fried Berg folds
Cejargordas raises 0.04€ to 0.06€
Critical30 calls 0.04€
*** FLOP *** [8s 8h 3s]
Cejargordas checks
Critical30 checks
*** TURN *** [8s 8h 3s][2h]
Cejargordas checks
Critical30 checks
*** RIVER *** [8s 8h 3s 2h][7s]
Cejargordas checks
Critical30 checks
*** SHOW DOWN ***
Critical30 shows [Qh Jc] (One pair : 8)
Cejargordas shows [Kh Ah] (One pair : 8)
Cejargordas collected 0.11€ from pot
*** SUMMARY ***
Total pot 0.11€ | Rake 0.01€
Board: [8s 8h 3s 2h 7s]
Seat 1: Cejargordas (small blind) showed [Kh Ah] and won 0.11€ with One pair : 8
Seat 2: Critical30 (big blind) showed [Qh Jc] and lost with One pair : 8


Winamax Poker - HOLD-UP "Colorado" - HandId: #19116069-339704-1701439857 - Holdem no limit (0.01€/0.02€) - 2023/12/01 14:10:57 UTC
Table: 'Colorado' 6-max (real money) Seat #6 is the button
Seat 1: FreeLouisias (2.74€)
Seat 2: S-aaron24 (2€)
Seat 3: Tofini (4.38€)
Seat 4: tobytom (2.05€)
Seat 5: _Chloe58 (2.99€)
Seat 6: Fried Berg (0.50€)
*** ANTE/BLINDS ***
FreeLouisias posts small blind 0.01€
S-aaron24 posts big blind 0.02€
Dealt to Fried Berg [Td Qs]
*** PRE-FLOP *** 
Tofini folds
tobytom folds
_Chloe58 calls 0.02€
Fried Berg calls 0.02€
FreeLouisias calls 0.01€
S-aaron24 checks
*** FLOP *** [7d Kc Ad]
FreeLouisias checks
S-aaron24 checks
_Chloe58 bets 0.02€
Fried Berg calls 0.02€
FreeLouisias calls 0.02€
S-aaron24 folds
*** TURN *** [7d Kc Ad][Qc]
FreeLouisias checks
_Chloe58 bets 0.05€
Fried Berg folds
FreeLouisias calls 0.05€
*** RIVER *** [7d Kc Ad Qc][Tc]
FreeLouisias bets 0.08€
_Chloe58 calls 0.08€
*** SHOW DOWN ***
_Chloe58 shows [Jd Ah] (Straight Ace high)
FreeLouisias shows [7c 5c] (Flush King high)
FreeLouisias collected 0.36€ from pot
*** SUMMARY ***
Total pot 0.36€ | Rake 0.04€
Board: [7d Kc Ad Qc Tc]
Seat 1: FreeLouisias (small blind) showed [7c 5c] and won 0.36€ with Flush King high
Seat 5: _Chloe58 showed [Jd Ah] and lost with Straight Ace high


Winamax Poker - HOLD-UP "Colorado" - HandId: #19116069-339849-1701439938 - Holdem no limit (0.01€/0.02€) - 2023/12/01 14:12:18 UTC
Table: 'Colorado' 6-max (real money) Seat #6 is the button
Seat 1: S-aaron24 (2.59€)
Seat 2: Fried Berg (0.46€)
Seat 3: Papaiah (2.25€)
Seat 4: magnumbenji (0.66€)
Seat 5: KKamarAAde (6.64€)
Seat 6: CTMieuxAvant (3.04€)
*** ANTE/BLINDS ***
S-aaron24 posts small blind 0.01€
Fried Berg posts big blind 0.02€
Dealt to Fried Berg [Jh 4c]
*** PRE-FLOP *** 
Papaiah raises 0.04€ to 0.06€
magnumbenji folds
KKamarAAde folds
CTMieuxAvant folds
S-aaron24 folds
Fried Berg folds
Papaiah collected 0.09€ from pot
*** SUMMARY ***
Total pot 0.09€ | No rake
Seat 3: Papaiah won 0.09€


Winamax Poker - HOLD-UP "Colorado" - HandId: #19116069-339853-1701439941 - Holdem no limit (0.01€/0.02€) - 2023/12/01 14:12:21 UTC
Table: 'Colorado' 6-max (real money) Seat #6 is the button
Seat 1: Thequeen1205 (3.78€)
Seat 2: RrAaCcHhEeLl (2€)
Seat 3: Fried Berg (0.44€)
Seat 4: haouuum28 (7.10€)
Seat 5: magnumbenji (0.66€)
Seat 6: curiouz dje (2.26€)
*** ANTE/BLINDS ***
Thequeen1205 posts small blind 0.01€
RrAaCcHhEeLl posts big blind 0.02€
Dealt to Fried Berg [5h 3c]
*** PRE-FLOP *** 
Fried Berg folds
haouuum28 folds
magnumbenji folds
curiouz dje raises 0.03€ to 0.05€
Thequeen1205 folds
RrAaCcHhEeLl folds
curiouz dje collected 0.08€ from pot
*** SUMMARY ***
Total pot 0.08€ | No rake
Seat 6: curiouz dje (button) won 0.08€


Winamax Poker - HOLD-UP "Colorado" - HandId: #19116069-339856-1701439942 - Holdem no limit (0.01€/0.02€) - 2023/12/01 14:12:22 UTC
Table: 'Colorado' 6-max (real money) Seat #6 is the button
Seat 1: Adame199623 (2.01€)
Seat 2: Fried Berg (0.44€)
Seat 3: widow974 (0.20€)
Seat 4: Bback (2.41€)
Seat 5: GTO-Mieko (3.56€)
Seat 6: muespachois1 (2.36€)
*** ANTE/BLINDS ***
Adame199623 posts small blind 0.01€
Fried Berg posts big blind 0.02€
Dealt to Fried Berg [2d Jd]
*** PRE-FLOP *** 
widow974 raises 0.18€ to 0.20€ and is all-in
Bback folds
GTO-Mieko folds
muespachois1 folds
Adame199623 calls 0.19€
Fried Berg folds
*** FLOP *** [5d Jc 3h]
*** TURN *** [5d Jc 3h][4s]
*** RIVER *** [5d Jc 3h 4s][8c]
*** SHOW DOWN ***
widow974 shows [6h Ad] (High card : Ace)
Adame199623 shows [Ks Kd] (One pair : Kings)
Adame199623 collected 0.38€ from pot
*** SUMMARY ***
Total pot 0.38€ | Rake 0.04€
Board: [5d Jc 3h 4s 8c]
Seat 1: Adame199623 (small blind) showed [Ks Kd] and won 0.38€ with One pair : Kings
Seat 3: widow974 showed [6h Ad] and lost with High card : Ace


Winamax Poker - HOLD-UP "Colorado" - HandId: #19116069-339870-1701439949 - Holdem no limit (0.01€/0.02€) - 2023/12/01 14:12:29 UTC
Table: 'Colorado' 6-max (real money) Seat #6 is the button
Seat 1: Fried Berg (0.42€)
Seat 2: LimpDoud (2€)
Seat 3: SharkAKK (3.26€)
Seat 4: juanktyga (3.52€)
Seat 5: KKamarAAde (6.64€)
Seat 6: Tofini (4.25€)
*** ANTE/BLINDS ***
Fried Berg posts small blind 0.01€
LimpDoud posts big blind 0.02€
Dealt to Fried Berg [2c Jc]
*** PRE-FLOP *** 
SharkAKK calls 0.02€
juanktyga folds
KKamarAAde calls 0.02€
Tofini raises 0.09€ to 0.11€
Fried Berg folds
LimpDoud folds
SharkAKK calls 0.09€
KKamarAAde calls 0.09€
*** FLOP *** [Js 4d 2s]
SharkAKK checks
KKamarAAde checks
Tofini bets 0.13€
SharkAKK folds
KKamarAAde calls 0.13€
*** TURN *** [Js 4d 2s][Ah]
KKamarAAde checks
Tofini bets 0.40€
KKamarAAde calls 0.40€
*** RIVER *** [Js 4d 2s Ah][7h]
KKamarAAde checks
Tofini bets 0.92€
KKamarAAde folds
Tofini collected 2.20€ from pot
*** SUMMARY ***
Total pot 2.20€ | Rake 0.14€
Board: [Js 4d 2s Ah 7h]
Seat 6: Tofini (button) won 2.20€


Winamax Poker - HOLD-UP "Colorado" - HandId: #19116069-339905-1701439967 - Holdem no limit (0.01€/0.02€) - 2023/12/01 14:12:47 UTC
Table: 'Colorado' 6-max (real money) Seat #6 is the button
Seat 1: Dios unic464 (0.48€)
Seat 2: muespachois1 (2.34€)
Seat 3: CTMieuxAvant (0.79€)
Seat 4: Fried Berg (0.41€)
Seat 5: MENDOSA-31 (0.55€)
Seat 6: _ilTulipano_ (3.63€)
*** ANTE/BLINDS ***
Dios unic464 posts small blind 0.01€
muespachois1 posts big blind 0.02€
Dealt to Fried Berg [Qd 7d]
*** PRE-FLOP *** 
CTMieuxAvant folds
Fried Berg raises 0.02€ to 0.04€
MENDOSA-31 folds
_ilTulipano_ folds
Dios unic464 folds
muespachois1 folds
Fried Berg collected 0.07€ from pot
*** SUMMARY ***
Total pot 0.07€ | No rake
Seat 4: Fried Berg won 0.07€


Winamax Poker - HOLD-UP "Colorado" - HandId: #19116069-339948-1701439987 - Holdem no limit (0.01€/0.02€) - 2023/12/01 14:13:07 UTC
Table: 'Colorado' 6-max (real money) Seat #6 is the button
Seat 1: zozo6750 (0.62€)
Seat 2: RrAaCcHhEeLl (2€)
Seat 3: lefraisier (2.06€)
Seat 4: Fried Berg (0.44€)
Seat 5: Thequeen1205 (2.96€)
Seat 6: Savab1spaser (1.30€)
*** ANTE/BLINDS ***
zozo6750 posts small blind 0.01€
RrAaCcHhEeLl posts big blind 0.02€
Dealt to Fried Berg [8h Qs]
*** PRE-FLOP *** 
lefraisier raises 0.04€ to 0.06€
Fried Berg folds
Thequeen1205 folds
Savab1spaser folds
zozo6750 folds
RrAaCcHhEeLl calls 0.04€
*** FLOP *** [Ad 4h Kd]
RrAaCcHhEeLl checks
lefraisier bets 0.13€
RrAaCcHhEeLl folds
lefraisier collected 0.25€ from pot
*** SUMMARY ***
Total pot 0.25€ | Rake 0.01€
Board: [Ad 4h Kd]
Seat 3: lefraisier won 0.25€


Winamax Poker - HOLD-UP "Colorado" - HandId: #19116069-339965-1701439996 - Holdem no limit (0.01€/0.02€) - 2023/12/01 14:13:16 UTC
Table: 'Colorado' 6-max (real money) Seat #6 is the button
Seat 1: S-aaron24 (2.12€)
Seat 2: Yondaime M (3.32€)
Seat 3: yann_Lord590 (0.58€)
Seat 4: Fried Berg (0.44€)
Seat 5: Cejargordas (2€)
Seat 6: Geider8080 (1.69€)
*** ANTE/BLINDS ***
S-aaron24 posts small blind 0.01€
Yondaime M posts big blind 0.02€
Dealt to Fried Berg [Kc 8d]
*** PRE-FLOP *** 
yann_Lord590 calls 0.02€
Fried Berg folds
Cejargordas folds
Geider8080 raises 1.67€ to 1.69€ and is all-in
S-aaron24 folds
Yondaime M folds
yann_Lord590 calls 0.56€ and is all-in
*** FLOP *** [4d Jh 2d]
*** TURN *** [4d Jh 2d][Tc]
*** RIVER *** [4d Jh 2d Tc][5h]
*** SHOW DOWN ***
yann_Lord590 shows [As Ts] (One pair : Tens)
Geider8080 shows [Js Ah] (One pair : Jacks)
Geider8080 collected 2.18€ from pot
*** SUMMARY ***
Total pot 2.18€ | Rake 0.12€
Board: [4d Jh 2d Tc 5h]
Seat 3: yann_Lord590 showed [As Ts] and lost with One pair : Tens
Seat 6: Geider8080 (button) showed [Js Ah] and won 2.18€ with One pair : Jacks


Winamax Poker - HOLD-UP "Colorado" - HandId: #19116069-339975-1701440001 - Holdem no limit (0.01€/0.02€) - 2023/12/01 14:13:21 UTC
Table: 'Colorado' 6-max (real money) Seat #6 is the button
Seat 1: Kaoky (4.52€)
Seat 2: Thequeen1205 (2.96€)
Seat 3: _ilTulipano_ (10.05€)
Seat 4: Jneb34b (0.81€)
Seat 5: Fried Berg (0.44€)
Seat 6: CHOPATATE-44 (2.05€)
*** ANTE/BLINDS ***
Kaoky posts small blind 0.01€
Thequeen1205 posts big blind 0.02€
Dealt to Fried Berg [Kh 4c]
*** PRE-FLOP *** 
_ilTulipano_ folds
Jneb34b folds
Fried Berg folds
CHOPATATE-44 folds
Kaoky folds
Thequeen1205 collected 0.03€ from pot
*** SUMMARY ***
Total pot 0.03€ | No rake
Seat 2: Thequeen1205 (big blind) won 0.03€


Winamax Poker - HOLD-UP "Colorado" - HandId: #19116069-339982-1701440004 - Holdem no limit (0.01€/0.02€) - 2023/12/01 14:13:24 UTC
Table: 'Colorado' 6-max (real money) Seat #6 is the button
Seat 1: Sirtrezze (2.46€)
Seat 2: S-aaron24 (2€)
Seat 3: Obe38 (2€)
Seat 4: vegifish (3.44€)
Seat 5: Fripon_77201 (2.59€)
Seat 6: Fried Berg (0.44€)
*** ANTE/BLINDS ***
Sirtrezze posts small blind 0.01€
S-aaron24 posts big blind 0.02€
Dealt to Fried Berg [Qs 8s]
*** PRE-FLOP *** 
Obe38 folds
vegifish folds
Fripon_77201 folds
Fried Berg raises 0.02€ to 0.04€
Sirtrezze folds
S-aaron24 folds
Fried Berg collected 0.07€ from pot
*** SUMMARY ***
Total pot 0.07€ | No rake
Seat 6: Fried Berg (button) won 0.07€


Winamax Poker - HOLD-UP "Colorado" - HandId: #19116069-340014-1701440023 - Holdem no limit (0.01€/0.02€) - 2023/12/01 14:13:43 UTC
Table: 'Colorado' 6-max (real money) Seat #6 is the button
Seat 1: Max134Max (1.36€)
Seat 2: Fried Berg (0.47€)
Seat 3: vegifish (3.41€)
Seat 4: _ilTulipano_ (2.45€)
Seat 5: Wolfert (4€)
Seat 6: Kaoky (4.05€)
*** ANTE/BLINDS ***
Max134Max posts small blind 0.01€
Fried Berg posts big blind 0.02€
Dealt to Fried Berg [3c Qc]
*** PRE-FLOP *** 
vegifish folds
_ilTulipano_ raises 0.04€ to 0.06€
Wolfert calls 0.06€
Kaoky folds
Max134Max folds
Fried Berg folds
*** FLOP *** [Ah 7s Jc]
_ilTulipano_ bets 0.08€
Wolfert folds
_ilTulipano_ collected 0.21€ from pot
*** SUMMARY ***
Total pot 0.21€ | Rake 0.02€
Board: [Ah 7s Jc]
Seat 4: _ilTulipano_ won 0.21€


Winamax Poker - HOLD-UP "Colorado" - HandId: #19116069-340028-1701440033 - Holdem no limit (0.01€/0.02€) - 2023/12/01 14:13:53 UTC
Table: 'Colorado' 6-max (real money) Seat #6 is the button
Seat 1: Fried Berg (0.45€)
Seat 2: Jeje27 (1.17€)
Seat 3: LDL1 (0.43€)
Seat 4: RrAaCcHhEeLl (2€)
Seat 5: veve 13 (0.65€)
Seat 6: tobytom (2.49€)
*** ANTE/BLINDS ***
Fried Berg posts small blind 0.01€
Jeje27 posts big blind 0.02€
Dealt to Fried Berg [Tc 4c]
*** PRE-FLOP *** 
LDL1 folds
RrAaCcHhEeLl calls 0.02€
veve 13 raises 0.04€ to 0.06€
tobytom folds
Fried Berg folds
Jeje27 folds
RrAaCcHhEeLl calls 0.04€
*** FLOP *** [8c 2c Ac]
RrAaCcHhEeLl checks
veve 13 bets 0.05€
RrAaCcHhEeLl calls 0.05€
*** TURN *** [8c 2c Ac][9d]
RrAaCcHhEeLl bets 0.09€
veve 13 calls 0.09€
*** RIVER *** [8c 2c Ac 9d][Jc]
RrAaCcHhEeLl bets 0.43€
veve 13 raises 0.02€ to 0.45€ and is all-in
RrAaCcHhEeLl calls 0.02€
*** SHOW DOWN ***
RrAaCcHhEeLl shows [Ah Jh] (Two pairs : Aces and Jacks)
veve 13 shows [7h 7c] (Flush Ace high)
veve 13 collected 1.20€ from pot
*** SUMMARY ***
Total pot 1.20€ | Rake 0.13€
Board: [8c 2c Ac 9d Jc]
Seat 4: RrAaCcHhEeLl showed [Ah Jh] and lost with Two pairs : Aces and Jacks
Seat 5: veve 13 showed [7h 7c] and won 1.20€ with Flush Ace high


Winamax Poker - HOLD-UP "Colorado" - HandId: #19116069-340035-1701440036 - Holdem no limit (0.01€/0.02€) - 2023/12/01 14:13:56 UTC
Table: 'Colorado' 6-max (real money) Seat #6 is the button
Seat 1: Qwark13850 (3.47€)
Seat 2: Tofini (2.35€)
Seat 3: Fried Berg (0.44€)
Seat 4: Cejargordas (2.01€)
Seat 5: Max134Max (1.35€)
Seat 6: Thequeen1205 (5.44€)
*** ANTE/BLINDS ***
Qwark13850 posts small blind 0.01€
Tofini posts big blind 0.02€
Dealt to Fried Berg [5c 6d]
*** PRE-FLOP *** 
Fried Berg folds
Cejargordas folds
Max134Max folds
Thequeen1205 folds
Qwark13850 raises 0.04€ to 0.06€
Tofini folds
Qwark13850 collected 0.08€ from pot
*** SUMMARY ***
Total pot 0.08€ | No rake
Seat 1: Qwark13850 (small blind) won 0.08€


Winamax Poker - HOLD-UP "Colorado" - HandId: #19116069-340038-1701440038 - Holdem no limit (0.01€/0.02€) - 2023/12/01 14:13:58 UTC
Table: 'Colorado' 6-max (real money) Seat #6 is the button
Seat 1: Adame199623 (2€)
Seat 2: Max134Max (1.35€)
Seat 3: DGG23 (0.11€)
Seat 4: SashaTDouss (2.07€)
Seat 5: Fried Berg (0.44€)
Seat 6: RamottttoTW (2.03€)
*** ANTE/BLINDS ***
Adame199623 posts small blind 0.01€
Max134Max posts big blind 0.02€
Dealt to Fried Berg [Js 5h]
*** PRE-FLOP *** 
DGG23 folds
SashaTDouss folds
Fried Berg folds
RamottttoTW folds
Adame199623 folds
Max134Max collected 0.03€ from pot
*** SUMMARY ***
Total pot 0.03€ | No rake
Seat 2: Max134Max (big blind) won 0.03€


Winamax Poker - HOLD-UP "Colorado" - HandId: #19116069-340041-1701440039 - Holdem no limit (0.01€/0.02€) - 2023/12/01 14:13:59 UTC
Table: 'Colorado' 6-max (real money) Seat #6 is the button
Seat 1: totomax22 (3.35€)
Seat 2: Cejargordas (5.02€)
Seat 3: Adame199623 (2€)
Seat 4: Fried Berg (0.44€)
Seat 5: Geider8080 (2.18€)
Seat 6: Fripon_77201 (2€)
*** ANTE/BLINDS ***
totomax22 posts small blind 0.01€
Cejargordas posts big blind 0.02€
Dealt to Fried Berg [8d 9h]
*** PRE-FLOP *** 
Adame199623 folds
Fried Berg folds
Geider8080 folds
Fripon_77201 raises 0.04€ to 0.06€
totomax22 folds
Cejargordas folds
Fripon_77201 collected 0.09€ from pot
*** SUMMARY ***
Total pot 0.09€ | No rake
Seat 6: Fripon_77201 (button) won 0.09€


Winamax Poker - HOLD-UP "Colorado" - HandId: #19116069-340050-1701440044 - Holdem no limit (0.01€/0.02€) - 2023/12/01 14:14:04 UTC
Table: 'Colorado' 6-max (real money) Seat #6 is the button
Seat 1: Adame199623 (3.59€)
Seat 2: LilRun (1.99€)
Seat 3: Dios unic464 (0.42€)
Seat 4: Puma24644584 (2.10€)
Seat 5: juanktyga (2.27€)
Seat 6: Fried Berg (0.44€)
*** ANTE/BLINDS ***
Adame199623 posts small blind 0.01€
LilRun posts big blind 0.02€
Dealt to Fried Berg [Jh 3d]
*** PRE-FLOP *** 
Dios unic464 folds
Puma24644584 raises 0.03€ to 0.05€
juanktyga folds
Fried Berg folds
Adame199623 folds
LilRun folds
Puma24644584 collected 0.08€ from pot
*** SUMMARY ***
Total pot 0.08€ | No rake
Seat 4: Puma24644584 won 0.08€


Winamax Poker - HOLD-UP "Colorado" - HandId: #19116069-340055-1701440047 - Holdem no limit (0.01€/0.02€) - 2023/12/01 14:14:07 UTC
Table: 'Colorado' 6-max (real money) Seat #6 is the button
Seat 1: RamottttoTW (2.10€)
Seat 2: SashaTDouss (2.07€)
Seat 3: Fried Berg (0.44€)
Seat 4: Qwark13850 (3.49€)
Seat 5: Dios unic464 (0.42€)
Seat 6: Thequeen1205 (3.79€)
*** ANTE/BLINDS ***
RamottttoTW posts small blind 0.01€
SashaTDouss posts big blind 0.02€
Dealt to Fried Berg [7s Jd]
*** PRE-FLOP *** 
Fried Berg folds
Qwark13850 folds
Dios unic464 folds
Thequeen1205 raises 0.02€ to 0.04€
RamottttoTW folds
SashaTDouss raises 0.12€ to 0.16€
Thequeen1205 folds
SashaTDouss collected 0.21€ from pot
*** SUMMARY ***
Total pot 0.21€ | No rake
Seat 2: SashaTDouss (big blind) won 0.21€


Winamax Poker - HOLD-UP "Colorado" - HandId: #19116069-340061-1701440050 - Holdem no limit (0.01€/0.02€) - 2023/12/01 14:14:10 UTC
Table: 'Colorado' 6-max (real money) Seat #6 is the button
Seat 1: PtitDidine (1.70€)
Seat 2: Fried Berg (0.44€)
Seat 3: LimpDoud (2.50€)
Seat 4: DGG23 (0.11€)
Seat 5: Adame199623 (3.58€)
Seat 6: tobytom (2.49€)
*** ANTE/BLINDS ***
PtitDidine posts small blind 0.01€
Fried Berg posts big blind 0.02€
Dealt to Fried Berg [Ad 3h]
*** PRE-FLOP *** 
LimpDoud folds
DGG23 folds
Adame199623 folds
tobytom folds
PtitDidine calls 0.01€
Fried Berg checks
*** FLOP *** [2s Qc 9h]
PtitDidine checks
Fried Berg checks
*** TURN *** [2s Qc 9h][6h]
PtitDidine checks
Fried Berg checks
*** RIVER *** [2s Qc 9h 6h][Td]
PtitDidine checks
Fried Berg checks
*** SHOW DOWN ***
PtitDidine shows [4h 5h] (High card : Queen)
Fried Berg shows [Ad 3h] (High card : Ace)
Fried Berg collected 0.04€ from pot
*** SUMMARY ***
Total pot 0.04€ | No rake
Board: [2s Qc 9h 6h Td]
Seat 1: PtitDidine (small blind) showed [4h 5h] and lost with High card : Queen
Seat 2: Fried Berg (big blind) showed [Ad 3h] and won 0.04€ with High card : Ace


Winamax Poker - HOLD-UP "Colorado" - HandId: #19116069-340105-1701440077 - Holdem no limit (0.01€/0.02€) - 2023/12/01 14:14:37 UTC
Table: 'Colorado' 6-max (real money) Seat #6 is the button
Seat 1: S-aaron24 (2.52€)
Seat 2: Kalendula (1.27€)
Seat 3: PtitDidine (1.68€)
Seat 4: Cejargordas (2.06€)
Seat 5: Fried Berg (0.46€)
Seat 6: CTMieuxAvant (2.99€)
*** ANTE/BLINDS ***
S-aaron24 posts small blind 0.01€
Kalendula posts big blind 0.02€
Dealt to Fried Berg [Js 2d]
*** PRE-FLOP *** 
PtitDidine calls 0.02€
Cejargordas folds
Fried Berg folds
CTMieuxAvant folds
S-aaron24 folds
Kalendula raises 1.25€ to 1.27€ and is all-in
PtitDidine calls 1.25€
*** FLOP *** [Td 8s 8h]
*** TURN *** [Td 8s 8h][3s]
*** RIVER *** [Td 8s 8h 3s][6c]
*** SHOW DOWN ***
PtitDidine shows [7h 7d] (Two pairs : 8 and 7)
Kalendula shows [Kc Kh] (Two pairs : Kings and 8)
Kalendula collected 2.29€ from pot
*** SUMMARY ***
Total pot 2.29€ | Rake 0.26€
Board: [Td 8s 8h 3s 6c]
Seat 2: Kalendula (big blind) showed [Kc Kh] and won 2.29€ with Two pairs : Kings and 8
Seat 3: PtitDidine showed [7h 7d] and lost with Two pairs : 8 and 7


Winamax Poker - HOLD-UP "Colorado" - HandId: #19116069-340109-1701440079 - Holdem no limit (0.01€/0.02€) - 2023/12/01 14:14:39 UTC
Table: 'Colorado' 6-max (real money) Seat #6 is the button
Seat 1: Thequeen1205 (3.74€)
Seat 2: Fried Berg (0.46€)
Seat 3: Adame199623 (2€)
Seat 4: LOURIMI (1.97€)
Seat 5: Thierryf52 (1.09€)
Seat 6: gil95100 (1.54€)
*** ANTE/BLINDS ***
Thequeen1205 posts small blind 0.01€
Fried Berg posts big blind 0.02€
Dealt to Fried Berg [Kh Td]
*** PRE-FLOP *** 
Adame199623 folds
LOURIMI folds
Thierryf52 raises 0.02€ to 0.04€
gil95100 calls 0.04€
Thequeen1205 folds
Fried Berg folds
*** FLOP *** [Kd Tc 7s]
Thierryf52 bets 1.05€ and is all-in
gil95100 folds
Thierryf52 collected 1.15€ from pot
*** SUMMARY ***
Total pot 1.15€ | Rake 0.01€
Board: [Kd Tc 7s]
Seat 5: Thierryf52 won 1.15€


Winamax Poker - HOLD-UP "Colorado" - HandId: #19116069-340128-1701440090 - Holdem no limit (0.01€/0.02€) - 2023/12/01 14:14:50 UTC
Table: 'Colorado' 6-max (real money) Seat #6 is the button
Seat 1: Fried Berg (0.44€)
Seat 2: Cejargordas (2.06€)
Seat 3: Upswing11 (2€)
Seat 4: zozo6750 (0.56€)
Seat 5: g8o8k8u (2€)
Seat 6: LimpDoud (3.30€)
*** ANTE/BLINDS ***
Fried Berg posts small blind 0.01€
Cejargordas posts big blind 0.02€
Dealt to Fried Berg [9c 8c]
*** PRE-FLOP *** 
Upswing11 folds
zozo6750 raises 0.03€ to 0.05€
g8o8k8u folds
LimpDoud folds
Fried Berg raises 0.03€ to 0.08€
Cejargordas folds
zozo6750 raises 0.48€ to 0.56€ and is all-in
Fried Berg calls 0.36€ and is all-in
*** FLOP *** [4c 4s 3c]
*** TURN *** [4c 4s 3c][4h]
*** RIVER *** [4c 4s 3c 4h][7s]
*** SHOW DOWN ***
Fried Berg shows [9c 8c] (Trips of 4)
zozo6750 shows [Td Ad] (Trips of 4)
zozo6750 collected 0.93€ from pot
*** SUMMARY ***
Total pot 0.93€ | Rake 0.09€
Board: [4c 4s 3c 4h 7s]
Seat 1: Fried Berg (small blind) showed [9c 8c] and lost with Trips of 4
Seat 4: zozo6750 showed [Td Ad] and won 0.93€ with Trips of 4


Winamax Poker - HOLD-UP "Colorado" - HandId: #19116069-340223-1701440144 - Holdem no limit (0.01€/0.02€) - 2023/12/01 14:15:44 UTC
Table: 'Colorado' 6-max (real money) Seat #6 is the button
Seat 1: CTMieuxAvant (3.17€)
Seat 2: sam.rio (0.50€)
Seat 3: AMORFOU (2.01€)
Seat 4: KKamarAAde (3.38€)
Seat 5: Tofini (2.27€)
Seat 6: Fried Berg (0.50€)
Hold-up to Pot: total 0.20€
*** ANTE/BLINDS ***
CTMieuxAvant posts small blind 0.01€
sam.rio posts big blind 0.02€
Dealt to Fried Berg [As Kh]
*** PRE-FLOP *** 
AMORFOU folds
KKamarAAde folds
Tofini raises 0.02€ to 0.04€
Fried Berg raises 0.46€ to 0.50€ and is all-in
CTMieuxAvant folds
sam.rio folds
Tofini folds
Fried Berg collected 0.77€ from pot
*** SUMMARY ***
Total pot 0.77€ | No rake
Seat 6: Fried Berg (button) won 0.77€


Winamax Poker - HOLD-UP "Colorado" - HandId: #19116069-340277-1701440176 - Holdem no limit (0.01€/0.02€) - 2023/12/01 14:16:16 UTC
Table: 'Colorado' 6-max (real money) Seat #6 is the button
Seat 1: Binu72 (4.73€)
Seat 2: Tofini (2.23€)
Seat 3: Fried Berg (0.77€)
Seat 4: DGG23 (0.53€)
Seat 5: TuMensTanT (2.71€)
Seat 6: curiouz dje (2.30€)
*** ANTE/BLINDS ***
Binu72 posts small blind 0.01€
Tofini posts big blind 0.02€
Dealt to Fried Berg [Ts As]
*** PRE-FLOP *** 
Fried Berg raises 0.04€ to 0.06€
DGG23 folds
TuMensTanT folds
curiouz dje folds
Binu72 folds
Tofini folds
Fried Berg collected 0.09€ from pot
*** SUMMARY ***
Total pot 0.09€ | No rake
Seat 3: Fried Berg won 0.09€


Winamax Poker - HOLD-UP "Colorado" - HandId: #19116069-340307-1701440195 - Holdem no limit (0.01€/0.02€) - 2023/12/01 14:16:35 UTC
Table: 'Colorado' 6-max (real money) Seat #6 is the button
Seat 1: Fried Berg (0.80€)
Seat 2: juanktyga (2.38€)
Seat 3: CTMieuxAvant (3.16€)
Seat 4: Stun72 (2.03€)
Seat 5: Yondaime M (4.94€)
Seat 6: lefraisier (2.14€)
*** ANTE/BLINDS ***
Fried Berg posts small blind 0.01€
juanktyga posts big blind 0.02€
Dealt to Fried Berg [Tc 2d]
*** PRE-FLOP *** 
CTMieuxAvant folds
Stun72 folds
Yondaime M folds
lefraisier folds
Fried Berg folds
juanktyga collected 0.03€ from pot
*** SUMMARY ***
Total pot 0.03€ | No rake
Seat 2: juanktyga (big blind) won 0.03€


Winamax Poker - HOLD-UP "Colorado" - HandId: #19116069-340312-1701440198 - Holdem no limit (0.01€/0.02€) - 2023/12/01 14:16:38 UTC
Table: 'Colorado' 6-max (real money) Seat #6 is the button
Seat 1: SharkAKK (2.98€)
Seat 2: Bback (2.24€)
Seat 3: LimpDoud (2.10€)
Seat 4: Kaoky (4.67€)
Seat 5: Fried Berg (0.79€)
Seat 6: Yondaime M (3.47€)
*** ANTE/BLINDS ***
SharkAKK posts small blind 0.01€
Bback posts big blind 0.02€
Dealt to Fried Berg [As Jd]
*** PRE-FLOP *** 
LimpDoud raises 0.03€ to 0.05€
Kaoky raises 0.10€ to 0.15€
Fried Berg raises 0.64€ to 0.79€ and is all-in
Yondaime M folds
SharkAKK folds
Bback folds
LimpDoud folds
Kaoky calls 0.64€
*** FLOP *** [6c Ac Th]
*** TURN *** [6c Ac Th][5s]
*** RIVER *** [6c Ac Th 5s][Ah]
*** SHOW DOWN ***
Kaoky shows [Ks Kh] (Two pairs : Aces and Kings)
Fried Berg shows [As Jd] (Trips of Aces)
Fried Berg collected 1.49€ from pot
*** SUMMARY ***
Total pot 1.49€ | Rake 0.17€
Board: [6c Ac Th 5s Ah]
Seat 4: Kaoky showed [Ks Kh] and lost with Two pairs : Aces and Kings
Seat 5: Fried Berg showed [As Jd] and won 1.49€ with Trips of Aces


Winamax Poker - HOLD-UP "Colorado" - HandId: #19116069-340373-1701440231 - Holdem no limit (0.01€/0.02€) - 2023/12/01 14:17:11 UTC
Table: 'Colorado' 6-max (real money) Seat #6 is the button
Seat 1: Bback (2.22€)
Seat 2: Toon89 (1.56€)
Seat 3: Cejargordas (2.01€)
Seat 4: Fried Berg (1.49€)
Seat 5: CTMieuxAvant (2.62€)
Seat 6: Dios unic464 (0.50€)
*** ANTE/BLINDS ***
Bback posts small blind 0.01€
Toon89 posts big blind 0.02€
Dealt to Fried Berg [9h 7c]
*** PRE-FLOP *** 
Cejargordas folds
Fried Berg folds
CTMieuxAvant folds
Dios unic464 folds
Bback raises 0.03€ to 0.05€
Toon89 calls 0.03€
*** FLOP *** [8d Kd 9d]
Bback checks
Toon89 checks
*** TURN *** [8d Kd 9d][7d]
Bback bets 0.05€
Toon89 folds
Bback collected 0.14€ from pot
*** SUMMARY ***
Total pot 0.14€ | Rake 0.01€
Board: [8d Kd 9d 7d]
Seat 1: Bback (small blind) won 0.14€


Winamax Poker - HOLD-UP "Colorado" - HandId: #19116069-340381-1701440234 - Holdem no limit (0.01€/0.02€) - 2023/12/01 14:17:14 UTC
Table: 'Colorado' 6-max (real money) Seat #6 is the button
Seat 1: gil95100 (1.43€)
Seat 2: El Paellas (0.50€)
Seat 3: Fried Berg (1.49€)
Seat 4: curiouz dje (2.01€)
Seat 5: CTMieuxAvant (3.18€)
Seat 6: J.C Deuces.0 (2.41€)
*** ANTE/BLINDS ***
gil95100 posts small blind 0.01€
El Paellas posts big blind 0.02€
Dealt to Fried Berg [Ts Qd]
*** PRE-FLOP *** 
Fried Berg folds
curiouz dje folds
CTMieuxAvant folds
J.C Deuces.0 folds
gil95100 raises 0.02€ to 0.04€
El Paellas folds
gil95100 collected 0.06€ from pot
*** SUMMARY ***
Total pot 0.06€ | No rake
Seat 1: gil95100 (small blind) won 0.06€


Winamax Poker - HOLD-UP "Colorado" - HandId: #19116069-340390-1701440241 - Holdem no limit (0.01€/0.02€) - 2023/12/01 14:17:21 UTC
Table: 'Colorado' 6-max (real money) Seat #6 is the button
Seat 1: CTMieuxAvant (3.18€)
Seat 2: Fried Berg (1.49€)
Seat 3: curiouz dje (2.01€)
Seat 4: Thequeen1205 (3.68€)
Seat 5: Adame199623 (2€)
Seat 6: Tyza.Davz (3.16€)
*** ANTE/BLINDS ***
CTMieuxAvant posts small blind 0.01€
Fried Berg posts big blind 0.02€
Dealt to Fried Berg [Jd 9d]
*** PRE-FLOP *** 
curiouz dje folds
Thequeen1205 folds
Adame199623 folds
Tyza.Davz folds
CTMieuxAvant folds
Fried Berg collected 0.03€ from pot
*** SUMMARY ***
Total pot 0.03€ | No rake
Seat 2: Fried Berg (big blind) won 0.03€


Winamax Poker - HOLD-UP "Colorado" - HandId: #19116069-340404-1701440249 - Holdem no limit (0.01€/0.02€) - 2023/12/01 14:17:29 UTC
Table: 'Colorado' 6-max (real money) Seat #6 is the button
Seat 1: tobytom (3.38€)
Seat 2: GTO-Mieko (4.11€)
Seat 3: rakefab (1.76€)
Seat 4: Stun72 (2€)
Seat 5: Fried Berg (1.50€)
Seat 6: RrAaCcHhEeLl (2€)
*** ANTE/BLINDS ***
tobytom posts small blind 0.01€
GTO-Mieko posts big blind 0.02€
Dealt to Fried Berg [9s 8s]
*** PRE-FLOP *** 
rakefab folds
Stun72 folds
Fried Berg raises 0.02€ to 0.04€
RrAaCcHhEeLl folds
tobytom folds
GTO-Mieko calls 0.02€
*** FLOP *** [Jc 6h Kh]
GTO-Mieko checks
Fried Berg checks
*** TURN *** [Jc 6h Kh][4d]
GTO-Mieko bets 0.06€
Fried Berg folds
GTO-Mieko collected 0.14€ from pot
*** SUMMARY ***
Total pot 0.14€ | Rake 0.01€
Board: [Jc 6h Kh 4d]
Seat 2: GTO-Mieko (big blind) won 0.14€


Winamax Poker - HOLD-UP "Colorado" - HandId: #19116069-340448-1701440274 - Holdem no limit (0.01€/0.02€) - 2023/12/01 14:17:54 UTC
Table: 'Colorado' 6-max (real money) Seat #6 is the button
Seat 1: DGG23 (0.54€)
Seat 2: KKamarAAde (2.30€)
Seat 3: Eytrewq (1.63€)
Seat 4: Br3izh_P0k3r (2€)
Seat 5: Fried Berg (1.46€)
Seat 6: El Paellas (0.50€)
*** ANTE/BLINDS ***
DGG23 posts small blind 0.01€
KKamarAAde posts big blind 0.02€
Dealt to Fried Berg [9h 3d]
*** PRE-FLOP *** 
Eytrewq folds
Br3izh_P0k3r raises 0.04€ to 0.06€
Fried Berg folds
El Paellas folds
DGG23 folds
KKamarAAde folds
Br3izh_P0k3r collected 0.09€ from pot
*** SUMMARY ***
Total pot 0.09€ | No rake
Seat 4: Br3izh_P0k3r won 0.09€


Winamax Poker - HOLD-UP "Colorado" - HandId: #19116069-340461-1701440279 - Holdem no limit (0.01€/0.02€) - 2023/12/01 14:17:59 UTC
Table: 'Colorado' 6-max (real money) Seat #6 is the button
Seat 1: Fried Berg (1.46€)
Seat 2: Stun72 (2.03€)
Seat 3: Kaoky (3.85€)
Seat 4: Tofini (2.84€)
Seat 5: kameleon73 (4.22€)
Seat 6: Fripon_77201 (2.18€)
*** ANTE/BLINDS ***
Fried Berg posts small blind 0.01€
Stun72 posts big blind 0.02€
Dealt to Fried Berg [Jh 5s]
*** PRE-FLOP *** 
Kaoky folds
Tofini folds
kameleon73 folds
Fripon_77201 folds
Fried Berg folds
Stun72 collected 0.03€ from pot
*** SUMMARY ***
Total pot 0.03€ | No rake
Seat 2: Stun72 (big blind) won 0.03€


Winamax Poker - HOLD-UP "Colorado" - HandId: #19116069-340474-1701440285 - Holdem no limit (0.01€/0.02€) - 2023/12/01 14:18:05 UTC
Table: 'Colorado' 6-max (real money) Seat #6 is the button
Seat 1: tobytom (3.41€)
Seat 2: Thequeen1205 (4.21€)
Seat 3: Fried Berg (1.45€)
Seat 4: Eytrewq (1.61€)
Seat 5: 164984084 (2.19€)
Seat 6: El Paellas (0.50€)
*** ANTE/BLINDS ***
tobytom posts small blind 0.01€
Thequeen1205 posts big blind 0.02€
Dealt to Fried Berg [4c Ts]
*** PRE-FLOP *** 
Fried Berg folds
Eytrewq folds
164984084 folds
El Paellas raises 0.03€ to 0.05€
tobytom folds
Thequeen1205 folds
El Paellas collected 0.08€ from pot
*** SUMMARY ***
Total pot 0.08€ | No rake
Seat 6: El Paellas (button) won 0.08€


Winamax Poker - HOLD-UP "Colorado" - HandId: #19116069-340485-1701440291 - Holdem no limit (0.01€/0.02€) - 2023/12/01 14:18:11 UTC
Table: 'Colorado' 6-max (real money) Seat #6 is the button
Seat 1: Fried Berg (1.45€)
Seat 2: MrFlash9 (2€)
Seat 3: vuesurmer (2.15€)
Seat 4: Cejargordas (2.21€)
Seat 5: Ewynner (2€)
Seat 6: Sirtrezze (2.14€)
*** ANTE/BLINDS ***
Fried Berg posts small blind 0.01€
MrFlash9 posts big blind 0.02€
Dealt to Fried Berg [Js 2d]
*** PRE-FLOP *** 
vuesurmer folds
Cejargordas folds
Ewynner folds
Sirtrezze raises 0.02€ to 0.04€
Fried Berg folds
MrFlash9 folds
Sirtrezze collected 0.07€ from pot
*** SUMMARY ***
Total pot 0.07€ | No rake
Seat 6: Sirtrezze (button) won 0.07€


Winamax Poker - HOLD-UP "Colorado" - HandId: #19116069-340489-1701440293 - Holdem no limit (0.01€/0.02€) - 2023/12/01 14:18:13 UTC
Table: 'Colorado' 6-max (real money) Seat #6 is the button
Seat 1: Papaiah (2.35€)
Seat 2: Fried Berg (1.44€)
Seat 3: KKamarAAde (8.03€)
Seat 4: vuesurmer (2.15€)
Seat 5: 121 (4.03€)
Seat 6: RamottttoTW (2.44€)
*** ANTE/BLINDS ***
Papaiah posts small blind 0.01€
Fried Berg posts big blind 0.02€
Dealt to Fried Berg [3s Td]
*** PRE-FLOP *** 
KKamarAAde folds
vuesurmer folds
121 raises 0.04€ to 0.06€
RamottttoTW folds
Papaiah folds
Fried Berg folds
121 collected 0.09€ from pot
*** SUMMARY ***
Total pot 0.09€ | No rake
Seat 5: 121 won 0.09€


Winamax Poker - HOLD-UP "Colorado" - HandId: #19116069-340504-1701440303 - Holdem no limit (0.01€/0.02€) - 2023/12/01 14:18:23 UTC
Table: 'Colorado' 6-max (real money) Seat #6 is the button
Seat 1: Adame199623 (2€)
Seat 2: DGG23 (0.38€)
Seat 3: Binu72 (4.66€)
Seat 4: Fried Berg (1.42€)
Seat 5: Papaiah (2.63€)
Seat 6: vuesurmer (2.15€)
*** ANTE/BLINDS ***
Adame199623 posts small blind 0.01€
DGG23 posts big blind 0.02€
Dealt to Fried Berg [2d Jc]
*** PRE-FLOP *** 
Binu72 folds
Fried Berg folds
Papaiah raises 0.04€ to 0.06€
vuesurmer folds
Adame199623 folds
DGG23 calls 0.04€
*** FLOP *** [4s 3s 3c]
DGG23 checks
Papaiah bets 0.07€
DGG23 calls 0.07€
*** TURN *** [4s 3s 3c][Qh]
DGG23 checks
Papaiah checks
*** RIVER *** [4s 3s 3c Qh][2c]
DGG23 checks
Papaiah checks
*** SHOW DOWN ***
Papaiah shows [Td Js] (One pair : 3)
DGG23 shows [Jd 4d] (Two pairs : 4 and 3)
DGG23 collected 0.24€ from pot
*** SUMMARY ***
Total pot 0.24€ | Rake 0.03€
Board: [4s 3s 3c Qh 2c]
Seat 2: DGG23 (big blind) showed [Jd 4d] and won 0.24€ with Two pairs : 4 and 3
Seat 5: Papaiah showed [Td Js] and lost with One pair : 3


Winamax Poker - HOLD-UP "Colorado" - HandId: #19116069-340508-1701440305 - Holdem no limit (0.01€/0.02€) - 2023/12/01 14:18:25 UTC
Table: 'Colorado' 6-max (real money) Seat #6 is the button
Seat 1: Kaoky (4.11€)
Seat 2: Stun72 (2.48€)
Seat 3: RamottttoTW (2.28€)
Seat 4: rakefab (2.46€)
Seat 5: Fried Berg (1.42€)
Seat 6: strada2012 (2.27€)
*** ANTE/BLINDS ***
Kaoky posts small blind 0.01€
Stun72 posts big blind 0.02€
Dealt to Fried Berg [2c 3c]
*** PRE-FLOP *** 
RamottttoTW folds
rakefab folds
Fried Berg raises 0.02€ to 0.04€
strada2012 folds
Kaoky folds
Stun72 folds
Fried Berg collected 0.07€ from pot
*** SUMMARY ***
Total pot 0.07€ | No rake
Seat 5: Fried Berg won 0.07€


Winamax Poker - HOLD-UP "Colorado" - HandId: #19116069-340531-1701440316 - Holdem no limit (0.01€/0.02€) - 2023/12/01 14:18:36 UTC
Table: 'Colorado' 6-max (real money) Seat #6 is the button
Seat 1: Fried Berg (1.45€)
Seat 2: Marvinx1 (2.65€)
Seat 3: Bback (2.18€)
Seat 4: 121 (3.05€)
Seat 5: toka30 (2.03€)
Seat 6: ElasticSkyX (1.17€)
*** ANTE/BLINDS ***
Fried Berg posts small blind 0.01€
Marvinx1 posts big blind 0.02€
Dealt to Fried Berg [Kc 7d]
*** PRE-FLOP *** 
Bback folds
121 folds
toka30 folds
ElasticSkyX folds
Fried Berg folds
Marvinx1 collected 0.03€ from pot
*** SUMMARY ***
Total pot 0.03€ | No rake
Seat 2: Marvinx1 (big blind) won 0.03€


Winamax Poker - HOLD-UP "Colorado" - HandId: #19116069-340564-1701440334 - Holdem no limit (0.01€/0.02€) - 2023/12/01 14:18:54 UTC
Table: 'Colorado' 6-max (real money) Seat #6 is the button
Seat 1: Kalendula (0.41€)
Seat 2: Binu72 (4.72€)
Seat 3: Stun72 (2.48€)
Seat 4: Fried Berg (1.44€)
Seat 5: El Paellas (0.50€)
Seat 6: zozo6750 (2.61€)
*** ANTE/BLINDS ***
Kalendula posts small blind 0.01€
Binu72 posts big blind 0.02€
Dealt to Fried Berg [4s 3h]
*** PRE-FLOP *** 
Stun72 folds
Fried Berg folds
El Paellas folds
zozo6750 folds
Kalendula raises 0.39€ to 0.41€ and is all-in
Binu72 folds
Kalendula collected 0.43€ from pot
*** SUMMARY ***
Total pot 0.43€ | No rake
Seat 1: Kalendula (small blind) won 0.43€


Winamax Poker - HOLD-UP "Colorado" - HandId: #19116069-340568-1701440336 - Holdem no limit (0.01€/0.02€) - 2023/12/01 14:18:56 UTC
Table: 'Colorado' 6-max (real money) Seat #6 is the button
Seat 1: Puma24644584 (1.78€)
Seat 2: Stun72 (2.48€)
Seat 3: Prudempoker (1.33€)
Seat 4: Yondaime M (3.46€)
Seat 5: Hilare_26070 (1.43€)
Seat 6: Fried Berg (1.44€)
*** ANTE/BLINDS ***
Puma24644584 posts small blind 0.01€
Stun72 posts big blind 0.02€
Dealt to Fried Berg [8d 7d]
*** PRE-FLOP *** 
Prudempoker raises 0.04€ to 0.06€
Yondaime M folds
Hilare_26070 raises 1.37€ to 1.43€ and is all-in
Fried Berg folds
Puma24644584 folds
Stun72 folds
Prudempoker folds
Hilare_26070 collected 1.52€ from pot
*** SUMMARY ***
Total pot 1.52€ | No rake
Seat 5: Hilare_26070 won 1.52€


Winamax Poker - HOLD-UP "Colorado" - HandId: #19116069-340602-1701440354 - Holdem no limit (0.01€/0.02€) - 2023/12/01 14:19:14 UTC
Table: 'Colorado' 6-max (real money) Seat #6 is the button
Seat 1: Tr0-_-L3urr3 (2.72€)
Seat 2: RamottttoTW (2.25€)
Seat 3: Fried Berg (1.44€)
Seat 4: tobytom (2.48€)
Seat 5: curiouz dje (2€)
Seat 6: Falco69 (0.49€)
*** ANTE/BLINDS ***
Tr0-_-L3urr3 posts small blind 0.01€
RamottttoTW posts big blind 0.02€
Dealt to Fried Berg [4d 5d]
*** PRE-FLOP *** 
Fried Berg raises 0.02€ to 0.04€
tobytom folds
curiouz dje folds
Falco69 folds
Tr0-_-L3urr3 folds
RamottttoTW folds
Fried Berg collected 0.07€ from pot
*** SUMMARY ***
Total pot 0.07€ | No rake
Seat 3: Fried Berg won 0.07€


Winamax Poker - HOLD-UP "Colorado" - HandId: #19116069-340618-1701440362 - Holdem no limit (0.01€/0.02€) - 2023/12/01 14:19:22 UTC
Table: 'Colorado' 6-max (real money) Seat #6 is the button
Seat 1: altruiste546 (4.27€)
Seat 2: vuesurmer (2.06€)
Seat 3: Jneb34b (0.67€)
Seat 4: Fried Berg (1.47€)
Seat 5: Kaoky (3.79€)
Seat 6: Dios unic464 (0.44€)
*** ANTE/BLINDS ***
altruiste546 posts small blind 0.01€
vuesurmer posts big blind 0.02€
Dealt to Fried Berg [3d 7s]
*** PRE-FLOP *** 
Jneb34b folds
Fried Berg folds
Kaoky folds
Dios unic464 raises 0.05€ to 0.07€
altruiste546 folds
vuesurmer folds
Dios unic464 collected 0.10€ from pot
*** SUMMARY ***
Total pot 0.10€ | No rake
Seat 6: Dios unic464 (button) won 0.10€


Winamax Poker - HOLD-UP "Colorado" - HandId: #19116069-340625-1701440366 - Holdem no limit (0.01€/0.02€) - 2023/12/01 14:19:26 UTC
Table: 'Colorado' 6-max (real money) Seat #6 is the button
Seat 1: Br3izh_P0k3r (2.07€)
Seat 2: Upswing11 (2.28€)
Seat 3: Tr0-_-L3urr3 (2.71€)
Seat 4: NICO L AS 2 (8.42€)
Seat 5: RrAaCcHhEeLl (2€)
Seat 6: Fried Berg (1.47€)
*** ANTE/BLINDS ***
Br3izh_P0k3r posts small blind 0.01€
Upswing11 posts big blind 0.02€
Dealt to Fried Berg [Qd 2d]
*** PRE-FLOP *** 
Tr0-_-L3urr3 folds
NICO L AS 2 raises 0.03€ to 0.05€
RrAaCcHhEeLl folds
Fried Berg folds
Br3izh_P0k3r folds
Upswing11 folds
NICO L AS 2 collected 0.08€ from pot
*** SUMMARY ***
Total pot 0.08€ | No rake
Seat 4: NICO L AS 2 won 0.08€


Winamax Poker - HOLD-UP "Colorado" - HandId: #19116069-340653-1701440382 - Holdem no limit (0.01€/0.02€) - 2023/12/01 14:19:42 UTC
Table: 'Colorado' 6-max (real money) Seat #6 is the button
Seat 1: SashaTDouss (2€)
Seat 2: Fried Berg (1.47€)
Seat 3: Nacho4178 (1.29€)
Seat 4: AMORFOU (2.83€)
Seat 5: CTMieuxAvant (1.33€)
Seat 6: Coconutz242 (2.33€)
*** ANTE/BLINDS ***
SashaTDouss posts small blind 0.01€
Fried Berg posts big blind 0.02€
Dealt to Fried Berg [Js Jh]
*** PRE-FLOP *** 
Nacho4178 folds
AMORFOU folds
CTMieuxAvant folds
Coconutz242 raises 0.04€ to 0.06€
SashaTDouss folds
Fried Berg raises 0.12€ to 0.18€
Coconutz242 calls 0.12€
*** FLOP *** [3h Jd 6h]
Fried Berg bets 0.12€
Coconutz242 calls 0.12€
*** TURN *** [3h Jd 6h][7h]
Fried Berg bets 0.10€
Coconutz242 raises 0.16€ to 0.26€
Fried Berg calls 0.16€
*** RIVER *** [3h Jd 6h 7h][Tc]
Fried Berg checks
Coconutz242 checks
*** SHOW DOWN ***
Coconutz242 shows [Kd Th] (One pair : Tens)
Fried Berg shows [Js Jh] (Trips of Jacks)
Fried Berg collected 1.02€ from pot
*** SUMMARY ***
Total pot 1.02€ | Rake 0.11€
Board: [3h Jd 6h 7h Tc]
Seat 2: Fried Berg (big blind) showed [Js Jh] and won 1.02€ with Trips of Jacks
Seat 6: Coconutz242 (button) showed [Kd Th] and lost with One pair : Tens


Winamax Poker - HOLD-UP "Colorado" - HandId: #19116069-340790-1701440457 - Holdem no limit (0.01€/0.02€) - 2023/12/01 14:20:57 UTC
Table: 'Colorado' 6-max (real money) Seat #6 is the button
Seat 1: tobytom (3.38€)
Seat 2: Douou (1.92€)
Seat 3: Coconutz242 (2€)
Seat 4: juanktyga (2.82€)
Seat 5: Stun72 (2.38€)
Seat 6: Fried Berg (1.93€)
*** ANTE/BLINDS ***
tobytom posts small blind 0.01€
Douou posts big blind 0.02€
Dealt to Fried Berg [5s Qd]
*** PRE-FLOP *** 
Coconutz242 folds
juanktyga folds
Stun72 raises 0.03€ to 0.05€
Fried Berg folds
tobytom folds
Douou calls 0.03€
*** FLOP *** [4c 2d Qc]
Douou checks
Stun72 bets 0.07€
Douou folds
Stun72 collected 0.17€ from pot
*** SUMMARY ***
Total pot 0.17€ | Rake 0.01€
Board: [4c 2d Qc]
Seat 5: Stun72 won 0.17€


Winamax Poker - HOLD-UP "Colorado" - HandId: #19116069-340807-1701440469 - Holdem no limit (0.01€/0.02€) - 2023/12/01 14:21:09 UTC
Table: 'Colorado' 6-max (real money) Seat #6 is the button
Seat 1: Fried Berg (1.93€)
Seat 2: Eytrewq (1.69€)
Seat 3: CTMieuxAvant (3.73€)
Seat 4: dadou13100 (1.94€)
Seat 5: AMORFOU (2€)
Seat 6: kameleon73 (4.17€)
*** ANTE/BLINDS ***
Fried Berg posts small blind 0.01€
Eytrewq posts big blind 0.02€
Dealt to Fried Berg [6c 4d]
*** PRE-FLOP *** 
CTMieuxAvant folds
dadou13100 folds
AMORFOU folds
kameleon73 raises 0.06€ to 0.08€
Fried Berg folds
Eytrewq calls 0.06€
*** FLOP *** [8d 4h 3s]
Eytrewq bets 0.09€
kameleon73 calls 0.09€
*** TURN *** [8d 4h 3s][Tc]
Eytrewq bets 0.18€
kameleon73 folds
Eytrewq collected 0.49€ from pot
*** SUMMARY ***
Total pot 0.49€ | Rake 0.04€
Board: [8d 4h 3s Tc]
Seat 2: Eytrewq (big blind) won 0.49€


Winamax Poker - HOLD-UP "Colorado" - HandId: #19116069-340810-1701440471 - Holdem no limit (0.01€/0.02€) - 2023/12/01 14:21:11 UTC
Table: 'Colorado' 6-max (real money) Seat #6 is the button
Seat 1: Kalendula (1.09€)
Seat 2: MagicBast 1 (0.50€)
Seat 3: Cejargordas (4.42€)
Seat 4: Kaoky (5.54€)
Seat 5: Fried Berg (1.92€)
Seat 6: Bback (2.70€)
*** ANTE/BLINDS ***
Kalendula posts small blind 0.01€
MagicBast 1 posts big blind 0.02€
Dealt to Fried Berg [2d Ks]
*** PRE-FLOP *** 
Cejargordas folds
Kaoky folds
Fried Berg folds
Bback folds
Kalendula raises 0.05€ to 0.07€
MagicBast 1 calls 0.05€
*** FLOP *** [6s Qd 9h]
Kalendula bets 0.09€
MagicBast 1 folds
Kalendula collected 0.22€ from pot
*** SUMMARY ***
Total pot 0.22€ | Rake 0.01€
Board: [6s Qd 9h]
Seat 1: Kalendula (small blind) won 0.22€


Winamax Poker - HOLD-UP "Colorado" - HandId: #19116069-340815-1701440474 - Holdem no limit (0.01€/0.02€) - 2023/12/01 14:21:14 UTC
Table: 'Colorado' 6-max (real money) Seat #6 is the button
Seat 1: Bback (2.70€)
Seat 2: Cejargordas (4.42€)
Seat 3: Fried Berg (1.92€)
Seat 4: Upswing11 (2.29€)
Seat 5: Toon89 (1.17€)
Seat 6: juanktyga (2.82€)
*** ANTE/BLINDS ***
Bback posts small blind 0.01€
Cejargordas posts big blind 0.02€
Dealt to Fried Berg [Jh 9c]
*** PRE-FLOP *** 
Fried Berg folds
Upswing11 folds
Toon89 folds
juanktyga raises 0.03€ to 0.05€
Bback folds
Cejargordas calls 0.03€
*** FLOP *** [2c 8d Qd]
Cejargordas checks
juanktyga bets 0.05€
Cejargordas calls 0.05€
*** TURN *** [2c 8d Qd][2s]
Cejargordas checks
juanktyga checks
*** RIVER *** [2c 8d Qd 2s][5h]
Cejargordas checks
juanktyga bets 0.08€
Cejargordas calls 0.08€
*** SHOW DOWN ***
Cejargordas shows [3s 3d] (Two pairs : 3 and 2)
juanktyga shows [Tc 5c] (Two pairs : 5 and 2)
juanktyga collected 0.33€ from pot
*** SUMMARY ***
Total pot 0.33€ | Rake 0.04€
Board: [2c 8d Qd 2s 5h]
Seat 2: Cejargordas (big blind) showed [3s 3d] and lost with Two pairs : 3 and 2
Seat 6: juanktyga (button) showed [Tc 5c] and won 0.33€ with Two pairs : 5 and 2


Winamax Poker - HOLD-UP "Colorado" - HandId: #19116069-340818-1701440476 - Holdem no limit (0.01€/0.02€) - 2023/12/01 14:21:16 UTC
Table: 'Colorado' 6-max (real money) Seat #6 is the button
Seat 1: CTMieuxAvant (0.50€)
Seat 2: El Paellas (0.53€)
Seat 3: RrAaCcHhEeLl (2€)
Seat 4: renteria45 (2.43€)
Seat 5: Toon89 (1.17€)
Seat 6: Fried Berg (1.92€)
*** ANTE/BLINDS ***
CTMieuxAvant posts small blind 0.01€
El Paellas posts big blind 0.02€
Dealt to Fried Berg [2d Jh]
*** PRE-FLOP *** 
RrAaCcHhEeLl folds
renteria45 folds
Toon89 folds
Fried Berg folds
CTMieuxAvant folds
El Paellas collected 0.03€ from pot
*** SUMMARY ***
Total pot 0.03€ | No rake
Seat 2: El Paellas (big blind) won 0.03€


Winamax Poker - HOLD-UP "Colorado" - HandId: #19116069-340823-1701440478 - Holdem no limit (0.01€/0.02€) - 2023/12/01 14:21:18 UTC
Table: 'Colorado' 6-max (real money) Seat #6 is the button
Seat 1: Tofini (4.94€)
Seat 2: Fried Berg (1.92€)
Seat 3: Nacho4178 (1.30€)
Seat 4: Myriamneuf (2.09€)
Seat 5: Upswing11 (2.29€)
Seat 6: RrAaCcHhEeLl (2€)
*** ANTE/BLINDS ***
Tofini posts small blind 0.01€
Fried Berg posts big blind 0.02€
Dealt to Fried Berg [5h 7c]
*** PRE-FLOP *** 
Nacho4178 folds
Myriamneuf calls 0.02€
Upswing11 raises 0.07€ to 0.09€
RrAaCcHhEeLl folds
Tofini folds
Fried Berg folds
Myriamneuf folds
Upswing11 collected 0.14€ from pot
*** SUMMARY ***
Total pot 0.14€ | No rake
Seat 5: Upswing11 won 0.14€


Winamax Poker - HOLD-UP "Colorado" - HandId: #19116069-340849-1701440492 - Holdem no limit (0.01€/0.02€) - 2023/12/01 14:21:32 UTC
Table: 'Colorado' 6-max (real money) Seat #6 is the button
Seat 1: Yondaime M (3.43€)
Seat 2: KKamarAAde (2€)
Seat 3: Fried Berg (1.90€)
Seat 4: RrAaCcHhEeLl (2€)
Seat 5: MrFlash9 (2€)
Seat 6: magnumbenji (0.65€)
*** ANTE/BLINDS ***
Yondaime M posts small blind 0.01€
KKamarAAde posts big blind 0.02€
Dealt to Fried Berg [8c 7c]
*** PRE-FLOP *** 
Fried Berg raises 0.02€ to 0.04€
RrAaCcHhEeLl folds
MrFlash9 folds
magnumbenji folds
Yondaime M folds
KKamarAAde calls 0.02€
*** FLOP *** [5c Qs Jd]
KKamarAAde checks
Fried Berg checks
*** TURN *** [5c Qs Jd][Ad]
KKamarAAde checks
Fried Berg checks
*** RIVER *** [5c Qs Jd Ad][Jc]
KKamarAAde checks
Fried Berg checks
*** SHOW DOWN ***
Fried Berg shows [8c 7c] (One pair : Jacks)
KKamarAAde shows [Kd 6d] (One pair : Jacks)
KKamarAAde collected 0.08€ from pot
*** SUMMARY ***
Total pot 0.08€ | Rake 0.01€
Board: [5c Qs Jd Ad Jc]
Seat 2: KKamarAAde (big blind) showed [Kd 6d] and won 0.08€ with One pair : Jacks
Seat 3: Fried Berg showed [8c 7c] and lost with One pair : Jacks


Winamax Poker - HOLD-UP "Colorado" - HandId: #19116069-340915-1701440529 - Holdem no limit (0.01€/0.02€) - 2023/12/01 14:22:09 UTC
Table: 'Colorado' 6-max (real money) Seat #6 is the button
Seat 1: Fried Berg (1.86€)
Seat 2: vuesurmer (3.32€)
Seat 3: Kaoky (5.19€)
Seat 4: AMORFOU (3.12€)
Seat 5: haouuum28 (1.13€)
Seat 6: J.C Deuces.0 (4.50€)
*** ANTE/BLINDS ***
Fried Berg posts small blind 0.01€
vuesurmer posts big blind 0.02€
Dealt to Fried Berg [Tc 3h]
*** PRE-FLOP *** 
Kaoky folds
AMORFOU raises 0.04€ to 0.06€
haouuum28 raises 1.07€ to 1.13€ and is all-in
J.C Deuces.0 folds
Fried Berg folds
vuesurmer folds
AMORFOU calls 1.07€
*** FLOP *** [6h Qc 5d]
*** TURN *** [6h Qc 5d][Qh]
*** RIVER *** [6h Qc 5d Qh][5h]
*** SHOW DOWN ***
haouuum28 shows [8c 8s] (Two pairs : Queens and 8)
AMORFOU shows [Js Jh] (Two pairs : Queens and Jacks)
AMORFOU collected 2.06€ from pot
*** SUMMARY ***
Total pot 2.06€ | Rake 0.23€
Board: [6h Qc 5d Qh 5h]
Seat 4: AMORFOU showed [Js Jh] and won 2.06€ with Two pairs : Queens and Jacks
Seat 5: haouuum28 showed [8c 8s] and lost with Two pairs : Queens and 8


Winamax Poker - HOLD-UP "Colorado" - HandId: #19116069-340919-1701440532 - Holdem no limit (0.01€/0.02€) - 2023/12/01 14:22:12 UTC
Table: 'Colorado' 6-max (real money) Seat #6 is the button
Seat 1: MENDOSA-31 (0.52€)
Seat 2: Max134Max (2.68€)
Seat 3: Upswing11 (2.31€)
Seat 4: Fried Berg (1.85€)
Seat 5: NICO L AS 2 (8.26€)
Seat 6: Marvinx1 (2.98€)
*** ANTE/BLINDS ***
MENDOSA-31 posts small blind 0.01€
Max134Max posts big blind 0.02€
Dealt to Fried Berg [9c 3d]
*** PRE-FLOP *** 
Upswing11 raises 0.04€ to 0.06€
Fried Berg folds
NICO L AS 2 folds
Marvinx1 folds
MENDOSA-31 calls 0.05€
Max134Max calls 0.04€
*** FLOP *** [Qc Ad 2s]
MENDOSA-31 checks
Max134Max checks
Upswing11 bets 0.06€
MENDOSA-31 calls 0.06€
Max134Max calls 0.06€
*** TURN *** [Qc Ad 2s][Ac]
MENDOSA-31 checks
Max134Max checks
Upswing11 bets 0.18€
MENDOSA-31 folds
Max134Max folds
Upswing11 collected 0.50€ from pot
*** SUMMARY ***
Total pot 0.50€ | Rake 0.04€
Board: [Qc Ad 2s Ac]
Seat 3: Upswing11 won 0.50€


Winamax Poker - HOLD-UP "Colorado" - HandId: #19116069-340923-1701440534 - Holdem no limit (0.01€/0.02€) - 2023/12/01 14:22:14 UTC
Table: 'Colorado' 6-max (real money) Seat #6 is the button
Seat 1: tobytom (3.32€)
Seat 2: TuMensTanT (3.60€)
Seat 3: _Chloe58 (2.72€)
Seat 4: El Paellas (0.55€)
Seat 5: MrFlash9 (2€)
Seat 6: Fried Berg (1.85€)
*** ANTE/BLINDS ***
tobytom posts small blind 0.01€
TuMensTanT posts big blind 0.02€
Dealt to Fried Berg [Ad 2h]
*** PRE-FLOP *** 
_Chloe58 calls 0.02€
El Paellas folds
MrFlash9 folds
Fried Berg calls 0.02€
tobytom folds
TuMensTanT checks
*** FLOP *** [7c 9s Kd]
TuMensTanT checks
_Chloe58 bets 0.02€
Fried Berg calls 0.02€
TuMensTanT folds
*** TURN *** [7c 9s Kd][Ks]
_Chloe58 bets 0.04€
Fried Berg calls 0.04€
*** RIVER *** [7c 9s Kd Ks][Kh]
_Chloe58 bets 0.60€
Fried Berg folds
_Chloe58 collected 0.77€ from pot
*** SUMMARY ***
Total pot 0.77€ | Rake 0.02€
Board: [7c 9s Kd Ks Kh]
Seat 3: _Chloe58 won 0.77€


Winamax Poker - HOLD-UP "Colorado" - HandId: #19116069-341038-1701440598 - Holdem no limit (0.01€/0.02€) - 2023/12/01 14:23:18 UTC
Table: 'Colorado' 6-max (real money) Seat #6 is the button
Seat 1: AMORFOU (2€)
Seat 2: Ewynner (2.06€)
Seat 3: dadou13100 (1.93€)
Seat 4: vuesurmer (2€)
Seat 5: Fried Berg (1.77€)
Seat 6: tobytom (3.37€)
*** ANTE/BLINDS ***
AMORFOU posts small blind 0.01€
Ewynner posts big blind 0.02€
Dealt to Fried Berg [Kh Tc]
*** PRE-FLOP *** 
dadou13100 folds
vuesurmer folds
Fried Berg raises 0.02€ to 0.04€
tobytom folds
AMORFOU folds
Ewynner calls 0.02€
*** FLOP *** [3c Td Jh]
Ewynner checks
Fried Berg checks
*** TURN *** [3c Td Jh][Qd]
Ewynner checks
Fried Berg checks
*** RIVER *** [3c Td Jh Qd][Js]
Ewynner bets 0.06€
Fried Berg calls 0.06€
*** SHOW DOWN ***
Ewynner shows [6c 8c] (One pair : Jacks)
Fried Berg shows [Kh Tc] (Two pairs : Jacks and Tens)
Fried Berg collected 0.19€ from pot
*** SUMMARY ***
Total pot 0.19€ | Rake 0.02€
Board: [3c Td Jh Qd Js]
Seat 2: Ewynner (big blind) showed [6c 8c] and lost with One pair : Jacks
Seat 5: Fried Berg showed [Kh Tc] and won 0.19€ with Two pairs : Jacks and Tens


Winamax Poker - HOLD-UP "Colorado" - HandId: #19116069-341087-1701440628 - Holdem no limit (0.01€/0.02€) - 2023/12/01 14:23:48 UTC
Table: 'Colorado' 6-max (real money) Seat #6 is the button
Seat 1: Fried Berg (1.86€)
Seat 2: Ddm8 (2.99€)
Seat 3: AMORFOU (2€)
Seat 4: bastos2525 (3.44€)
Seat 5: Coconutz242 (2.06€)
Seat 6: Ewynner (2€)
*** ANTE/BLINDS ***
Fried Berg posts small blind 0.01€
Ddm8 posts big blind 0.02€
Dealt to Fried Berg [As 8c]
*** PRE-FLOP *** 
AMORFOU raises 0.03€ to 0.05€
bastos2525 folds
Coconutz242 calls 0.05€
Ewynner folds
Fried Berg calls 0.04€
Ddm8 folds
*** FLOP *** [5d 9s 9h]
Fried Berg checks
AMORFOU checks
Coconutz242 bets 0.09€
Fried Berg folds
AMORFOU folds
Coconutz242 collected 0.24€ from pot
*** SUMMARY ***
Total pot 0.24€ | Rake 0.02€
Board: [5d 9s 9h]
Seat 5: Coconutz242 won 0.24€


Winamax Poker - HOLD-UP "Colorado" - HandId: #19116069-341163-1701440670 - Holdem no limit (0.01€/0.02€) - 2023/12/01 14:24:30 UTC
Table: 'Colorado' 6-max (real money) Seat #6 is the button
Seat 1: Stun72 (2.14€)
Seat 2: Fried Berg (1.81€)
Seat 3: Fripon_77201 (2.02€)
Seat 4: muespachois1 (2.26€)
Seat 5: kameleon73 (3.42€)
Seat 6: Diaz-Merry (2€)
*** ANTE/BLINDS ***
Stun72 posts small blind 0.01€
Fried Berg posts big blind 0.02€
Dealt to Fried Berg [7c 6s]
*** PRE-FLOP *** 
Fripon_77201 folds
muespachois1 folds
kameleon73 raises 0.02€ to 0.04€
Diaz-Merry calls 0.04€
Stun72 calls 0.03€
Fried Berg folds
*** FLOP *** [4s Ad Ac]
Stun72 checks
kameleon73 checks
Diaz-Merry bets 0.04€
Stun72 calls 0.04€
kameleon73 folds
*** TURN *** [4s Ad Ac][4c]
Stun72 checks
Diaz-Merry bets 0.11€
Stun72 raises 0.19€ to 0.30€
Diaz-Merry calls 0.19€
*** RIVER *** [4s Ad Ac 4c][Kc]
Stun72 bets 0.30€
Diaz-Merry calls 0.30€
*** SHOW DOWN ***
Stun72 shows [As 7h] (Full of Aces and 4)
Diaz-Merry shows [Ah 2s] (Full of Aces and 4)
Diaz-Merry collected 0.64€ from pot
Stun72 collected 0.64€ from pot
*** SUMMARY ***
Total pot 1.28€ | Rake 0.14€
Board: [4s Ad Ac 4c Kc]
Seat 1: Stun72 (small blind) showed [As 7h] and won 0.64€ with Full of Aces and 4
Seat 6: Diaz-Merry (button) showed [Ah 2s] and won 0.64€ with Full of Aces and 4


Winamax Poker - HOLD-UP "Colorado" - HandId: #19116069-341181-1701440677 - Holdem no limit (0.01€/0.02€) - 2023/12/01 14:24:37 UTC
Table: 'Colorado' 6-max (real money) Seat #6 is the button
Seat 1: Thequeen1205 (4.18€)
Seat 2: bastos2525 (2.12€)
Seat 3: dadou13100 (1.89€)
Seat 4: tobytom (3.33€)
Seat 5: Fried Berg (1.79€)
Seat 6: LilRun (2.29€)
*** ANTE/BLINDS ***
Thequeen1205 posts small blind 0.01€
bastos2525 posts big blind 0.02€
Dealt to Fried Berg [2d 9c]
*** PRE-FLOP *** 
dadou13100 folds
tobytom raises 0.04€ to 0.06€
Fried Berg folds
LilRun folds
Thequeen1205 folds
bastos2525 folds
tobytom collected 0.09€ from pot
*** SUMMARY ***
Total pot 0.09€ | No rake
Seat 4: tobytom won 0.09€


Winamax Poker - HOLD-UP "Colorado" - HandId: #19116069-341184-1701440679 - Holdem no limit (0.01€/0.02€) - 2023/12/01 14:24:39 UTC
Table: 'Colorado' 6-max (real money) Seat #6 is the button
Seat 1: Fran1Oller (2.29€)
Seat 2: Fried Berg (1.79€)
Seat 3: coyoteuch (2.08€)
Seat 4: vuesurmer (3.32€)
Seat 5: Cejargordas (2.16€)
Seat 6: curiouz dje (2.22€)
*** ANTE/BLINDS ***
Fran1Oller posts small blind 0.01€
Fried Berg posts big blind 0.02€
Dealt to Fried Berg [4d 7d]
*** PRE-FLOP *** 
coyoteuch folds
vuesurmer folds
Cejargordas folds
curiouz dje folds
Fran1Oller folds
Fried Berg collected 0.03€ from pot
*** SUMMARY ***
Total pot 0.03€ | No rake
Seat 2: Fried Berg (big blind) won 0.03€


Winamax Poker - HOLD-UP "Colorado" - HandId: #19116069-341216-1701440698 - Holdem no limit (0.01€/0.02€) - 2023/12/01 14:24:58 UTC
Table: 'Colorado' 6-max (real money) Seat #6 is the button
Seat 1: dadou13100 (1.82€)
Seat 2: strada2012 (2.84€)
Seat 3: Cejargordas (2.31€)
Seat 4: Fried Berg (1.80€)
Seat 5: tobytom (3.64€)
Seat 6: KKamarAAde (3.83€)
*** ANTE/BLINDS ***
dadou13100 posts small blind 0.01€
strada2012 posts big blind 0.02€
Dealt to Fried Berg [Jc 4d]
*** PRE-FLOP *** 
Cejargordas folds
Fried Berg folds
tobytom raises 0.03€ to 0.05€
KKamarAAde folds
dadou13100 calls 0.04€
strada2012 calls 0.03€
*** FLOP *** [Td 4s 9s]
dadou13100 checks
strada2012 checks
tobytom bets 0.08€
dadou13100 calls 0.08€
strada2012 folds
*** TURN *** [Td 4s 9s][Th]
dadou13100 checks
tobytom checks
*** RIVER *** [Td 4s 9s Th][Ts]
dadou13100 bets 0.20€
tobytom folds
dadou13100 collected 0.48€ from pot
*** SUMMARY ***
Total pot 0.48€ | Rake 0.03€
Board: [Td 4s 9s Th Ts]
Seat 1: dadou13100 (small blind) won 0.48€


Winamax Poker - HOLD-UP "Colorado" - HandId: #19116069-341222-1701440701 - Holdem no limit (0.01€/0.02€) - 2023/12/01 14:25:01 UTC
Table: 'Colorado' 6-max (real money) Seat #6 is the button
Seat 1: RrAaCcHhEeLl (2.32€)
Seat 2: coyoteuch (2.02€)
Seat 3: Fried Berg (1.80€)
Seat 4: Papaiah (2.12€)
Seat 5: Thequeen1205 (6.04€)
Seat 6: Tr0-_-L3urr3 (2.96€)
*** ANTE/BLINDS ***
RrAaCcHhEeLl posts small blind 0.01€
coyoteuch posts big blind 0.02€
Dealt to Fried Berg [7s Th]
*** PRE-FLOP *** 
Fried Berg folds
Papaiah folds
Thequeen1205 folds
Tr0-_-L3urr3 raises 0.03€ to 0.05€
RrAaCcHhEeLl calls 0.04€
coyoteuch folds
*** FLOP *** [Tc 7h 4c]
RrAaCcHhEeLl checks
Tr0-_-L3urr3 checks
*** TURN *** [Tc 7h 4c][Qd]
RrAaCcHhEeLl bets 0.12€
Tr0-_-L3urr3 folds
RrAaCcHhEeLl collected 0.23€ from pot
*** SUMMARY ***
Total pot 0.23€ | Rake 0.01€
Board: [Tc 7h 4c Qd]
Seat 1: RrAaCcHhEeLl (small blind) won 0.23€


Winamax Poker - HOLD-UP "Colorado" - HandId: #19116069-341225-1701440703 - Holdem no limit (0.01€/0.02€) - 2023/12/01 14:25:03 UTC
Table: 'Colorado' 6-max (real money) Seat #6 is the button
Seat 1: Papaiah (2.12€)
Seat 2: AMORFOU (2.25€)
Seat 3: Fried Berg (1.80€)
Seat 4: Coconutz242 (2€)
Seat 5: juanktyga (2.78€)
Seat 6: Thequeen1205 (6.04€)
*** ANTE/BLINDS ***
Papaiah posts small blind 0.01€
AMORFOU posts big blind 0.02€
Dealt to Fried Berg [Ac Ad]
*** PRE-FLOP *** 
Fried Berg raises 0.04€ to 0.06€
Coconutz242 calls 0.06€
juanktyga folds
Thequeen1205 folds
Papaiah folds
AMORFOU folds
*** FLOP *** [Td 8c Jh]
Fried Berg bets 0.12€
Coconutz242 calls 0.12€
*** TURN *** [Td 8c Jh][9c]
Fried Berg bets 0.16€
Coconutz242 calls 0.16€
*** RIVER *** [Td 8c Jh 9c][8h]
Fried Berg bets 0.20€
Coconutz242 raises 0.30€ to 0.50€
Fried Berg calls 0.30€
*** SHOW DOWN ***
Fried Berg shows [Ac Ad] (Two pairs : Aces and 8)
Coconutz242 shows [Jc Qs] (Straight Queen high)
Coconutz242 collected 1.54€ from pot
*** SUMMARY ***
Total pot 1.54€ | Rake 0.17€
Board: [Td 8c Jh 9c 8h]
Seat 3: Fried Berg showed [Ac Ad] and lost with Two pairs : Aces and 8
Seat 4: Coconutz242 showed [Jc Qs] and won 1.54€ with Straight Queen high


Winamax Poker - HOLD-UP "Colorado" - HandId: #19116069-341319-1701440758 - Holdem no limit (0.01€/0.02€) - 2023/12/01 14:25:58 UTC
Table: 'Colorado' 6-max (real money) Seat #6 is the button
Seat 1: Tr0-_-L3urr3 (6.03€)
Seat 2: Wolfert (4.90€)
Seat 3: 8Tourinho (1.17€)
Seat 4: Fried Berg (0.96€)
Seat 5: juanktyga (2.74€)
Seat 6: Jneb34b (0.63€)
*** ANTE/BLINDS ***
Tr0-_-L3urr3 posts small blind 0.01€
Wolfert posts big blind 0.02€
Dealt to Fried Berg [3h Jc]
*** PRE-FLOP *** 
8Tourinho folds
Fried Berg folds
juanktyga folds
Jneb34b folds
Tr0-_-L3urr3 folds
Wolfert collected 0.03€ from pot
*** SUMMARY ***
Total pot 0.03€ | No rake
Seat 2: Wolfert (big blind) won 0.03€


Winamax Poker - HOLD-UP "Colorado" - HandId: #19116069-341361-1701440778 - Holdem no limit (0.01€/0.02€) - 2023/12/01 14:26:18 UTC
Table: 'Colorado' 6-max (real money) Seat #6 is the button
Seat 1: Cejargordas (2€)
Seat 2: Br3izh_P0k3r (2€)
Seat 3: Fran1Oller (2€)
Seat 4: rakefab (3.92€)
Seat 5: Homer14510 (2€)
Seat 6: Fried Berg (0.96€)
*** ANTE/BLINDS ***
Cejargordas posts small blind 0.01€
Br3izh_P0k3r posts big blind 0.02€
Dealt to Fried Berg [6h Js]
*** PRE-FLOP *** 
Fran1Oller raises 0.04€ to 0.06€
rakefab folds
Homer14510 folds
Fried Berg folds
Cejargordas folds
Br3izh_P0k3r folds
Fran1Oller collected 0.09€ from pot
*** SUMMARY ***
Total pot 0.09€ | No rake
Seat 3: Fran1Oller won 0.09€


Winamax Poker - HOLD-UP "Colorado" - HandId: #19116069-341368-1701440783 - Holdem no limit (0.01€/0.02€) - 2023/12/01 14:26:23 UTC
Table: 'Colorado' 6-max (real money) Seat #6 is the button
Seat 1: Fried Berg (0.96€)
Seat 2: Falco69 (0.54€)
Seat 3: PtitDidine (1.11€)
Seat 4: drexler922 (2€)
Seat 5: strada2012 (4.39€)
Seat 6: tobytom (4.08€)
*** ANTE/BLINDS ***
Fried Berg posts small blind 0.01€
Falco69 posts big blind 0.02€
Dealt to Fried Berg [2d Qs]
*** PRE-FLOP *** 
PtitDidine calls 0.02€
drexler922 folds
strada2012 raises 0.07€ to 0.09€
tobytom folds
Fried Berg folds
Falco69 folds
PtitDidine calls 0.07€
*** FLOP *** [4d Ad 8d]
PtitDidine checks
strada2012 bets 0.14€
PtitDidine calls 0.14€
*** TURN *** [4d Ad 8d][Kc]
PtitDidine checks
strada2012 bets 0.17€
PtitDidine calls 0.17€
*** RIVER *** [4d Ad 8d Kc][9d]
PtitDidine checks
strada2012 checks
*** SHOW DOWN ***
strada2012 shows [Js Ah] (One pair : Aces)
PtitDidine shows [Ac 4s] (Two pairs : Aces and 4)
PtitDidine collected 0.75€ from pot
*** SUMMARY ***
Total pot 0.75€ | Rake 0.08€
Board: [4d Ad 8d Kc 9d]
Seat 3: PtitDidine showed [Ac 4s] and won 0.75€ with Two pairs : Aces and 4
Seat 5: strada2012 showed [Js Ah] and lost with One pair : Aces


Winamax Poker - HOLD-UP "Colorado" - HandId: #19116069-341379-1701440790 - Holdem no limit (0.01€/0.02€) - 2023/12/01 14:26:30 UTC
Table: 'Colorado' 6-max (real money) Seat #6 is the button
Seat 1: zozo6750 (4.89€)
Seat 2: Sirtrezze (2.55€)
Seat 3: metamex (1.97€)
Seat 4: muespachois1 (2.14€)
Seat 5: Fried Berg (0.95€)
Seat 6: Nacho4178 (1.35€)
Hold-up to Pot: total 0.10€
*** ANTE/BLINDS ***
zozo6750 posts small blind 0.01€
Sirtrezze posts big blind 0.02€
Dealt to Fried Berg [Td As]
*** PRE-FLOP *** 
metamex calls 0.02€
muespachois1 folds
Fried Berg raises 0.93€ to 0.95€ and is all-in
Nacho4178 folds
zozo6750 folds
Sirtrezze folds
metamex folds
Fried Berg collected 1.10€ from pot
*** SUMMARY ***
Total pot 1.10€ | No rake
Seat 5: Fried Berg won 1.10€


Winamax Poker - HOLD-UP "Colorado" - HandId: #19116069-341417-1701440811 - Holdem no limit (0.01€/0.02€) - 2023/12/01 14:26:51 UTC
Table: 'Colorado' 6-max (real money) Seat #6 is the button
Seat 1: Upswing11 (2.47€)
Seat 2: Cejargordas (3.86€)
Seat 3: RrAaCcHhEeLl (2.35€)
Seat 4: tobytom (4.08€)
Seat 5: Fried Berg (1.10€)
Seat 6: Coconutz242 (2.02€)
*** ANTE/BLINDS ***
Upswing11 posts small blind 0.01€
Cejargordas posts big blind 0.02€
Dealt to Fried Berg [Ah 5s]
*** PRE-FLOP *** 
RrAaCcHhEeLl folds
tobytom folds
Fried Berg raises 0.02€ to 0.04€
Coconutz242 folds
Upswing11 folds
Cejargordas calls 0.02€
*** FLOP *** [3c Kc 9d]
Cejargordas checks
Fried Berg checks
*** TURN *** [3c Kc 9d][6c]
Cejargordas checks
Fried Berg checks
*** RIVER *** [3c Kc 9d 6c][9c]
Cejargordas checks
Fried Berg checks
*** SHOW DOWN ***
Cejargordas shows [2h Ad] (One pair : 9)
Fried Berg shows [Ah 5s] (One pair : 9)
Fried Berg collected 0.04€ from pot
Cejargordas collected 0.04€ from pot
*** SUMMARY ***
Total pot 0.08€ | Rake 0.01€
Board: [3c Kc 9d 6c 9c]
Seat 2: Cejargordas (big blind) showed [2h Ad] and won 0.04€ with One pair : 9
Seat 5: Fried Berg showed [Ah 5s] and won 0.04€ with One pair : 9


Winamax Poker - HOLD-UP "Colorado" - HandId: #19116069-341480-1701440843 - Holdem no limit (0.01€/0.02€) - 2023/12/01 14:27:23 UTC
Table: 'Colorado' 6-max (real money) Seat #6 is the button
Seat 1: Duality2 (2€)
Seat 2: Aggro Loser (2.07€)
Seat 3: Thequeen1205 (4.21€)
Seat 4: Diaz-Merry (2.50€)
Seat 5: Cejargordas (3.86€)
Seat 6: Fried Berg (1.10€)
*** ANTE/BLINDS ***
Duality2 posts small blind 0.01€
Aggro Loser posts big blind 0.02€
Dealt to Fried Berg [8c Qd]
*** PRE-FLOP *** 
Thequeen1205 folds
Diaz-Merry folds
Cejargordas folds
Fried Berg folds
Duality2 folds
Aggro Loser collected 0.03€ from pot
*** SUMMARY ***
Total pot 0.03€ | No rake
Seat 2: Aggro Loser (big blind) won 0.03€


Winamax Poker - HOLD-UP "Colorado" - HandId: #19116069-345586-1701442912 - Holdem no limit (0.01€/0.02€) - 2023/12/01 15:01:52 UTC
Table: 'Colorado' 6-max (real money) Seat #6 is the button
Seat 1: Tr0-_-L3urr3 (3.17€)
Seat 2: Fried Berg (0.50€)
Seat 3: Nandini16 (2.88€)
Seat 4: Neferusobek (2.74€)
Seat 5: Maracujaaaa (2€)
Seat 6: Mac2luxe_Bzh (2€)
*** ANTE/BLINDS ***
Tr0-_-L3urr3 posts small blind 0.01€
Fried Berg posts big blind 0.02€
Dealt to Fried Berg [9c Jh]
*** PRE-FLOP *** 
Nandini16 folds
Neferusobek folds
Maracujaaaa folds
Mac2luxe_Bzh raises 0.03€ to 0.05€
Tr0-_-L3urr3 raises 0.18€ to 0.23€
Fried Berg folds
Mac2luxe_Bzh folds
Tr0-_-L3urr3 collected 0.30€ from pot
*** SUMMARY ***
Total pot 0.30€ | No rake
Seat 1: Tr0-_-L3urr3 (small blind) won 0.30€


Winamax Poker - HOLD-UP "Colorado" - HandId: #19116069-345619-1701442924 - Holdem no limit (0.01€/0.02€) - 2023/12/01 15:02:04 UTC
Table: 'Colorado' 6-max (real money) Seat #6 is the button
Seat 1: Fried Berg (0.48€)
Seat 2: Maracujaaaa (2.06€)
Seat 3: bananAsSplit (2.23€)
Seat 4: Cejargordas (3.02€)
Seat 5: Bback (2.30€)
Seat 6: Amazigh 78 (2.02€)
*** ANTE/BLINDS ***
Fried Berg posts small blind 0.01€
Maracujaaaa posts big blind 0.02€
Dealt to Fried Berg [9d Qh]
*** PRE-FLOP *** 
bananAsSplit folds
Cejargordas folds
Bback raises 0.04€ to 0.06€
Amazigh 78 folds
Fried Berg folds
Maracujaaaa calls 0.04€
*** FLOP *** [2h 5h 4d]
Maracujaaaa checks
Bback bets 0.07€
Maracujaaaa folds
Bback collected 0.19€ from pot
*** SUMMARY ***
Total pot 0.19€ | Rake 0.01€
Board: [2h 5h 4d]
Seat 5: Bback won 0.19€


Winamax Poker - HOLD-UP "Colorado" - HandId: #19116069-345633-1701442930 - Holdem no limit (0.01€/0.02€) - 2023/12/01 15:02:10 UTC
Table: 'Colorado' 6-max (real money) Seat #6 is the button
Seat 1: Calimort (2.26€)
Seat 2: Xnikos2X (2.29€)
Seat 3: Fried Berg (0.47€)
Seat 4: Thequeen1205 (4.14€)
Seat 5: DGG23 (0.35€)
Seat 6: KKamarAAde (2€)
*** ANTE/BLINDS ***
Calimort posts small blind 0.01€
Xnikos2X posts big blind 0.02€
Dealt to Fried Berg [4d 2s]
*** PRE-FLOP *** 
Fried Berg folds
Thequeen1205 folds
DGG23 folds
KKamarAAde folds
Calimort raises 0.04€ to 0.06€
Xnikos2X folds
Calimort collected 0.08€ from pot
*** SUMMARY ***
Total pot 0.08€ | No rake
Seat 1: Calimort (small blind) won 0.08€


Winamax Poker - HOLD-UP "Colorado" - HandId: #19116069-345636-1701442932 - Holdem no limit (0.01€/0.02€) - 2023/12/01 15:02:12 UTC
Table: 'Colorado' 6-max (real money) Seat #6 is the button
Seat 1: Jerrycan57 (2.43€)
Seat 2: Yondaime M (2.13€)
Seat 3: LDL1 (1.79€)
Seat 4: Fried Berg (0.47€)
Seat 5: Brut2pok (2.43€)
Seat 6: El tiki tiki (2.88€)
*** ANTE/BLINDS ***
Jerrycan57 posts small blind 0.01€
Yondaime M posts big blind 0.02€
Dealt to Fried Berg [Jh 9c]
*** PRE-FLOP *** 
LDL1 folds
Fried Berg folds
Brut2pok folds
El tiki tiki raises 0.04€ to 0.06€
Jerrycan57 folds
Yondaime M calls 0.04€
*** FLOP *** [Jd Ts Kd]
Yondaime M checks
El tiki tiki checks
*** TURN *** [Jd Ts Kd][3s]
Yondaime M bets 0.08€
El tiki tiki raises 0.16€ to 0.24€
Yondaime M calls 0.16€
*** RIVER *** [Jd Ts Kd 3s][Ks]
Yondaime M bets 1.83€ and is all-in
El tiki tiki folds
Yondaime M collected 2.38€ from pot
*** SUMMARY ***
Total pot 2.38€ | Rake 0.06€
Board: [Jd Ts Kd 3s Ks]
Seat 2: Yondaime M (big blind) won 2.38€


Winamax Poker - HOLD-UP "Colorado" - HandId: #19116069-345641-1701442934 - Holdem no limit (0.01€/0.02€) - 2023/12/01 15:02:14 UTC
Table: 'Colorado' 6-max (real money) Seat #6 is the button
Seat 1: curiouz dje (2.02€)
Seat 2: Shadow b97 (0.42€)
Seat 3: Industrial17 (0.78€)
Seat 4: fran314to (1.02€)
Seat 5: Fried Berg (0.47€)
Seat 6: Kangourou_JJ (2€)
*** ANTE/BLINDS ***
curiouz dje posts small blind 0.01€
Shadow b97 posts big blind 0.02€
Dealt to Fried Berg [6c 6d]
*** PRE-FLOP *** 
Industrial17 folds
fran314to folds
Fried Berg raises 0.02€ to 0.04€
Kangourou_JJ folds
curiouz dje folds
Shadow b97 folds
Fried Berg collected 0.07€ from pot
*** SUMMARY ***
Total pot 0.07€ | No rake
Seat 5: Fried Berg won 0.07€


Winamax Poker - HOLD-UP "Colorado" - HandId: #19116069-345676-1701442950 - Holdem no limit (0.01€/0.02€) - 2023/12/01 15:02:30 UTC
Table: 'Colorado' 6-max (real money) Seat #6 is the button
Seat 1: gueyf (1.99€)
Seat 2: freddytooo (2.32€)
Seat 3: DGG23 (0.24€)
Seat 4: Cejargordas (3.95€)
Seat 5: galettedesKK (2.86€)
Seat 6: Fried Berg (0.50€)
Hold-up to Pot: total 0.10€
*** ANTE/BLINDS ***
gueyf posts small blind 0.01€
freddytooo posts big blind 0.02€
Dealt to Fried Berg [9h Kc]
*** PRE-FLOP *** 
DGG23 folds
Cejargordas folds
galettedesKK folds
Fried Berg folds
gueyf folds
freddytooo collected 0.13€ from pot
*** SUMMARY ***
Total pot 0.13€ | No rake
Seat 2: freddytooo (big blind) won 0.13€


Winamax Poker - HOLD-UP "Colorado" - HandId: #19116069-345710-1701442968 - Holdem no limit (0.01€/0.02€) - 2023/12/01 15:02:48 UTC
Table: 'Colorado' 6-max (real money) Seat #6 is the button
Seat 1: Jorj-X-McKie (2€)
Seat 2: 14cruyff14 (0.50€)
Seat 3: Fried Berg (0.50€)
Seat 4: tobytom (2.22€)
Seat 5: mp1z (2.97€)
Seat 6: Cejargordas (3.25€)
*** ANTE/BLINDS ***
Jorj-X-McKie posts small blind 0.01€
14cruyff14 posts big blind 0.02€
Dealt to Fried Berg [6d Tc]
*** PRE-FLOP *** 
Fried Berg folds
tobytom folds
mp1z raises 0.04€ to 0.06€
Cejargordas folds
Jorj-X-McKie folds
14cruyff14 folds
mp1z collected 0.09€ from pot
*** SUMMARY ***
Total pot 0.09€ | No rake
Seat 5: mp1z won 0.09€


Winamax Poker - HOLD-UP "Colorado" - HandId: #19116069-345713-1701442969 - Holdem no limit (0.01€/0.02€) - 2023/12/01 15:02:49 UTC
Table: 'Colorado' 6-max (real money) Seat #6 is the button
Seat 1: Fried Berg (0.50€)
Seat 2: Jorj-X-McKie (2€)
Seat 3: _gonzai_ (2€)
Seat 4: LDL1 (1.79€)
Seat 5: strada2012 (2.96€)
Seat 6: julien08090 (1.61€)
*** ANTE/BLINDS ***
Fried Berg posts small blind 0.01€
Jorj-X-McKie posts big blind 0.02€
Dealt to Fried Berg [As Qh]
*** PRE-FLOP *** 
_gonzai_ folds
LDL1 folds
strada2012 folds
julien08090 folds
Fried Berg raises 0.02€ to 0.04€
Jorj-X-McKie calls 0.02€
*** FLOP *** [Tc 3c 2h]
Fried Berg bets 0.02€
Jorj-X-McKie calls 0.02€
*** TURN *** [Tc 3c 2h][9s]
Fried Berg bets 0.02€
Jorj-X-McKie folds
Fried Berg collected 0.13€ from pot
*** SUMMARY ***
Total pot 0.13€ | Rake 0.01€
Board: [Tc 3c 2h 9s]
Seat 1: Fried Berg (small blind) won 0.13€


Winamax Poker - HOLD-UP "Colorado" - HandId: #19116069-345787-1701443006 - Holdem no limit (0.01€/0.02€) - 2023/12/01 15:03:26 UTC
Table: 'Colorado' 6-max (real money) Seat #6 is the button
Seat 1: curiouz dje (2.01€)
Seat 2: Fried Berg (0.55€)
Seat 3: haouuum28 (3.74€)
Seat 4: 14cruyff14 (0.50€)
Seat 5: Jerrycan57 (2.70€)
Seat 6: freddytooo (2.43€)
*** ANTE/BLINDS ***
curiouz dje posts small blind 0.01€
Fried Berg posts big blind 0.02€
Dealt to Fried Berg [3d 8d]
*** PRE-FLOP *** 
haouuum28 raises 0.04€ to 0.06€
14cruyff14 folds
Jerrycan57 folds
freddytooo folds
curiouz dje folds
Fried Berg folds
haouuum28 collected 0.09€ from pot
*** SUMMARY ***
Total pot 0.09€ | No rake
Seat 3: haouuum28 won 0.09€


Winamax Poker - HOLD-UP "Colorado" - HandId: #19116069-345831-1701443029 - Holdem no limit (0.01€/0.02€) - 2023/12/01 15:03:49 UTC
Table: 'Colorado' 6-max (real money) Seat #6 is the button
Seat 1: bananAsSplit (2.58€)
Seat 2: tobytom (2.97€)
Seat 3: freddytooo (2.40€)
Seat 4: Fried Berg (0.53€)
Seat 5: Ewynner (2€)
Seat 6: Faramiix57 (2.09€)
*** ANTE/BLINDS ***
bananAsSplit posts small blind 0.01€
tobytom posts big blind 0.02€
Dealt to Fried Berg [Ts 8c]
*** PRE-FLOP *** 
freddytooo folds
Fried Berg folds
Ewynner folds
Faramiix57 folds
bananAsSplit folds
tobytom collected 0.03€ from pot
*** SUMMARY ***
Total pot 0.03€ | No rake
Seat 2: tobytom (big blind) won 0.03€


Winamax Poker - HOLD-UP "Colorado" - HandId: #19116069-345875-1701443046 - Holdem no limit (0.01€/0.02€) - 2023/12/01 15:04:06 UTC
Table: 'Colorado' 6-max (real money) Seat #6 is the button
Seat 1: KON-2-PEUTE (2€)
Seat 2: matmyl (2.03€)
Seat 3: bananAsSplit (3.11€)
Seat 4: Kaoky (5.25€)
Seat 5: Fried Berg (0.53€)
Seat 6: Dario 365 (4.50€)
*** ANTE/BLINDS ***
KON-2-PEUTE posts small blind 0.01€
matmyl posts big blind 0.02€
Dealt to Fried Berg [8s 8d]
*** PRE-FLOP *** 
bananAsSplit folds
Kaoky folds
Fried Berg raises 0.02€ to 0.04€
Dario 365 folds
KON-2-PEUTE folds
matmyl calls 0.02€
*** FLOP *** [Kc 8h 5d]
matmyl checks
Fried Berg bets 0.02€
matmyl folds
Fried Berg collected 0.10€ from pot
*** SUMMARY ***
Total pot 0.10€ | Rake 0.01€
Board: [Kc 8h 5d]
Seat 5: Fried Berg won 0.10€


Winamax Poker - HOLD-UP "Colorado" - HandId: #19116069-345945-1701443079 - Holdem no limit (0.01€/0.02€) - 2023/12/01 15:04:39 UTC
Table: 'Colorado' 6-max (real money) Seat #6 is the button
Seat 1: freddytooo (2.34€)
Seat 2: _FanZ_ (2.07€)
Seat 3: Dario 365 (2.48€)
Seat 4: vegifish (1.97€)
Seat 5: Polanskii (2.50€)
Seat 6: Fried Berg (0.57€)
*** ANTE/BLINDS ***
freddytooo posts small blind 0.01€
_FanZ_ posts big blind 0.02€
Dealt to Fried Berg [Th 6c]
*** PRE-FLOP *** 
Dario 365 raises 0.05€ to 0.07€
vegifish folds
Polanskii raises 0.22€ to 0.29€
Fried Berg folds
freddytooo folds
_FanZ_ folds
Dario 365 folds
Polanskii collected 0.39€ from pot
*** SUMMARY ***
Total pot 0.39€ | No rake
Seat 5: Polanskii won 0.39€


Winamax Poker - HOLD-UP "Colorado" - HandId: #19116069-345978-1701443095 - Holdem no limit (0.01€/0.02€) - 2023/12/01 15:04:55 UTC
Table: 'Colorado' 6-max (real money) Seat #6 is the button
Seat 1: strada2012 (2.14€)
Seat 2: 14cruyff14 (0.50€)
Seat 3: Tr0-_-L3urr3 (5.78€)
Seat 4: Yondaime M (2.63€)
Seat 5: Kangourou_JJ (2.12€)
Seat 6: Fried Berg (0.57€)
*** ANTE/BLINDS ***
strada2012 posts small blind 0.01€
14cruyff14 posts big blind 0.02€
Dealt to Fried Berg [Js 2c]
*** PRE-FLOP *** 
Tr0-_-L3urr3 folds
Yondaime M raises 0.03€ to 0.05€
Kangourou_JJ folds
Fried Berg folds
strada2012 folds
14cruyff14 folds
Yondaime M collected 0.08€ from pot
*** SUMMARY ***
Total pot 0.08€ | No rake
Seat 4: Yondaime M won 0.08€


Winamax Poker - HOLD-UP "Colorado" - HandId: #19116069-345986-1701443099 - Holdem no limit (0.01€/0.02€) - 2023/12/01 15:04:59 UTC
Table: 'Colorado' 6-max (real money) Seat #6 is the button
Seat 1: Kaoky (2.18€)
Seat 2: Fried Berg (0.57€)
Seat 3: vicoaudrey11 (1.15€)
Seat 4: tobytom (2.16€)
Seat 5: KON-2-PEUTE (2.22€)
Seat 6: DGG23 (0.22€)
*** ANTE/BLINDS ***
Kaoky posts small blind 0.01€
Fried Berg posts big blind 0.02€
Dealt to Fried Berg [9c 2s]
*** PRE-FLOP *** 
vicoaudrey11 calls 0.02€
tobytom raises 0.07€ to 0.09€
KON-2-PEUTE folds
DGG23 folds
Kaoky folds
Fried Berg folds
vicoaudrey11 calls 0.07€
*** FLOP *** [6h 2c 2d]
vicoaudrey11 checks
tobytom checks
*** TURN *** [6h 2c 2d][Ks]
vicoaudrey11 checks
tobytom checks
*** RIVER *** [6h 2c 2d Ks][Jc]
vicoaudrey11 checks
tobytom checks
*** SHOW DOWN ***
vicoaudrey11 shows [5s 4s] (One pair : 2)
tobytom shows [As Qh] (One pair : 2)
tobytom collected 0.19€ from pot
*** SUMMARY ***
Total pot 0.19€ | Rake 0.02€
Board: [6h 2c 2d Ks Jc]
Seat 3: vicoaudrey11 showed [5s 4s] and lost with One pair : 2
Seat 4: tobytom showed [As Qh] and won 0.19€ with One pair : 2


Winamax Poker - HOLD-UP "Colorado" - HandId: #19116069-346008-1701443111 - Holdem no limit (0.01€/0.02€) - 2023/12/01 15:05:11 UTC
Table: 'Colorado' 6-max (real money) Seat #6 is the button
Seat 1: Fried Berg (0.55€)
Seat 2: DGG23 (0.41€)
Seat 3: curiouz dje (2.81€)
Seat 4: KKamarAAde (2€)
Seat 5: freddytooo (2€)
Seat 6: Faramiix57 (2.16€)
*** ANTE/BLINDS ***
Fried Berg posts small blind 0.01€
DGG23 posts big blind 0.02€
Dealt to Fried Berg [Qd Tc]
*** PRE-FLOP *** 
curiouz dje folds
KKamarAAde folds
freddytooo folds
Faramiix57 raises 0.04€ to 0.06€
Fried Berg folds
DGG23 calls 0.04€
*** FLOP *** [6s 2c As]
DGG23 checks
Faramiix57 bets 0.05€
DGG23 raises 0.30€ to 0.35€ and is all-in
Faramiix57 folds
DGG23 collected 0.51€ from pot
*** SUMMARY ***
Total pot 0.51€ | Rake 0.02€
Board: [6s 2c As]
Seat 2: DGG23 (big blind) won 0.51€


Winamax Poker - HOLD-UP "Colorado" - HandId: #19116069-346023-1701443118 - Holdem no limit (0.01€/0.02€) - 2023/12/01 15:05:18 UTC
Table: 'Colorado' 6-max (real money) Seat #6 is the button
Seat 1: gil95100 (2.96€)
Seat 2: bastos2525 (1.87€)
Seat 3: Fried Berg (0.54€)
Seat 4: curiouz dje (3.92€)
Seat 5: _FanZ_ (2.11€)
Seat 6: vegifish (2€)
*** ANTE/BLINDS ***
gil95100 posts small blind 0.01€
bastos2525 posts big blind 0.02€
Dealt to Fried Berg [2d 6d]
*** PRE-FLOP *** 
Fried Berg folds
curiouz dje folds
_FanZ_ folds
vegifish folds
gil95100 calls 0.01€
bastos2525 checks
*** FLOP *** [Th Kh 9h]
gil95100 checks
bastos2525 checks
*** TURN *** [Th Kh 9h][Js]
gil95100 checks
bastos2525 checks
*** RIVER *** [Th Kh 9h Js][6s]
gil95100 bets 0.06€
bastos2525 folds
gil95100 collected 0.10€ from pot
*** SUMMARY ***
Total pot 0.10€ | No rake
Board: [Th Kh 9h Js 6s]
Seat 1: gil95100 (small blind) won 0.10€


Winamax Poker - HOLD-UP "Colorado" - HandId: #19116069-346027-1701443121 - Holdem no limit (0.01€/0.02€) - 2023/12/01 15:05:21 UTC
Table: 'Colorado' 6-max (real money) Seat #6 is the button
Seat 1: Thequeen1205 (2.57€)
Seat 2: bananAsSplit (2€)
Seat 3: KKamarAAde (2€)
Seat 4: Fried Berg (0.54€)
Seat 5: DosdeBras (0.82€)
Seat 6: Xnikos2X (2.11€)
*** ANTE/BLINDS ***
Thequeen1205 posts small blind 0.01€
bananAsSplit posts big blind 0.02€
Dealt to Fried Berg [2h 4h]
*** PRE-FLOP *** 
KKamarAAde folds
Fried Berg folds
DosdeBras raises 0.04€ to 0.06€
Xnikos2X folds
Thequeen1205 calls 0.05€
bananAsSplit folds
*** FLOP *** [8c 4d Qs]
Thequeen1205 checks
DosdeBras bets 0.06€
Thequeen1205 calls 0.06€
*** TURN *** [8c 4d Qs][2d]
Thequeen1205 checks
DosdeBras checks
*** RIVER *** [8c 4d Qs 2d][Kc]
Thequeen1205 checks
DosdeBras checks
*** SHOW DOWN ***
Thequeen1205 shows [5c Ac] (High card : Ace)
DosdeBras shows [7c 7s] (One pair : 7)
DosdeBras collected 0.23€ from pot
*** SUMMARY ***
Total pot 0.23€ | Rake 0.03€
Board: [8c 4d Qs 2d Kc]
Seat 1: Thequeen1205 (small blind) showed [5c Ac] and lost with High card : Ace
Seat 5: DosdeBras showed [7c 7s] and won 0.23€ with One pair : 7


Winamax Poker - HOLD-UP "Colorado" - HandId: #19116069-346030-1701443122 - Holdem no limit (0.01€/0.02€) - 2023/12/01 15:05:22 UTC
Table: 'Colorado' 6-max (real money) Seat #6 is the button
Seat 1: KON-2-PEUTE (2.04€)
Seat 2: _FanZ_ (2.11€)
Seat 3: gueyf (1.96€)
Seat 4: Calimort (0.54€)
Seat 5: Fried Berg (0.54€)
Seat 6: Kangourou_JJ (2.08€)
*** ANTE/BLINDS ***
KON-2-PEUTE posts small blind 0.01€
_FanZ_ posts big blind 0.02€
Dealt to Fried Berg [Kh Qd]
*** PRE-FLOP *** 
gueyf folds
Calimort calls 0.02€
Fried Berg raises 0.04€ to 0.06€
Kangourou_JJ folds
KON-2-PEUTE folds
_FanZ_ folds
Calimort calls 0.04€
*** FLOP *** [6s 6d 8s]
Calimort checks
Fried Berg checks
*** TURN *** [6s 6d 8s][5d]
Calimort bets 0.10€
Fried Berg calls 0.10€
*** RIVER *** [6s 6d 8s 5d][7h]
Calimort checks
Fried Berg checks
*** SHOW DOWN ***
Fried Berg shows [Kh Qd] (One pair : 6)
Calimort shows [5c Jh] (Two pairs : 6 and 5)
Calimort collected 0.31€ from pot
*** SUMMARY ***
Total pot 0.31€ | Rake 0.04€
Board: [6s 6d 8s 5d 7h]
Seat 4: Calimort showed [5c Jh] and won 0.31€ with Two pairs : 6 and 5
Seat 5: Fried Berg showed [Kh Qd] and lost with One pair : 6


Winamax Poker - HOLD-UP "Colorado" - HandId: #19116069-346128-1701443171 - Holdem no limit (0.01€/0.02€) - 2023/12/01 15:06:11 UTC
Table: 'Colorado' 6-max (real money) Seat #6 is the button
Seat 1: batiflopllc (1.68€)
Seat 2: Neferusobek (2.40€)
Seat 3: bananAsSplit (2.04€)
Seat 4: vegifish (2.29€)
Seat 5: Calimort (0.69€)
Seat 6: Fried Berg (0.38€)
*** ANTE/BLINDS ***
batiflopllc posts small blind 0.01€
Neferusobek posts big blind 0.02€
Dealt to Fried Berg [7h 3c]
*** PRE-FLOP *** 
bananAsSplit folds
vegifish folds
Calimort calls 0.02€
Fried Berg folds
batiflopllc folds
Neferusobek checks
*** FLOP *** [9s 3d 6h]
Neferusobek checks
Calimort bets 0.05€
Neferusobek folds
Calimort collected 0.09€ from pot
*** SUMMARY ***
Total pot 0.09€ | Rake 0.01€
Board: [9s 3d 6h]
Seat 5: Calimort won 0.09€


Winamax Poker - HOLD-UP "Colorado" - HandId: #19116069-346146-1701443180 - Holdem no limit (0.01€/0.02€) - 2023/12/01 15:06:20 UTC
Table: 'Colorado' 6-max (real money) Seat #6 is the button
Seat 1: _FanZ_ (2.15€)
Seat 2: Fried Berg (0.38€)
Seat 3: DonKmillo (4.71€)
Seat 4: J.C Deuces.0 (1.90€)
Seat 5: KON-2-PEUTE (2€)
Seat 6: AceOf_Spades (1.94€)
*** ANTE/BLINDS ***
_FanZ_ posts small blind 0.01€
Fried Berg posts big blind 0.02€
Dealt to Fried Berg [5h 9h]
*** PRE-FLOP *** 
DonKmillo folds
J.C Deuces.0 raises 0.04€ to 0.06€
KON-2-PEUTE folds
AceOf_Spades folds
_FanZ_ folds
Fried Berg folds
J.C Deuces.0 collected 0.09€ from pot
*** SUMMARY ***
Total pot 0.09€ | No rake
Seat 4: J.C Deuces.0 won 0.09€


Winamax Poker - HOLD-UP "Colorado" - HandId: #19116069-346174-1701443191 - Holdem no limit (0.01€/0.02€) - 2023/12/01 15:06:31 UTC
Table: 'Colorado' 6-max (real money) Seat #6 is the button
Seat 1: Fried Berg (0.36€)
Seat 2: Ilya1mai (3.79€)
Seat 3: MR-Sniper274 (1.03€)
Seat 4: Shadow b97 (0.30€)
Seat 5: Erenox (2.01€)
Seat 6: Kaoky (7.06€)
*** ANTE/BLINDS ***
Fried Berg posts small blind 0.01€
Ilya1mai posts big blind 0.02€
Dealt to Fried Berg [8d 4d]
*** PRE-FLOP *** 
MR-Sniper274 folds
Shadow b97 calls 0.02€
Erenox folds
Kaoky folds
Fried Berg folds
Ilya1mai checks
*** FLOP *** [Ac Qh Ah]
Ilya1mai checks
Shadow b97 checks
*** TURN *** [Ac Qh Ah][Td]
Ilya1mai checks
Shadow b97 bets 0.02€
Ilya1mai folds
Shadow b97 collected 0.06€ from pot
*** SUMMARY ***
Total pot 0.06€ | Rake 0.01€
Board: [Ac Qh Ah Td]
Seat 4: Shadow b97 won 0.06€


Winamax Poker - HOLD-UP "Colorado" - HandId: #19116069-346180-1701443194 - Holdem no limit (0.01€/0.02€) - 2023/12/01 15:06:34 UTC
Table: 'Colorado' 6-max (real money) Seat #6 is the button
Seat 1: Syeeda (2€)
Seat 2: matmyl (2€)
Seat 3: Fried Berg (0.35€)
Seat 4: curiouz dje (2.76€)
Seat 5: DGG23 (0.51€)
Seat 6: Salvinha710 (2.27€)
*** ANTE/BLINDS ***
Syeeda posts small blind 0.01€
matmyl posts big blind 0.02€
Dealt to Fried Berg [Ad 9d]
*** PRE-FLOP *** 
Fried Berg raises 0.04€ to 0.06€
curiouz dje folds
DGG23 folds
Salvinha710 folds
Syeeda folds
matmyl folds
Fried Berg collected 0.09€ from pot
*** SUMMARY ***
Total pot 0.09€ | No rake
Seat 3: Fried Berg won 0.09€


Winamax Poker - HOLD-UP "Colorado" - HandId: #19116069-346202-1701443203 - Holdem no limit (0.01€/0.02€) - 2023/12/01 15:06:43 UTC
Table: 'Colorado' 6-max (real money) Seat #6 is the button
Seat 1: Pay TaxT0Xav (2.08€)
Seat 2: Fran1Oller (2.05€)
Seat 3: Dios unic464 (0.48€)
Seat 4: Fried Berg (0.38€)
Seat 5: DosdeBras (0.98€)
Seat 6: LDL1 (1.54€)
*** ANTE/BLINDS ***
Pay TaxT0Xav posts small blind 0.01€
Fran1Oller posts big blind 0.02€
Dealt to Fried Berg [5d 7h]
*** PRE-FLOP *** 
Dios unic464 raises 0.02€ to 0.04€
Fried Berg folds
DosdeBras folds
LDL1 folds
Pay TaxT0Xav calls 0.03€
Fran1Oller raises 0.12€ to 0.16€
Dios unic464 calls 0.12€
Pay TaxT0Xav calls 0.12€
*** FLOP *** [Ks Ad 3s]
Pay TaxT0Xav checks
Fran1Oller bets 0.17€
Dios unic464 folds
Pay TaxT0Xav folds
Fran1Oller collected 0.60€ from pot
*** SUMMARY ***
Total pot 0.60€ | Rake 0.05€
Board: [Ks Ad 3s]
Seat 2: Fran1Oller (big blind) won 0.60€


Winamax Poker - HOLD-UP "Colorado" - HandId: #19116069-346208-1701443207 - Holdem no limit (0.01€/0.02€) - 2023/12/01 15:06:47 UTC
Table: 'Colorado' 6-max (real money) Seat #6 is the button
Seat 1: tobytom (3.96€)
Seat 2: ANG55 (0.59€)
Seat 3: bananAsSplit (2.10€)
Seat 4: Brut2pok (3.64€)
Seat 5: Fried Berg (0.38€)
Seat 6: Faramiix57 (2.08€)
*** ANTE/BLINDS ***
tobytom posts small blind 0.01€
ANG55 posts big blind 0.02€
Dealt to Fried Berg [Tc 8c]
*** PRE-FLOP *** 
bananAsSplit folds
Brut2pok raises 0.04€ to 0.06€
Fried Berg calls 0.06€
Faramiix57 folds
tobytom folds
ANG55 folds
*** FLOP *** [Qs Ks 2d]
Brut2pok bets 0.15€
Fried Berg folds
Brut2pok collected 0.28€ from pot
*** SUMMARY ***
Total pot 0.28€ | Rake 0.02€
Board: [Qs Ks 2d]
Seat 4: Brut2pok won 0.28€


Winamax Poker - HOLD-UP "Colorado" - HandId: #19116069-346251-1701443230 - Holdem no limit (0.01€/0.02€) - 2023/12/01 15:07:10 UTC
Table: 'Colorado' 6-max (real money) Seat #6 is the button
Seat 1: Maracujaaaa (2€)
Seat 2: Elkebabio (2.58€)
Seat 3: LilRun (1.19€)
Seat 4: Beralopette (1.03€)
Seat 5: Fried Berg (0.32€)
Seat 6: bananAsSplit (2.65€)
*** ANTE/BLINDS ***
Maracujaaaa posts small blind 0.01€
Elkebabio posts big blind 0.02€
Dealt to Fried Berg [2c 9c]
*** PRE-FLOP *** 
LilRun folds
Beralopette folds
Fried Berg folds
bananAsSplit folds
Maracujaaaa folds
Elkebabio collected 0.03€ from pot
*** SUMMARY ***
Total pot 0.03€ | No rake
Seat 2: Elkebabio (big blind) won 0.03€


Winamax Poker - HOLD-UP "Colorado" - HandId: #19116069-346255-1701443232 - Holdem no limit (0.01€/0.02€) - 2023/12/01 15:07:12 UTC
Table: 'Colorado' 6-max (real money) Seat #6 is the button
Seat 1: El tiki tiki (2.10€)
Seat 2: Fried Berg (0.32€)
Seat 3: gueyf (1.91€)
Seat 4: haouuum28 (3.73€)
Seat 5: Mac2luxe_Bzh (2€)
Seat 6: Thequeen1205 (2.40€)
*** ANTE/BLINDS ***
El tiki tiki posts small blind 0.01€
Fried Berg posts big blind 0.02€
Dealt to Fried Berg [7c Kd]
*** PRE-FLOP *** 
gueyf folds
haouuum28 folds
Mac2luxe_Bzh folds
Thequeen1205 folds
El tiki tiki folds
Fried Berg collected 0.03€ from pot
*** SUMMARY ***
Total pot 0.03€ | No rake
Seat 2: Fried Berg (big blind) won 0.03€


Winamax Poker - HOLD-UP "Colorado" - HandId: #19116069-346440-1701443335 - Holdem no limit (0.01€/0.02€) - 2023/12/01 15:08:55 UTC
Table: 'Colorado' 6-max (real money) Seat #6 is the button
Seat 1: Fried Berg (0.33€)
Seat 2: Faramiix57 (2€)
Seat 3: cecilon (0.50€)
Seat 4: Ilya1mai (3.66€)
Seat 5: John  95 (1.16€)
Seat 6: Dario 365 (2.83€)
*** ANTE/BLINDS ***
Fried Berg posts small blind 0.01€
Faramiix57 posts big blind 0.02€
Dealt to Fried Berg [Td 5s]
*** PRE-FLOP *** 
cecilon folds
Ilya1mai folds
John  95 calls 0.02€
Dario 365 raises 0.07€ to 0.09€
Fried Berg folds
Faramiix57 folds
John  95 calls 0.07€
*** FLOP *** [Qh 4d Kd]
John  95 bets 0.14€
Dario 365 calls 0.14€
*** TURN *** [Qh 4d Kd][6s]
John  95 bets 0.17€
Dario 365 calls 0.17€
*** RIVER *** [Qh 4d Kd 6s][5c]
John  95 bets 0.76€ and is all-in
Dario 365 folds
John  95 collected 1.51€ from pot
*** SUMMARY ***
Total pot 1.51€ | Rake 0.08€
Board: [Qh 4d Kd 6s 5c]
Seat 5: John  95 won 1.51€


Winamax Poker - HOLD-UP "Colorado" - HandId: #19116069-346459-1701443345 - Holdem no limit (0.01€/0.02€) - 2023/12/01 15:09:05 UTC
Table: 'Colorado' 6-max (real money) Seat #6 is the button
Seat 1: Duality2 (2€)
Seat 2: T.REx. (4.10€)
Seat 3: Fried Berg (0.32€)
Seat 4: Thequeen1205 (3.82€)
Seat 5: Kangourou_JJ (2.06€)
Seat 6: Xnikos2X (2.16€)
*** ANTE/BLINDS ***
Duality2 posts small blind 0.01€
T.REx. posts big blind 0.02€
Dealt to Fried Berg [5c 6c]
*** PRE-FLOP *** 
Fried Berg raises 0.02€ to 0.04€
Thequeen1205 folds
Kangourou_JJ folds
Xnikos2X folds
Duality2 folds
T.REx. folds
Fried Berg collected 0.07€ from pot
*** SUMMARY ***
Total pot 0.07€ | No rake
Seat 3: Fried Berg won 0.07€


Winamax Poker - HOLD-UP "Colorado" - HandId: #19116069-346499-1701443367 - Holdem no limit (0.01€/0.02€) - 2023/12/01 15:09:27 UTC
Table: 'Colorado' 6-max (real money) Seat #6 is the button
Seat 1: Prudempoker (1.84€)
Seat 2: KON-2-PEUTE (2.48€)
Seat 3: Ertorko (2€)
Seat 4: ABDELBEYADH (0.32€)
Seat 5: bananAsSplit (2.06€)
Seat 6: Fried Berg (0.35€)
*** ANTE/BLINDS ***
Prudempoker posts small blind 0.01€
KON-2-PEUTE posts big blind 0.02€
Dealt to Fried Berg [7s 8d]
*** PRE-FLOP *** 
Ertorko folds
ABDELBEYADH folds
bananAsSplit folds
Fried Berg raises 0.02€ to 0.04€
Prudempoker calls 0.03€
KON-2-PEUTE folds
*** FLOP *** [6s 6h Ac]
Prudempoker checks
Fried Berg checks
*** TURN *** [6s 6h Ac][Qs]
Prudempoker checks
Fried Berg checks
*** RIVER *** [6s 6h Ac Qs][7c]
Prudempoker checks
Fried Berg checks
*** SHOW DOWN ***
Fried Berg shows [7s 8d] (Two pairs : 7 and 6)
Prudempoker shows [Qh 9h] (Two pairs : Queens and 6)
Prudempoker collected 0.09€ from pot
*** SUMMARY ***
Total pot 0.09€ | Rake 0.01€
Board: [6s 6h Ac Qs 7c]
Seat 1: Prudempoker (small blind) showed [Qh 9h] and won 0.09€ with Two pairs : Queens and 6
Seat 6: Fried Berg (button) showed [7s 8d] and lost with Two pairs : 7 and 6


Winamax Poker - HOLD-UP "Colorado" - HandId: #19116069-346542-1701443390 - Holdem no limit (0.01€/0.02€) - 2023/12/01 15:09:50 UTC
Table: 'Colorado' 6-max (real money) Seat #6 is the button
Seat 1: Amazigh 78 (1.39€)
Seat 2: vegifish (2.23€)
Seat 3: Tr0-_-L3urr3 (3.90€)
Seat 4: Fried Berg (0.31€)
Seat 5: Prudempoker (1.89€)
Seat 6: Thequeen1205 (2.34€)
*** ANTE/BLINDS ***
Amazigh 78 posts small blind 0.01€
vegifish posts big blind 0.02€
Dealt to Fried Berg [2h Kd]
*** PRE-FLOP *** 
Tr0-_-L3urr3 folds
Fried Berg folds
Prudempoker folds
Thequeen1205 folds
Amazigh 78 folds
vegifish collected 0.03€ from pot
*** SUMMARY ***
Total pot 0.03€ | No rake
Seat 2: vegifish (big blind) won 0.03€


Winamax Poker - HOLD-UP "Colorado" - HandId: #19116069-346549-1701443393 - Holdem no limit (0.01€/0.02€) - 2023/12/01 15:09:53 UTC
Table: 'Colorado' 6-max (real money) Seat #6 is the button
Seat 1: tobytom (3.35€)
Seat 2: Thequeen1205 (2.34€)
Seat 3: Fried Berg (0.31€)
Seat 4: KON-2-PEUTE (2.03€)
Seat 5: batiflopllc (2.64€)
Seat 6: Erenox (2.49€)
*** ANTE/BLINDS ***
tobytom posts small blind 0.01€
Thequeen1205 posts big blind 0.02€
Dealt to Fried Berg [4h 4s]
*** PRE-FLOP *** 
Fried Berg folds
KON-2-PEUTE folds
batiflopllc folds
Erenox raises 0.04€ to 0.06€
tobytom folds
Thequeen1205 folds
Erenox collected 0.09€ from pot
*** SUMMARY ***
Total pot 0.09€ | No rake
Seat 6: Erenox (button) won 0.09€


Winamax Poker - HOLD-UP "Colorado" - HandId: #19116069-346556-1701443396 - Holdem no limit (0.01€/0.02€) - 2023/12/01 15:09:56 UTC
Table: 'Colorado' 6-max (real money) Seat #6 is the button
Seat 1: titituf (0.48€)
Seat 2: Fried Berg (0.31€)
Seat 3: Ertorko (2.03€)
Seat 4: Kaoky (7.01€)
Seat 5: BobiBogdanov (2.36€)
Seat 6: julien08090 (1.65€)
*** ANTE/BLINDS ***
titituf posts small blind 0.01€
Fried Berg posts big blind 0.02€
Dealt to Fried Berg [Jd Qh]
*** PRE-FLOP *** 
Ertorko folds
Kaoky folds
BobiBogdanov folds
julien08090 calls 0.02€
titituf folds
Fried Berg checks
*** FLOP *** [Qs 2c Kc]
Fried Berg checks
julien08090 bets 0.05€
Fried Berg calls 0.05€
*** TURN *** [Qs 2c Kc][5h]
Fried Berg checks
julien08090 checks
*** RIVER *** [Qs 2c Kc 5h][7h]
Fried Berg checks
julien08090 checks
*** SHOW DOWN ***
julien08090 shows [8h 7c] (One pair : 7)
Fried Berg shows [Jd Qh] (One pair : Queens)
Fried Berg collected 0.13€ from pot
*** SUMMARY ***
Total pot 0.13€ | Rake 0.02€
Board: [Qs 2c Kc 5h 7h]
Seat 2: Fried Berg (big blind) showed [Jd Qh] and won 0.13€ with One pair : Queens
Seat 6: julien08090 (button) showed [8h 7c] and lost with One pair : 7


Winamax Poker - HOLD-UP "Colorado" - HandId: #19116069-346610-1701443422 - Holdem no limit (0.01€/0.02€) - 2023/12/01 15:10:22 UTC
Table: 'Colorado' 6-max (real money) Seat #6 is the button
Seat 1: Fried Berg (0.37€)
Seat 2: julien08090 (1.58€)
Seat 3: MFCBronson (3.86€)
Seat 4: JuNeufQs (1.74€)
Seat 5: Brut2pok (2.10€)
Seat 6: bananAsSplit (2.06€)
*** ANTE/BLINDS ***
Fried Berg posts small blind 0.01€
julien08090 posts big blind 0.02€
Dealt to Fried Berg [7d 7h]
*** PRE-FLOP *** 
MFCBronson folds
JuNeufQs folds
Brut2pok folds
bananAsSplit folds
Fried Berg raises 0.04€ to 0.06€
julien08090 calls 0.04€
*** FLOP *** [Kd 9s Tc]
Fried Berg checks
julien08090 checks
*** TURN *** [Kd 9s Tc][5d]
Fried Berg checks
julien08090 checks
*** RIVER *** [Kd 9s Tc 5d][6d]
Fried Berg bets 0.02€
julien08090 calls 0.02€
*** SHOW DOWN ***
julien08090 shows [Qc 8c] (High card : King)
Fried Berg shows [7d 7h] (One pair : 7)
Fried Berg collected 0.14€ from pot
*** SUMMARY ***
Total pot 0.14€ | Rake 0.02€
Board: [Kd 9s Tc 5d 6d]
Seat 1: Fried Berg (small blind) showed [7d 7h] and won 0.14€ with One pair : 7
Seat 2: julien08090 (big blind) showed [Qc 8c] and lost with High card : King


Winamax Poker - HOLD-UP "Colorado" - HandId: #19116069-346662-1701443451 - Holdem no limit (0.01€/0.02€) - 2023/12/01 15:10:51 UTC
Table: 'Colorado' 6-max (real money) Seat #6 is the button
Seat 1: _FanZ_ (2.14€)
Seat 2: Thequeen1205 (3.77€)
Seat 3: vegifish (2.13€)
Seat 4: Myriamneuf (0.75€)
Seat 5: Fried Berg (0.43€)
Seat 6: Jerrycan57 (4.34€)
*** ANTE/BLINDS ***
_FanZ_ posts small blind 0.01€
Thequeen1205 posts big blind 0.02€
Dealt to Fried Berg [5s 7h]
*** PRE-FLOP *** 
vegifish folds
Myriamneuf calls 0.02€
Fried Berg folds
Jerrycan57 folds
_FanZ_ folds
Thequeen1205 checks
*** FLOP *** [9s 8d 3c]
Thequeen1205 bets 0.02€
Myriamneuf calls 0.02€
*** TURN *** [9s 8d 3c][Ac]
Thequeen1205 bets 0.05€
Myriamneuf calls 0.05€
*** RIVER *** [9s 8d 3c Ac][2s]
Thequeen1205 checks
Myriamneuf bets 0.12€
Thequeen1205 folds
Myriamneuf collected 0.29€ from pot
*** SUMMARY ***
Total pot 0.29€ | Rake 0.02€
Board: [9s 8d 3c Ac 2s]
Seat 4: Myriamneuf won 0.29€


Winamax Poker - HOLD-UP "Colorado" - HandId: #19116069-346675-1701443457 - Holdem no limit (0.01€/0.02€) - 2023/12/01 15:10:57 UTC
Table: 'Colorado' 6-max (real money) Seat #6 is the button
Seat 1: DonKmillo (4.58€)
Seat 2: sopra61 (3.34€)
Seat 3: Dios unic464 (0.49€)
Seat 4: Fried Berg (0.43€)
Seat 5: Amazigh 78 (1.04€)
Seat 6: matmyl (2.12€)
*** ANTE/BLINDS ***
DonKmillo posts small blind 0.01€
sopra61 posts big blind 0.02€
Dealt to Fried Berg [Qc As]
*** PRE-FLOP *** 
Dios unic464 folds
Fried Berg raises 0.04€ to 0.06€
Amazigh 78 folds
matmyl raises 0.12€ to 0.18€
DonKmillo folds
sopra61 folds
Fried Berg calls 0.12€
*** FLOP *** [Qs 7h 9s]
Fried Berg bets 0.25€ and is all-in
matmyl folds
Fried Berg collected 0.60€ from pot
*** SUMMARY ***
Total pot 0.60€ | Rake 0.04€
Board: [Qs 7h 9s]
Seat 4: Fried Berg won 0.60€


Winamax Poker - HOLD-UP "Colorado" - HandId: #19116069-346733-1701443490 - Holdem no limit (0.01€/0.02€) - 2023/12/01 15:11:30 UTC
Table: 'Colorado' 6-max (real money) Seat #6 is the button
Seat 1: vegifish (2.03€)
Seat 2: him14689 (0.82€)
Seat 3: KKamarAAde (4.11€)
Seat 4: MFCBronson (3.83€)
Seat 5: matmyl (2.14€)
Seat 6: Fried Berg (0.60€)
*** ANTE/BLINDS ***
vegifish posts small blind 0.01€
him14689 posts big blind 0.02€
Dealt to Fried Berg [3h 9c]
*** PRE-FLOP *** 
KKamarAAde folds
MFCBronson folds
matmyl raises 0.03€ to 0.05€
Fried Berg folds
vegifish folds
him14689 calls 0.03€
*** FLOP *** [4d 8c 8h]
him14689 bets 0.07€
matmyl folds
him14689 collected 0.17€ from pot
*** SUMMARY ***
Total pot 0.17€ | Rake 0.01€
Board: [4d 8c 8h]
Seat 2: him14689 (big blind) won 0.17€


Winamax Poker - HOLD-UP "Colorado" - HandId: #19116069-346741-1701443495 - Holdem no limit (0.01€/0.02€) - 2023/12/01 15:11:35 UTC
Table: 'Colorado' 6-max (real money) Seat #6 is the button
Seat 1: KKamarAAde (4.11€)
Seat 2: MFCBronson (3.83€)
Seat 3: 14cruyff14 (0.50€)
Seat 4: bananAsSplit (2.09€)
Seat 5: OursDesMers (2€)
Seat 6: Fried Berg (0.60€)
*** ANTE/BLINDS ***
KKamarAAde posts small blind 0.01€
MFCBronson posts big blind 0.02€
Dealt to Fried Berg [Qc 3c]
*** PRE-FLOP *** 
14cruyff14 folds
bananAsSplit folds
OursDesMers folds
Fried Berg raises 0.02€ to 0.04€
KKamarAAde calls 0.03€
MFCBronson folds
*** FLOP *** [6c 4s 2h]
KKamarAAde checks
Fried Berg checks
*** TURN *** [6c 4s 2h][Ad]
KKamarAAde checks
Fried Berg checks
*** RIVER *** [6c 4s 2h Ad][8c]
KKamarAAde bets 0.08€
Fried Berg folds
KKamarAAde collected 0.17€ from pot
*** SUMMARY ***
Total pot 0.17€ | Rake 0.01€
Board: [6c 4s 2h Ad 8c]
Seat 1: KKamarAAde (small blind) won 0.17€


Winamax Poker - HOLD-UP "Colorado" - HandId: #19116069-346803-1701443526 - Holdem no limit (0.01€/0.02€) - 2023/12/01 15:12:06 UTC
Table: 'Colorado' 6-max (real money) Seat #6 is the button
Seat 1: TONETONE510 (1.02€)
Seat 2: Fried Berg (0.56€)
Seat 3: DGG23 (0.47€)
Seat 4: Thequeen1205 (2.20€)
Seat 5: SharkAKK (2.43€)
Seat 6: _FanZ_ (2.07€)
*** ANTE/BLINDS ***
TONETONE510 posts small blind 0.01€
Fried Berg posts big blind 0.02€
Dealt to Fried Berg [As 5s]
*** PRE-FLOP *** 
DGG23 folds
Thequeen1205 folds
SharkAKK folds
_FanZ_ folds
TONETONE510 folds
Fried Berg collected 0.03€ from pot
*** SUMMARY ***
Total pot 0.03€ | No rake
Seat 2: Fried Berg (big blind) won 0.03€


Winamax Poker - HOLD-UP "Colorado" - HandId: #19116069-346821-1701443537 - Holdem no limit (0.01€/0.02€) - 2023/12/01 15:12:17 UTC
Table: 'Colorado' 6-max (real money) Seat #6 is the button
Seat 1: Beralopette (1.21€)
Seat 2: Prudempoker (2.55€)
Seat 3: Fried Berg (0.57€)
Seat 4: Ilya1mai (3.42€)
Seat 5: Bback (4.59€)
Seat 6: Thequeen1205 (3.61€)
*** ANTE/BLINDS ***
Beralopette posts small blind 0.01€
Prudempoker posts big blind 0.02€
Dealt to Fried Berg [5h Kd]
*** PRE-FLOP *** 
Fried Berg folds
Ilya1mai calls 0.02€
Bback folds
Thequeen1205 folds
Beralopette folds
Prudempoker checks
*** FLOP *** [As 4d 8s]
Prudempoker checks
Ilya1mai checks
*** TURN *** [As 4d 8s][Qc]
Prudempoker checks
Ilya1mai checks
*** RIVER *** [As 4d 8s Qc][3s]
Prudempoker checks
Ilya1mai bets 0.04€
Prudempoker folds
Ilya1mai collected 0.08€ from pot
*** SUMMARY ***
Total pot 0.08€ | Rake 0.01€
Board: [As 4d 8s Qc 3s]
Seat 4: Ilya1mai won 0.08€


Winamax Poker - HOLD-UP "Colorado" - HandId: #19116069-346825-1701443540 - Holdem no limit (0.01€/0.02€) - 2023/12/01 15:12:20 UTC
Table: 'Colorado' 6-max (real money) Seat #6 is the button
Seat 1: Fried Berg (0.57€)
Seat 2: JFSredbaron (2.15€)
Seat 3: Bback (4.59€)
Seat 4: Fran1Oller (4.07€)
Seat 5: Tr0-_-L3urr3 (4.50€)
Seat 6: Beralopette (1.20€)
*** ANTE/BLINDS ***
Fried Berg posts small blind 0.01€
JFSredbaron posts big blind 0.02€
Dealt to Fried Berg [Qh 5c]
*** PRE-FLOP *** 
Bback folds
Fran1Oller folds
Tr0-_-L3urr3 folds
Beralopette raises 0.03€ to 0.05€
Fried Berg folds
JFSredbaron calls 0.03€
*** FLOP *** [3c 7s Js]
JFSredbaron checks
Beralopette bets 0.07€
JFSredbaron folds
Beralopette collected 0.17€ from pot
*** SUMMARY ***
Total pot 0.17€ | Rake 0.01€
Board: [3c 7s Js]
Seat 6: Beralopette (button) won 0.17€


Winamax Poker - HOLD-UP "Colorado" - HandId: #19116069-346828-1701443542 - Holdem no limit (0.01€/0.02€) - 2023/12/01 15:12:22 UTC
Table: 'Colorado' 6-max (real money) Seat #6 is the button
Seat 1: Syeeda (2.43€)
Seat 2: Jerrycan57 (2.12€)
Seat 3: 14cruyff14 (0.53€)
Seat 4: vegifish (1.86€)
Seat 5: Fried Berg (0.56€)
Seat 6: KON-2-PEUTE (2.50€)
*** ANTE/BLINDS ***
Syeeda posts small blind 0.01€
Jerrycan57 posts big blind 0.02€
Dealt to Fried Berg [8s Kc]
*** PRE-FLOP *** 
14cruyff14 folds
vegifish folds
Fried Berg folds
KON-2-PEUTE folds
Syeeda folds
Jerrycan57 collected 0.03€ from pot
*** SUMMARY ***
Total pot 0.03€ | No rake
Seat 2: Jerrycan57 (big blind) won 0.03€


Winamax Poker - HOLD-UP "Colorado" - HandId: #19116069-346831-1701443544 - Holdem no limit (0.01€/0.02€) - 2023/12/01 15:12:24 UTC
Table: 'Colorado' 6-max (real money) Seat #6 is the button
Seat 1: Eychem24 (0.50€)
Seat 2: bananAsSplit (2.07€)
Seat 3: Thequeen1205 (2€)
Seat 4: Fried Berg (0.56€)
Seat 5: Salvinha710 (2.51€)
Seat 6: JissEl1te (2.94€)
*** ANTE/BLINDS ***
Eychem24 posts small blind 0.01€
bananAsSplit posts big blind 0.02€
Dealt to Fried Berg [8s 3d]
*** PRE-FLOP *** 
Thequeen1205 folds
Fried Berg folds
Salvinha710 raises 0.02€ to 0.04€
JissEl1te folds
Eychem24 folds
bananAsSplit calls 0.02€
*** FLOP *** [5s 2h 5d]
bananAsSplit checks
Salvinha710 checks
*** TURN *** [5s 2h 5d][Qd]
bananAsSplit checks
Salvinha710 bets 0.03€
bananAsSplit folds
Salvinha710 collected 0.11€ from pot
*** SUMMARY ***
Total pot 0.11€ | Rake 0.01€
Board: [5s 2h 5d Qd]
Seat 5: Salvinha710 won 0.11€


Winamax Poker - HOLD-UP "Colorado" - HandId: #19116069-346833-1701443545 - Holdem no limit (0.01€/0.02€) - 2023/12/01 15:12:25 UTC
Table: 'Colorado' 6-max (real money) Seat #6 is the button
Seat 1: Fran1Oller (4.07€)
Seat 2: loncholoncho (3.62€)
Seat 3: vatoloco26 (1.51€)
Seat 4: Ertorko (2.35€)
Seat 5: Fried Berg (0.56€)
Seat 6: DGG23 (0.29€)
*** ANTE/BLINDS ***
Fran1Oller posts small blind 0.01€
loncholoncho posts big blind 0.02€
Dealt to Fried Berg [6h Jc]
*** PRE-FLOP *** 
vatoloco26 raises 1.49€ to 1.51€ and is all-in
Ertorko folds
Fried Berg folds
DGG23 folds
Fran1Oller folds
loncholoncho folds
vatoloco26 collected 1.54€ from pot
*** SUMMARY ***
Total pot 1.54€ | No rake
Seat 3: vatoloco26 won 1.54€


Winamax Poker - HOLD-UP "Colorado" - HandId: #19116069-346836-1701443546 - Holdem no limit (0.01€/0.02€) - 2023/12/01 15:12:26 UTC
Table: 'Colorado' 6-max (real money) Seat #6 is the button
Seat 1: mp1z (3.13€)
Seat 2: Fried Berg (0.56€)
Seat 3: zRotteN (1.98€)
Seat 4: Yondaime M (2.64€)
Seat 5: moussaillax (1.08€)
Seat 6: Ertorko (2.35€)
*** ANTE/BLINDS ***
mp1z posts small blind 0.01€
Fried Berg posts big blind 0.02€
Dealt to Fried Berg [Th Jc]
*** PRE-FLOP *** 
zRotteN folds
Yondaime M folds
moussaillax folds
Ertorko folds
mp1z raises 0.04€ to 0.06€
Fried Berg calls 0.04€
*** FLOP *** [6h 7h Ad]
mp1z checks
Fried Berg checks
*** TURN *** [6h 7h Ad][5d]
mp1z checks
Fried Berg checks
*** RIVER *** [6h 7h Ad 5d][6c]
mp1z checks
Fried Berg checks
*** SHOW DOWN ***
Fried Berg shows [Th Jc] (One pair : 6)
mp1z shows [Qc Jd] (One pair : 6)
mp1z collected 0.11€ from pot
*** SUMMARY ***
Total pot 0.11€ | Rake 0.01€
Board: [6h 7h Ad 5d 6c]
Seat 1: mp1z (small blind) showed [Qc Jd] and won 0.11€ with One pair : 6
Seat 2: Fried Berg (big blind) showed [Th Jc] and lost with One pair : 6


Winamax Poker - HOLD-UP "Colorado" - HandId: #19116069-346881-1701443567 - Holdem no limit (0.01€/0.02€) - 2023/12/01 15:12:47 UTC
Table: 'Colorado' 6-max (real money) Seat #6 is the button
Seat 1: zRotteN (1.98€)
Seat 2: Thequeen1205 (3.34€)
Seat 3: Fried Berg (0.50€)
Seat 4: mp1z (3.18€)
Seat 5: BestLoser85 (1.48€)
Seat 6: DGG23 (0.07€)
*** ANTE/BLINDS ***
zRotteN posts small blind 0.01€
Thequeen1205 posts big blind 0.02€
Dealt to Fried Berg [4d Ad]
*** PRE-FLOP *** 
Fried Berg raises 0.02€ to 0.04€
mp1z folds
BestLoser85 folds
DGG23 folds
zRotteN folds
Thequeen1205 folds
Fried Berg collected 0.07€ from pot
*** SUMMARY ***
Total pot 0.07€ | No rake
Seat 3: Fried Berg won 0.07€


Winamax Poker - HOLD-UP "Colorado" - HandId: #19116069-346921-1701443592 - Holdem no limit (0.01€/0.02€) - 2023/12/01 15:13:12 UTC
Table: 'Colorado' 6-max (real money) Seat #6 is the button
Seat 1: DGG23 (0.24€)
Seat 2: Eychem24 (0.50€)
Seat 3: vegifish (2.08€)
Seat 4: zRotteN (1.94€)
Seat 5: Fried Berg (0.53€)
Seat 6: 14cruyff14 (0.70€)
*** ANTE/BLINDS ***
DGG23 posts small blind 0.01€
Eychem24 posts big blind 0.02€
Dealt to Fried Berg [Th 6d]
*** PRE-FLOP *** 
vegifish folds
zRotteN folds
Fried Berg folds
14cruyff14 folds
DGG23 calls 0.01€
Eychem24 raises 0.03€ to 0.05€
DGG23 calls 0.03€
*** FLOP *** [Js 9h 3c]
DGG23 checks
Eychem24 bets 0.06€
DGG23 raises 0.13€ to 0.19€ and is all-in
Eychem24 folds
DGG23 collected 0.33€ from pot
*** SUMMARY ***
Total pot 0.33€ | Rake 0.02€
Board: [Js 9h 3c]
Seat 1: DGG23 (small blind) won 0.33€


Winamax Poker - HOLD-UP "Colorado" - HandId: #19116069-346971-1701443621 - Holdem no limit (0.01€/0.02€) - 2023/12/01 15:13:41 UTC
Table: 'Colorado' 6-max (real money) Seat #6 is the button
Seat 1: Fried Berg (0.53€)
Seat 2: LilRun (1.29€)
Seat 3: AceOf_Spades (1.97€)
Seat 4: Tr0-_-L3urr3 (3.93€)
Seat 5: moussaillax (1.04€)
Seat 6: 8Tourinho (1.31€)
*** ANTE/BLINDS ***
Fried Berg posts small blind 0.01€
LilRun posts big blind 0.02€
Dealt to Fried Berg [Jh As]
*** PRE-FLOP *** 
AceOf_Spades folds
Tr0-_-L3urr3 folds
moussaillax folds
8Tourinho raises 0.03€ to 0.05€
Fried Berg calls 0.04€
LilRun folds
*** FLOP *** [Ts 3c 2h]
Fried Berg checks
8Tourinho checks
*** TURN *** [Ts 3c 2h][Ah]
Fried Berg checks
8Tourinho bets 0.08€
Fried Berg calls 0.08€
*** RIVER *** [Ts 3c 2h Ah][Ks]
Fried Berg checks
8Tourinho bets 0.10€
Fried Berg calls 0.10€
*** SHOW DOWN ***
8Tourinho shows [Kc Jd] (One pair : Kings)
Fried Berg shows [Jh As] (One pair : Aces)
Fried Berg collected 0.43€ from pot
*** SUMMARY ***
Total pot 0.43€ | Rake 0.05€
Board: [Ts 3c 2h Ah Ks]
Seat 1: Fried Berg (small blind) showed [Jh As] and won 0.43€ with One pair : Aces
Seat 6: 8Tourinho (button) showed [Kc Jd] and lost with One pair : Kings


Winamax Poker - HOLD-UP "Colorado" - HandId: #19116069-347049-1701443665 - Holdem no limit (0.01€/0.02€) - 2023/12/01 15:14:25 UTC
Table: 'Colorado' 6-max (real money) Seat #6 is the button
Seat 1: Ertorko (2.69€)
Seat 2: 8Tourinho (1.08€)
Seat 3: T.REx. (4.17€)
Seat 4: Fried Berg (0.73€)
Seat 5: gagnejamais4 (1.61€)
Seat 6: vegifish (1.83€)
*** ANTE/BLINDS ***
Ertorko posts small blind 0.01€
8Tourinho posts big blind 0.02€
Dealt to Fried Berg [7h 9s]
*** PRE-FLOP *** 
T.REx. folds
Fried Berg folds
gagnejamais4 folds
vegifish raises 0.03€ to 0.05€
Ertorko calls 0.04€
8Tourinho folds
*** FLOP *** [Kc 8s Jd]
Ertorko checks
vegifish bets 0.06€
Ertorko calls 0.06€
*** TURN *** [Kc 8s Jd][Jh]
Ertorko checks
vegifish checks
*** RIVER *** [Kc 8s Jd Jh][Ah]
Ertorko bets 0.20€
vegifish calls 0.20€
*** SHOW DOWN ***
Ertorko shows [Js Qc] (Trips of Jacks)
vegifish shows [Qs Td] (Straight Ace high)
vegifish collected 0.58€ from pot
*** SUMMARY ***
Total pot 0.58€ | Rake 0.06€
Board: [Kc 8s Jd Jh Ah]
Seat 1: Ertorko (small blind) showed [Js Qc] and lost with Trips of Jacks
Seat 6: vegifish (button) showed [Qs Td] and won 0.58€ with Straight Ace high


Winamax Poker - HOLD-UP "Colorado" - HandId: #19116069-347055-1701443668 - Holdem no limit (0.01€/0.02€) - 2023/12/01 15:14:28 UTC
Table: 'Colorado' 6-max (real money) Seat #6 is the button
Seat 1: Neferusobek (2€)
Seat 2: 14cruyff14 (0.50€)
Seat 3: matmyl (2.11€)
Seat 4: Alexisdpp (2.05€)
Seat 5: Kaoky (5.45€)
Seat 6: Fried Berg (0.73€)
*** ANTE/BLINDS ***
Neferusobek posts small blind 0.01€
14cruyff14 posts big blind 0.02€
Dealt to Fried Berg [Kh 5h]
*** PRE-FLOP *** 
matmyl folds
Alexisdpp folds
Kaoky folds
Fried Berg raises 0.02€ to 0.04€
Neferusobek folds
14cruyff14 folds
Fried Berg collected 0.07€ from pot
*** SUMMARY ***
Total pot 0.07€ | No rake
Seat 6: Fried Berg (button) won 0.07€


Winamax Poker - HOLD-UP "Colorado" - HandId: #19116069-347090-1701443690 - Holdem no limit (0.01€/0.02€) - 2023/12/01 15:14:50 UTC
Table: 'Colorado' 6-max (real money) Seat #6 is the button
Seat 1: Dario 365 (2.33€)
Seat 2: Fried Berg (0.76€)
Seat 3: matmyl (2.11€)
Seat 4: Kaoky (2€)
Seat 5: Shadow b97 (0.49€)
Seat 6: Prudempoker (2.38€)
*** ANTE/BLINDS ***
Dario 365 posts small blind 0.01€
Fried Berg posts big blind 0.02€
Dealt to Fried Berg [9c Ah]
*** PRE-FLOP *** 
matmyl folds
Kaoky raises 0.04€ to 0.06€
Shadow b97 folds
Prudempoker folds
Dario 365 folds
Fried Berg calls 0.04€
*** FLOP *** [Qd 8s Jc]
Fried Berg checks
Kaoky bets 0.02€
Fried Berg folds
Kaoky collected 0.14€ from pot
*** SUMMARY ***
Total pot 0.14€ | Rake 0.01€
Board: [Qd 8s Jc]
Seat 4: Kaoky won 0.14€


Winamax Poker - HOLD-UP "Colorado" - HandId: #19116069-347137-1701443720 - Holdem no limit (0.01€/0.02€) - 2023/12/01 15:15:20 UTC
Table: 'Colorado' 6-max (real money) Seat #6 is the button
Seat 1: Fried Berg (0.70€)
Seat 2: bananAsSplit (2.01€)
Seat 3: Yondaime M (2.33€)
Seat 4: Jbes12 (0.85€)
Seat 5: Upswing11 (2€)
Seat 6: haouuum28 (3.84€)
*** ANTE/BLINDS ***
Fried Berg posts small blind 0.01€
bananAsSplit posts big blind 0.02€
Dealt to Fried Berg [2h 9d]
*** PRE-FLOP *** 
Yondaime M folds
Jbes12 folds
Upswing11 folds
haouuum28 folds
Fried Berg folds
bananAsSplit collected 0.03€ from pot
*** SUMMARY ***
Total pot 0.03€ | No rake
Seat 2: bananAsSplit (big blind) won 0.03€


Winamax Poker - HOLD-UP "Colorado" - HandId: #19116069-347141-1701443722 - Holdem no limit (0.01€/0.02€) - 2023/12/01 15:15:22 UTC
Table: 'Colorado' 6-max (real money) Seat #6 is the button
Seat 1: Yondaime M (2.33€)
Seat 2: Jerrycan57 (2.11€)
Seat 3: TONETONE510 (1.14€)
Seat 4: Kangourou_JJ (2.02€)
Seat 5: Eychem24 (0.50€)
Seat 6: Fried Berg (0.69€)
*** ANTE/BLINDS ***
Yondaime M posts small blind 0.01€
Jerrycan57 posts big blind 0.02€
Dealt to Fried Berg [Jd 2d]
*** PRE-FLOP *** 
TONETONE510 folds
Kangourou_JJ folds
Eychem24 folds
Fried Berg raises 0.02€ to 0.04€
Yondaime M folds
Jerrycan57 calls 0.02€
*** FLOP *** [7h 9h 8c]
Jerrycan57 checks
Fried Berg checks
*** TURN *** [7h 9h 8c][Ks]
Jerrycan57 checks
Fried Berg checks
*** RIVER *** [7h 9h 8c Ks][2s]
Jerrycan57 checks
Fried Berg checks
*** SHOW DOWN ***
Fried Berg shows [Jd 2d] (One pair : 2)
Jerrycan57 shows [6h 6s] (One pair : 6)
Jerrycan57 collected 0.08€ from pot
*** SUMMARY ***
Total pot 0.08€ | Rake 0.01€
Board: [7h 9h 8c Ks 2s]
Seat 2: Jerrycan57 (big blind) showed [6h 6s] and won 0.08€ with One pair : 6
Seat 6: Fried Berg (button) showed [Jd 2d] and lost with One pair : 2


Winamax Poker - HOLD-UP "Colorado" - HandId: #19116069-347185-1701443748 - Holdem no limit (0.01€/0.02€) - 2023/12/01 15:15:48 UTC
Table: 'Colorado' 6-max (real money) Seat #6 is the button
Seat 1: Jerrycan57 (2.15€)
Seat 2: DonKmillo (4.04€)
Seat 3: Fried Berg (0.65€)
Seat 4: KKamarAAde (4.68€)
Seat 5: KLeeMerHaut (2.03€)
Seat 6: Pierrof24 (2€)
*** ANTE/BLINDS ***
Jerrycan57 posts small blind 0.01€
DonKmillo posts big blind 0.02€
Dealt to Fried Berg [9c 4c]
*** PRE-FLOP *** 
Fried Berg folds
KKamarAAde folds
KLeeMerHaut raises 0.04€ to 0.06€
Pierrof24 folds
Jerrycan57 folds
DonKmillo calls 0.04€
*** FLOP *** [Kh 3h 2s]
DonKmillo checks
KLeeMerHaut bets 0.07€
DonKmillo calls 0.07€
*** TURN *** [Kh 3h 2s][Tc]
DonKmillo checks
KLeeMerHaut bets 0.22€
DonKmillo folds
KLeeMerHaut collected 0.46€ from pot
*** SUMMARY ***
Total pot 0.46€ | Rake 0.03€
Board: [Kh 3h 2s Tc]
Seat 5: KLeeMerHaut won 0.46€


Winamax Poker - HOLD-UP "Colorado" - HandId: #19116069-347190-1701443750 - Holdem no limit (0.01€/0.02€) - 2023/12/01 15:15:50 UTC
Table: 'Colorado' 6-max (real money) Seat #6 is the button
Seat 1: Brut2pok (2.11€)
Seat 2: Tofini (2.04€)
Seat 3: Elkebabio (2.17€)
Seat 4: Fried Berg (0.65€)
Seat 5: DosdeBras (1.20€)
Seat 6: 121 (2€)
*** ANTE/BLINDS ***
Brut2pok posts small blind 0.01€
Tofini posts big blind 0.02€
Dealt to Fried Berg [Jh Tc]
*** PRE-FLOP *** 
Elkebabio raises 0.02€ to 0.04€
Fried Berg folds
DosdeBras folds
121 folds
Brut2pok folds
Tofini folds
Elkebabio collected 0.07€ from pot
*** SUMMARY ***
Total pot 0.07€ | No rake
Seat 3: Elkebabio won 0.07€


Winamax Poker - HOLD-UP "Colorado" - HandId: #19116069-347202-1701443756 - Holdem no limit (0.01€/0.02€) - 2023/12/01 15:15:56 UTC
Table: 'Colorado' 6-max (real money) Seat #6 is the button
Seat 1: Tr0-_-L3urr3 (5.15€)
Seat 2: moussaillax (0.52€)
Seat 3: Fried Berg (0.65€)
Seat 4: Kangourou_JJ (2.40€)
Seat 5: DosdeBras (1.19€)
Seat 6: cecilon (0.45€)
*** ANTE/BLINDS ***
Tr0-_-L3urr3 posts small blind 0.01€
moussaillax posts big blind 0.02€
Dealt to Fried Berg [7s 9s]
*** PRE-FLOP *** 
Fried Berg folds
Kangourou_JJ folds
DosdeBras folds
cecilon folds
Tr0-_-L3urr3 folds
moussaillax collected 0.03€ from pot
*** SUMMARY ***
Total pot 0.03€ | No rake
Seat 2: moussaillax (big blind) won 0.03€


Winamax Poker - HOLD-UP "Colorado" - HandId: #19116069-347207-1701443759 - Holdem no limit (0.01€/0.02€) - 2023/12/01 15:15:59 UTC
Table: 'Colorado' 6-max (real money) Seat #6 is the button
Seat 1: MFCBronson (3.72€)
Seat 2: Fried Berg (0.65€)
Seat 3: P3nderYn3r (2.12€)
Seat 4: bastos2525 (2.04€)
Seat 5: Sucre10 (2.08€)
Seat 6: Ertorko (2.17€)
*** ANTE/BLINDS ***
MFCBronson posts small blind 0.01€
Fried Berg posts big blind 0.02€
Dealt to Fried Berg [5s Th]
*** PRE-FLOP *** 
P3nderYn3r folds
bastos2525 folds
Sucre10 folds
Ertorko raises 0.03€ to 0.05€
MFCBronson folds
Fried Berg folds
Ertorko collected 0.08€ from pot
*** SUMMARY ***
Total pot 0.08€ | No rake
Seat 6: Ertorko (button) won 0.08€


Winamax Poker - HOLD-UP "Colorado" - HandId: #19116069-347220-1701443767 - Holdem no limit (0.01€/0.02€) - 2023/12/01 15:16:07 UTC
Table: 'Colorado' 6-max (real money) Seat #6 is the button
Seat 1: Fried Berg (0.63€)
Seat 2: Thequeen1205 (2€)
Seat 3: Dario 365 (2.48€)
Seat 4: KKamarAAde (2.10€)
Seat 5: Salvinha710 (2.32€)
Seat 6: freddytooo (3.32€)
*** ANTE/BLINDS ***
Fried Berg posts small blind 0.01€
Thequeen1205 posts big blind 0.02€
Dealt to Fried Berg [Th Jc]
*** PRE-FLOP *** 
Dario 365 folds
KKamarAAde folds
Salvinha710 folds
freddytooo folds
Fried Berg raises 0.02€ to 0.04€
Thequeen1205 calls 0.02€
*** FLOP *** [Qs Tc Ah]
Fried Berg checks
Thequeen1205 checks
*** TURN *** [Qs Tc Ah][2s]
Fried Berg checks
Thequeen1205 checks
*** RIVER *** [Qs Tc Ah 2s][6c]
Fried Berg checks
Thequeen1205 checks
*** SHOW DOWN ***
Fried Berg shows [Th Jc] (One pair : Tens)
Thequeen1205 shows [Td Jd] (One pair : Tens)
Thequeen1205 collected 0.04€ from pot
Fried Berg collected 0.03€ from pot
*** SUMMARY ***
Total pot 0.07€ | Rake 0.01€
Board: [Qs Tc Ah 2s 6c]
Seat 1: Fried Berg (small blind) showed [Th Jc] and won 0.03€ with One pair : Tens
Seat 2: Thequeen1205 (big blind) showed [Td Jd] and won 0.04€ with One pair : Tens


Winamax Poker - HOLD-UP "Colorado" - HandId: #19116069-347267-1701443794 - Holdem no limit (0.01€/0.02€) - 2023/12/01 15:16:34 UTC
Table: 'Colorado' 6-max (real money) Seat #6 is the button
Seat 1: freddytooo (3.10€)
Seat 2: Brut2pok (2.09€)
Seat 3: cecilon (0.42€)
Seat 4: Fried Berg (0.62€)
Seat 5: MFCBronson (3.72€)
Seat 6: T.REx. (1.97€)
*** ANTE/BLINDS ***
freddytooo posts small blind 0.01€
Brut2pok posts big blind 0.02€
Dealt to Fried Berg [Ks 8h]
*** PRE-FLOP *** 
cecilon raises 0.03€ to 0.05€
Fried Berg folds
MFCBronson folds
T.REx. calls 0.05€
freddytooo folds
Brut2pok folds
*** FLOP *** [5h 2h 8d]
cecilon checks
T.REx. checks
*** TURN *** [5h 2h 8d][Td]
cecilon bets 0.02€
T.REx. calls 0.02€
*** RIVER *** [5h 2h 8d Td][Ad]
cecilon bets 0.06€
T.REx. calls 0.06€
*** SHOW DOWN ***
cecilon shows [Ah Jd] (One pair : Aces)
T.REx. shows [Ac Kh] (One pair : Aces)
T.REx. collected 0.26€ from pot
*** SUMMARY ***
Total pot 0.26€ | Rake 0.03€
Board: [5h 2h 8d Td Ad]
Seat 3: cecilon showed [Ah Jd] and lost with One pair : Aces
Seat 6: T.REx. (button) showed [Ac Kh] and won 0.26€ with One pair : Aces


Winamax Poker - HOLD-UP "Colorado" - HandId: #19116069-347272-1701443797 - Holdem no limit (0.01€/0.02€) - 2023/12/01 15:16:37 UTC
Table: 'Colorado' 6-max (real money) Seat #6 is the button
Seat 1: gagnejamais4 (1.55€)
Seat 2: Fran1Oller (2.50€)
Seat 3: SharkAKK (2.66€)
Seat 4: Ertorko (2.36€)
Seat 5: Fried Berg (0.62€)
Seat 6: Jerrycan57 (2.03€)
*** ANTE/BLINDS ***
gagnejamais4 posts small blind 0.01€
Fran1Oller posts big blind 0.02€
Dealt to Fried Berg [3d 7s]
*** PRE-FLOP *** 
SharkAKK folds
Ertorko raises 0.03€ to 0.05€
Fried Berg folds
Jerrycan57 folds
gagnejamais4 folds
Fran1Oller folds
Ertorko collected 0.08€ from pot
*** SUMMARY ***
Total pot 0.08€ | No rake
Seat 4: Ertorko won 0.08€


Winamax Poker - HOLD-UP "Colorado" - HandId: #19116069-347276-1701443799 - Holdem no limit (0.01€/0.02€) - 2023/12/01 15:16:39 UTC
Table: 'Colorado' 6-max (real money) Seat #6 is the button
Seat 1: Ilya1mai (3.47€)
Seat 2: Sucre10 (2.07€)
Seat 3: 14cruyff14 (0.50€)
Seat 4: BobiBogdanov (2.72€)
Seat 5: Trefles4 06 (1.58€)
Seat 6: Fried Berg (0.62€)
*** ANTE/BLINDS ***
Ilya1mai posts small blind 0.01€
Sucre10 posts big blind 0.02€
Dealt to Fried Berg [Ts Jd]
*** PRE-FLOP *** 
14cruyff14 folds
BobiBogdanov raises 0.03€ to 0.05€
Trefles4 06 calls 0.05€
Fried Berg folds
Ilya1mai folds
Sucre10 folds
*** FLOP *** [4s 8c 9h]
BobiBogdanov bets 0.04€
Trefles4 06 calls 0.04€
*** TURN *** [4s 8c 9h][2s]
BobiBogdanov bets 0.07€
Trefles4 06 folds
BobiBogdanov collected 0.26€ from pot
*** SUMMARY ***
Total pot 0.26€ | Rake 0.02€
Board: [4s 8c 9h 2s]
Seat 4: BobiBogdanov won 0.26€


Winamax Poker - HOLD-UP "Colorado" - HandId: #19116069-347290-1701443806 - Holdem no limit (0.01€/0.02€) - 2023/12/01 15:16:46 UTC
Table: 'Colorado' 6-max (real money) Seat #6 is the button
Seat 1: Bback (4.60€)
Seat 2: Salvinha710 (2.28€)
Seat 3: Fried Berg (0.62€)
Seat 4: wAAlterrr (1.97€)
Seat 5: Magic-Harpe (1.07€)
Seat 6: OursDesMers (2.01€)
*** ANTE/BLINDS ***
Bback posts small blind 0.01€
Salvinha710 posts big blind 0.02€
Dealt to Fried Berg [4c 8d]
*** PRE-FLOP *** 
Fried Berg folds
wAAlterrr folds
Magic-Harpe folds
OursDesMers raises 0.04€ to 0.06€
Bback raises 0.12€ to 0.18€
Salvinha710 folds
OursDesMers calls 0.12€
*** FLOP *** [7c 7s 5c]
Bback bets 0.19€
OursDesMers folds
Bback collected 0.53€ from pot
*** SUMMARY ***
Total pot 0.53€ | Rake 0.04€
Board: [7c 7s 5c]
Seat 1: Bback (small blind) won 0.53€


Winamax Poker - HOLD-UP "Colorado" - HandId: #19116069-347293-1701443808 - Holdem no limit (0.01€/0.02€) - 2023/12/01 15:16:48 UTC
Table: 'Colorado' 6-max (real money) Seat #6 is the button
Seat 1: Tofini (2€)
Seat 2: Kangourou_JJ (2€)
Seat 3: iban72 (1.24€)
Seat 4: Fried Berg (0.62€)
Seat 5: Thequeen1205 (2€)
Seat 6: Ertorko (2.07€)
*** ANTE/BLINDS ***
Tofini posts small blind 0.01€
Kangourou_JJ posts big blind 0.02€
Dealt to Fried Berg [4c Qd]
*** PRE-FLOP *** 
iban72 folds
Fried Berg folds
Thequeen1205 folds
Ertorko raises 0.03€ to 0.05€
Tofini calls 0.04€
Kangourou_JJ folds
*** FLOP *** [9d 7d 6d]
Tofini checks
Ertorko bets 0.04€
Tofini folds
Ertorko collected 0.15€ from pot
*** SUMMARY ***
Total pot 0.15€ | Rake 0.01€
Board: [9d 7d 6d]
Seat 6: Ertorko (button) won 0.15€


Winamax Poker - HOLD-UP "Colorado" - HandId: #19116069-347300-1701443810 - Holdem no limit (0.01€/0.02€) - 2023/12/01 15:16:50 UTC
Table: 'Colorado' 6-max (real money) Seat #6 is the button
Seat 1: vatoloco26 (1.24€)
Seat 2: Fried Berg (0.62€)
Seat 3: titituf (0.85€)
Seat 4: vegifish (2.34€)
Seat 5: bananAsSplit (2.14€)
Seat 6: Thequeen1205 (2€)
*** ANTE/BLINDS ***
vatoloco26 posts small blind 0.01€
Fried Berg posts big blind 0.02€
Dealt to Fried Berg [Ac 2h]
*** PRE-FLOP *** 
titituf calls 0.02€
vegifish raises 0.05€ to 0.07€
bananAsSplit folds
Thequeen1205 folds
vatoloco26 calls 0.06€
Fried Berg folds
titituf calls 0.05€
*** FLOP *** [Jd 4h 7c]
vatoloco26 checks
titituf bets 0.02€
vegifish calls 0.02€
vatoloco26 folds
*** TURN *** [Jd 4h 7c][5d]
titituf bets 0.02€
vegifish calls 0.02€
*** RIVER *** [Jd 4h 7c 5d][9d]
titituf bets 0.04€
vegifish folds
titituf collected 0.32€ from pot
*** SUMMARY ***
Total pot 0.32€ | Rake 0.03€
Board: [Jd 4h 7c 5d 9d]
Seat 3: titituf won 0.32€


Winamax Poker - HOLD-UP "Colorado" - HandId: #19116069-347314-1701443818 - Holdem no limit (0.01€/0.02€) - 2023/12/01 15:16:58 UTC
Table: 'Colorado' 6-max (real money) Seat #6 is the button
Seat 1: Fried Berg (0.60€)
Seat 2: JissEl1te (2.10€)
Seat 3: Jneb34b (0.73€)
Seat 4: 121 (2€)
Seat 5: Malva-125593 (2€)
Seat 6: MFCBronson (3.66€)
*** ANTE/BLINDS ***
Fried Berg posts small blind 0.01€
JissEl1te posts big blind 0.02€
Dealt to Fried Berg [3d 5c]
*** PRE-FLOP *** 
Jneb34b folds
121 folds
Malva-125593 folds
MFCBronson raises 0.03€ to 0.05€
Fried Berg folds
JissEl1te folds
MFCBronson collected 0.08€ from pot
*** SUMMARY ***
Total pot 0.08€ | No rake
Seat 6: MFCBronson (button) won 0.08€


Winamax Poker - HOLD-UP "Colorado" - HandId: #19116069-347320-1701443821 - Holdem no limit (0.01€/0.02€) - 2023/12/01 15:17:01 UTC
Table: 'Colorado' 6-max (real money) Seat #6 is the button
Seat 1: Tr0-_-L3urr3 (5.78€)
Seat 2: JuNeufQs (3.04€)
Seat 3: Ilya1mai (3.46€)
Seat 4: Brut2pok (2.07€)
Seat 5: Fried Berg (0.59€)
Seat 6: gagnejamais4 (1.65€)
*** ANTE/BLINDS ***
Tr0-_-L3urr3 posts small blind 0.01€
JuNeufQs posts big blind 0.02€
Dealt to Fried Berg [Jh 7s]
*** PRE-FLOP *** 
Ilya1mai folds
Brut2pok folds
Fried Berg folds
gagnejamais4 raises 0.04€ to 0.06€
Tr0-_-L3urr3 folds
JuNeufQs folds
gagnejamais4 collected 0.09€ from pot
*** SUMMARY ***
Total pot 0.09€ | No rake
Seat 6: gagnejamais4 (button) won 0.09€


Winamax Poker - HOLD-UP "Colorado" - HandId: #19116069-347325-1701443824 - Holdem no limit (0.01€/0.02€) - 2023/12/01 15:17:04 UTC
Table: 'Colorado' 6-max (real money) Seat #6 is the button
Seat 1: 121 (2€)
Seat 2: bastos2525 (0.83€)
Seat 3: Fried Berg (0.59€)
Seat 4: Neferusobek (2.44€)
Seat 5: DGG23 (0.39€)
Seat 6: KLeeMerHaut (2.11€)
*** ANTE/BLINDS ***
121 posts small blind 0.01€
bastos2525 posts big blind 0.02€
Dealt to Fried Berg [3d 3s]
*** PRE-FLOP *** 
Fried Berg raises 0.02€ to 0.04€
Neferusobek folds
DGG23 folds
KLeeMerHaut folds
121 folds
bastos2525 calls 0.02€
*** FLOP *** [4h Kc 6h]
bastos2525 checks
Fried Berg checks
*** TURN *** [4h Kc 6h][8d]
bastos2525 bets 0.09€
Fried Berg folds
bastos2525 collected 0.17€ from pot
*** SUMMARY ***
Total pot 0.17€ | Rake 0.01€
Board: [4h Kc 6h 8d]
Seat 2: bastos2525 (big blind) won 0.17€


Winamax Poker - HOLD-UP "Colorado" - HandId: #19116069-347360-1701443841 - Holdem no limit (0.01€/0.02€) - 2023/12/01 15:17:21 UTC
Table: 'Colorado' 6-max (real money) Seat #6 is the button
Seat 1: 14cruyff14 (0.93€)
Seat 2: stephenko33 (0.49€)
Seat 3: 121 (2.03€)
Seat 4: KKamarAAde (5.20€)
Seat 5: Tr0-_-L3urr3 (5.77€)
Seat 6: Fried Berg (0.55€)
*** ANTE/BLINDS ***
14cruyff14 posts small blind 0.01€
stephenko33 posts big blind 0.02€
Dealt to Fried Berg [2s Jc]
*** PRE-FLOP *** 
121 folds
KKamarAAde raises 0.04€ to 0.06€
Tr0-_-L3urr3 folds
Fried Berg folds
14cruyff14 folds
stephenko33 folds
KKamarAAde collected 0.09€ from pot
*** SUMMARY ***
Total pot 0.09€ | No rake
Seat 4: KKamarAAde won 0.09€


Winamax Poker - HOLD-UP "Colorado" - HandId: #19116069-347364-1701443843 - Holdem no limit (0.01€/0.02€) - 2023/12/01 15:17:23 UTC
Table: 'Colorado' 6-max (real money) Seat #6 is the button
Seat 1: Upswing11 (2.01€)
Seat 2: haouuum28 (2.95€)
Seat 3: Eychem24 (0.50€)
Seat 4: Fried Berg (0.55€)
Seat 5: bastos2525 (1.25€)
Seat 6: JFSredbaron (2.12€)
*** ANTE/BLINDS ***
Upswing11 posts small blind 0.01€
haouuum28 posts big blind 0.02€
Dealt to Fried Berg [8h Ts]
*** PRE-FLOP *** 
Eychem24 folds
Fried Berg folds
bastos2525 raises 0.05€ to 0.07€
JFSredbaron folds
Upswing11 folds
haouuum28 folds
bastos2525 collected 0.10€ from pot
*** SUMMARY ***
Total pot 0.10€ | No rake
Seat 5: bastos2525 won 0.10€


Winamax Poker - HOLD-UP "Colorado" - HandId: #19116069-347370-1701443845 - Holdem no limit (0.01€/0.02€) - 2023/12/01 15:17:25 UTC
Table: 'Colorado' 6-max (real money) Seat #6 is the button
Seat 1: KLeeMerHaut (2.16€)
Seat 2: julien08090 (1.95€)
Seat 3: flushpurple (2.14€)
Seat 4: BMWTPM (1.59€)
Seat 5: Fried Berg (0.55€)
Seat 6: Fran1Oller (5.22€)
Hold-up to Pot: total 0.20€
*** ANTE/BLINDS ***
KLeeMerHaut posts small blind 0.01€
julien08090 posts big blind 0.02€
Dealt to Fried Berg [3c 2h]
*** PRE-FLOP *** 
flushpurple folds
BMWTPM folds
Fried Berg folds
Fran1Oller calls 0.02€
KLeeMerHaut calls 0.01€
julien08090 checks
*** FLOP *** [9h Qh 7d]
KLeeMerHaut checks
julien08090 bets 0.09€
Fran1Oller folds
KLeeMerHaut calls 0.09€
*** TURN *** [9h Qh 7d][4c]
KLeeMerHaut checks
julien08090 bets 0.15€
KLeeMerHaut calls 0.15€
*** RIVER *** [9h Qh 7d 4c][2s]
KLeeMerHaut checks
julien08090 checks
*** SHOW DOWN ***
KLeeMerHaut shows [6h 5h] (High card : Queen)
julien08090 shows [7h Td] (One pair : 7)
julien08090 collected 0.69€ from pot
*** SUMMARY ***
Total pot 0.69€ | Rake 0.05€
Board: [9h Qh 7d 4c 2s]
Seat 1: KLeeMerHaut (small blind) showed [6h 5h] and lost with High card : Queen
Seat 2: julien08090 (big blind) showed [7h Td] and won 0.69€ with One pair : 7


Winamax Poker - HOLD-UP "Colorado" - HandId: #19116069-347379-1701443851 - Holdem no limit (0.01€/0.02€) - 2023/12/01 15:17:31 UTC
Table: 'Colorado' 6-max (real money) Seat #6 is the button
Seat 1: Ertorko (2.58€)
Seat 2: Fried Berg (0.55€)
Seat 3: freddytooo (3.10€)
Seat 4: stephenko33 (0.46€)
Seat 5: Tofini (2€)
Seat 6: Brut2pok (3.35€)
*** ANTE/BLINDS ***
Ertorko posts small blind 0.01€
Fried Berg posts big blind 0.02€
Dealt to Fried Berg [7s 2h]
*** PRE-FLOP *** 
freddytooo folds
stephenko33 raises 0.02€ to 0.04€
Tofini folds
Brut2pok folds
Ertorko raises 2.54€ to 2.58€ and is all-in
Fried Berg folds
stephenko33 folds
Ertorko collected 2.64€ from pot
*** SUMMARY ***
Total pot 2.64€ | No rake
Seat 1: Ertorko (small blind) won 2.64€


Winamax Poker - HOLD-UP "Colorado" - HandId: #19116069-347392-1701443857 - Holdem no limit (0.01€/0.02€) - 2023/12/01 15:17:37 UTC
Table: 'Colorado' 6-max (real money) Seat #6 is the button
Seat 1: Fried Berg (0.53€)
Seat 2: Dario 365 (4.25€)
Seat 3: gil95100 (2.87€)
Seat 4: freddytooo (2.84€)
Seat 5: vatoloco26 (1.17€)
Seat 6: Beralopette (1.56€)
*** ANTE/BLINDS ***
Fried Berg posts small blind 0.01€
Dario 365 posts big blind 0.02€
Dealt to Fried Berg [5s Ad]
*** PRE-FLOP *** 
gil95100 folds
freddytooo folds
vatoloco26 calls 0.02€
Beralopette folds
Fried Berg calls 0.01€
Dario 365 checks
*** FLOP *** [9h 2h 3s]
Fried Berg checks
Dario 365 checks
vatoloco26 checks
*** TURN *** [9h 2h 3s][Td]
Fried Berg checks
Dario 365 checks
vatoloco26 bets 0.04€
Fried Berg folds
Dario 365 folds
vatoloco26 collected 0.09€ from pot
*** SUMMARY ***
Total pot 0.09€ | Rake 0.01€
Board: [9h 2h 3s Td]
Seat 5: vatoloco26 won 0.09€


Winamax Poker - HOLD-UP "Colorado" - HandId: #19116069-347462-1701443906 - Holdem no limit (0.01€/0.02€) - 2023/12/01 15:18:26 UTC
Table: 'Colorado' 6-max (real money) Seat #6 is the button
Seat 1: Thequeen1205 (2.09€)
Seat 2: Fried Berg (0.51€)
Seat 3: angelirola14 (1.97€)
Seat 4: Fanfan190 (2€)
Seat 5: OursDesMers (2.20€)
Seat 6: moussaillax (0.39€)
*** ANTE/BLINDS ***
Thequeen1205 posts small blind 0.01€
Fried Berg posts big blind 0.02€
Dealt to Fried Berg [3h 4s]
*** PRE-FLOP *** 
angelirola14 folds
Fanfan190 raises 0.04€ to 0.06€
OursDesMers folds
moussaillax folds
Thequeen1205 folds
Fried Berg folds
Fanfan190 collected 0.09€ from pot
*** SUMMARY ***
Total pot 0.09€ | No rake
Seat 4: Fanfan190 won 0.09€


Winamax Poker - HOLD-UP "Colorado" - HandId: #19116069-347475-1701443914 - Holdem no limit (0.01€/0.02€) - 2023/12/01 15:18:34 UTC
Table: 'Colorado' 6-max (real money) Seat #6 is the button
Seat 1: Cejargordas (2€)
Seat 2: 121 (2.03€)
Seat 3: Fried Berg (0.49€)
Seat 4: vicoaudrey11 (2.02€)
Seat 5: DGG23 (0.50€)
Seat 6: Erenox (2.69€)
*** ANTE/BLINDS ***
Cejargordas posts small blind 0.01€
121 posts big blind 0.02€
Dealt to Fried Berg [Jc Qd]
*** PRE-FLOP *** 
Fried Berg raises 0.03€ to 0.05€
vicoaudrey11 calls 0.05€
DGG23 calls 0.05€
Erenox folds
Cejargordas folds
121 raises 0.25€ to 0.30€
Fried Berg raises 0.19€ to 0.49€ and is all-in
vicoaudrey11 calls 0.44€
DGG23 raises 0.01€ to 0.50€ and is all-in
121 calls 0.20€
vicoaudrey11 calls 0.01€
*** FLOP *** [6c Ad 9c]
121 bets 0.50€
vicoaudrey11 calls 0.50€
*** TURN *** [6c Ad 9c][7d]
121 checks
vicoaudrey11 checks
*** RIVER *** [6c Ad 9c 7d][Td]
121 checks
vicoaudrey11 checks
*** SHOW DOWN ***
Fried Berg shows [Jc Qd] (High card : Ace)
vicoaudrey11 shows [Js 5s] (High card : Ace)
DGG23 shows [4d 4s] (One pair : 4)
121 shows [Qs Qh] (One pair : Queens)
121 collected 2.70€ from pot
*** SUMMARY ***
Total pot 2.70€ | Rake 0.30€
Board: [6c Ad 9c 7d Td]
Seat 2: 121 (big blind) showed [Qs Qh] and won 2.70€ with One pair : Queens
Seat 3: Fried Berg showed [Jc Qd] and lost with High card : Ace
Seat 4: vicoaudrey11 showed [Js 5s] and lost with High card : Ace
Seat 5: DGG23 showed [4d 4s] and lost with One pair : 4


